timestamp,as_id,ipv4_prefix_count,ipv6_prefix_count,total_prefix_count,ipv4_neighbor_count,ipv6_neighbor_count,total_neighbor_count
2023-06-01,19653,10,17,27,505,351,519
2023-06-01,14315,20,5,25,56,43,57
2023-06-01,6453,122,22,144,621,335,631
2023-06-01,39120,48,6,54,5416,3760,5695
2023-06-01,13335,1840,1295,3135,807,246,817
2023-06-01,61568,50,33,83,3606,135,3608
2023-06-01,1299,130,18,148,2278,1570,2310
2023-06-01,3216,2087,3,2090,1929,96,1930
2023-06-01,45352,141,31,172,1649,16,1649
2023-06-01,9268,62,14,76,625,19,625
2023-06-01,38001,77,10,87,591,442,641
2023-06-01,6939,229,20,249,9540,6482,10502
2023-06-01,3561,736,7,743,125,10,126
2023-06-01,209,2433,44,2477,1062,63,1066
2023-06-01,3356,819,81,900,6451,1742,6509
2023-06-01,3257,844,41,885,1913,826,1929
2023-06-01,8289,8,0,8,173,0,173
2023-06-01,40630,4,2,6,198,125,200
2023-06-01,23367,10,8,18,368,254,380
2023-06-01,46450,63,2,65,139,89,141
2023-06-01,5645,120,4,124,315,209,318
2023-06-01,63927,29,4,33,2055,1295,2106
2023-06-01,3292,162,8,170,360,49,362
2023-06-01,55222,12,4,16,18,4,18
2023-06-01,174,3510,673,4183,6442,2245,6524
2023-06-01,40387,87,1,88,26,8,26
2023-06-01,2381,36,2,38,217,22,218
2023-06-01,5650,1887,6,1893,213,17,215
2023-06-01,7545,5720,1170,6890,329,45,334
2023-06-01,2764,309,31,340,55,5,57
2023-06-01,38803,15,0,15,2,0,2
2023-06-01,4764,379,4,383,173,26,176
2023-06-01,1221,325,3,328,249,61,254
2023-06-01,2519,190,2,192,73,49,77
2023-06-01,2914,246,9,255,1474,898,1510
2023-06-01,2497,173,8,181,197,112,198
2023-06-01,11164,5,3,8,151,41,152
2023-06-01,9304,468,13,481,219,65,228
2023-06-01,141750,0,0,0,5,0,5
2023-06-01,141748,6,0,6,1,0,1
2023-06-01,9498,2983,74,3057,967,314,984
2023-06-01,15412,33,1,34,69,25,71
2023-06-01,1239,817,32,849,446,58,452
2023-06-01,4657,199,78,277,251,50,258
2023-06-01,7670,18,1,19,29,12,30
2023-06-01,18144,22,1,23,1,1,1
2023-06-01,37468,13,3,16,922,98,926
2023-06-01,30600,77,2,79,69,31,69
2023-06-01,7473,42,8,50,294,136,303
2023-06-01,2516,516,9,525,194,96,200
2023-06-01,4637,542,14,556,473,199,489
2023-06-01,38040,27,4,31,35,16,36
2023-06-01,23969,1926,7,1933,14,4,14
2023-06-01,9002,37,1,38,1065,563,1223
2023-06-01,58453,65,7,72,125,53,136
2023-06-01,4651,35,1,36,65,38,69
2023-06-01,4837,900,462,1362,100,45,102
2023-06-01,138421,236,29,265,4,2,4
2023-06-01,6461,204,14,218,2336,614,2365
2023-06-01,10099,63,3,66,69,8,70
2023-06-01,5511,104,8,112,240,126,252
2023-06-01,4766,2321,152,2473,496,34,507
2023-06-01,21859,1132,123,1255,153,81,161
2023-06-01,24151,53,35,88,8,8,8
2023-06-01,4808,1530,916,2446,93,23,94
2023-06-01,3491,449,21,470,638,255,646
2023-06-01,4134,705,605,1310,167,119,175
2023-06-01,58461,311,21,332,6,4,7
2023-06-01,37963,568,112,680,15,12,16
2023-06-01,24406,16,7,23,6,3,7
2023-06-01,9737,1,0,1,1,0,1
2023-06-01,17676,752,3,755,188,81,189
2023-06-01,4725,168,1,169,15,4,16
2023-06-01,1828,289,47,336,115,53,120
2023-06-01,9583,1772,32,1804,174,58,179
2023-06-01,4755,2186,8,2194,749,180,762
2023-06-01,23473,549,34,583,280,12,280
2023-06-01,1273,175,1,176,242,78,245
2023-06-01,64049,7,0,7,24,16,28
2023-06-01,55836,287,228,515,128,41,128
2023-06-01,132215,153,10,163,72,29,72
2023-06-01,64764,1,0,1,1,0,1
2023-06-01,137130,8,1,9,2,1,2
2023-06-01,6762,155,6,161,554,259,563
2023-06-01,3320,660,60,720,490,203,506
2023-06-01,57463,1,0,1,73,34,82
2023-06-01,140202,3,0,3,3,0,3
2023-06-01,396421,3,0,3,5,0,5
2023-06-01,7497,434,158,592,17,8,17
2023-06-01,38345,26,11,37,4,6,6
2023-06-01,4788,376,3,379,127,66,135
2023-06-01,9885,2,0,2,15,9,16
2023-06-01,142501,6,6,12,4,3,4
2023-06-01,148000,5,5,10,2,3,3
2023-06-01,142502,7,11,18,4,4,5
2023-06-01,22388,1,2,3,10,9,10
2023-06-01,11537,31,1,32,120,94,121
2023-06-01,396390,1,0,1,5,4,5
2023-06-01,3786,868,56,924,337,5,337
2023-06-01,38091,68,0,68,17,0,17
2023-06-01,18313,57,0,57,1,0,1
2023-06-01,41095,79,56,135,711,312,762
2023-06-01,18318,48,0,48,1,0,1
2023-06-01,9318,675,4,679,364,28,367
2023-06-01,45996,98,0,98,5,0,5
2023-06-01,701,1057,40,1097,1083,126,1113
2023-06-01,38669,139,0,139,1,0,1
2023-06-01,17839,126,0,126,1,0,1
2023-06-01,4811,230,77,307,15,9,15
2023-06-01,45090,2239,39,2278,16,7,17
2023-06-01,58466,123,24,147,10,7,10
2023-06-01,136958,367,574,941,10,5,11
2023-06-01,132203,1056,18,1074,51,27,54
2023-06-01,140979,214,4,218,2,1,2
2023-06-01,134756,77,17,94,3,2,3
2023-06-01,38283,476,47,523,9,6,9
2023-06-01,131098,2,0,2,1,0,1
2023-06-01,131099,2,0,2,1,0,1
2023-06-01,131100,3,2,5,1,1,1
2023-06-01,9957,12,0,12,33,20,33
2023-06-01,9286,185,5,190,19,4,19
2023-06-01,23599,4,3,7,3,2,3
2023-06-01,17579,25,4,29,11,6,11
2023-06-01,1237,198,5,203,42,5,43
2023-06-01,23596,5,4,9,4,3,4
2023-06-01,7660,2,2,4,31,20,32
2023-06-01,4847,922,5,927,73,18,76
2023-06-01,22548,1,1,2,21,15,24
2023-06-01,16735,41,4,45,518,284,536
2023-06-01,9858,17,1,18,5,3,5
2023-06-01,23600,12,4,16,6,5,6
2023-06-01,8763,4,1,5,16,13,18
2023-06-01,33891,0,0,0,217,576,621
2023-06-01,5539,20,5,25,18,9,20
2023-06-01,20562,0,0,0,99,75,122
2023-06-01,13237,34,20,54,209,92,215
2023-06-01,21385,9,1,10,26,18,28
2023-06-01,24785,19,2,21,138,75,153
2023-06-01,56120,26,0,26,1,0,1
2023-06-01,59125,15,4,19,6,2,6
2023-06-01,38634,9,1,10,11,6,11
2023-06-01,55410,913,10,923,210,49,217
2023-06-01,45528,829,39,868,9,4,9
2023-06-01,9730,8,3,11,154,32,155
2023-06-01,18881,1102,69,1171,190,1,190
2023-06-01,12956,50,4,54,196,116,203
2023-06-01,139007,169,70,239,1,1,1
2023-06-01,9929,194,22,216,22,8,23
2023-06-01,64050,1159,2,1161,38,3,38
2023-06-01,4809,294,105,399,124,46,133
2023-06-01,23764,109,16,125,112,29,118
2023-06-01,3223,257,20,277,246,26,249
2023-06-01,2514,168,4,172,15,8,15
2023-06-01,9680,1,0,1,15,7,15
2023-06-01,3462,243,250,493,57,30,60
2023-06-01,6079,119,18,137,197,32,200
2023-06-01,4760,386,9,395,11,4,11
2023-06-01,4635,0,0,0,153,53,165
2023-06-01,4775,349,122,471,169,39,171
2023-06-01,29838,336,31,367,91,35,96
2023-06-01,40633,2,0,2,5,0,5
2023-06-01,18392,2,0,2,2,0,2
2023-06-01,132199,581,185,766,2,2,2
2023-06-01,3549,744,47,791,808,144,822
2023-06-01,38266,759,1301,2060,3,3,3
2023-06-01,55644,102,61,163,21,13,21
2023-06-01,4804,257,9,266,5,5,6
2023-06-01,7474,279,6,285,205,34,210
2023-06-01,45083,52,0,52,1,0,1
2023-06-01,10089,11,2,13,16,14,18
2023-06-01,9587,76,34,110,9,5,10
2023-06-01,24378,74,13,87,2,1,2
2023-06-01,15932,11,1,12,13,12,15
2023-06-01,140647,17,186,203,1,11,11
2023-06-01,4538,5098,2,5100,44,133,173
2023-06-01,23911,2,2,4,12,13,19
2023-06-01,24361,33,0,33,1,0,1
2023-06-01,23855,2,1,3,26,14,26
2023-06-01,24490,1,1,2,12,6,12
2023-06-01,24489,2,2,4,4,3,5
2023-06-01,18403,4207,4214,8421,220,89,225
2023-06-01,59360,0,0,0,20,0,20
2023-06-01,38819,113,10,123,8,2,8
2023-06-01,9444,29,0,29,1,0,1
2023-06-01,9605,905,301,1206,11,9,13
2023-06-01,142404,2,0,2,1,0,1
2023-06-01,132147,7,3,10,1,1,1
2023-06-01,134768,59,33,92,1,11,11
2023-06-01,17429,42,0,42,3,0,3
2023-06-01,9808,9489,4448,13937,32,22,33
2023-06-01,56048,120,45,165,29,8,32
2023-06-01,23724,710,67,777,18,11,18
2023-06-01,55990,160,8,168,11,9,14
2023-06-01,137753,2,1,3,3,1,3
2023-06-01,58851,20,0,20,1,0,1
2023-06-01,59034,1,0,1,1,0,1
2023-06-01,9845,318,0,318,3,0,3
2023-06-01,10066,85,0,85,1,0,1
2023-06-01,17577,74,0,74,1,0,1
2023-06-01,9697,106,0,106,1,0,1
2023-06-01,4826,179,9,188,470,111,478
2023-06-01,9723,200,2,202,26,1,26
2023-06-01,137409,177,89,266,383,103,395
2023-06-01,136907,238,45,283,66,47,73
2023-06-01,7303,237,117,354,222,44,226
2023-06-01,10834,102,1,103,25,2,25
2023-06-01,6663,51,2,53,137,37,142
2023-06-01,12975,261,8,269,29,5,29
2023-06-01,12479,7305,1612,8917,76,16,79
2023-06-01,15169,873,106,979,43,29,48
2023-06-01,396982,2660,74,2734,2,1,2
2023-06-01,131293,278,4,282,20,13,20
2023-06-01,45806,18,0,18,6,0,6
2023-06-01,137241,2,1,3,2,1,2
2023-06-01,147027,4,2,6,4,2,4
2023-06-01,45758,43,1,44,42,13,46
2023-06-01,55808,5,0,5,16,7,16
2023-06-01,134166,26,1,27,4,1,4
2023-06-01,45769,229,28,257,13,4,13
2023-06-01,45271,835,1748,2583,2,2,2
2023-06-01,139019,234,0,234,1,0,1
2023-06-01,137687,51,0,51,1,0,1
2023-06-01,139018,34,0,34,2,0,2
2023-06-01,139587,2,0,2,1,0,1
2023-06-01,9505,30,9,39,63,25,65
2023-06-01,24157,104,25,129,8,3,8
2023-06-01,9924,630,23,653,61,21,61
2023-06-01,10158,22,4,26,17,9,17
2023-06-01,38099,55,1,56,1,1,1
2023-06-01,9848,88,2,90,52,2,52
2023-06-01,23588,23,0,23,4,0,4
2023-06-01,4791,30,0,30,1,0,1
2023-06-01,9579,2,0,2,2,0,2
2023-06-01,9526,47,0,47,4,0,4
2023-06-01,45376,12,0,12,3,0,3
2023-06-01,18305,53,0,53,5,0,5
2023-06-01,55633,2,0,2,2,0,2
2023-06-01,45974,282,0,282,10,0,10
2023-06-01,9630,2,0,2,2,0,2
2023-06-01,9684,18,0,18,2,0,2
2023-06-01,9638,30,0,30,4,0,4
2023-06-01,38707,13,0,13,2,0,2
2023-06-01,7562,135,0,135,13,0,13
2023-06-01,9569,72,0,72,1,0,1
2023-06-01,9762,113,0,113,1,0,1
2023-06-01,23584,329,0,329,2,0,2
2023-06-01,9319,216,0,216,1,0,1
2023-06-01,9277,1,0,1,1,0,1
2023-06-01,17846,1,0,1,1,0,1
2023-06-01,46004,1,0,1,1,0,1
2023-06-01,10196,6,0,6,3,0,3
2023-06-01,55586,27,0,27,2,0,2
2023-06-01,45370,19,1,20,3,2,3
2023-06-01,23601,18,0,18,2,0,2
2023-06-01,55615,109,0,109,2,0,2
2023-06-01,9647,62,0,62,4,0,4
2023-06-01,9851,2,0,2,1,0,1
2023-06-01,38688,17,0,17,2,0,2
2023-06-01,131852,2,0,2,2,0,2
2023-06-01,9967,5,0,5,3,0,3
2023-06-01,17873,9,0,9,2,0,2
2023-06-01,10069,3,0,3,2,0,2
2023-06-01,23579,26,0,26,2,0,2
2023-06-01,10167,9,0,9,4,0,4
2023-06-01,38122,4,0,4,2,0,2
2023-06-01,9944,7,0,7,2,0,2
2023-06-01,16477,32,0,32,20,0,20
2023-06-01,9860,13,0,13,2,0,2
2023-06-01,38123,9,0,9,1,0,1
2023-06-01,4665,31,0,31,3,0,3
2023-06-01,18314,6,0,6,3,0,3
2023-06-01,17574,18,0,18,4,0,4
2023-06-01,17841,445,0,445,6,0,6
2023-06-01,45400,194,0,194,10,0,10
2023-06-01,38396,5,0,5,1,0,1
2023-06-01,38390,6,0,6,1,0,1
2023-06-01,9692,3,0,3,2,0,2
2023-06-01,10185,25,0,25,3,0,3
2023-06-01,38392,5,0,5,1,0,1
2023-06-01,38394,6,0,6,1,0,1
2023-06-01,38697,18,0,18,2,0,2
2023-06-01,9773,6,0,6,2,0,2
2023-06-01,18317,5,0,5,4,0,4
2023-06-01,38402,8,0,8,1,0,1
2023-06-01,38400,8,0,8,1,0,1
2023-06-01,38411,6,0,6,1,0,1
2023-06-01,38401,22,0,22,1,0,1
2023-06-01,38399,4,0,4,1,0,1
2023-06-01,45409,2,0,2,2,0,2
2023-06-01,38415,33,0,33,1,0,1
2023-06-01,38408,7,0,7,1,0,1
2023-06-01,38403,7,0,7,1,0,1
2023-06-01,131802,4,0,4,3,0,3
2023-06-01,9766,2,0,2,3,0,3
2023-06-01,38407,4,0,4,1,0,1
2023-06-01,38414,4,0,4,1,0,1
2023-06-01,9523,18,0,18,2,0,2
2023-06-01,63199,411,13,424,47,14,49
2023-06-01,140951,8,0,8,29,8,29
2023-06-01,55625,11,0,11,2,0,2
2023-06-01,10062,4,0,4,2,0,2
2023-06-01,131101,3,0,3,2,0,2
2023-06-01,38112,2,0,2,2,0,2
2023-06-01,23594,4,0,4,1,0,1
2023-06-01,38389,12,0,12,2,0,2
2023-06-01,9958,4,0,4,1,0,1
2023-06-01,23930,140,1,141,26,5,26
2023-06-01,23576,178,0,178,26,0,26
2023-06-01,9770,308,0,308,1,0,1
2023-06-01,9704,6,0,6,2,0,2
2023-06-01,3215,907,41,948,109,29,112
2023-06-01,20940,4142,812,4954,151,129,162
2023-06-01,34164,140,74,214,11,11,11
2023-06-01,16625,3102,5,3107,12,3,14
2023-06-01,3303,333,42,375,199,81,206
2023-06-01,12874,118,3,121,229,35,233
2023-06-01,12389,2941,117,3058,1123,171,1132
2023-06-01,12222,35,158,193,32,26,37
2023-06-01,8220,169,21,190,1041,225,1053
2023-06-01,21342,85,75,160,4,3,4
2023-06-01,8966,25,7,32,83,45,86
2023-06-01,43639,1,1,2,3,3,3
2023-06-01,3741,209,4,213,85,23,85
2023-06-01,37350,19,1,20,13,2,13
2023-06-01,30997,1,1,2,3,1,3
2023-06-01,26615,1028,325,1353,90,33,93
2023-06-01,37662,22,17,39,124,48,131
2023-06-01,15964,85,15,100,27,5,27
2023-06-01,37100,10,3,13,239,78,243
2023-06-01,12735,512,293,805,53,19,56
2023-06-01,15830,308,62,370,217,58,224
2023-06-01,34984,2284,102,2386,245,30,250
2023-06-01,11280,11,1,12,40,1,40
2023-06-01,5713,92,6,98,69,22,72
2023-06-01,37457,674,7,681,6,3,7
2023-06-01,22356,55,8,63,94,42,96
2023-06-01,37271,2,1,3,121,49,123
2023-06-01,8697,57,2,59,14,4,14
2023-06-01,32787,324,75,399,681,60,686
2023-06-01,57187,6,1,7,20,5,20
2023-06-01,8708,133,7,140,340,41,347
2023-06-01,15924,314,1,315,140,16,142
2023-06-01,27747,195,157,352,3,4,4
2023-06-01,10474,58,2,60,17,6,18
2023-06-01,9121,356,39,395,270,47,275
2023-06-01,327724,7,1,8,5,2,5
2023-06-01,6682,0,0,0,12,8,13
2023-06-01,49800,15,2,17,47,6,48
2023-06-01,51225,5,1,6,2,2,2
2023-06-01,196709,0,0,0,8,4,8
2023-06-01,15897,568,25,593,1,1,1
2023-06-01,37545,35,0,35,11,0,11
2023-06-01,30844,280,13,293,212,72,217
2023-06-01,33905,31,10,41,1,1,1
2023-06-01,7713,3571,325,3896,453,101,488
2023-06-01,52320,6,2,8,125,98,135
2023-06-01,208374,0,0,0,5,4,5
2023-06-01,210834,7,4,11,6,6,6
2023-06-01,6667,4,0,4,34,26,38
2023-06-01,719,171,5,176,59,21,60
2023-06-01,34224,153,9,162,117,27,121
2023-06-01,262589,290,60,350,215,119,226
2023-06-01,1031,2,1,3,36,29,43
2023-06-01,5580,30,2,32,45,15,46
2023-06-01,20485,89,2,91,703,124,710
2023-06-01,553,98,4,102,23,16,25
2023-06-01,212522,1,1,2,5,5,5
2023-06-01,1267,156,2,158,89,17,92
2023-06-01,61580,7,7,14,6,4,6
2023-06-01,12552,301,30,331,198,105,203
2023-06-01,31027,137,15,152,184,81,193
2023-06-01,852,653,30,683,204,31,208
2023-06-01,15502,262,0,262,4,0,4
2023-06-01,34912,0,0,0,4,0,4
2023-06-01,12400,775,3,778,107,27,112
2023-06-01,9116,0,0,0,18,10,20
2023-06-01,24955,212,39,251,19,5,20
2023-06-01,31133,340,32,372,589,118,594
2023-06-01,10429,153,67,220,254,108,261
2023-06-01,200612,13,9,22,23,13,26
2023-06-01,8781,152,11,163,32,21,34
2023-06-01,12576,45,2,47,9,8,11
2023-06-01,30722,283,3,286,33,4,34
2023-06-01,44957,3,0,3,1,0,1
2023-06-01,5384,340,0,340,32,0,32
2023-06-01,50630,4,4,8,6,5,9
2023-06-01,213373,12,1,13,11,7,13
2023-06-01,50673,123,78,201,132,384,438
2023-06-01,34854,2,1,3,20,11,23
2023-06-01,213034,1,2,3,1,1,1
2023-06-01,57344,67,1,68,118,25,124
2023-06-01,48584,10,0,10,3,0,3
2023-06-01,208641,2,0,2,1,0,1
2023-06-01,31083,77,0,77,11,0,11
2023-06-01,9009,2711,352,3063,163,71,172
2023-06-01,18530,172,5,177,18,8,19
2023-06-01,11404,135,5,140,138,46,141
2023-06-01,6789,21,1,22,57,9,58
2023-06-01,203451,6,0,6,2,0,2
2023-06-01,28917,26,5,31,177,53,183
2023-06-01,201776,72,1,73,44,7,44
2023-06-01,48084,1,0,1,18,4,18
2023-06-01,8219,2,0,2,1,0,1
2023-06-01,211181,1,1,2,11,6,11
2023-06-01,208293,0,0,0,58,31,58
2023-06-01,57324,39,2,41,15,6,15
2023-06-01,203217,50,2,52,16,4,16
2023-06-01,209173,2,0,2,2,0,2
2023-06-01,51395,13,8,21,9,6,10
2023-06-01,35336,1,0,1,1,0,1
2023-06-01,8953,29,1,30,89,10,90
2023-06-01,48095,109,0,109,2,0,2
2023-06-01,48181,3,0,3,1,0,1
2023-06-01,34465,3,22,25,18,25,33
2023-06-01,213035,57,3,60,21,6,23
2023-06-01,399471,56,0,56,1,0,1
2023-06-01,396998,37,68,105,124,29,130
2023-06-01,199484,79,4,83,13,4,14
2023-06-01,43260,317,21,338,19,5,19
2023-06-01,199366,20,0,20,1,0,1
2023-06-01,209170,6,0,6,2,0,2
2023-06-01,62081,0,0,0,260,26,260
2023-06-01,209208,4,2,6,2,3,3
2023-06-01,62874,43,7,50,16,10,19
2023-06-01,396319,19,1,20,2,1,2
2023-06-01,29404,1,0,1,6,0,6
2023-06-01,209216,2,1,3,3,1,3
2023-06-01,42929,8,2,10,8,4,8
2023-06-01,29075,17,4,21,98,59,102
2023-06-01,43531,16,0,16,62,0,62
2023-06-01,31216,22,7,29,34,11,36
2023-06-01,4455,31,12,43,105,50,114
2023-06-01,57724,23,1,24,98,9,98
2023-06-01,29076,59,1,60,163,50,172
2023-06-01,210079,118,16,134,7,7,8
2023-06-01,49612,2,0,2,10,0,10
2023-06-01,35415,223,3,226,11,7,11
2023-06-01,135330,27,4,31,12,6,12
2023-06-01,142113,2,1,3,2,2,2
2023-06-01,47408,5,1,6,12,2,12
2023-06-01,209234,1,0,1,1,0,1
2023-06-01,47147,3,2,5,73,57,78
2023-06-01,197540,95,5,100,1,1,1
2023-06-01,16265,0,0,0,29,21,34
2023-06-01,60781,543,119,662,6,6,6
2023-06-01,20773,113,7,120,21,15,25
2023-06-01,29066,68,5,73,4,4,6
2023-06-01,6661,18,1,19,37,18,41
2023-06-01,206610,29,9,38,12,1,12
2023-06-01,13789,71,2,73,73,11,74
2023-06-01,35913,789,47,836,17,13,19
2023-06-01,58061,179,12,191,1,1,1
2023-06-01,397373,188,13,201,12,10,12
2023-06-01,10912,26,1,27,30,11,32
2023-06-01,209102,1,1,2,6,7,9
2023-06-01,60501,15,3,18,17,7,19
2023-06-01,41327,18,2,20,144,64,147
2023-06-01,57264,4,0,4,6,4,7
2023-06-01,209232,1,0,1,1,0,1
2023-06-01,8767,70,13,83,76,44,80
2023-06-01,15626,29,8,37,13,4,14
2023-06-01,48031,99,2,101,1,2,2
2023-06-01,35320,3,1,4,138,42,141
2023-06-01,40676,737,281,1018,78,35,83
2023-06-01,49505,857,3,860,21,11,22
2023-06-01,20764,6,1,7,270,110,276
2023-06-01,8100,756,186,942,48,24,51
2023-06-01,395092,40,22,62,8,8,8
2023-06-01,209231,6,1,7,3,2,3
2023-06-01,60068,232,52,284,153,97,163
2023-06-01,212238,777,71,848,1,1,1
2023-06-01,6830,290,20,310,280,122,319
2023-06-01,199967,69,1,70,2,2,2
2023-06-01,57152,35,2,37,21,7,21
2023-06-01,207709,13,0,13,1,0,1
2023-06-01,43100,0,0,0,34,14,38
2023-06-01,15401,22,1,23,7,3,7
2023-06-01,12453,9,1,10,7,6,9
2023-06-01,39912,43,3,46,26,17,27
2023-06-01,42831,126,15,141,28,17,31
2023-06-01,1004,1,2,3,1,1,2
2023-06-01,212477,45,1,46,11,1,11
2023-06-01,204914,4,0,4,2,0,2
2023-06-01,39737,106,4,110,84,18,88
2023-06-01,3280,12,22,34,1,3,3
2023-06-01,49870,25,1,26,18,5,18
2023-06-01,49183,25,3,28,15,9,17
2023-06-01,43309,6,1,7,8,3,8
2023-06-01,12883,9,1,10,61,18,64
2023-06-01,1836,80,6,86,39,18,41
2023-06-01,200888,1,0,1,1,0,1
2023-06-01,196922,10,1,11,15,11,17
2023-06-01,213300,1,1,2,1,1,1
2023-06-01,8315,57,15,72,19,13,22
2023-06-01,6774,21,2,23,57,28,59
2023-06-01,31566,16,2,18,5,2,5
2023-06-01,62240,887,1220,2107,44,24,51
2023-06-01,211432,66,0,66,3,0,3
2023-06-01,786,190,8,198,42,12,43
2023-06-01,60282,1,0,1,2,0,2
2023-06-01,42689,22,4,26,13,9,14
2023-06-01,20965,2,2,4,50,44,51
2023-06-01,5400,86,4,90,85,20,88
2023-06-01,36224,98,0,98,30,0,30
2023-06-01,2856,319,6,325,159,16,162
2023-06-01,8717,104,4,108,182,24,183
2023-06-01,12297,101,1,102,42,7,43
2023-06-01,16190,13,0,13,6,0,6
2023-06-01,39560,13,1,14,7,5,8
2023-06-01,202448,63,9,72,11,11,11
2023-06-01,8218,24,14,38,191,88,197
2023-06-01,35625,26,4,30,33,17,36
2023-06-01,29396,12,4,16,20,14,23
2023-06-01,41960,69,7,76,16,10,18
2023-06-01,8455,42,11,53,115,82,121
2023-06-01,199524,281,98,379,87,41,93
2023-06-01,202422,237,0,237,1,0,1
2023-06-01,12859,51,18,69,26,14,28
2023-06-01,47787,16,33,49,35,24,42
2023-06-01,203020,802,13,815,8,3,8
2023-06-01,203440,7,0,7,8,0,8
2023-06-01,43140,7,0,7,4,0,4
2023-06-01,41692,1,1,2,13,9,16
2023-06-01,47138,5,1,6,10,2,11
2023-06-01,49392,153,6,159,3,8,8
2023-06-01,35598,30,1,31,205,27,208
2023-06-01,39238,38,1,39,17,9,17
2023-06-01,42861,2,6,8,35,15,37
2023-06-01,30823,115,13,128,30,18,34
2023-06-01,213250,27,2,29,2,1,2
2023-06-01,203698,6,2,8,8,5,8
2023-06-01,39421,5,1,6,1,1,1
2023-06-01,23520,103,1,104,149,84,150
2023-06-01,265721,65,3,68,16,14,16
2023-06-01,269931,7,1,8,15,9,16
2023-06-01,272027,9,2,11,2,1,2
2023-06-01,55081,168,19,187,13,10,14
2023-06-01,56911,30,14,44,28,15,32
2023-06-01,202704,1,0,1,1,0,1
2023-06-01,136787,232,2,234,8,1,8
2023-06-01,54825,144,53,197,64,34,68
2023-06-01,834,903,0,903,2,0,2
2023-06-01,40065,666,0,666,24,0,24
2023-06-01,199531,1,0,1,1,0,1
2023-06-01,49666,25,1,26,28,13,28
2023-06-01,12880,64,1,65,24,3,24
2023-06-01,202251,1,0,1,4,0,4
2023-06-01,49100,67,3,70,34,5,37
2023-06-01,44090,6,0,6,1,0,1
2023-06-01,29119,443,12,455,198,52,203
2023-06-01,204861,8,1,9,9,1,9
2023-06-01,20804,27,2,29,243,38,250
2023-06-01,209200,3,0,3,3,0,3
2023-06-01,16509,8349,3461,11810,51,35,59
2023-06-01,17408,150,3,153,66,19,67
2023-06-01,141158,7,0,7,3,0,3
2023-06-01,61317,1683,178,1861,32,22,41
2023-06-01,42090,6,0,6,4,0,4
2023-06-01,2110,12,2,14,25,9,28
2023-06-01,209222,1,1,2,2,2,2
2023-06-01,35297,18,6,24,148,32,153
2023-06-01,209117,3,1,4,2,1,3
2023-06-01,48422,16,0,16,27,0,27
2023-06-01,49181,2,1,3,3,2,3
2023-06-01,47914,5,1,6,6,1,6
2023-06-01,50309,5,1,6,27,13,28
2023-06-01,210017,2,1,3,2,2,2
2023-06-01,57948,10,7,17,3,3,4
2023-06-01,35280,26,6,32,83,47,88
2023-06-01,42455,10,1,11,9,8,11
2023-06-01,199909,8,1,9,1,1,1
2023-06-01,50782,7,3,10,7,5,8
2023-06-01,209070,1,1,2,2,2,2
2023-06-01,29405,33,6,39,29,18,30
2023-06-01,31167,14,1,15,29,5,29
2023-06-01,60718,11,0,11,3,0,3
2023-06-01,8359,196,37,233,401,76,407
2023-06-01,209206,3,0,3,1,0,1
2023-06-01,203462,10,0,10,7,0,7
2023-06-01,56786,4,2,6,11,4,12
2023-06-01,47583,313,40,353,19,15,19
2023-06-01,61323,56,7,63,13,9,14
2023-06-01,15085,107,14,121,14,8,15
2023-06-01,2711,132,6,138,83,19,83
2023-06-01,2686,152,3,155,118,16,121
2023-06-01,30337,39,8,47,10,6,10
2023-06-01,702,196,23,219,184,24,185
2023-06-01,41798,165,18,183,56,15,58
2023-06-01,60299,1,1,2,13,5,14
2023-06-01,43727,71,1,72,63,14,65
2023-06-01,49600,7,0,7,42,9,42
2023-06-01,60609,38,0,38,1,0,1
2023-06-01,42473,236,112,348,73,57,80
2023-06-01,60171,15,9,24,88,22,89
2023-06-01,210321,4,1,5,12,8,12
2023-06-01,201466,7,3,10,1,1,1
2023-06-01,15943,59,2,61,29,14,32
2023-06-01,47890,18,4,22,8,2,8
2023-06-01,9050,112,1,113,168,19,171
2023-06-01,49468,25,0,25,2,0,2
2023-06-01,131090,584,1,585,2,2,2
2023-06-01,209202,1,1,2,1,1,1
2023-06-01,201893,6,0,6,3,0,3
2023-06-01,29535,8,3,11,217,18,223
2023-06-01,31229,36,5,41,15,8,16
2023-06-01,12912,54,2,56,226,34,229
2023-06-01,43424,9,3,12,5,2,5
2023-06-01,208312,3,0,3,1,0,1
2023-06-01,8540,14,3,17,10,6,11
2023-06-01,205584,6,1,7,3,1,3
2023-06-01,20647,9,3,12,22,12,23
2023-06-01,31852,2,0,2,3,0,3
2023-06-01,10587,4,1,5,8,4,8
2023-06-01,15305,25,4,29,46,14,47
2023-06-01,46133,1,0,1,1,0,1
2023-06-01,7040,47,1,48,3,1,3
2023-06-01,206092,134,20,154,1,1,1
2023-06-01,262287,237,29,266,31,18,34
2023-06-01,25273,22,4,26,7,3,7
2023-06-01,49063,152,1,153,74,12,75
2023-06-01,210200,8,0,8,1,0,1
2023-06-01,209189,4,0,4,1,0,1
2023-06-01,202766,75,3,78,73,8,75
2023-06-01,205289,2,0,2,1,0,1
2023-06-01,208781,1,0,1,2,0,2
2023-06-01,209198,1,1,2,2,2,2
2023-06-01,16082,12,2,14,11,5,11
2023-06-01,197522,24,8,32,6,3,6
2023-06-01,3255,317,1,318,186,26,188
2023-06-01,201053,0,0,0,199,0,199
2023-06-01,209062,2,0,2,4,0,4
2023-06-01,50607,2,0,2,314,31,317
2023-06-01,35805,37,2,39,79,13,82
2023-06-01,209012,4,0,4,1,0,1
2023-06-01,39823,3,1,4,4,3,4
2023-06-01,207568,1,1,2,4,1,4
2023-06-01,3249,31,4,35,46,19,48
2023-06-01,201843,31,0,31,6,0,6
2023-06-01,58128,6,0,6,1,0,1
2023-06-01,8551,3880,121,4001,151,43,160
2023-06-01,209028,4,0,4,2,0,2
2023-06-01,209811,13,1,14,2,1,2
2023-06-01,12578,30,1,31,98,24,101
2023-06-01,24645,10,0,10,7,0,7
2023-06-01,207291,5,0,5,1,0,1
2023-06-01,8764,704,35,739,58,20,63
2023-06-01,61135,23,4,27,54,10,55
2023-06-01,207459,57,0,57,6,0,6
2023-06-01,3507,44,0,44,1,0,1
2023-06-01,211373,56,0,56,2,0,2
2023-06-01,1257,449,49,498,198,102,201
2023-06-01,42318,4,0,4,2,0,2
2023-06-01,46261,364,8,372,14,9,15
2023-06-01,11325,21,0,21,1,0,1
2023-06-01,34927,13,43,56,83,1457,1471
2023-06-01,213279,1,1,2,4,2,4
2023-06-01,20473,978,280,1258,485,879,1100
2023-06-01,213018,1,1,2,3,2,3
2023-06-01,49434,16,6,22,18,15,20
2023-06-01,57878,352,27,379,2,2,2
2023-06-01,39351,30,13,43,21,18,26
2023-06-01,206279,4,0,4,1,0,1
2023-06-01,22822,129,26,155,45,32,48
2023-06-01,19905,153,18,171,52,15,53
2023-06-01,397688,10,0,10,1,0,1
2023-06-01,38622,9,1,10,9,5,9
2023-06-01,199959,3,2,5,1,1,1
2023-06-01,64421,2,1,3,2,1,2
2023-06-01,24651,48,3,51,14,2,14
2023-06-01,24875,27,3,30,50,18,54
2023-06-01,58073,14,1,15,1,1,1
2023-06-01,2119,172,23,195,112,56,116
2023-06-01,203779,3,1,4,10,4,10
2023-06-01,200665,8,3,11,2,1,2
2023-06-01,25400,66,14,80,31,21,32
2023-06-01,2116,181,24,205,83,42,86
2023-06-01,203061,90,0,90,6,0,6
2023-06-01,2872,8,0,8,1,0,1
2023-06-01,9119,70,6,76,75,13,76
2023-06-01,5391,46,1,47,49,8,49
2023-06-01,200462,5,8,13,5,6,8
2023-06-01,49981,136,18,154,38,26,43
2023-06-01,34549,99,14,113,60,78,91
2023-06-01,207732,1,0,1,1,0,1
2023-06-01,35133,3,3,6,9,11,11
2023-06-01,210558,9,2,11,2,2,3
2023-06-01,57706,1,1,2,2,2,2
2023-06-01,41378,97,60,157,36,20,42
2023-06-01,23352,117,23,140,52,22,54
2023-06-01,50340,305,1,306,18,4,18
2023-06-01,42366,297,4,301,4,2,4
2023-06-01,207990,986,0,986,1,0,1
2023-06-01,23470,260,33,293,12,4,12
2023-06-01,7922,174,5,179,109,60,116
2023-06-01,51167,486,7,493,16,13,19
2023-06-01,201364,24,48,72,4,1,4
2023-06-01,142111,35,1,36,10,1,11
2023-06-01,63023,136,18,154,22,15,24
2023-06-01,1759,126,10,136,49,14,52
2023-06-01,209123,1,0,1,1,0,1
2023-06-01,50509,2,1,3,79,18,85
2023-06-01,34665,226,3,229,7,1,7
2023-06-01,50308,2,3,5,1,1,2
2023-06-01,62019,1,0,1,2,0,2
2023-06-01,43274,17,0,17,4,0,4
2023-06-01,44267,13,1,14,17,5,17
2023-06-01,9049,35,3,38,391,117,407
2023-06-01,56630,105,17,122,62,37,74
2023-06-01,208626,15,5,20,4,4,4
2023-06-01,202984,33,3,36,31,14,32
2023-06-01,31500,45,9,54,148,62,165
2023-06-01,8881,345,135,480,174,86,184
2023-06-01,212341,7,1,8,3,2,3
2023-06-01,12843,59,13,72,37,18,38
2023-06-01,25579,34,1,35,1,1,1
2023-06-01,8560,95,11,106,25,17,32
2023-06-01,8075,355,39,394,35,21,39
2023-06-01,39686,49,9,58,48,17,48
2023-06-01,58299,6,6,12,32,58,67
2023-06-01,209185,1,3,4,1,5,5
2023-06-01,44592,44,12,56,13,7,13
2023-06-01,49581,45,12,57,9,7,10
2023-06-01,20853,45,7,52,22,7,23
2023-06-01,15605,16,1,17,12,5,13
2023-06-01,12637,50,12,62,20,11,22
2023-06-01,1680,103,19,122,170,39,174
2023-06-01,42013,9,0,9,4,0,4
2023-06-01,210218,32,0,32,4,0,4
2023-06-01,209171,4,0,4,2,0,2
2023-06-01,35826,10,2,12,11,8,12
2023-06-01,61419,21,2,23,2,1,2
2023-06-01,47777,7,4,11,8,4,8
2023-06-01,207843,2,2,4,2,2,2
2023-06-01,38930,10,4,14,27,11,27
2023-06-01,21473,24,6,30,31,18,35
2023-06-01,199556,1,0,1,2,0,2
2023-06-01,3170,55,13,68,25,19,30
2023-06-01,43949,9,0,9,2,0,2
2023-06-01,200984,3,0,3,1,0,1
2023-06-01,12430,54,3,57,12,8,14
2023-06-01,12357,21,0,21,88,7,89
2023-06-01,200555,21,0,21,2,0,2
2023-06-01,209181,49,13,62,12,9,14
2023-06-01,213122,81,0,81,11,2,11
2023-06-01,30886,59,0,59,9,0,9
2023-06-01,208841,4,0,4,2,0,2
2023-06-01,1820,38,5,43,134,27,136
2023-06-01,3269,3069,5,3074,154,12,156
2023-06-01,208775,5,0,5,2,0,2
2023-06-01,28716,39,5,44,90,24,93
2023-06-01,202805,2,0,2,4,0,4
2023-06-01,35179,15,1,16,36,9,38
2023-06-01,208427,1,0,1,1,0,1
2023-06-01,35007,17,1,18,3,2,4
2023-06-01,47605,6,2,8,78,40,80
2023-06-01,201006,2,1,3,1,1,2
2023-06-01,9299,494,9,503,203,37,206
2023-06-01,133334,18,4,22,10,5,10
2023-06-01,135607,71,2,73,77,15,78
2023-06-01,212669,87,0,87,2,0,2
2023-06-01,50266,35,1,36,13,9,16
2023-06-01,13127,32,9,41,20,11,21
2023-06-01,47829,2,1,3,3,3,3
2023-06-01,9678,14,6,20,7,4,8
2023-06-01,41717,58,1,59,7,1,7
2023-06-01,48152,12,1,13,14,7,16
2023-06-01,209177,2,0,2,2,0,2
2023-06-01,49425,7,2,9,24,10,25
2023-06-01,12189,14,19,33,50,30,50
2023-06-01,59210,24,1,25,1,1,1
2023-06-01,12779,20,5,25,47,31,52
2023-06-01,42425,21,0,21,8,0,8
2023-06-01,48577,3,0,3,1,0,1
2023-06-01,42830,5,1,6,6,2,6
2023-06-01,24724,3,0,3,64,23,65
2023-06-01,5606,123,5,128,114,18,118
2023-06-01,20668,58,0,58,1,0,1
2023-06-01,42599,1,0,1,1,0,1
2023-06-01,48955,21,0,21,1,0,1
2023-06-01,200148,14,0,14,5,0,5
2023-06-01,39326,31,4,35,30,16,32
2023-06-01,209113,3,0,3,2,0,2
2023-06-01,201011,35,20,55,2,1,2
2023-06-01,207821,7,1,8,4,3,4
2023-06-01,30742,24,7,31,16,6,17
2023-06-01,39572,69,51,120,20,10,20
2023-06-01,9123,311,10,321,11,4,11
2023-06-01,44066,50,11,61,23,20,27
2023-06-01,209169,1,1,2,1,1,1
2023-06-01,29226,19,1,20,182,23,187
2023-06-01,12722,81,6,87,28,2,29
2023-06-01,35048,180,45,225,4,5,6
2023-06-01,8376,816,180,996,12,2,12
2023-06-01,209029,3,0,3,2,0,2
2023-06-01,48237,0,0,0,20,13,22
2023-06-01,35819,537,196,733,59,11,61
2023-06-01,29684,122,8,130,18,4,18
2023-06-01,35753,342,122,464,70,21,73
2023-06-01,400039,47,0,47,4,0,4
2023-06-01,136557,70,29,99,36,21,39
2023-06-01,206216,9,6,15,5,4,6
2023-06-01,212335,34,0,34,2,0,2
2023-06-01,48266,14,4,18,3,1,3
2023-06-01,34762,53,13,66,6,4,6
2023-06-01,60032,31,3,34,8,7,9
2023-06-01,15557,110,21,131,92,33,104
2023-06-01,197628,7,0,7,2,0,2
2023-06-01,42652,32,7,39,23,18,26
2023-06-01,34240,6,1,7,3,1,3
2023-06-01,9063,62,8,70,33,19,36
2023-06-01,209145,1,0,1,1,0,1
2023-06-01,34309,11,6,17,73,24,74
2023-06-01,19324,23,3,26,6,1,6
2023-06-01,209167,3,0,3,3,0,3
2023-06-01,132839,222,1,223,4,1,4
2023-06-01,47680,5,0,5,6,0,6
2023-06-01,197957,2,0,2,1,0,1
2023-06-01,47720,11,3,14,17,9,17
2023-06-01,203499,39,0,39,2,0,2
2023-06-01,60397,10,0,10,1,0,1
2023-06-01,202505,20,26,46,3,1,3
2023-06-01,204548,22,0,22,2,0,2
2023-06-01,210329,27,1,28,2,2,2
2023-06-01,41436,26,1,27,2,2,2
2023-06-01,212219,31,0,31,1,0,1
2023-06-01,212865,24,3,27,3,4,4
2023-06-01,42493,14,0,14,1,0,1
2023-06-01,44486,86,16,102,7,5,9
2023-06-01,58212,27,3,30,3,5,7
2023-06-01,8368,46,7,53,28,14,29
2023-06-01,29462,9,2,11,1,1,1
2023-06-01,59919,8,1,9,7,3,7
2023-06-01,5398,14,3,17,26,10,27
2023-06-01,16347,56,15,71,28,7,30
2023-06-01,57809,55,5,60,5,3,5
2023-06-01,52925,19,3,22,97,33,97
2023-06-01,138195,116,0,116,12,0,12
2023-06-01,137427,0,0,0,2,0,2
2023-06-01,205960,12,0,12,1,0,1
2023-06-01,136038,16,0,16,6,0,6
2023-06-01,137445,14,0,14,7,0,7
2023-06-01,137969,24,0,24,24,6,24
2023-06-01,134578,3,0,3,12,4,12
2023-06-01,141039,21,10,31,7,5,7
2023-06-01,12555,5,2,7,21,6,21
2023-06-01,44676,17,0,17,1,0,1
2023-06-01,211618,1,0,1,1,0,1
2023-06-01,209153,4,0,4,2,0,2
2023-06-01,8728,39,4,43,13,10,16
2023-06-01,202376,8,2,10,1,1,1
2023-06-01,213220,11,10,21,6,2,6
2023-06-01,207027,12,0,12,1,0,1
2023-06-01,48678,23,0,23,16,0,16
2023-06-01,207633,37,0,37,1,0,1
2023-06-01,21100,21,6,27,10,4,10
2023-06-01,199058,4,0,4,3,0,3
2023-06-01,39642,27,10,37,21,11,25
2023-06-01,198473,4,1,5,3,2,3
2023-06-01,49028,6,2,8,7,2,7
2023-06-01,200845,665,2,667,38,4,38
2023-06-01,47169,39,4,43,28,8,28
2023-06-01,42205,5,0,5,1,0,1
2023-06-01,209723,7,1,8,2,1,2
2023-06-01,50572,13,1,14,5,3,5
2023-06-01,208001,4,0,4,3,0,3
2023-06-01,202656,115,1,116,1,1,1
2023-06-01,48959,1,0,1,1,0,1
2023-06-01,196695,22,1,23,46,6,47
2023-06-01,202317,1,0,1,1,0,1
2023-06-01,61297,7,1,8,17,4,17
2023-06-01,209155,3,0,3,2,0,2
2023-06-01,21488,4,1,5,32,2,32
2023-06-01,209992,11,0,11,4,0,4
2023-06-01,209835,18,0,18,4,0,4
2023-06-01,24904,67,3,70,6,3,6
2023-06-01,50923,22,1,23,18,7,18
2023-06-01,202136,2,1,3,3,2,3
2023-06-01,61031,6,0,6,9,0,9
2023-06-01,60446,7,1,8,13,7,16
2023-06-01,207279,68,0,68,2,0,2
2023-06-01,17447,23,0,23,1,0,1
2023-06-01,46308,10,0,10,1,0,1
2023-06-01,57580,4,0,4,5,0,5
2023-06-01,48421,1,0,1,2,0,2
2023-06-01,44034,10,3,13,9,5,10
2023-06-01,9198,1118,2,1120,69,12,69
2023-06-01,29355,101,9,110,3,1,3
2023-06-01,8657,5,1,6,28,14,30
2023-06-01,3243,15,1,16,9,1,9
2023-06-01,12713,21,10,31,21,13,23
2023-06-01,6799,78,32,110,36,5,37
2023-06-01,39386,12,1,13,57,39,65
2023-06-01,25019,1171,205,1376,34,7,35
2023-06-01,39891,4897,1316,6213,2,1,2
2023-06-01,8402,784,5,789,20,4,20
2023-06-01,34038,12,0,12,2,0,2
2023-06-01,13285,64,5,69,18,3,18
2023-06-01,20746,782,6,788,11,2,11
2023-06-01,5607,34,11,45,10,7,12
2023-06-01,9158,26,2,28,11,5,13
2023-06-01,209141,3,0,3,8,0,8
2023-06-01,3352,215,4,219,93,4,93
2023-06-01,44244,379,24,403,3,1,3
2023-06-01,49832,3,3,6,12,2,12
2023-06-01,29049,165,19,184,59,27,61
2023-06-01,6739,85,1,86,20,2,21
2023-06-01,48159,11,1,12,12,1,12
2023-06-01,58224,1826,0,1826,72,0,72
2023-06-01,39533,2,1,3,10,8,13
2023-06-01,60148,19,0,19,4,0,4
2023-06-01,41689,1,0,1,3,2,3
2023-06-01,43754,251,12,263,76,19,78
2023-06-01,50810,117,1,118,20,3,21
2023-06-01,42337,535,1,536,136,15,138
2023-06-01,44400,16,0,16,14,2,14
2023-06-01,56616,4,0,4,1,0,1
2023-06-01,212161,1,0,1,2,0,2
2023-06-01,43395,44,0,44,8,0,8
2023-06-01,204650,21,0,21,10,0,10
2023-06-01,48944,31,1,32,1,1,1
2023-06-01,202798,1,0,1,1,0,1
2023-06-01,12660,44,0,44,2,0,2
2023-06-01,48359,72,0,72,5,0,5
2023-06-01,197343,14,0,14,2,0,2
2023-06-01,59912,4,0,4,2,0,2
2023-06-01,62196,4,0,4,1,0,1
2023-06-01,49515,7,1,8,6,3,6
2023-06-01,16232,19,1,20,1,1,1
2023-06-01,3209,312,19,331,105,39,111
2023-06-01,6805,30,2,32,20,14,23
2023-06-01,3301,333,44,377,95,47,100
2023-06-01,14618,780,208,988,1,1,1
2023-06-01,8987,32,31,63,1,1,1
2023-06-01,7224,20,0,20,3,0,3
2023-06-01,22335,17,0,17,29,9,30
2023-06-01,10490,71,2,73,35,14,35
2023-06-01,393529,3,1,4,3,2,3
2023-06-01,7018,2474,51,2525,2186,192,2196
2023-06-01,46164,38,0,38,1,0,1
2023-06-01,1,130,1,131,11,1,12
2023-06-01,6619,139,8,147,21,8,22
2023-06-01,13904,187,1,188,10,1,10
2023-06-01,6866,143,7,150,42,12,45
2023-06-01,29386,0,0,0,8,3,8
2023-06-01,29256,347,2,349,2,1,2
2023-06-01,3326,152,22,174,255,50,259
2023-06-01,15785,12,10,22,1,1,1
2023-06-01,198731,5,1,6,3,1,3
2023-06-01,64267,442,1,443,5,1,5
2023-06-01,204490,18,1,19,4,2,5
2023-06-01,42007,18,0,18,1,0,1
2023-06-01,212559,3,3,6,4,2,4
2023-06-01,210892,9,4,13,3,2,3
2023-06-01,42260,1,0,1,1,0,1
2023-06-01,15493,16,5,21,16,4,16
2023-06-01,39791,4,1,5,11,7,12
2023-06-01,198161,2,1,3,1,1,1
2023-06-01,29208,30,4,34,66,41,70
2023-06-01,212567,4,2,6,11,8,14
2023-06-01,24679,15,3,18,11,7,13
2023-06-01,205948,7,2,9,1,1,1
2023-06-01,207439,2,2,4,4,4,5
2023-06-01,56382,12,10,22,21,16,24
2023-06-01,50629,19,7,26,51,39,55
2023-06-01,198385,7,3,10,17,8,19
2023-06-01,15576,48,12,60,59,30,60
2023-06-01,212648,0,0,0,7,0,7
2023-06-01,198735,22,0,22,3,0,3
2023-06-01,17056,13,1,14,3,1,3
2023-06-01,6128,88,3,91,16,10,17
2023-06-01,54004,96,2,98,343,17,344
2023-06-01,49697,2,5,7,16,16,21
2023-06-01,48646,2,6,8,19,23,31
2023-06-01,210168,1,1,2,2,2,3
2023-06-01,199610,118,29,147,15,14,19
2023-06-01,12638,4,0,4,1,0,1
2023-06-01,198471,241,1,242,8,1,8
2023-06-01,21472,9,1,10,11,5,11
2023-06-01,48101,38,9,47,9,4,9
2023-06-01,51678,26,1,27,2,1,3
2023-06-01,48858,5,1,6,71,14,74
2023-06-01,41560,50,0,50,10,0,10
2023-06-01,5563,74,0,74,16,0,16
2023-06-01,60404,10,9,19,10,15,17
2023-06-01,42156,5,3,8,16,11,17
2023-06-01,43391,57,3,60,22,3,22
2023-06-01,3188,21,0,21,5,0,5
2023-06-01,198432,6,0,6,1,0,1
2023-06-01,31655,30,3,33,7,2,7
2023-06-01,31483,19,5,24,1,1,1
2023-06-01,51570,119,5,124,1,1,1
2023-06-01,34150,19,1,20,1,1,1
2023-06-01,59713,25,3,28,1,2,2
2023-06-01,56420,82,3,85,2,1,2
2023-06-01,41403,21,0,21,1,0,1
2023-06-01,51819,58,5,63,1,1,1
2023-06-01,52207,55,1,56,1,1,1
2023-06-01,50512,59,5,64,1,1,1
2023-06-01,196705,15,1,16,7,2,7
2023-06-01,62287,3,1,4,4,1,4
2023-06-01,28761,23,2,25,52,11,55
2023-06-01,48441,2,0,2,5,0,5
2023-06-01,41754,51,5,56,1,1,1
2023-06-01,57044,76,3,79,1,1,1
2023-06-01,12772,264,0,264,1,0,1
2023-06-01,50498,65,5,70,2,1,2
2023-06-01,39028,35,3,38,1,1,1
2023-06-01,211221,1,1,2,2,1,2
2023-06-01,21378,7,1,8,5,1,5
2023-06-01,206171,2,0,2,3,0,3
2023-06-01,207078,1,0,1,3,0,3
2023-06-01,201706,69,1,70,106,3,106
2023-06-01,211202,2,0,2,2,0,2
2023-06-01,41661,39,5,44,1,2,2
2023-06-01,209303,2,0,2,2,0,2
2023-06-01,28840,259,0,259,13,0,13
2023-06-01,206661,4,0,4,4,0,4
2023-06-01,212740,7,0,7,1,0,1
2023-06-01,41682,57,6,63,1,2,2
2023-06-01,42683,9,1,10,1,1,1
2023-06-01,41668,58,5,63,1,1,1
2023-06-01,50542,43,3,46,1,1,1
2023-06-01,42682,106,7,113,2,1,2
2023-06-01,57026,46,7,53,1,1,1
2023-06-01,57378,77,7,84,1,1,1
2023-06-01,50543,64,7,71,1,1,1
2023-06-01,206804,47,11,58,26,9,26
2023-06-01,8492,127,4,131,53,9,53
2023-06-01,205601,1,0,1,2,0,2
2023-06-01,56534,50,6,56,87,13,87
2023-06-01,202425,53,1,54,11,4,12
2023-06-01,57717,5,2,7,12,6,13
2023-06-01,43201,4,0,4,23,3,23
2023-06-01,39558,7,0,7,3,0,3
2023-06-01,133296,219,20,239,52,26,54
2023-06-01,39087,14,1,15,8,5,8
2023-06-01,210756,110,21,131,23,12,23
2023-06-01,35277,29,7,36,7,6,9
2023-06-01,59947,0,0,0,5,5,7
2023-06-01,205701,1,0,1,1,0,1
2023-06-01,19437,216,4,220,3,1,3
2023-06-01,44812,17,23,40,1,1,1
2023-06-01,60922,6,0,6,4,0,4
2023-06-01,56541,8,0,8,4,0,4
2023-06-01,30848,60,1,61,10,5,10
2023-06-01,42020,12,2,14,103,20,103
2023-06-01,31126,263,7,270,14,2,14
2023-06-01,3181,4,0,4,3,0,3
2023-06-01,25227,191,1,192,47,1,47
2023-06-01,198762,1,0,1,1,0,1
2023-06-01,31261,35,1,36,61,5,63
2023-06-01,198833,1,0,1,2,0,2
2023-06-01,198821,1,0,1,4,0,4
2023-06-01,51219,14,1,15,8,3,8
2023-06-01,199599,28,1,29,81,14,82
2023-06-01,47440,11,1,12,15,4,15
2023-06-01,59530,1,0,1,2,0,2
2023-06-01,12695,149,11,160,70,19,74
2023-06-01,41842,2,0,2,8,0,8
2023-06-01,212967,1,0,1,1,0,1
2023-06-01,34123,20,1,21,24,9,24
2023-06-01,199231,2,0,2,6,0,6
2023-06-01,8641,57,1,58,131,26,133
2023-06-01,7155,4043,3,4046,17,9,18
2023-06-01,29286,319,19,338,16,7,18
2023-06-01,49301,10,0,10,1,0,1
2023-06-01,15774,343,13,356,11,4,11
2023-06-01,28884,26,2,28,13,2,14
2023-06-01,21365,6,0,6,4,0,4
2023-06-01,44217,49,4,53,20,13,22
2023-06-01,3178,13,1,14,1,1,1
2023-06-01,204601,187,1,188,2,1,2
2023-06-01,48213,2,1,3,6,3,6
2023-06-01,211492,1,0,1,1,0,1
2023-06-01,202025,3,0,3,1,0,1
2023-06-01,24940,82,9,91,39,27,42
2023-06-01,198726,13,1,14,15,12,17
2023-06-01,25291,17,15,32,61,39,68
2023-06-01,60169,1,1,2,12,9,15
2023-06-01,57154,7,1,8,11,5,11
2023-06-01,33965,12,5,17,20,16,22
2023-06-01,60610,33,3,36,24,15,28
2023-06-01,199045,6,0,6,3,0,3
2023-06-01,20771,18,1,19,30,9,30
2023-06-01,198967,50,1,51,16,12,18
2023-06-01,36351,477,97,574,49,21,55
2023-06-01,25160,41,9,50,18,16,22
2023-06-01,51088,41,15,56,25,21,30
2023-06-01,54103,320,11,331,12,8,12
2023-06-01,39855,613,10,623,20,6,20
2023-06-01,49835,24,1,25,16,10,17
2023-06-01,20676,81,8,89,24,11,26
2023-06-01,212330,14,1,15,11,8,11
2023-06-01,3194,12,1,13,4,1,4
2023-06-01,44568,16,2,18,1,1,1
2023-06-01,25098,37,2,39,8,5,8
2023-06-01,48147,18,17,35,8,3,8
2023-06-01,212607,1,0,1,1,0,1
2023-06-01,62068,46,13,59,14,10,17
2023-06-01,212025,2,1,3,2,1,2
2023-06-01,57043,80,7,87,15,8,17
2023-06-01,211059,1,0,1,1,0,1
2023-06-01,5403,49,1,50,10,6,10
2023-06-01,3190,2,1,3,1,1,1
2023-06-01,1764,73,15,88,135,79,139
2023-06-01,207701,1,1,2,10,7,11
2023-06-01,205020,0,0,0,2,0,2
2023-06-01,42705,20,0,20,12,2,13
2023-06-01,21277,54,7,61,30,12,30
2023-06-01,207734,7,0,7,4,0,4
2023-06-01,13984,28,3,31,26,6,27
2023-06-01,36614,25,0,25,4,0,4
2023-06-01,7843,157,15,172,41,24,42
2023-06-01,33363,414,152,566,86,8,87
2023-06-01,47217,15,2,17,7,3,7
2023-06-01,47215,16,6,22,9,7,10
2023-06-01,25593,10,1,11,8,4,8
2023-06-01,209304,6,3,9,2,1,2
2023-06-01,43530,6,0,6,10,0,10
2023-06-01,56578,1,0,1,1,0,1
2023-06-01,31214,16,1,17,8,4,8
2023-06-01,51048,6,1,7,23,10,24
2023-06-01,196646,1,0,1,1,0,1
2023-06-01,15404,157,4,161,2,1,2
2023-06-01,16135,263,89,352,2,1,2
2023-06-01,21353,63,0,63,1,0,1
2023-06-01,42116,63,5,68,1,1,1
2023-06-01,31363,102,3,105,1,1,1
2023-06-01,41733,104,0,104,1,0,1
2023-06-01,47111,4,0,4,1,0,1
2023-06-01,21412,43,4,47,11,1,11
2023-06-01,13194,130,2,132,61,25,63
2023-06-01,50010,553,183,736,23,16,26
2023-06-01,197207,217,15,232,6,2,6
2023-06-01,50463,89,84,173,9,6,9
2023-06-01,51043,17,1,18,16,11,17
2023-06-01,196763,7,3,10,3,3,3
2023-06-01,49985,4,1,5,7,2,8
2023-06-01,201934,2,0,2,1,0,1
2023-06-01,39392,12,5,17,103,70,103
2023-06-01,16019,93,16,109,86,45,93
2023-06-01,31200,69,2,71,25,9,25
2023-06-01,60500,1,0,1,1,0,1
2023-06-01,5578,56,5,61,65,27,69
2023-06-01,8778,3,2,5,21,5,22
2023-06-01,43451,27,3,30,3,1,3
2023-06-01,60829,3,1,4,2,1,2
2023-06-01,48964,19,0,19,18,0,18
2023-06-01,34259,6,0,6,8,0,8
2023-06-01,31042,46,2,48,81,11,83
2023-06-01,34636,31,1,32,13,1,13
2023-06-01,57391,16,0,16,8,0,8
2023-06-01,48289,2,0,2,1,0,1
2023-06-01,39521,60,2,62,6,2,6
2023-06-01,49453,79,10,89,19,10,22
2023-06-01,202053,35,12,47,14,11,17
2023-06-01,5413,109,5,114,22,12,29
2023-06-01,43905,14,0,14,2,0,2
2023-06-01,197524,9,2,11,3,3,3
2023-06-01,39704,18,3,21,20,14,24
2023-06-01,34977,160,0,160,23,0,23
2023-06-01,40009,67,32,99,2,2,2
2023-06-01,3302,46,2,48,53,16,55
2023-06-01,207964,1,0,1,3,0,3
2023-06-01,5610,62,4,66,38,12,38
2023-06-01,34659,16,2,18,10,6,11
2023-06-01,13193,18,3,21,8,3,9
2023-06-01,5410,20,2,22,11,4,11
2023-06-01,12844,2,0,2,13,2,13
2023-06-01,16302,12,4,16,26,20,26
2023-06-01,35382,2,1,3,2,2,2
2023-06-01,12969,32,2,34,22,7,25
2023-06-01,8636,20,1,21,14,6,14
2023-06-01,57214,22,0,22,4,0,4
2023-06-01,58002,3,1,4,13,4,16
2023-06-01,8517,15,2,17,27,6,27
2023-06-01,8678,14,0,14,1,0,1
2023-06-01,21320,1,1,2,41,26,42
2023-06-01,6848,79,9,88,23,9,24
2023-06-01,62214,18,8,26,14,8,14
2023-06-01,12303,1,1,2,3,3,3
2023-06-01,196983,21,1,22,7,2,7
2023-06-01,58177,1,0,1,1,0,1
2023-06-01,8439,20,0,20,2,0,2
2023-06-01,139628,29,0,29,12,0,12
2023-06-01,137811,14,0,14,5,0,5
2023-06-01,55329,21,1,22,35,14,36
2023-06-01,38082,27,9,36,68,26,70
2023-06-01,9902,97,8,105,30,11,31
2023-06-01,24482,45,1,46,62,37,71
2023-06-01,45430,60,25,85,56,40,60
2023-06-01,137557,1,1,2,27,12,27
2023-06-01,42010,16,1,17,10,4,10
2023-06-01,20860,209,18,227,36,15,37
2023-06-01,35425,22,4,26,2,3,3
2023-06-01,16097,39,3,42,35,22,40
2023-06-01,20880,17,3,20,4,3,4
2023-06-01,12849,666,3,669,34,5,34
2023-06-01,21450,33,15,48,2,2,2
2023-06-01,15802,165,120,285,52,13,54
2023-06-01,60168,15,0,15,4,0,4
2023-06-01,31287,45,3,48,91,13,94
2023-06-01,57705,9,0,9,2,0,2
2023-06-01,44549,4,1,5,6,4,6
2023-06-01,5603,82,13,95,131,28,134
2023-06-01,12778,2,1,3,20,11,22
2023-06-01,43714,3,0,3,3,0,3
2023-06-01,204941,4,0,4,10,0,10
2023-06-01,13009,21,2,23,14,6,14
2023-06-01,15533,18,2,20,7,1,8
2023-06-01,198870,1,0,1,2,0,2
2023-06-01,25454,50,4,54,39,8,40
2023-06-01,15836,10,1,11,35,9,36
2023-06-01,8926,163,7,170,22,13,23
2023-06-01,41221,0,0,0,38,0,38
2023-06-01,208671,1,0,1,1,0,1
2023-06-01,34547,25,1,26,15,2,15
2023-06-01,34772,20,1,21,39,14,42
2023-06-01,8447,78,11,89,135,33,137
2023-06-01,43612,27,1,28,6,2,6
2023-06-01,16333,36,1,37,1,1,1
2023-06-01,198904,4,1,5,2,2,2
2023-06-01,15366,6,1,7,10,7,12
2023-06-01,8529,14,0,14,41,24,44
2023-06-01,28885,189,12,201,9,5,10
2023-06-01,35168,8,0,8,33,15,33
2023-06-01,21299,822,7,829,25,2,25
2023-06-01,35104,164,5,169,43,8,43
2023-06-01,197556,59,3,62,3,3,3
2023-06-01,206026,190,75,265,2,1,2
2023-06-01,35566,47,0,47,3,0,3
2023-06-01,199435,3,0,3,3,0,3
2023-06-01,51407,233,3,236,19,4,19
2023-06-01,51440,6,0,6,1,0,1
2023-06-01,64010,9,2,11,7,7,8
2023-06-01,204957,69,18,87,10,10,11
2023-06-01,8772,25,10,35,19,27,36
2023-06-01,198800,8,1,9,3,1,3
2023-06-01,202468,56,1,57,7,1,7
2023-06-01,39835,10,4,14,11,10,12
2023-06-01,20810,10,2,12,9,8,10
2023-06-01,12759,5,1,6,10,5,11
2023-06-01,58141,1,0,1,1,0,1
2023-06-01,41564,176,5,181,15,2,15
2023-06-01,57858,185,0,185,2,0,2
2023-06-01,13030,56,21,77,108,73,123
2023-06-01,198288,5,2,7,6,2,6
2023-06-01,20634,14,2,16,6,2,6
2023-06-01,48362,9,1,10,25,14,27
2023-06-01,207651,184,3,187,9,3,10
2023-06-01,43263,5,0,5,5,0,5
2023-06-01,56694,20,2,22,14,9,15
2023-06-01,3175,42,2,44,17,7,19
2023-06-01,61424,8,2,10,3,1,3
2023-06-01,8681,56,2,58,18,7,19
2023-06-01,58143,7,0,7,1,0,1
2023-06-01,49820,2,2,4,5,5,7
2023-06-01,42303,34,4,38,5,2,5
2023-06-01,31577,22,0,22,6,2,7
2023-06-01,8972,688,4,692,1,1,1
2023-06-01,5483,105,7,112,68,9,69
2023-06-01,16276,156,8,164,46,21,52
2023-06-01,34594,16,2,18,20,7,20
2023-06-01,205714,1,1,2,3,2,3
2023-06-01,8331,4,1,5,21,3,21
2023-06-01,58157,1,0,1,1,0,1
2023-06-01,31673,13,1,14,8,7,10
2023-06-01,8530,10,1,11,8,1,8
2023-06-01,58291,8,3,11,8,6,11
2023-06-01,29512,5,1,6,2,1,2
2023-06-01,12741,77,3,80,422,41,427
2023-06-01,47232,16,5,21,58,46,63
2023-06-01,8932,2,2,4,27,13,29
2023-06-01,43733,23,1,24,9,4,10
2023-06-01,33852,22,1,23,11,1,11
2023-06-01,56561,6,0,6,3,0,3
2023-06-01,198871,8,0,8,2,0,2
2023-06-01,198792,1,1,2,7,4,8
2023-06-01,51985,5,0,5,3,0,3
2023-06-01,60641,9,0,9,2,0,2
2023-06-01,48173,33,4,37,20,16,23
2023-06-01,42649,14,9,23,25,17,31
2023-06-01,30938,23,0,23,1,0,1
2023-06-01,398343,49,1,50,3,2,3
2023-06-01,205888,14,0,14,1,0,1
2023-06-01,206487,34,1,35,5,1,5
2023-06-01,207412,8,0,8,1,0,1
2023-06-01,201748,16,0,16,3,0,3
2023-06-01,39493,5,0,5,7,0,7
2023-06-01,210644,46,31,77,8,4,9
2023-06-01,204603,3,0,3,2,0,2
2023-06-01,8595,37,1,38,62,6,65
2023-06-01,28968,10,1,11,30,2,30
2023-06-01,8242,16,0,16,5,0,5
2023-06-01,199264,1,0,1,2,0,2
2023-06-01,204916,12,152,164,2,1,2
2023-06-01,202973,4,0,4,6,2,6
2023-06-01,203727,5,0,5,3,0,3
2023-06-01,212165,2,0,2,1,0,1
2023-06-01,8680,65,3,68,18,6,18
2023-06-01,41998,46,2,48,34,25,36
2023-06-01,50627,10,0,10,4,0,4
2023-06-01,56327,2,1,3,10,3,10
2023-06-01,58208,3,1,4,4,5,5
2023-06-01,57902,2,1,3,6,6,7
2023-06-01,25369,160,16,176,51,29,55
2023-06-01,208226,8,2,10,3,1,4
2023-06-01,55497,2,0,2,2,0,2
2023-06-01,57976,144,33,177,29,21,36
2023-06-01,59729,102,3,105,1,3,4
2023-06-01,197883,34,1,35,5,3,5
2023-06-01,39637,12,1,13,20,7,22
2023-06-01,206188,1,0,1,1,0,1
2023-06-01,200356,2,2,4,1,2,2
2023-06-01,49943,7,0,7,4,0,4
2023-06-01,35000,48,3,51,69,21,71
2023-06-01,200780,29,2,31,24,21,26
2023-06-01,211573,1,1,2,1,1,1
2023-06-01,212598,6,3,9,1,2,2
2023-06-01,8544,172,2,174,28,13,31
2023-06-01,206244,3,0,3,3,0,3
2023-06-01,8849,23,5,28,36,31,48
2023-06-01,31019,8,1,9,7,4,8
2023-06-01,202496,14,0,14,1,0,1
2023-06-01,56769,6,0,6,1,0,1
2023-06-01,60287,1,0,1,1,0,1
2023-06-01,62300,18,0,18,1,0,1
2023-06-01,201631,1,0,1,2,0,2
2023-06-01,34559,4,0,4,2,0,2
2023-06-01,50089,1,0,1,1,0,1
2023-06-01,62005,27,12,39,4,4,4
2023-06-01,211028,3,0,3,3,0,3
2023-06-01,210273,2,0,2,1,0,1
2023-06-01,200436,5,0,5,2,0,2
2023-06-01,58250,12,1,13,4,1,4
2023-06-01,12353,29,2,31,14,3,14
2023-06-01,42560,32,0,32,11,0,11
2023-06-01,3212,36,6,42,37,13,39
2023-06-01,48642,42,2,44,16,2,16
2023-06-01,51248,21,4,25,5,8,10
2023-06-01,29050,3,0,3,8,0,8
2023-06-01,49605,6,2,8,9,7,11
2023-06-01,21191,57,14,71,4,1,4
2023-06-01,198830,2,0,2,2,0,2
2023-06-01,39812,13,0,13,5,0,5
2023-06-01,13768,736,24,760,60,23,62
2023-06-01,196925,20,1,21,30,16,33
2023-06-01,197830,9,1,10,1,1,1
2023-06-01,48763,7,0,7,4,0,4
2023-06-01,207713,58,22,80,19,12,20
2023-06-01,52000,121,15,136,22,16,25
2023-06-01,202423,49,3,52,2,2,2
2023-06-01,197155,43,1,44,11,6,12
2023-06-01,200088,76,3,79,4,3,4
2023-06-01,196844,2,1,3,34,20,36
2023-06-01,12831,11,1,12,33,8,33
2023-06-01,13293,4,1,5,24,13,24
2023-06-01,39787,2,1,3,4,3,4
2023-06-01,60358,1,0,1,2,0,2
2023-06-01,20978,420,85,505,2,1,2
2023-06-01,45031,22,3,25,3,2,3
2023-06-01,8648,8,1,9,10,9,13
2023-06-01,21413,49,6,55,45,34,46
2023-06-01,45012,89,8,97,4,3,5
2023-06-01,15600,71,22,93,12,6,12
2023-06-01,58185,3,0,3,4,0,4
2023-06-01,44327,4,0,4,8,2,8
2023-06-01,16010,44,1,45,26,4,27
2023-06-01,60144,17,6,23,12,7,12
2023-06-01,38926,5,0,5,3,0,3
2023-06-01,30781,63,11,74,156,53,163
2023-06-01,34757,11,1,12,7,1,7
2023-06-01,41794,5,0,5,3,0,3
2023-06-01,40995,8,0,8,3,0,3
2023-06-01,50928,38,10,48,25,3,25
2023-06-01,47433,4,0,4,3,0,3
2023-06-01,198848,1,0,1,2,0,2
2023-06-01,12757,4,2,6,4,3,4
2023-06-01,29518,140,10,150,31,8,31
2023-06-01,41491,5,0,5,8,0,8
2023-06-01,25255,30,2,32,8,6,10
2023-06-01,8437,50,32,82,60,12,63
2023-06-01,2588,16,1,17,42,5,43
2023-06-01,43513,133,4,137,9,2,9
2023-06-01,5518,39,4,43,37,5,37
2023-06-01,198823,2,0,2,1,0,1
2023-06-01,57168,23,0,23,7,0,7
2023-06-01,201692,8,0,8,1,0,1
2023-06-01,142594,11,8,19,3,3,3
2023-06-01,3236,16,2,18,1,1,1
2023-06-01,58349,7,1,8,9,1,9
2023-06-01,59711,25,9,34,15,10,17
2023-06-01,210974,6,0,6,5,0,5
2023-06-01,199134,1,0,1,1,0,1
2023-06-01,206576,16,4,20,5,3,5
2023-06-01,59705,2,1,3,1,2,2
2023-06-01,29006,0,1,1,9,7,10
2023-06-01,36483,13,1,14,5,3,7
2023-06-01,203842,2,0,2,2,0,2
2023-06-01,25180,55,3,58,74,14,77
2023-06-01,42707,26,2,28,9,8,11
2023-06-01,200017,81,0,81,2,0,2
2023-06-01,200310,2,0,2,1,0,1
2023-06-01,55002,191,37,228,123,9,123
2023-06-01,8194,7,2,9,18,11,20
2023-06-01,201547,3,1,4,1,1,1
2023-06-01,58223,2,0,2,3,0,3
2023-06-01,47474,20,2,22,15,2,16
2023-06-01,198605,75,6,81,15,6,16
2023-06-01,48910,10,2,12,7,6,8
2023-06-01,30282,13,1,14,12,9,12
2023-06-01,12182,38,2,40,40,13,40
2023-06-01,198068,110,3,113,5,3,5
2023-06-01,3327,44,2,46,52,21,56
2023-06-01,9038,185,1,186,26,1,26
2023-06-01,211582,4,4,8,2,1,2
2023-06-01,208966,1,1,2,2,2,2
2023-06-01,15704,152,39,191,44,6,44
2023-06-01,60203,42,0,42,3,0,3
2023-06-01,29141,22,3,25,11,5,11
2023-06-01,24961,48,9,57,60,93,117
2023-06-01,9051,211,2,213,17,3,17
2023-06-01,60406,1,0,1,1,0,1
2023-06-01,48847,10,0,10,4,0,4
2023-06-01,198867,2,0,2,1,0,1
2023-06-01,208722,34,17,51,15,13,17
2023-06-01,13238,33,1,34,3,1,3
2023-06-01,30764,23,2,25,13,8,13
2023-06-01,15425,8,1,9,1,1,1
2023-06-01,205917,10,0,10,10,0,10
2023-06-01,51945,4,1,5,18,9,18
2023-06-01,61137,7,0,7,3,0,3
2023-06-01,29222,22,2,24,7,6,8
2023-06-01,13124,430,71,501,2,2,2
2023-06-01,3329,397,122,519,32,4,32
2023-06-01,8637,4,4,8,28,17,30
2023-06-01,61408,6,1,7,1,1,1
2023-06-01,198887,8,0,8,3,0,3
2023-06-01,13249,5,1,6,53,16,58
2023-06-01,60860,8,0,8,5,0,5
2023-06-01,57033,22,0,22,2,0,2
2023-06-01,50581,78,15,93,53,13,54
2023-06-01,199995,13,0,13,73,5,73
2023-06-01,46786,11,3,14,20,12,23
2023-06-01,29278,46,1,47,24,17,24
2023-06-01,41075,37,3,40,2,1,2
2023-06-01,5588,17,3,20,14,2,14
2023-06-01,12301,192,5,197,54,10,55
2023-06-01,199248,7,1,8,8,1,8
2023-06-01,24916,22,1,23,11,3,11
2023-06-01,57286,16,0,16,4,0,4
2023-06-01,42440,1,0,1,3,2,3
2023-06-01,16322,64,0,64,15,0,15
2023-06-01,60976,56,0,56,28,0,28
2023-06-01,208555,12,0,12,2,0,2
2023-06-01,61191,1,0,1,1,0,1
2023-06-01,200296,6,0,6,1,0,1
2023-06-01,13178,11,7,18,8,5,8
2023-06-01,15552,11,1,12,1,1,1
2023-06-01,202207,2,1,3,7,5,8
2023-06-01,58233,1,0,1,1,0,1
2023-06-01,15954,10,3,13,15,11,17
2023-06-01,198850,1,0,1,2,0,2
2023-06-01,39010,159,0,159,19,0,19
2023-06-01,38999,6,5,11,1,2,2
2023-06-01,3176,3,0,3,3,0,3
2023-06-01,24982,2,0,2,1,0,1
2023-06-01,8449,43,1,44,33,6,33
2023-06-01,43996,30,16,46,24,19,28
2023-06-01,202196,23,76,99,12,11,12
2023-06-01,199434,6,1,7,9,4,11
2023-06-01,47330,7,0,7,6,0,6
2023-06-01,34412,15,4,19,6,2,6
2023-06-01,211421,2,0,2,3,0,3
2023-06-01,201194,6,0,6,4,0,4
2023-06-01,50372,11,1,12,3,4,4
2023-06-01,198608,2,1,3,1,1,1
2023-06-01,204167,12,3,15,4,4,4
2023-06-01,39608,17,2,19,20,2,20
2023-06-01,49332,11,0,11,2,0,2
2023-06-01,15958,17,1,18,34,14,37
2023-06-01,197423,51,0,51,2,0,2
2023-06-01,8400,45,1,46,104,25,108
2023-06-01,44684,6,2,8,26,27,34
2023-06-01,8330,3,1,4,4,2,4
2023-06-01,49902,14,0,14,6,0,6
2023-06-01,43939,104,5,109,2,1,2
2023-06-01,12360,7,1,8,11,7,12
2023-06-01,199554,5,1,6,4,2,4
2023-06-01,25697,18,3,21,7,6,7
2023-06-01,7393,194,1,195,8,4,8
2023-06-01,28775,3,1,4,16,2,16
2023-06-01,8473,90,7,97,64,29,67
2023-06-01,35100,18,1,19,2,1,2
2023-06-01,35706,10,1,11,15,6,15
2023-06-01,16223,7,1,8,9,3,9
2023-06-01,56634,5,0,5,9,0,9
2023-06-01,28725,9,2,11,35,23,39
2023-06-01,196952,2,1,3,2,1,2
2023-06-01,34820,9,1,10,10,3,10
2023-06-01,6855,36,8,44,92,43,95
2023-06-01,202564,2,0,2,2,0,2
2023-06-01,25589,4,1,5,1,1,1
2023-06-01,56361,17,1,18,5,3,5
2023-06-01,48146,96,0,96,1,0,1
2023-06-01,207165,5,0,5,2,0,2
2023-06-01,203072,0,0,0,8,6,8
2023-06-01,39906,9,2,11,3,1,3
2023-06-01,62161,16,0,16,3,0,3
2023-06-01,61367,12,0,12,1,0,1
2023-06-01,59494,4,1,5,2,1,2
2023-06-01,206649,1,0,1,2,0,2
2023-06-01,209863,2,1,3,5,2,5
2023-06-01,205946,1,0,1,1,0,1
2023-06-01,202813,25,0,25,7,0,7
2023-06-01,35699,108,7,115,57,9,59
2023-06-01,205645,3,1,4,1,1,1
2023-06-01,203068,22,0,22,8,0,8
2023-06-01,16030,70,1,71,7,2,7
2023-06-01,207717,3,0,3,2,0,2
2023-06-01,211471,2,0,2,1,0,1
2023-06-01,25424,7,2,9,9,2,9
2023-06-01,211137,1,0,1,1,0,1
2023-06-01,41050,3,1,4,1,1,1
2023-06-01,204004,9,0,9,1,0,1
2023-06-01,202829,21,1,22,6,2,6
2023-06-01,202654,6,0,6,2,0,2
2023-06-01,8251,6,1,7,21,17,24
2023-06-01,57707,6,1,7,3,2,3
2023-06-01,197074,2,0,2,1,0,1
2023-06-01,198668,11,4,15,1,1,1
2023-06-01,51211,3,0,3,1,0,1
2023-06-01,43139,7,3,10,24,2,24
2023-06-01,57361,2,0,2,1,0,1
2023-06-01,56400,3,0,3,6,0,6
2023-06-01,6768,7,2,9,51,7,52
2023-06-01,209855,5,0,5,1,0,1
2023-06-01,44587,7,0,7,6,0,6
2023-06-01,47626,14,1,15,32,6,33
2023-06-01,57888,16,0,16,3,0,3
2023-06-01,25144,39,1,40,19,4,19
2023-06-01,31117,20,3,23,37,20,39
2023-06-01,211034,1,0,1,1,0,1
2023-06-01,205715,5,0,5,1,0,1
2023-06-01,49749,17,0,17,2,0,2
2023-06-01,57971,12,0,12,1,0,1
2023-06-01,8280,35,14,49,19,7,19
2023-06-01,211726,1,0,1,1,0,1
2023-06-01,212109,4,2,6,7,5,7
2023-06-01,48481,8,0,8,2,0,2
2023-06-01,44843,12,1,13,21,6,22
2023-06-01,205446,1,0,1,1,0,1
2023-06-01,212313,6,2,8,1,1,1
2023-06-01,12687,6,1,7,19,6,19
2023-06-01,51500,13,1,14,13,2,13
2023-06-01,2603,11,1,12,29,27,35
2023-06-01,204741,9,1,10,4,1,4
2023-06-01,210117,2,0,2,1,0,1
2023-06-01,200467,2,0,2,1,0,1
2023-06-01,6696,44,3,47,35,18,35
2023-06-01,50083,9,3,12,9,5,10
2023-06-01,200736,71,6,77,10,3,10
2023-06-01,212326,2,0,2,2,0,2
2023-06-01,29632,23,7,30,34,75,90
2023-06-01,208780,2,0,2,2,0,2
2023-06-01,207369,3,0,3,1,0,1
2023-06-01,59684,6,1,7,1,1,1
2023-06-01,59432,24,1,25,15,5,17
2023-06-01,212097,24,0,24,4,0,4
2023-06-01,210148,3,0,3,1,0,1
2023-06-01,209311,3,0,3,5,0,5
2023-06-01,203324,1,0,1,1,0,1
2023-06-01,212043,2,0,2,1,0,1
2023-06-01,8732,15,1,16,141,20,145
2023-06-01,34959,3,1,4,11,6,11
2023-06-01,60720,7,1,8,5,3,5
2023-06-01,49791,2,2,4,3,2,3
2023-06-01,8374,22,2,24,37,9,39
2023-06-01,204923,3,0,3,5,0,5
2023-06-01,60748,1,0,1,1,0,1
2023-06-01,51178,9,2,11,24,5,24
2023-06-01,199072,2,1,3,3,2,3
2023-06-01,60476,5,2,7,11,7,12
2023-06-01,47764,69,4,73,17,7,19
2023-06-01,58262,14,0,14,2,0,2
2023-06-01,36352,1612,0,1612,26,0,26
2023-06-01,39655,3,0,3,1,0,1
2023-06-01,28753,93,13,106,7,6,7
2023-06-01,15644,8,1,9,8,1,8
2023-06-01,33491,116,276,392,245,12,248
2023-06-01,58173,5,0,5,2,0,2
2023-06-01,8469,14,2,16,10,9,12
2023-06-01,20904,22,2,24,14,8,14
2023-06-01,8866,729,56,785,119,18,126
2023-06-01,43561,4,1,5,27,5,28
2023-06-01,39683,5,0,5,2,0,2
2023-06-01,44901,62,3,65,38,7,39
2023-06-01,199373,7,0,7,4,0,4
2023-06-01,25577,30,3,33,32,13,34
2023-06-01,25460,5,1,6,15,4,15
2023-06-01,58243,36,7,43,18,18,21
2023-06-01,198885,8,0,8,1,0,1
2023-06-01,198193,55,0,55,5,0,5
2023-06-01,211972,1,7,8,3,3,3
2023-06-01,209282,2,2,4,1,1,1
2023-06-01,202709,16,2,18,11,3,11
2023-06-01,60798,12,4,16,10,3,10
2023-06-01,12333,6,1,7,4,5,6
2023-06-01,63956,73,21,94,35,17,39
2023-06-01,133480,41,15,56,9,3,9
2023-06-01,15570,18,1,19,29,6,29
2023-06-01,12180,43,3,46,22,6,22
2023-06-01,16397,138,4,142,69,11,70
2023-06-01,62275,5,4,9,13,6,14
2023-06-01,14537,166,7,173,45,11,47
2023-06-01,34929,1,0,1,2,2,2
2023-06-01,198589,42,8,50,5,2,5
2023-06-01,210021,22,4,26,19,8,19
2023-06-01,41805,0,0,0,13,3,13
2023-06-01,205473,30,10,40,10,2,10
2023-06-01,57218,159,7,166,4,1,4
2023-06-01,37558,15,2,17,15,6,15
2023-06-01,37284,98,1,99,13,4,13
2023-06-01,57497,35,2,37,3,2,4
2023-06-01,206264,37,5,42,22,16,27
2023-06-01,48011,21,2,23,8,2,8
2023-06-01,16292,1,0,1,1,0,1
2023-06-01,31688,5,0,5,4,0,4
2023-06-01,62336,38,5,43,7,7,10
2023-06-01,49813,10,0,10,6,0,6
2023-06-01,21309,40,1,41,11,5,12
2023-06-01,13213,432,58,490,28,19,32
2023-06-01,39134,186,4,190,16,6,16
2023-06-01,197695,333,23,356,7,5,8
2023-06-01,44395,20,3,23,18,3,18
2023-06-01,201921,2,0,2,2,0,2
2023-06-01,61310,7,4,11,2,2,2
2023-06-01,208399,1,0,1,1,0,1
2023-06-01,203306,1,0,1,3,0,3
2023-06-01,205776,2,0,2,2,0,2
2023-06-01,200602,6,0,6,4,0,4
2023-06-01,202563,2,0,2,4,0,4
2023-06-01,21334,61,5,66,20,8,21
2023-06-01,56981,76,2,78,1,1,1
2023-06-01,31727,123,2,125,22,9,22
2023-06-01,212317,80,1,81,3,3,3
2023-06-01,12200,7,0,7,39,23,40
2023-06-01,15395,31,1,32,1,1,1
2023-06-01,8369,50,1,51,19,7,20
2023-06-01,51050,7,2,9,9,8,11
2023-06-01,39647,65,3,68,15,11,18
2023-06-01,58273,44,8,52,9,6,10
2023-06-01,35362,8,1,9,6,1,6
2023-06-01,28717,16,5,21,4,2,4
2023-06-01,12310,19,1,20,66,11,67
2023-06-01,34060,4,0,4,3,0,3
2023-06-01,56553,2,0,2,1,0,1
2023-06-01,199498,1,0,1,1,0,1
2023-06-01,51204,1,0,1,2,0,2
2023-06-01,3164,14,1,15,2,1,2
2023-06-01,207115,1,0,1,2,0,2
2023-06-01,12302,367,5,372,147,11,147
2023-06-01,64398,3,2,5,1,1,1
2023-06-01,20616,10,0,10,6,0,6
2023-06-01,35775,3,0,3,1,0,1
2023-06-01,16086,72,8,80,62,24,63
2023-06-01,61395,1,0,1,1,0,1
2023-06-01,50563,52,0,52,1,0,1
2023-06-01,198898,1,0,1,2,0,2
2023-06-01,208862,9,0,9,4,0,4
2023-06-01,58287,1,0,1,3,0,3
2023-06-01,212741,1,0,1,2,0,2
2023-06-01,31025,0,0,0,13,10,15
2023-06-01,12586,144,9,153,32,13,34
2023-06-01,200924,12,7,19,9,9,11
2023-06-01,51059,8,1,9,3,2,3
2023-06-01,34270,1,1,2,10,3,10
2023-06-01,39506,6,0,6,3,0,3
2023-06-01,43192,2,0,2,10,0,10
2023-06-01,57791,5,0,5,1,0,1
2023-06-01,28876,9,1,10,14,12,17
2023-06-01,42038,6,0,6,4,0,4
2023-06-01,58324,2,0,2,1,0,1
2023-06-01,394695,52,0,52,12,0,12
2023-06-01,26337,1,0,1,4,0,4
2023-06-01,46606,190,0,190,8,0,8
2023-06-01,30873,119,8,127,4,4,4
2023-06-01,61275,21,0,21,5,0,5
2023-06-01,60280,3,1,4,15,10,17
2023-06-01,12406,14,1,15,37,14,38
2023-06-01,44087,28,8,36,1,1,1
2023-06-01,60330,21,3,24,31,13,31
2023-06-01,25106,215,20,235,10,3,10
2023-06-01,12481,3,0,3,1,0,1
2023-06-01,56902,14,0,14,2,0,2
2023-06-01,207457,1,0,1,4,0,4
2023-06-01,209785,1,0,1,1,0,1
2023-06-01,62063,1,0,1,2,0,2
2023-06-01,204128,2,0,2,9,0,9
2023-06-01,25478,5,2,7,61,10,62
2023-06-01,44709,81,1,82,4,1,4
2023-06-01,56340,25,0,25,4,0,4
2023-06-01,201952,5,1,6,1,1,1
2023-06-01,201589,5,3,8,4,3,4
2023-06-01,48096,129,4,133,10,4,10
2023-06-01,50113,29,25,54,12,5,14
2023-06-01,44050,99,5,104,10,3,10
2023-06-01,14061,767,19,786,26,17,29
2023-06-01,198610,181,0,181,13,0,13
2023-06-01,3267,72,2,74,71,27,76
2023-06-01,25591,24,0,24,3,0,3
2023-06-01,60115,1,1,2,2,1,2
2023-06-01,6730,50,4,54,51,11,54
2023-06-01,200999,20,2,22,9,3,9
2023-06-01,208984,1,0,1,2,0,2
2023-06-01,210272,1,0,1,2,0,2
2023-06-01,42927,35,3,38,30,5,31
2023-06-01,208423,1,0,1,2,0,2
2023-06-01,208424,1,0,1,2,0,2
2023-06-01,28797,1,0,1,6,0,6
2023-06-01,42908,11,4,15,14,12,16
2023-06-01,41023,7,0,7,2,0,2
2023-06-01,51110,30,2,32,5,1,5
2023-06-01,33576,103,7,110,25,17,25
2023-06-01,48252,24,3,27,5,2,5
2023-06-01,8586,16,1,17,1,1,1
2023-06-01,7029,1800,38,1838,294,43,301
2023-06-01,199976,8,0,8,9,0,9
2023-06-01,201359,1,0,1,3,0,3
2023-06-01,209259,1,0,1,1,0,1
2023-06-01,207191,1,0,1,2,0,2
2023-06-01,200380,1,0,1,3,0,3
2023-06-01,52102,15,1,16,4,1,4
2023-06-01,59414,9,6,15,7,7,8
2023-06-01,28890,16,1,17,17,3,17
2023-06-01,199284,18,2,20,11,9,13
2023-06-01,196714,12,2,14,18,12,20
2023-06-01,50300,44,9,53,19,11,20
2023-06-01,31463,81,7,88,19,14,22
2023-06-01,204170,415,6,421,3,2,3
2023-06-01,6908,53,7,60,32,10,33
2023-06-01,208905,61,2,63,21,12,21
2023-06-01,47956,35,2,37,2,2,2
2023-06-01,44869,12,1,13,6,5,6
2023-06-01,47883,114,0,114,5,0,5
2023-06-01,198977,2,1,3,1,1,1
2023-06-01,48815,37,0,37,3,0,3
2023-06-01,42833,1,0,1,1,0,1
2023-06-01,48276,7,0,7,29,0,29
2023-06-01,59815,9,0,9,8,0,8
2023-06-01,52091,3,1,4,15,1,15
2023-06-01,15133,521,451,972,75,65,85
2023-06-01,59605,15,7,22,46,23,50
2023-06-01,42961,190,9,199,13,5,13
2023-06-01,33991,17,1,18,15,5,15
2023-06-01,209372,350,13,363,5,1,5
2023-06-01,396356,141,40,181,35,22,37
2023-06-01,20278,250,20,270,31,21,34
2023-06-01,131199,16,1,17,1,1,1
2023-06-01,141995,24,3,27,8,6,9
2023-06-01,51873,4,2,6,3,3,4
2023-06-01,50624,12,0,12,5,0,5
2023-06-01,57112,23,3,26,10,5,12
2023-06-01,43350,166,22,188,33,23,36
2023-06-01,64437,18,0,18,3,0,3
2023-06-01,21263,42,7,49,22,15,25
2023-06-01,203507,10,7,17,10,10,12
2023-06-01,206970,1,1,2,1,3,3
2023-06-01,202003,1,0,1,2,0,2
2023-06-01,8262,23,1,24,78,13,80
2023-06-01,34376,30,1,31,4,1,4
2023-06-01,49699,30,0,30,1,0,1
2023-06-01,34524,10,1,11,3,2,3
2023-06-01,210992,2,0,2,1,0,1
2023-06-01,205331,4,0,4,1,0,1
2023-06-01,28760,4,1,5,14,9,15
2023-06-01,21013,10,3,13,41,20,42
2023-06-01,3330,12,4,16,23,9,24
2023-06-01,49544,125,58,183,61,39,67
2023-06-01,62370,10,1,11,1,1,1
2023-06-01,20645,49,2,51,11,2,12
2023-06-01,2828,107,2,109,253,29,254
2023-06-01,58321,18,1,19,21,4,21
2023-06-01,198356,5,0,5,7,0,7
2023-06-01,212815,12,1,13,23,21,31
2023-06-01,204372,41,0,41,1,0,1
2023-06-01,12732,7,6,13,19,15,22
2023-06-01,15731,153,0,153,1,0,1
2023-06-01,49519,1,1,2,2,2,3
2023-06-01,198587,2,1,3,1,1,2
2023-06-01,212384,74,0,74,2,0,2
2023-06-01,203639,21,0,21,1,0,1
2023-06-01,211138,5,2,7,1,1,1
2023-06-01,47400,0,0,0,3,4,5
2023-06-01,198883,27,0,27,1,0,1
2023-06-01,60721,232,5,237,4,1,4
2023-06-01,22773,3678,1428,5106,506,50,513
2023-06-01,46573,972,9,981,5,3,6
2023-06-01,204843,61,0,61,3,0,3
2023-06-01,400377,31,0,31,1,0,1
2023-06-01,61272,21,4,25,5,4,5
2023-06-01,210993,7,0,7,4,0,4
2023-06-01,15083,63,2,65,3,2,3
2023-06-01,138687,36,0,36,1,0,1
2023-06-01,38337,33,0,33,1,0,1
2023-06-01,7411,32,0,32,1,0,1
2023-06-01,198802,6,0,6,1,0,1
2023-06-01,208287,3,0,3,1,0,1
2023-06-01,211252,82,1,83,1,1,2
2023-06-01,206150,38,0,38,1,0,1
2023-06-01,60458,70,0,70,2,0,2
2023-06-01,50058,16,35,51,28,64,80
2023-06-01,61138,114,14,128,12,15,21
2023-06-01,54600,134,3,137,8,1,8
2023-06-01,48614,29,4,33,3,3,4
2023-06-01,60159,5,1,6,23,6,24
2023-06-01,2,14,2,16,23,2,23
2023-06-01,204384,9,0,9,8,0,8
2023-06-01,50263,0,0,0,3,2,4
2023-06-01,34400,24,0,24,1,0,1
2023-06-01,60119,13,0,13,6,0,6
2023-06-01,13094,1,0,1,22,4,23
2023-06-01,206817,2,0,2,3,0,3
2023-06-01,57494,43,0,43,7,0,7
2023-06-01,205076,1,1,2,1,2,2
2023-06-01,8666,2,4,6,3,3,3
2023-06-01,44453,10,2,12,2,1,2
2023-06-01,47692,72,8,80,34,19,35
2023-06-01,31400,14,4,18,1,1,1
2023-06-01,15702,5,1,6,15,4,15
2023-06-01,44306,10,1,11,40,13,42
2023-06-01,203744,8,0,8,6,0,6
2023-06-01,198994,1,0,1,2,0,2
2023-06-01,59395,13,3,16,15,7,16
2023-06-01,8468,52,4,56,25,11,26
2023-06-01,57704,35,2,37,14,1,14
2023-06-01,199046,21,0,21,2,0,2
2023-06-01,31543,24,5,29,17,6,18
2023-06-01,8412,118,38,156,55,28,64
2023-06-01,199468,3,2,5,3,2,3
2023-06-01,198292,8,0,8,6,0,6
2023-06-01,198102,16,1,17,7,3,8
2023-06-01,213365,1,0,1,2,0,2
2023-06-01,15440,36,2,38,41,10,41
2023-06-01,34177,25,2,27,24,10,25
2023-06-01,14717,63,2,65,22,4,22
2023-06-01,12494,31,1,32,14,7,15
2023-06-01,61081,2,1,3,7,1,7
2023-06-01,43366,8,3,11,21,12,23
2023-06-01,60880,6,2,8,4,2,4
2023-06-01,206509,31,1,32,11,4,11
2023-06-01,212434,1,0,1,1,0,1
2023-06-01,39184,188,0,188,4,0,4
2023-06-01,200752,15,0,15,6,0,6
2023-06-01,38933,1,0,1,1,0,1
2023-06-01,43297,12,0,12,3,0,3
2023-06-01,212589,1,0,1,1,0,1
2023-06-01,212602,4,1,5,6,3,6
2023-06-01,212523,2,0,2,1,0,1
2023-06-01,28910,5,1,6,34,22,34
2023-06-01,34250,1,0,1,37,2,37
2023-06-01,8193,63,4,67,2,1,2
2023-06-01,205103,4,2,6,6,5,6
2023-06-01,20875,49,0,49,7,0,7
2023-06-01,41877,9,0,9,2,0,2
2023-06-01,51561,35,2,37,9,5,9
2023-06-01,43207,8,0,8,5,0,5
2023-06-01,51747,140,0,140,19,0,19
2023-06-01,41107,15,1,16,9,2,9
2023-06-01,20552,23,1,24,36,5,36
2023-06-01,197227,13,1,14,5,2,5
2023-06-01,29314,112,4,116,36,11,38
2023-06-01,29017,6,2,8,12,10,15
2023-06-01,34282,7,1,8,5,4,5
2023-06-01,15547,35,3,38,16,8,17
2023-06-01,39440,5,1,6,2,1,2
2023-06-01,58345,5,0,5,3,0,3
2023-06-01,203936,28,2,30,28,12,29
2023-06-01,39232,82,1,83,3,1,3
2023-06-01,8308,13,2,15,66,12,68
2023-06-01,197336,4,0,4,2,0,2
2023-06-01,39039,5,0,5,2,0,2
2023-06-01,199075,6,1,7,2,2,2
2023-06-01,55850,20,1,21,30,21,32
2023-06-01,64073,24,8,32,23,16,23
2023-06-01,62129,4,0,4,7,0,7
2023-06-01,34391,9,1,10,3,1,3
2023-06-01,41937,63,8,71,7,3,8
2023-06-01,3242,50,1,51,7,3,7
2023-06-01,200553,13,0,13,8,0,8
2023-06-01,209583,1,0,1,1,0,1
2023-06-01,205647,35,0,35,9,4,9
2023-06-01,31549,228,1,229,23,3,23
2023-06-01,42656,4,2,6,7,6,9
2023-06-01,31621,6,3,9,9,6,10
2023-06-01,21367,47,2,49,11,5,11
2023-06-01,35177,7,0,7,3,0,3
2023-06-01,2854,21,8,29,132,23,136
2023-06-01,60716,1,0,1,2,0,2
2023-06-01,12668,54,1,55,18,4,19
2023-06-01,12332,32,0,32,12,0,12
2023-06-01,15468,47,0,47,6,0,6
2023-06-01,12730,4,0,4,3,0,3
2023-06-01,201907,1,1,2,1,1,1
2023-06-01,203841,1,0,1,2,0,2
2023-06-01,25091,14,2,16,76,42,82
2023-06-01,42346,15,3,18,16,8,17
2023-06-01,50785,7,2,9,1,1,1
2023-06-01,13055,9,0,9,1,0,1
2023-06-01,59445,3,0,3,6,0,6
2023-06-01,60022,23,18,41,11,8,13
2023-06-01,61349,12,4,16,12,11,16
2023-06-01,57866,13,4,17,77,48,82
2023-06-01,60891,4,0,4,1,0,1
2023-06-01,59441,56,20,76,6,2,6
2023-06-01,6736,16,4,20,28,2,28
2023-06-01,8304,46,3,49,18,9,19
2023-06-01,197267,8,0,8,7,0,7
2023-06-01,197991,12,2,14,3,4,4
2023-06-01,11426,223,6,229,87,12,89
2023-06-01,31638,87,1,88,12,7,13
2023-06-01,137,83,2,85,26,14,28
2023-06-01,29247,14,4,18,1,1,1
2023-06-01,203165,3,3,6,6,5,7
2023-06-01,60256,3,0,3,1,0,1
2023-06-01,60423,7,0,7,4,0,4
2023-06-01,35193,2,0,2,3,0,3
2023-06-01,34953,19,8,27,21,11,23
2023-06-01,32034,49,0,49,6,0,6
2023-06-01,196916,6,0,6,1,0,1
2023-06-01,33132,65,24,89,144,17,147
2023-06-01,197206,8,0,8,4,0,4
2023-06-01,44381,8,1,9,6,7,8
2023-06-01,44265,8,0,8,7,0,7
2023-06-01,39020,64,4,68,13,2,13
2023-06-01,198807,1,1,2,3,2,3
2023-06-01,48294,15,0,15,7,2,7
2023-06-01,211678,2,1,3,2,2,2
2023-06-01,140079,3,0,3,2,0,2
2023-06-01,208484,2,1,3,2,1,2
2023-06-01,8375,30,2,32,6,2,6
2023-06-01,29691,10,3,13,18,16,21
2023-06-01,34960,12,4,16,4,4,6
2023-06-01,33967,4,0,4,4,0,4
2023-06-01,59581,1,0,1,3,0,3
2023-06-01,59847,19,0,19,2,0,2
2023-06-01,9146,107,14,121,19,11,21
2023-06-01,39216,39,6,45,21,8,21
2023-06-01,59422,3,2,5,3,2,3
2023-06-01,49571,15,0,15,5,2,5
2023-06-01,59458,4,0,4,2,0,2
2023-06-01,43836,0,0,0,3,2,3
2023-06-01,57588,25,2,27,9,1,9
2023-06-01,48980,1,0,1,2,2,2
2023-06-01,29467,21,2,23,28,21,34
2023-06-01,28907,16,1,17,15,7,15
2023-06-01,2611,36,9,45,23,18,31
2023-06-01,21438,11,0,11,1,0,1
2023-06-01,56724,9,2,11,2,1,2
2023-06-01,209420,5,0,5,2,0,2
2023-06-01,201551,4,0,4,1,0,1
2023-06-01,60731,2,0,2,3,0,3
2023-06-01,56410,20,1,21,5,4,6
2023-06-01,47548,16,3,19,7,6,7
2023-06-01,196890,4,1,5,3,2,4
2023-06-01,50477,22,1,23,14,4,14
2023-06-01,58067,18,1,19,17,3,17
2023-06-01,60388,10,1,11,14,1,15
2023-06-01,35816,15,1,16,7,2,7
2023-06-01,12611,16,1,17,8,8,10
2023-06-01,197248,29,2,31,7,2,7
2023-06-01,6681,3,0,3,9,0,9
2023-06-01,61046,7,2,9,2,2,2
2023-06-01,201525,2,2,4,3,2,3
2023-06-01,60187,48,2,50,5,1,5
2023-06-01,5089,233,2,235,71,2,72
2023-06-01,5602,34,0,34,9,0,9
2023-06-01,10122,200,6,206,32,7,34
2023-06-01,36131,28,0,28,2,0,2
2023-06-01,31151,9,0,9,2,0,2
2023-06-01,60530,27,2,29,4,4,4
2023-06-01,57630,25,1,26,20,11,22
2023-06-01,59472,9,1,10,2,1,2
2023-06-01,20738,213,2,215,1,1,1
2023-06-01,38195,145,4,149,90,40,91
2023-06-01,17819,164,9,173,139,26,142
2023-06-01,48077,0,0,0,3,0,3
2023-06-01,59519,5,0,5,3,0,3
2023-06-01,5538,7,2,9,11,9,12
2023-06-01,199051,10,0,10,1,0,1
2023-06-01,59695,1,0,1,1,0,1
2023-06-01,12703,59,8,67,29,12,33
2023-06-01,29550,31,1,32,14,8,14
2023-06-01,44574,22,11,33,3,4,4
2023-06-01,60687,1,1,2,3,1,3
2023-06-01,3261,60,0,60,11,0,11
2023-06-01,57455,2,1,3,10,2,10
2023-06-01,21497,94,1,95,55,11,57
2023-06-01,209595,2,0,2,2,0,2
2023-06-01,206810,1,0,1,28,0,28
2023-06-01,41039,24,0,24,33,0,33
2023-06-01,8274,2,0,2,3,0,3
2023-06-01,41081,3,0,3,1,0,1
2023-06-01,41172,1,0,1,1,0,1
2023-06-01,196977,3,0,3,4,0,4
2023-06-01,169677,0,0,0,1,0,1
2023-06-01,47694,5,0,5,6,0,6
2023-06-01,50957,11,1,12,1,1,1
2023-06-01,207614,15,1,16,5,1,5
2023-06-01,199952,14,5,19,1,3,3
2023-06-01,206757,26,0,26,3,0,3
2023-06-01,47756,0,0,0,4,0,4
2023-06-01,60711,9,0,9,1,0,1
2023-06-01,204774,3,1,4,2,1,2
2023-06-01,206124,16,0,16,1,0,1
2023-06-01,209551,7,3,10,1,1,1
2023-06-01,57869,25,0,25,2,0,2
2023-06-01,206492,5,1,6,3,3,4
2023-06-01,8758,39,8,47,29,15,31
2023-06-01,6718,15,7,22,7,7,8
2023-06-01,48273,21,0,21,13,0,13
2023-06-01,198454,7,1,8,2,1,2
2023-06-01,51402,3,1,4,11,10,13
2023-06-01,41110,29,1,30,4,2,4
2023-06-01,25394,26,9,35,35,20,39
2023-06-01,59790,24,0,24,6,0,6
2023-06-01,207148,1,0,1,1,0,1
2023-06-01,200156,1,0,1,2,0,2
2023-06-01,12025,147,426,573,73,11,73
2023-06-01,209622,13,4,17,6,4,6
2023-06-01,62094,4,1,5,3,1,3
2023-06-01,207743,25,0,25,2,0,2
2023-06-01,57972,5,0,5,1,0,1
2023-06-01,3399,22,3,25,39,35,47
2023-06-01,58065,363,5,368,11,3,11
2023-06-01,60485,12,0,12,1,0,1
2023-06-01,51269,14,2,16,11,7,11
2023-06-01,62163,15,0,15,8,0,8
2023-06-01,48635,75,24,99,20,17,24
2023-06-01,35612,23,1,24,11,3,11
2023-06-01,49687,12,1,13,5,1,5
2023-06-01,212192,10,0,10,2,0,2
2023-06-01,197476,5,0,5,2,0,2
2023-06-01,199552,13,1,14,2,1,2
2023-06-01,199181,4,0,4,9,0,9
2023-06-01,43160,26,1,27,17,6,19
2023-06-01,60134,14,0,14,2,0,2
2023-06-01,201121,1,2,3,3,1,3
2023-06-01,44369,5,0,5,1,0,1
2023-06-01,38934,3,0,3,4,0,4
2023-06-01,199990,1,1,2,2,1,2
2023-06-01,59518,9,1,10,3,1,3
2023-06-01,197692,3,1,4,9,7,11
2023-06-01,199143,5,0,5,2,0,2
2023-06-01,41489,5,1,6,3,3,3
2023-06-01,34892,17,0,17,2,0,2
2023-06-01,8362,38,1,39,3,1,3
2023-06-01,49808,30,2,32,25,12,27
2023-06-01,59499,3,0,3,1,0,1
2023-06-01,59503,1,0,1,1,0,1
2023-06-01,61167,1,0,1,2,0,2
2023-06-01,200568,3,0,3,3,0,3
2023-06-01,25249,13,0,13,3,0,3
2023-06-01,9136,10,9,19,18,17,23
2023-06-01,202016,2,1,3,1,1,1
2023-06-01,61194,7,0,7,6,0,6
2023-06-01,198357,13,0,13,1,0,1
2023-06-01,56687,1,2,3,3,1,3
2023-06-01,58192,2,4,6,3,1,3
2023-06-01,207724,9,0,9,3,0,3
2023-06-01,59507,3,1,4,10,8,12
2023-06-01,59508,2,0,2,5,0,5
2023-06-01,209687,5,0,5,4,0,4
2023-06-01,197078,23,1,24,10,2,10
2023-06-01,59659,3,1,4,12,1,12
2023-06-01,12338,66,22,88,17,3,17
2023-06-01,199053,6,0,6,3,0,3
2023-06-01,42755,15,1,16,13,6,16
2023-06-01,48620,3,1,4,4,1,4
2023-06-01,62262,12,0,12,4,0,4
2023-06-01,34655,33,5,38,19,12,22
2023-06-01,47381,17,3,20,5,5,6
2023-06-01,41296,4,0,4,1,0,1
2023-06-01,200554,1,0,1,2,0,2
2023-06-01,212355,1,0,1,1,0,1
2023-06-01,61176,1,0,1,1,0,1
2023-06-01,29577,14,0,14,1,0,1
2023-06-01,62318,1,0,1,1,0,1
2023-06-01,62157,3,0,3,3,0,3
2023-06-01,25184,214,6,220,30,1,30
2023-06-01,51469,19,1,20,3,1,3
2023-06-01,51235,15,1,16,4,1,5
2023-06-01,64460,1,0,1,1,0,1
2023-06-01,44208,32,0,32,2,0,2
2023-06-01,50855,2,0,2,2,0,2
2023-06-01,25158,1,0,1,1,0,1
2023-06-01,49847,16,1,17,2,1,2
2023-06-01,60811,3,0,3,2,0,2
2023-06-01,59961,2,0,2,2,0,2
2023-06-01,59838,3,0,3,2,0,2
2023-06-01,24631,221,1,222,45,3,47
2023-06-01,62039,6,0,6,4,0,4
2023-06-01,51074,5,1,6,25,2,26
2023-06-01,39074,84,0,84,4,0,4
2023-06-01,59757,1,0,1,1,0,1
2023-06-01,59501,1,0,1,1,0,1
2023-06-01,50692,3,0,3,2,0,2
2023-06-01,62265,3,0,3,3,0,3
2023-06-01,49433,3,0,3,3,0,3
2023-06-01,35615,10,0,10,2,0,2
2023-06-01,35043,5,0,5,2,0,2
2023-06-01,213230,197,1,198,6,4,6
2023-06-01,41843,68,4,72,1,2,2
2023-06-01,56377,17,3,20,1,1,1
2023-06-01,34533,7,2,9,1,1,1
2023-06-01,51604,137,1,138,2,1,2
2023-06-01,49048,28,5,33,1,1,1
2023-06-01,51035,50,5,55,1,1,1
2023-06-01,12768,114,7,121,1,1,1
2023-06-01,51645,110,8,118,1,1,1
2023-06-01,41727,46,5,51,1,1,1
2023-06-01,28964,63,0,63,3,0,3
2023-06-01,9125,228,3,231,33,4,33
2023-06-01,20559,34,7,41,11,7,13
2023-06-01,43599,7,0,7,3,0,3
2023-06-01,31115,38,1,39,10,6,11
2023-06-01,51580,24,0,24,14,0,14
2023-06-01,20712,61,11,72,19,15,21
2023-06-01,39582,96,1,97,16,6,17
2023-06-01,53264,18,1,19,23,10,23
2023-06-01,27176,47,4,51,6,3,7
2023-06-01,19151,23,2,25,56,24,58
2023-06-01,56595,34,2,36,26,16,29
2023-06-01,21064,3,0,3,6,0,6
2023-06-01,15798,9,1,10,3,1,3
2023-06-01,8501,8,1,9,29,26,29
2023-06-01,21021,43,0,43,25,0,25
2023-06-01,60279,1,0,1,3,0,3
2023-06-01,207012,1,0,1,3,0,3
2023-06-01,199081,61,3,64,12,3,13
2023-06-01,197580,5,2,7,5,3,5
2023-06-01,60911,1,0,1,2,0,2
2023-06-01,13113,9,2,11,10,6,10
2023-06-01,38983,4,1,5,14,12,16
2023-06-01,199139,2,1,3,1,1,1
2023-06-01,39603,18,1,19,9,4,9
2023-06-01,201019,7,0,7,6,0,6
2023-06-01,199352,1,0,1,2,0,2
2023-06-01,50926,45,3,48,7,5,7
2023-06-01,29419,4,0,4,8,0,8
2023-06-01,47886,25,7,32,31,12,34
2023-06-01,44507,15,0,15,6,0,6
2023-06-01,43793,8,0,8,1,0,1
2023-06-01,44084,4,1,5,3,2,3
2023-06-01,50738,13,0,13,7,0,7
2023-06-01,16262,10,0,10,4,0,4
2023-06-01,28787,34,0,34,8,0,8
2023-06-01,15723,3,0,3,1,0,1
2023-06-01,34170,63,0,63,7,0,7
2023-06-01,15962,23,1,24,14,7,15
2023-06-01,42708,181,11,192,61,28,62
2023-06-01,59554,1,1,2,6,5,6
2023-06-01,60475,10,1,11,9,3,9
2023-06-01,34073,6,1,7,10,5,10
2023-06-01,8605,3,1,4,2,2,2
2023-06-01,3241,3,0,3,1,0,1
2023-06-01,59597,7,2,9,3,2,3
2023-06-01,58282,20,0,20,1,0,1
2023-06-01,197308,16,2,18,3,2,3
2023-06-01,49463,9,2,11,9,5,10
2023-06-01,34235,7,0,7,2,0,2
2023-06-01,25148,11,2,13,7,3,7
2023-06-01,34244,39,4,43,7,6,8
2023-06-01,12577,7,1,8,9,3,9
2023-06-01,198400,3,0,3,1,0,1
2023-06-01,57013,17,0,17,1,0,1
2023-06-01,64429,19,0,19,4,0,4
2023-06-01,49587,1,0,1,2,0,2
2023-06-01,210135,7,0,7,3,0,3
2023-06-01,18978,86,11,97,11,7,11
2023-06-01,210122,18,0,18,1,0,1
2023-06-01,42298,103,292,395,6,3,6
2023-06-01,208944,2,1,3,2,1,2
2023-06-01,48728,62,1,63,15,3,15
2023-06-01,200131,15,0,15,1,0,1
2023-06-01,209146,1,1,2,2,1,2
2023-06-01,50818,7,1,8,8,4,8
2023-06-01,56987,2,1,3,7,7,9
2023-06-01,147049,21,13,34,11,10,12
2023-06-01,48314,113,15,128,15,10,17
2023-06-01,200760,6,1,7,7,3,7
2023-06-01,208761,5,0,5,1,0,1
2023-06-01,210574,6,0,6,1,0,1
2023-06-01,134196,19,1,20,11,4,12
2023-06-01,138968,56,1,57,9,1,9
2023-06-01,55933,141,8,149,14,6,15
2023-06-01,41813,1,0,1,1,0,1
2023-06-01,60840,21,0,21,8,0,8
2023-06-01,211376,8,1,9,2,1,2
2023-06-01,210452,1,0,1,3,0,3
2023-06-01,29177,24,1,25,11,5,11
2023-06-01,12307,2,2,4,7,8,9
2023-06-01,35202,1,1,2,2,3,3
2023-06-01,57747,1,0,1,1,0,1
2023-06-01,42864,32,1,33,12,5,13
2023-06-01,203084,2,0,2,2,0,2
2023-06-01,29657,10,3,13,5,1,6
2023-06-01,197889,16,0,16,6,0,6
2023-06-01,209549,6,1,7,3,2,3
2023-06-01,43633,6,0,6,11,0,11
2023-06-01,207569,15,1,16,2,1,2
2023-06-01,210702,1,0,1,2,0,2
2023-06-01,268581,16,6,22,5,3,5
2023-06-01,53013,13,10,23,226,164,236
2023-06-01,40021,61,10,71,7,6,7
2023-06-01,397630,202,0,202,3,0,3
2023-06-01,209137,12,0,12,6,0,6
2023-06-01,50867,78,6,84,13,3,13
2023-06-01,203576,33,0,33,2,0,2
2023-06-01,206483,5,0,5,11,0,11
2023-06-01,209135,2,4,6,2,2,2
2023-06-01,24641,10,2,12,18,4,19
2023-06-01,34049,4,1,5,2,2,3
2023-06-01,24971,34,13,47,13,11,14
2023-06-01,208578,1,1,2,1,1,2
2023-06-01,56444,2,1,3,10,6,11
2023-06-01,209134,3,0,3,1,0,1
2023-06-01,204805,35,117,152,13,10,15
2023-06-01,25540,77,8,85,15,5,15
2023-06-01,199290,19,0,19,5,0,5
2023-06-01,39122,33,8,41,23,18,28
2023-06-01,1197,2,1,3,2,1,2
2023-06-01,201971,27,6,33,12,4,12
2023-06-01,210658,2,0,2,1,0,1
2023-06-01,48737,65,4,69,5,3,5
2023-06-01,201341,124,1,125,4,1,5
2023-06-01,30633,49,57,106,6,6,6
2023-06-01,210412,2,1,3,4,2,4
2023-06-01,211289,1,1,2,1,1,1
2023-06-01,210879,1,1,2,6,6,6
2023-06-01,210855,1,1,2,1,1,1
2023-06-01,47872,7,7,14,19,4,19
2023-06-01,211128,1,0,1,1,0,1
2023-06-01,57099,16,1,17,4,2,4
2023-06-01,205847,2,0,2,1,0,1
2023-06-01,28709,11,6,17,7,3,7
2023-06-01,207970,1,0,1,1,0,1
2023-06-01,50360,18,1,19,21,6,21
2023-06-01,51358,5,0,5,1,0,1
2023-06-01,211632,2,2,4,1,1,1
2023-06-01,35236,12,5,17,15,10,16
2023-06-01,50825,4,1,5,1,1,1
2023-06-01,61231,7,2,9,25,5,25
2023-06-01,207645,19,1,20,2,2,3
2023-06-01,8943,7,4,11,12,8,14
2023-06-01,43915,36,1,37,4,2,4
2023-06-01,31122,22,6,28,33,16,39
2023-06-01,50469,24,1,25,12,3,13
2023-06-01,9930,73,5,78,107,40,113
2023-06-01,55720,343,11,354,28,6,29
2023-06-01,206238,15,1,16,8,5,9
2023-06-01,211588,2,7,9,4,4,5
2023-06-01,200223,2,1,3,1,1,1
2023-06-01,209260,69,0,69,1,0,1
2023-06-01,209071,4,0,4,2,0,2
2023-06-01,209125,4,0,4,2,0,2
2023-06-01,39798,18,7,25,8,6,8
2023-06-01,26548,122,8,130,15,8,16
2023-06-01,397423,188,9,197,19,12,19
2023-06-01,206459,1,1,2,2,2,2
2023-06-01,205282,2,0,2,1,0,1
2023-06-01,32097,16,8,24,28,11,28
2023-06-01,62164,34,0,34,1,0,1
2023-06-01,35830,56,0,56,3,0,3
2023-06-01,209124,1,0,1,3,0,3
2023-06-01,209043,53,0,53,2,0,2
2023-06-01,200482,33,2,35,2,1,2
2023-06-01,132779,9,1,10,20,5,20
2023-06-01,135752,64,1,65,1,1,1
2023-06-01,46887,718,105,823,938,92,950
2023-06-01,202673,4,1,5,3,1,3
2023-06-01,211975,50,0,50,1,0,1
2023-06-01,201814,22,3,25,12,6,12
2023-06-01,60989,11,2,13,8,5,8
2023-06-01,51684,62,0,62,10,0,10
2023-06-01,51018,86,3,89,5,1,5
2023-06-01,212042,5,0,5,2,0,2
2023-06-01,59637,4,0,4,4,0,4
2023-06-01,209088,1,0,1,3,0,3
2023-06-01,51681,23,0,23,5,0,5
2023-06-01,45102,505,51,556,45,11,45
2023-06-01,42962,3,6,9,6,4,6
2023-06-01,136796,16,4,20,2,1,2
2023-06-01,35145,3,0,3,2,0,2
2023-06-01,210237,1,0,1,1,0,1
2023-06-01,42947,71,19,90,12,4,13
2023-06-01,207174,14,0,14,3,0,3
2023-06-01,209116,1,0,1,6,0,6
2023-06-01,44128,32,2,34,4,3,4
2023-06-01,201902,3,0,3,3,0,3
2023-06-01,209709,7,0,7,1,0,1
2023-06-01,33387,30,3,33,14,6,15
2023-06-01,197216,28,3,31,10,2,10
2023-06-01,43264,1,0,1,2,0,2
2023-06-01,35682,4,0,4,1,0,1
2023-06-01,51724,8,0,8,1,0,1
2023-06-01,9199,8,0,8,8,2,8
2023-06-01,35346,2,2,4,38,8,40
2023-06-01,209945,4,0,4,1,0,1
2023-06-01,44477,211,39,250,25,24,26
2023-06-01,56322,8,2,10,4,4,4
2023-06-01,2860,128,3,131,45,19,48
2023-06-01,44222,2,1,3,3,4,4
2023-06-01,48918,31,7,38,26,11,27
2023-06-01,209110,1,1,2,3,1,3
2023-06-01,61173,33,0,33,8,0,8
2023-06-01,211772,2,1,3,1,1,1
2023-06-01,53340,56,8,64,18,9,19
2023-06-01,64249,55,4,59,2,3,3
2023-06-01,43045,3,1,4,6,3,6
2023-06-01,35142,4,0,4,4,0,4
2023-06-01,135391,118,29,147,51,22,54
2023-06-01,57843,6,0,6,8,0,8
2023-06-01,205891,2,0,2,4,0,4
2023-06-01,48940,22,0,22,8,0,8
2023-06-01,15884,1,0,1,1,0,1
2023-06-01,35213,12,2,14,14,8,16
2023-06-01,209106,2,1,3,1,1,1
2023-06-01,29310,14,0,14,1,0,1
2023-06-01,206825,20,1,21,7,4,8
2023-06-01,211619,30,1,31,4,1,4
2023-06-01,49999,101,0,101,1,0,1
2023-06-01,209068,2,0,2,2,0,2
2023-06-01,43142,17,14,31,7,4,7
2023-06-01,209095,1,0,1,1,0,1
2023-06-01,198906,7,0,7,4,0,4
2023-06-01,209097,7,6,13,5,4,5
2023-06-01,2027,4,2,6,17,24,24
2023-06-01,198330,8,1,9,9,4,9
2023-06-01,206548,5,1,6,6,5,7
2023-06-01,34471,59,10,69,15,1,15
2023-06-01,59877,3,2,5,10,1,10
2023-06-01,208957,4,0,4,2,0,2
2023-06-01,202089,21,0,21,5,0,5
2023-06-01,211402,4,0,4,1,0,1
2023-06-01,9135,5,1,6,5,1,5
2023-06-01,44700,7,2,9,10,6,10
2023-06-01,16370,9,0,9,2,0,2
2023-06-01,64200,101,0,101,13,0,13
2023-06-01,20001,245,142,387,116,7,118
2023-06-01,20115,2249,1277,3526,337,44,338
2023-06-01,209094,1,1,2,1,1,1
2023-06-01,50522,13,1,14,13,8,15
2023-06-01,207357,1,0,1,1,0,1
2023-06-01,27552,11,3,14,53,26,54
2023-06-01,64425,5,1,6,1,1,1
2023-06-01,134548,454,17,471,14,5,14
2023-06-01,205109,2,0,2,2,0,2
2023-06-01,21396,18,3,21,6,6,7
2023-06-01,12897,29,3,32,19,13,21
2023-06-01,206119,76,0,76,8,0,8
2023-06-01,208972,80,33,113,10,2,10
2023-06-01,212905,4,0,4,2,0,2
2023-06-01,209042,4,1,5,2,2,2
2023-06-01,212201,1,1,2,1,1,1
2023-06-01,49961,24,0,24,5,0,5
2023-06-01,8487,13,3,16,20,10,24
2023-06-01,47176,9,2,11,16,9,17
2023-06-01,201476,14,1,15,3,1,3
2023-06-01,39305,28,5,33,7,4,7
2023-06-01,197033,17,0,17,7,0,7
2023-06-01,211285,6,0,6,2,0,2
2023-06-01,57334,21,0,21,3,0,3
2023-06-01,209039,3,1,4,1,1,1
2023-06-01,48447,4,1,5,4,2,4
2023-06-01,209044,2,1,3,2,2,2
2023-06-01,56665,26,5,31,27,13,30
2023-06-01,208406,4,0,4,2,0,2
2023-06-01,9211,16,2,18,25,12,26
2023-06-01,35258,10,2,12,6,7,8
2023-06-01,19844,46,6,52,7,2,7
2023-06-01,13786,9,15,24,128,112,131
2023-06-01,8796,713,7,720,10,5,11
2023-06-01,57353,16,7,23,7,6,8
2023-06-01,60503,11,8,19,21,3,21
2023-06-01,206316,13,3,16,2,1,2
2023-06-01,7195,139,84,223,111,80,117
2023-06-01,51083,14,10,24,4,3,4
2023-06-01,200818,6,1,7,6,3,6
2023-06-01,210172,6,0,6,1,0,1
2023-06-01,9312,31,2,33,9,5,10
2023-06-01,136173,17,0,17,5,0,5
2023-06-01,197133,26,2,28,10,6,11
2023-06-01,56985,1,0,1,1,0,1
2023-06-01,208653,1,1,2,2,2,2
2023-06-01,209072,1,0,1,4,0,4
2023-06-01,42897,6,1,7,3,2,3
2023-06-01,43618,7,0,7,3,0,3
2023-06-01,210767,2,1,3,3,1,3
2023-06-01,49598,2,0,2,2,0,2
2023-06-01,211825,1,0,1,1,0,1
2023-06-01,201250,7,0,7,4,0,4
2023-06-01,202778,1,0,1,3,0,3
2023-06-01,43557,17,2,19,4,4,5
2023-06-01,209054,2,0,2,2,0,2
2023-06-01,49292,2,2,4,1,2,2
2023-06-01,60201,1,0,1,1,0,1
2023-06-01,57668,1,0,1,3,0,3
2023-06-01,39383,9,0,9,2,0,2
2023-06-01,202486,20,2,22,3,5,6
2023-06-01,42820,10,0,10,1,0,1
2023-06-01,200487,12,1,13,3,3,3
2023-06-01,200438,4,0,4,4,0,4
2023-06-01,211440,52,0,52,1,0,1
2023-06-01,12998,4,1,5,9,1,10
2023-06-01,37002,50,1,51,11,5,12
2023-06-01,209050,1,1,2,1,1,1
2023-06-01,199736,5,1,6,1,1,1
2023-06-01,56689,7,1,8,5,3,5
2023-06-01,1853,17,2,19,54,33,56
2023-06-01,14576,105,7,112,7,3,7
2023-06-01,5617,76,4,80,251,30,254
2023-06-01,49628,31,0,31,13,0,13
2023-06-01,57768,12,0,12,1,0,1
2023-06-01,43082,1,0,1,1,0,1
2023-06-01,29164,4,1,5,2,2,2
2023-06-01,11352,13,2,15,4,2,4
2023-06-01,203833,7,1,8,1,1,1
2023-06-01,199096,3,0,3,4,0,4
2023-06-01,213298,8,0,8,2,0,2
2023-06-01,44604,23,0,23,1,0,1
2023-06-01,21351,19,15,34,22,15,23
2023-06-01,6697,265,11,276,46,17,49
2023-06-01,205553,4,0,4,2,0,2
2023-06-01,47478,4,1,5,10,2,10
2023-06-01,200590,57,1,58,20,5,20
2023-06-01,50107,2,1,3,6,4,6
2023-06-01,41909,2,1,3,1,1,1
2023-06-01,205378,1,0,1,1,0,1
2023-06-01,199860,22,1,23,9,3,10
2023-06-01,202660,3,0,3,4,0,4
2023-06-01,49287,6,0,6,8,0,8
2023-06-01,24768,46,2,48,12,9,13
2023-06-01,200391,1,0,1,1,0,1
2023-06-01,43444,24,0,24,4,0,4
2023-06-01,12737,26,0,26,8,0,8
2023-06-01,49665,6,0,6,2,0,2
2023-06-01,211670,1,0,1,1,0,1
2023-06-01,31721,45,0,45,1,0,1
2023-06-01,200729,9,0,9,4,0,4
2023-06-01,201678,15,0,15,1,0,1
2023-06-01,57293,14,0,14,2,0,2
2023-06-01,12390,20,2,22,12,6,12
2023-06-01,61425,1,0,1,1,0,1
2023-06-01,34019,7,3,10,27,22,30
2023-06-01,209523,4,2,6,4,4,4
2023-06-01,44530,1,1,2,8,5,10
2023-06-01,12414,19,4,23,17,12,19
2023-06-01,16125,23,1,24,5,2,5
2023-06-01,48284,9,1,10,10,5,11
2023-06-01,44702,50,9,59,3,1,3
2023-06-01,33915,330,25,355,26,10,26
2023-06-01,12521,23,0,23,4,0,4
2023-06-01,39398,5,0,5,3,0,3
2023-06-01,49984,3,1,4,5,1,5
2023-06-01,44600,22,1,23,65,9,66
2023-06-01,206862,3,0,3,2,0,2
2023-06-01,12324,5,1,6,4,1,4
2023-06-01,56547,4,0,4,2,0,2
2023-06-01,201150,5,0,5,1,0,1
2023-06-01,200376,1,0,1,1,0,1
2023-06-01,204834,14,0,14,4,0,4
2023-06-01,208593,1,0,1,1,0,1
2023-06-01,8448,3,1,4,6,6,7
2023-06-01,213155,8,1,9,2,2,2
2023-06-01,60587,6,1,7,26,6,28
2023-06-01,50719,5,0,5,1,0,1
2023-06-01,47674,37,2,39,14,10,15
2023-06-01,202441,2,1,3,3,1,3
2023-06-01,206262,54,6,60,15,5,15
2023-06-01,57332,6,0,6,6,0,6
2023-06-01,41291,20,0,20,6,0,6
2023-06-01,199677,0,0,0,3,0,3
2023-06-01,2187,9,0,9,2,0,2
2023-06-01,198411,16,0,16,1,0,1
2023-06-01,51701,6,3,9,6,3,6
2023-06-01,1136,434,15,449,32,22,35
2023-06-01,8737,5,0,5,2,2,2
2023-06-01,15879,31,8,39,1,1,1
2023-06-01,49765,52,0,52,4,0,4
2023-06-01,29007,6,0,6,3,0,3
2023-06-01,58313,1,1,2,5,5,7
2023-06-01,39045,43,1,44,9,2,9
2023-06-01,49788,19,6,25,21,13,21
2023-06-01,21119,13,3,16,1,1,1
2023-06-01,43578,15,3,18,15,5,15
2023-06-01,23033,23,1,24,23,16,28
2023-06-01,27323,88,4,92,2,2,2
2023-06-01,32875,11,2,13,1,1,1
2023-06-01,34587,21,0,21,3,0,3
2023-06-01,209242,213,11,224,1,1,1
2023-06-01,8580,14,0,14,3,0,3
2023-06-01,65000,5,0,5,8,0,8
2023-06-01,16012,3,0,3,1,0,1
2023-06-01,48612,18,0,18,3,0,3
2023-06-01,39001,13,0,13,2,0,2
2023-06-01,50406,5,0,5,1,0,1
2023-06-01,39858,4,0,4,1,0,1
2023-06-01,29190,23,0,23,1,0,1
2023-06-01,42610,22,2,24,9,1,9
2023-06-01,28676,6,1,7,15,7,17
2023-06-01,200275,2,0,2,3,0,3
2023-06-01,15895,28,2,30,52,8,54
2023-06-01,31034,83,12,95,23,5,23
2023-06-01,51559,134,112,246,16,8,17
2023-06-01,208485,57,0,57,1,0,1
2023-06-01,42277,8,1,9,5,2,5
2023-06-01,51468,18,6,24,11,7,13
2023-06-01,41369,18,1,19,5,3,6
2023-06-01,12714,289,2,291,35,2,35
2023-06-01,44725,6,0,6,1,0,1
2023-06-01,35542,6,0,6,2,0,2
2023-06-01,48166,7,1,8,23,5,25
2023-06-01,59674,19,0,19,1,0,1
2023-06-01,43417,6,0,6,1,0,1
2023-06-01,200497,7,0,7,6,0,6
2023-06-01,49367,90,12,102,18,7,20
2023-06-01,200019,47,2,49,9,5,9
2023-06-01,45796,8,3,11,32,15,33
2023-06-01,54339,34,0,34,3,0,3
2023-06-01,59796,15,0,15,101,3,101
2023-06-01,43298,3,0,3,49,0,49
2023-06-01,201548,2,0,2,4,0,4
2023-06-01,41849,5,1,6,3,2,3
2023-06-01,41071,3,1,4,3,2,3
2023-06-01,206977,19,0,19,2,0,2
2023-06-01,209374,1,0,1,1,0,1
2023-06-01,209468,3,0,3,3,0,3
2023-06-01,31221,8,0,8,5,0,5
2023-06-01,209476,4,0,4,3,0,3
2023-06-01,30456,17,2,19,31,3,31
2023-06-01,211715,5,1,6,5,2,6
2023-06-01,39175,3,1,4,11,6,11
2023-06-01,59816,15,1,16,5,2,5
2023-06-01,209910,18,0,18,1,0,1
2023-06-01,208863,5,0,5,1,0,1
2023-06-01,209086,1,0,1,4,0,4
2023-06-01,855,946,7,953,34,8,34
2023-06-01,577,590,48,638,264,41,270
2023-06-01,41653,18,2,20,7,5,8
2023-06-01,29031,7,0,7,6,0,6
2023-06-01,58271,7,0,7,5,0,5
2023-06-01,198920,1,0,1,1,0,1
2023-06-01,6735,7,4,11,11,6,13
2023-06-01,49079,11,1,12,5,2,5
2023-06-01,49065,2,0,2,2,0,2
2023-06-01,207813,1,0,1,1,0,1
2023-06-01,30860,55,1,56,17,1,17
2023-06-01,51603,0,0,0,5,6,7
2023-06-01,43950,6,6,12,5,4,5
2023-06-01,47935,1,1,2,3,3,3
2023-06-01,32181,64,6,70,13,7,13
2023-06-01,8416,7,1,8,8,2,8
2023-06-01,43273,4,0,4,1,0,1
2023-06-01,55039,32,2,34,21,12,23
2023-06-01,15377,17,1,18,9,2,9
2023-06-01,8647,2,1,3,15,9,17
2023-06-01,17941,70,1,71,12,6,14
2023-06-01,15694,48,4,52,135,19,137
2023-06-01,208926,2,0,2,1,0,1
2023-06-01,51290,7,1,8,6,2,6
2023-06-01,209328,1,0,1,2,0,2
2023-06-01,198187,31,28,59,7,5,8
2023-06-01,208489,1,0,1,2,0,2
2023-06-01,61362,1,0,1,1,0,1
2023-06-01,203417,5,1,6,6,1,6
2023-06-01,61955,5,33,38,16,3,17
2023-06-01,44599,3,0,3,2,0,2
2023-06-01,31055,32,0,32,5,0,5
2023-06-01,9145,51,2,53,50,23,53
2023-06-01,209130,3,0,3,1,0,1
2023-06-01,41497,23,1,24,1,1,1
2023-06-01,209404,1,0,1,1,0,1
2023-06-01,58327,6,0,6,1,0,1
2023-06-01,47447,52,49,101,15,14,20
2023-06-01,51487,25,0,25,2,0,2
2023-06-01,199163,11,7,18,10,9,14
2023-06-01,58511,11,1,12,63,33,65
2023-06-01,134743,45,1,46,3,2,3
2023-06-01,22427,0,0,0,5,2,5
2023-06-01,202602,6,1,7,1,1,1
2023-06-01,207994,2,0,2,5,0,5
2023-06-01,209301,1,0,1,4,0,4
2023-06-01,39777,3,0,3,7,0,7
2023-06-01,41494,2,1,3,27,4,28
2023-06-01,47734,0,0,0,11,0,11
2023-06-01,211642,11,0,11,1,0,1
2023-06-01,209457,4,0,4,3,0,3
2023-06-01,57863,5,0,5,2,0,2
2023-06-01,34397,56,0,56,12,0,12
2023-06-01,208046,18,14,32,2,2,2
2023-06-01,133448,25,0,25,8,0,8
2023-06-01,138995,32,1,33,9,3,10
2023-06-01,399114,20,6,26,4,2,4
2023-06-01,15695,136,34,170,58,36,63
2023-06-01,209393,1,0,1,1,0,1
2023-06-01,209452,3,0,3,2,0,2
2023-06-01,209412,1,0,1,1,0,1
2023-06-01,13156,70,1,71,6,5,6
2023-06-01,9186,26,7,33,14,6,16
2023-06-01,34643,7,0,7,1,0,1
2023-06-01,44821,6,1,7,2,2,2
2023-06-01,209426,1,0,1,2,0,2
2023-06-01,29802,637,141,778,72,41,77
2023-06-01,30707,2,3,5,1,2,2
2023-06-01,42807,39,1,40,2,1,2
2023-06-01,209330,2,0,2,2,0,2
2023-06-01,211261,18,0,18,1,0,1
2023-06-01,209448,1,0,1,3,0,3
2023-06-01,6731,0,1,1,51,4,51
2023-06-01,209447,1,0,1,2,0,2
2023-06-01,209435,2,0,2,3,0,3
2023-06-01,202759,10,2,12,2,2,2
2023-06-01,8426,87,20,107,30,14,34
2023-06-01,35758,37,3,40,5,2,5
2023-06-01,39011,2,0,2,1,0,1
2023-06-01,42263,12,1,13,3,3,4
2023-06-01,211472,1,0,1,1,0,1
2023-06-01,29081,6,1,7,6,5,7
2023-06-01,209441,1,0,1,1,0,1
2023-06-01,61049,13,3,16,9,1,9
2023-06-01,49781,1,0,1,1,0,1
2023-06-01,48551,38,1,39,5,1,5
2023-06-01,205659,40,0,40,2,0,2
2023-06-01,21211,33,1,34,7,1,7
2023-06-01,47123,33,3,36,12,4,13
2023-06-01,43872,16,2,18,5,4,5
2023-06-01,39743,9,0,9,1,0,1
2023-06-01,199204,1,0,1,2,0,2
2023-06-01,213195,7,0,7,1,0,1
2023-06-01,199205,2,0,2,3,0,3
2023-06-01,12688,7,1,8,1,1,1
2023-06-01,31272,42,3,45,8,4,9
2023-06-01,199713,14,0,14,10,0,10
2023-06-01,15623,42,6,48,24,11,24
2023-06-01,197328,102,0,102,5,0,5
2023-06-01,204413,8,3,11,3,3,3
2023-06-01,60222,1,0,1,1,0,1
2023-06-01,204963,1,1,2,1,1,1
2023-06-01,5432,85,3,88,6,3,6
2023-06-01,5488,21,0,21,36,3,36
2023-06-01,201887,5,0,5,2,0,2
2023-06-01,9140,3,0,3,2,0,2
2023-06-01,41552,8,1,9,10,7,13
2023-06-01,34700,13,1,14,14,7,15
2023-06-01,21310,6,1,7,5,2,5
2023-06-01,749,3100,0,3100,1,0,1
2023-06-01,668,216,2,218,28,25,35
2023-06-01,721,502,1,503,8,6,8
2023-06-01,27064,684,6,690,72,10,73
2023-06-01,367,1664,2,1666,18,1,18
2023-06-01,3908,17,0,17,8,2,8
2023-06-01,27066,93,4,97,32,3,33
2023-06-01,747,53,0,53,2,0,2
2023-06-01,1600,40,0,40,2,0,2
2023-06-01,1637,62,0,62,1,0,1
2023-06-01,1602,48,0,48,2,0,2
2023-06-01,3910,22,0,22,10,3,10
2023-06-01,27065,42,3,45,18,4,19
2023-06-01,1733,15,1,16,17,1,17
2023-06-01,6034,63,0,63,3,0,3
2023-06-01,531,194,0,194,2,0,2
2023-06-01,1649,65,0,65,1,0,1
2023-06-01,1554,15,0,15,14,0,14
2023-06-01,1565,2,0,2,1,0,1
2023-06-01,745,28,0,28,7,0,7
2023-06-01,1561,2,0,2,1,0,1
2023-06-01,1544,3,0,3,3,0,3
2023-06-01,2685,32,1,33,17,4,18
2023-06-01,397892,2,0,2,1,0,1
2023-06-01,398997,1,2,3,1,1,1
2023-06-01,396835,10,0,10,3,0,3
2023-06-01,394558,1,0,1,2,0,2
2023-06-01,394928,8,0,8,4,0,4
2023-06-01,27614,1,0,1,3,0,3
2023-06-01,11178,12,0,12,8,0,8
2023-06-01,395922,2,0,2,2,0,2
2023-06-01,30118,4,0,4,2,0,2
2023-06-01,53393,2,0,2,1,0,1
2023-06-01,11312,2,0,2,3,0,3
2023-06-01,53506,4,1,5,6,1,6
2023-06-01,36671,12,2,14,10,2,10
2023-06-01,46636,23,1,24,3,2,3
2023-06-01,14610,7,0,7,9,0,9
2023-06-01,45820,950,20,970,226,38,226
2023-06-01,396238,13,1,14,14,4,14
2023-06-01,19224,13,1,14,5,3,5
2023-06-01,26554,43,1,44,90,9,90
2023-06-01,33668,33,43,76,82,6,82
2023-06-01,36394,12,1,13,2,2,2
2023-06-01,23089,389,7,396,21,7,21
2023-06-01,18690,12,0,12,5,0,5
2023-06-01,394041,2,0,2,3,0,3
2023-06-01,13716,3,0,3,2,0,2
2023-06-01,32798,42,6,48,8,4,8
2023-06-01,10835,84,2,86,28,5,28
2023-06-01,32208,7,0,7,1,0,1
2023-06-01,399183,4,1,5,3,2,3
2023-06-01,36149,13,1,14,26,6,27
2023-06-01,23019,3,0,3,3,0,3
2023-06-01,395148,21,0,21,5,0,5
2023-06-01,395563,6,0,6,3,0,3
2023-06-01,47054,8,0,8,1,0,1
2023-06-01,46559,27,0,27,2,0,2
2023-06-01,63402,11,0,11,7,0,7
2023-06-01,16743,13,0,13,1,0,1
2023-06-01,395354,52,5,57,11,8,11
2023-06-01,7131,72,34,106,9,5,9
2023-06-01,32578,7,2,9,4,4,5
2023-06-01,62988,3,0,3,3,0,3
2023-06-01,393852,3,0,3,4,0,4
2023-06-01,33313,17,0,17,2,0,2
2023-06-01,14821,32,3,35,6,2,6
2023-06-01,397290,1,0,1,1,0,1
2023-06-01,14602,7,1,8,2,1,2
2023-06-01,22116,4,0,4,5,0,5
2023-06-01,396395,2,0,2,3,0,3
2023-06-01,394009,2,0,2,1,0,1
2023-06-01,33267,4,0,4,4,0,4
2023-06-01,33651,93,309,402,188,10,190
2023-06-01,395753,31,0,31,11,0,11
2023-06-01,40866,18,0,18,4,0,4
2023-06-01,25806,2,0,2,1,0,1
2023-06-01,40675,4,0,4,3,0,3
2023-06-01,1975,1,0,1,4,0,4
2023-06-01,40548,3,0,3,3,0,3
2023-06-01,1321,18,10,28,25,5,25
2023-06-01,46186,11,0,11,8,0,8
2023-06-01,703,50,41,91,83,15,85
2023-06-01,18888,14,11,25,8,7,10
2023-06-01,22003,6,0,6,5,0,5
2023-06-01,11251,22,13,35,10,9,10
2023-06-01,30103,246,72,318,36,32,44
2023-06-01,18741,2,0,2,3,0,3
2023-06-01,46990,4,0,4,3,0,3
2023-06-01,19397,146,0,146,6,0,6
2023-06-01,32308,24,0,24,8,0,8
2023-06-01,33667,34,74,108,159,16,163
2023-06-01,11483,6,3,9,6,3,6
2023-06-01,22115,6,0,6,2,0,2
2023-06-01,17903,100,0,100,16,0,16
2023-06-01,27446,11,1,12,20,5,20
2023-06-01,40386,7,2,9,4,1,4
2023-06-01,64213,2,1,3,16,4,17
2023-06-01,1008,5,0,5,3,0,3
2023-06-01,7979,1112,17,1129,23,16,24
2023-06-01,13535,6,2,8,1,1,1
2023-06-01,11734,29,10,39,7,4,7
2023-06-01,27258,23,1,24,17,6,17
2023-06-01,395658,36,1,37,2,2,2
2023-06-01,14744,51,2,53,31,10,31
2023-06-01,29818,2,0,2,2,0,2
2023-06-01,400036,2,0,2,2,0,2
2023-06-01,33650,28,145,173,67,3,68
2023-06-01,53828,18,1,19,47,9,48
2023-06-01,393254,1,0,1,1,0,1
2023-06-01,33492,1,0,1,2,0,2
2023-06-01,3064,46,2,48,3,3,3
2023-06-01,33724,60,4,64,8,5,8
2023-06-01,11096,30,5,35,49,8,49
2023-06-01,6356,15,1,16,3,1,3
2023-06-01,398665,2,0,2,2,0,2
2023-06-01,19452,2,0,2,2,0,2
2023-06-01,53316,41,0,41,7,0,7
2023-06-01,30027,6,0,6,4,0,4
2023-06-01,27425,67,36,103,11,3,11
2023-06-01,18570,9,0,9,4,3,4
2023-06-01,13649,643,32,675,185,17,187
2023-06-01,40525,5,0,5,2,0,2
2023-06-01,396104,2,0,2,2,0,2
2023-06-01,203,154,1,155,1,1,1
2023-06-01,14567,5,0,5,3,0,3
2023-06-01,33652,38,218,256,76,8,77
2023-06-01,398699,10,0,10,6,0,6
2023-06-01,394287,1,0,1,2,0,2
2023-06-01,393796,22,1,23,3,2,3
2023-06-01,22542,2,0,2,2,0,2
2023-06-01,30016,10,0,10,2,0,2
2023-06-01,400311,1,0,1,3,0,3
2023-06-01,35872,2,0,2,5,0,5
2023-06-01,11466,2,0,2,4,0,4
2023-06-01,26471,4,0,4,1,0,1
2023-06-01,14554,31,0,31,2,0,2
2023-06-01,393444,5,1,6,16,8,16
2023-06-01,13781,44,10,54,7,3,7
2023-06-01,11758,8,0,8,34,11,35
2023-06-01,40749,19,0,19,7,0,7
2023-06-01,395435,2,0,2,3,0,3
2023-06-01,393436,29,0,29,5,0,5
2023-06-01,11167,4,0,4,4,0,4
2023-06-01,989,23,0,23,1,0,1
2023-06-01,36113,11,5,16,4,4,4
2023-06-01,40264,30,598,628,113,9,114
2023-06-01,11940,4,0,4,5,0,5
2023-06-01,10796,679,13,692,204,25,207
2023-06-01,62728,8,0,8,4,0,4
2023-06-01,32182,2,0,2,2,0,2
2023-06-01,10979,3,0,3,1,0,1
2023-06-01,15347,10,0,10,9,0,9
2023-06-01,17405,2,0,2,2,0,2
2023-06-01,40410,42,0,42,5,0,5
2023-06-01,62,203,9,212,110,12,111
2023-06-01,46198,40,3,43,4,1,4
2023-06-01,46378,18,2,20,5,2,5
2023-06-01,30363,7,0,7,1,0,1
2023-06-01,11168,21,0,21,5,0,5
2023-06-01,33123,1,0,1,1,0,1
2023-06-01,23059,16,7,23,4,3,4
2023-06-01,33182,88,9,97,35,17,37
2023-06-01,398728,2,0,2,2,0,2
2023-06-01,23314,221,1,222,32,5,32
2023-06-01,22796,1,1,2,2,1,2
2023-06-01,10905,3,0,3,2,0,2
2023-06-01,26959,4,0,4,4,0,4
2023-06-01,20454,108,7,115,29,2,30
2023-06-01,26283,2,0,2,2,0,2
2023-06-01,21869,7,0,7,4,0,4
2023-06-01,14590,5,0,5,1,0,1
2023-06-01,394736,3,0,3,3,0,3
2023-06-01,16641,4,0,4,2,0,2
2023-06-01,53602,6,0,6,2,0,2
2023-06-01,36851,1,0,1,1,0,1
2023-06-01,7148,6,0,6,6,0,6
2023-06-01,20129,4,0,4,1,0,1
2023-06-01,17035,25,2,27,20,2,20
2023-06-01,26573,1,0,1,2,0,2
2023-06-01,2647,12,0,12,16,4,16
2023-06-01,17406,5,0,5,2,0,2
2023-06-01,400835,2,0,2,2,0,2
2023-06-01,395505,9,0,9,10,0,10
2023-06-01,27548,9,0,9,4,0,4
2023-06-01,31922,3,0,3,4,0,4
2023-06-01,7385,77,4,81,116,16,117
2023-06-01,15202,3,0,3,3,0,3
2023-06-01,46213,1,0,1,2,0,2
2023-06-01,33287,56,478,534,139,9,142
2023-06-01,3770,1,0,1,4,2,4
2023-06-01,13536,102,9,111,146,30,149
2023-06-01,32249,1,0,1,3,0,3
2023-06-01,20262,1,0,1,1,0,1
2023-06-01,398029,5,0,5,2,0,2
2023-06-01,13767,130,21,151,81,14,82
2023-06-01,33127,9,1,10,10,1,10
2023-06-01,25674,35,0,35,4,0,4
2023-06-01,31874,3,0,3,1,0,1
2023-06-01,29152,11,2,13,9,4,9
2023-06-01,6102,18,0,18,3,0,3
2023-06-01,23005,135,7,142,149,26,152
2023-06-01,32969,5,0,5,4,0,4
2023-06-01,17076,3,0,3,1,0,1
2023-06-01,14721,5,0,5,5,0,5
2023-06-01,12286,1,0,1,2,0,2
2023-06-01,1407,2,0,2,1,0,1
2023-06-01,394562,5,0,5,1,0,1
2023-06-01,36236,183,59,242,126,95,137
2023-06-01,31793,1,0,1,1,0,1
2023-06-01,30666,22,1,23,8,1,8
2023-06-01,21655,2,0,2,1,0,1
2023-06-01,400043,6,0,6,3,0,3
2023-06-01,23338,53,0,53,5,0,5
2023-06-01,21656,2,0,2,3,0,3
2023-06-01,13817,1,0,1,1,0,1
2023-06-01,26378,2,0,2,2,0,2
2023-06-01,47631,12,2,14,9,5,10
2023-06-01,21906,2,0,2,1,0,1
2023-06-01,53621,2,0,2,3,0,3
2023-06-01,32999,1,0,1,1,0,1
2023-06-01,202,1,0,1,106,7,107
2023-06-01,20053,12,0,12,5,0,5
2023-06-01,26102,2,0,2,1,0,1
2023-06-01,14404,1,1,2,1,2,2
2023-06-01,32098,263,1347,1610,131,61,134
2023-06-01,17072,347,1270,1617,61,28,62
2023-06-01,28469,192,28,220,7,3,7
2023-06-01,395788,3,0,3,2,0,2
2023-06-01,18540,8,1,9,6,3,6
2023-06-01,33052,6,1,7,2,1,2
2023-06-01,18624,24,0,24,4,0,4
2023-06-01,1286,14,0,14,3,0,3
2023-06-01,7310,4,0,4,3,0,3
2023-06-01,12169,29,0,29,3,0,3
2023-06-01,64224,8,2,10,3,2,3
2023-06-01,40596,6,0,6,2,0,2
2023-06-01,7725,35,170,205,62,3,62
2023-06-01,26876,7,0,7,3,0,3
2023-06-01,33661,15,22,37,16,1,16
2023-06-01,32059,9,0,9,2,0,2
2023-06-01,399433,1,0,1,1,0,1
2023-06-01,40711,2,0,2,1,0,1
2023-06-01,40493,2,0,2,3,0,3
2023-06-01,17054,87,17,104,51,5,52
2023-06-01,32035,47,3,50,18,15,21
2023-06-01,26967,11,1,12,2,2,2
2023-06-01,46639,7,2,9,3,3,3
2023-06-01,36734,7,1,8,7,5,7
2023-06-01,40311,9,0,9,3,0,3
2023-06-01,13886,247,0,247,5,0,5
2023-06-01,12144,2,0,2,2,0,2
2023-06-01,32692,2,0,2,2,0,2
2023-06-01,54819,5,0,5,2,0,2
2023-06-01,399929,2,0,2,1,0,1
2023-06-01,31890,14,0,14,3,0,3
2023-06-01,30517,14,7,21,52,7,53
2023-06-01,394141,19,1,20,12,1,12
2023-06-01,21970,2,0,2,4,0,4
2023-06-01,19067,5,0,5,2,0,2
2023-06-01,395747,13,17,30,7,7,7
2023-06-01,18826,1,0,1,1,0,1
2023-06-01,47040,1,0,1,1,0,1
2023-06-01,18779,273,23,296,16,9,17
2023-06-01,26762,7,6,13,5,2,5
2023-06-01,25751,13,10,23,6,5,6
2023-06-01,398989,3,1,4,2,2,2
2023-06-01,53281,7,0,7,3,0,3
2023-06-01,396858,1,0,1,1,0,1
2023-06-01,13427,6,1,7,3,1,3
2023-06-01,21691,4,0,4,3,0,3
2023-06-01,40526,12,0,12,10,0,10
2023-06-01,16676,2,0,2,2,0,2
2023-06-01,393259,19,0,19,3,0,3
2023-06-01,27559,1,0,1,3,0,3
2023-06-01,397818,4,0,4,3,0,3
2023-06-01,16774,7,0,7,2,0,2
2023-06-01,19001,6,0,6,4,0,4
2023-06-01,33445,3,0,3,4,0,4
2023-06-01,46864,8,0,8,6,0,6
2023-06-01,394941,2,2,4,1,3,4
2023-06-01,399749,1,0,1,2,0,2
2023-06-01,13367,14,76,90,80,7,81
2023-06-01,398432,9,0,9,2,0,2
2023-06-01,62743,1,0,1,3,0,3
2023-06-01,40393,16,0,16,6,0,6
2023-06-01,399882,1,0,1,1,0,1
2023-06-01,16998,1,0,1,1,0,1
2023-06-01,400494,2,0,2,2,0,2
2023-06-01,13955,3,0,3,4,0,4
2023-06-01,400733,3,0,3,3,0,3
2023-06-01,53285,10,0,10,6,0,6
2023-06-01,17466,22,0,22,10,0,10
2023-06-01,13380,6,2,8,4,2,4
2023-06-01,53780,8,0,8,5,0,5
2023-06-01,26143,1,0,1,1,0,1
2023-06-01,32696,8,0,8,4,0,4
2023-06-01,53279,1,0,1,2,0,2
2023-06-01,32385,14,0,14,3,0,3
2023-06-01,53943,4,0,4,4,0,4
2023-06-01,19589,5,0,5,1,0,1
2023-06-01,2734,99,20,119,23,9,23
2023-06-01,35873,21,7,28,4,3,4
2023-06-01,31837,7,0,7,4,0,4
2023-06-01,1019,2,0,2,2,0,2
2023-06-01,29946,26,1,27,3,1,3
2023-06-01,10397,58,10,68,6,3,7
2023-06-01,393365,3,0,3,3,0,3
2023-06-01,7459,456,3,459,45,11,48
2023-06-01,396365,2,0,2,1,0,1
2023-06-01,400608,2,0,2,1,0,1
2023-06-01,26344,15,2,17,11,3,11
2023-06-01,40371,8,0,8,5,0,5
2023-06-01,35847,27,4,31,14,3,14
2023-06-01,394437,61,1,62,34,6,34
2023-06-01,36317,1,0,1,1,0,1
2023-06-01,20149,37,0,37,3,0,3
2023-06-01,23256,1,0,1,1,0,1
2023-06-01,40495,4,0,4,5,0,5
2023-06-01,53775,2,0,2,4,0,4
2023-06-01,396431,1,1,2,5,3,5
2023-06-01,30372,7,0,7,9,0,9
2023-06-01,394945,5,0,5,3,0,3
2023-06-01,14784,1,0,1,3,0,3
2023-06-01,136039,6,1,7,4,3,4
2023-06-01,19695,1,0,1,2,0,2
2023-06-01,53670,2,1,3,1,1,1
2023-06-01,13724,2,0,2,3,0,3
2023-06-01,22147,12,4,16,2,2,2
2023-06-01,25623,4,4,8,2,2,2
2023-06-01,63107,10,0,10,3,0,3
2023-06-01,33302,12,2,14,7,4,7
2023-06-01,23393,21,4,25,10,4,11
2023-06-01,397158,1,0,1,1,0,1
2023-06-01,394161,23,7,30,7,2,7
2023-06-01,397756,1,0,1,2,0,2
2023-06-01,15073,3,0,3,3,0,3
2023-06-01,14112,30,0,30,2,0,2
2023-06-01,40470,9,3,12,4,3,4
2023-06-01,20353,2,0,2,3,0,3
2023-06-01,397336,4,0,4,4,0,4
2023-06-01,16493,9,0,9,3,0,3
2023-06-01,6181,101,2,103,60,8,60
2023-06-01,396267,1,0,1,2,0,2
2023-06-01,2731,12,1,13,10,2,10
2023-06-01,40026,11,0,11,6,0,6
2023-06-01,55136,1,10,11,2,4,4
2023-06-01,62828,1,0,1,1,0,1
2023-06-01,393762,1,0,1,2,0,2
2023-06-01,46680,2,0,2,1,0,1
2023-06-01,5091,15,0,15,16,0,16
2023-06-01,33740,1,0,1,1,0,1
2023-06-01,11553,2,0,2,3,0,3
2023-06-01,11427,223,14,237,155,16,158
2023-06-01,396146,2,0,2,2,0,2
2023-06-01,398035,5,0,5,2,0,2
2023-06-01,53407,18,1,19,9,1,9
2023-06-01,46754,4,0,4,4,0,4
2023-06-01,6336,10,4,14,7,3,7
2023-06-01,7921,1,0,1,1,0,1
2023-06-01,23118,68,1,69,6,1,6
2023-06-01,46347,11,0,11,4,0,4
2023-06-01,12220,9,4,13,3,3,4
2023-06-01,11351,159,14,173,90,12,92
2023-06-01,3685,13,1,14,7,4,7
2023-06-01,3754,3,1,4,63,22,63
2023-06-01,53533,6,0,6,5,0,5
2023-06-01,394128,1,1,2,2,1,2
2023-06-01,13938,14,0,14,7,0,7
2023-06-01,36086,121,13,134,58,11,58
2023-06-01,1821,5,0,5,3,0,3
2023-06-01,393947,1,0,1,1,0,1
2023-06-01,397929,1,0,1,1,0,1
2023-06-01,30647,5,0,5,2,0,2
2023-06-01,27908,1,0,1,6,0,6
2023-06-01,27876,50,0,50,4,0,4
2023-06-01,393266,2,0,2,1,0,1
2023-06-01,62994,10,0,10,3,0,3
2023-06-01,399782,2,0,2,2,0,2
2023-06-01,394976,13,6,19,11,8,12
2023-06-01,46121,5,0,5,3,0,3
2023-06-01,395866,10,0,10,3,0,3
2023-06-01,136897,66,8,74,30,10,31
2023-06-01,399539,2,0,2,2,0,2
2023-06-01,46435,11,1,12,16,1,16
2023-06-01,14627,3,1,4,3,1,3
2023-06-01,53845,12,0,12,10,0,10
2023-06-01,23240,1,0,1,1,0,1
2023-06-01,54623,12,0,12,4,0,4
2023-06-01,18801,9,0,9,2,0,2
2023-06-01,19257,39,1,40,14,1,14
2023-06-01,1625,2,0,2,1,0,1
2023-06-01,21949,108,1,109,110,37,113
2023-06-01,397105,1,0,1,1,0,1
2023-06-01,14828,31,1,32,9,1,9
2023-06-01,33561,23,1,24,5,1,5
2023-06-01,16574,32,0,32,5,0,5
2023-06-01,32309,2,0,2,3,0,3
2023-06-01,22084,3,1,4,2,2,2
2023-06-01,53690,9,0,9,4,0,4
2023-06-01,7784,13,2,15,18,5,18
2023-06-01,26852,2,0,2,3,0,3
2023-06-01,6130,59,7,66,23,9,26
2023-06-01,54761,5,0,5,2,0,2
2023-06-01,14911,2,0,2,1,0,1
2023-06-01,20070,2,0,2,2,0,2
2023-06-01,46610,1,0,1,2,0,2
2023-06-01,26062,2,1,3,1,1,2
2023-06-01,62949,3,0,3,2,0,2
2023-06-01,24429,134,35,169,70,25,72
2023-06-01,36298,6,0,6,2,0,2
2023-06-01,62747,3,0,3,1,0,1
2023-06-01,27507,4,0,4,2,0,2
2023-06-01,25611,5,0,5,4,0,4
2023-06-01,33428,1,0,1,2,0,2
2023-06-01,12271,188,5,193,50,5,52
2023-06-01,16567,41,1,42,9,3,9
2023-06-01,394517,2,0,2,4,0,4
2023-06-01,22688,3,0,3,4,0,4
2023-06-01,13414,53,3,56,23,13,27
2023-06-01,35995,6,0,6,1,0,1
2023-06-01,53444,4,0,4,1,0,1
2023-06-01,54169,2,0,2,3,0,3
2023-06-01,22680,4,0,4,4,0,4
2023-06-01,395362,2,0,2,2,0,2
2023-06-01,53985,7,0,7,6,0,6
2023-06-01,26903,3,0,3,2,0,2
2023-06-01,44521,11,0,11,6,0,6
2023-06-01,399773,4,0,4,3,0,3
2023-06-01,30328,4,0,4,4,0,4
2023-06-01,397007,2,0,2,2,0,2
2023-06-01,19222,6,0,6,4,0,4
2023-06-01,13739,6,2,8,16,7,16
2023-06-01,10753,395,64,459,59,10,62
2023-06-01,13604,3,0,3,1,0,1
2023-06-01,17348,11,0,11,5,0,5
2023-06-01,11414,45,1,46,6,2,6
2023-06-01,53524,3,0,3,3,0,3
2023-06-01,394526,2,0,2,3,0,3
2023-06-01,19149,8,1,9,4,2,4
2023-06-01,14739,6,0,6,3,0,3
2023-06-01,26991,2,0,2,3,0,3
2023-06-01,55209,4,0,4,5,0,5
2023-06-01,62532,2,1,3,6,3,6
2023-06-01,1436,1,0,1,6,0,6
2023-06-01,12209,2,0,2,3,0,3
2023-06-01,6086,16,1,17,2,1,2
2023-06-01,19843,8,0,8,2,0,2
2023-06-01,10913,23,1,24,38,10,38
2023-06-01,62713,23,1,24,15,1,15
2023-06-01,19009,91,10,101,69,8,69
2023-06-01,14230,60,11,71,38,12,39
2023-06-01,395809,1,0,1,1,0,1
2023-06-01,23160,4,0,4,3,0,3
2023-06-01,395729,2,0,2,1,0,1
2023-06-01,64279,2,0,2,2,0,2
2023-06-01,36118,1,0,1,1,0,1
2023-06-01,393233,3,0,3,4,0,4
2023-06-01,393625,2,0,2,3,0,3
2023-06-01,17098,6,3,9,3,2,3
2023-06-01,14901,2,1,3,4,2,4
2023-06-01,398074,1,0,1,1,0,1
2023-06-01,54983,3,0,3,1,0,1
2023-06-01,1605,5,0,5,4,0,4
2023-06-01,23286,7,0,7,3,0,3
2023-06-01,24309,204,75,279,9,5,9
2023-06-01,53675,4,0,4,3,0,3
2023-06-01,14094,3,0,3,2,0,2
2023-06-01,103,21,1,22,7,3,7
2023-06-01,55281,4,0,4,3,0,3
2023-06-01,30536,61,5,66,9,4,9
2023-06-01,14745,56,2,58,31,11,32
2023-06-01,396894,2,0,2,3,0,3
2023-06-01,6955,1,0,1,3,0,3
2023-06-01,7016,45,315,360,113,5,113
2023-06-01,22511,11,0,11,4,0,4
2023-06-01,395389,3,0,3,4,0,4
2023-06-01,396379,1,0,1,1,0,1
2023-06-01,22898,27,1,28,6,2,6
2023-06-01,46601,14,0,14,4,0,4
2023-06-01,4566,3,0,3,4,0,4
2023-06-01,32378,1,0,1,1,0,1
2023-06-01,13760,117,4,121,111,27,115
2023-06-01,36730,16,1,17,6,1,6
2023-06-01,40800,4,0,4,3,0,3
2023-06-01,394272,1,0,1,3,0,3
2023-06-01,22909,14,83,97,32,3,33
2023-06-01,13450,4,0,4,3,0,3
2023-06-01,18712,40,1,41,18,3,18
2023-06-01,36444,86,4,90,6,2,6
2023-06-01,32244,41,10,51,21,12,21
2023-06-01,30056,1,0,1,1,0,1
2023-06-01,60653,2,0,2,3,0,3
2023-06-01,32419,2,0,2,1,0,1
2023-06-01,16657,12,1,13,1,1,1
2023-06-01,62614,3,0,3,4,0,4
2023-06-01,53720,3,0,3,2,0,2
2023-06-01,17151,42,0,42,9,0,9
2023-06-01,13461,4,0,4,2,0,2
2023-06-01,55270,3,0,3,4,0,4
2023-06-01,54758,1,0,1,2,0,2
2023-06-01,31984,21,3,24,5,3,5
2023-06-01,393792,13,0,13,4,0,4
2023-06-01,26114,20,0,20,6,0,6
2023-06-01,22064,4,0,4,5,0,5
2023-06-01,26028,3,0,3,4,0,4
2023-06-01,18590,43,1,44,3,2,3
2023-06-01,16820,2,0,2,3,0,3
2023-06-01,53851,2,0,2,1,0,1
2023-06-01,395368,1,0,1,3,0,3
2023-06-01,26004,2,1,3,3,2,3
2023-06-01,13982,1,0,1,2,0,2
2023-06-01,397690,1,0,1,1,0,1
2023-06-01,394053,2,0,2,2,0,2
2023-06-01,33616,125,0,125,5,0,5
2023-06-01,36162,3,0,3,4,0,4
2023-06-01,22474,4,0,4,3,0,3
2023-06-01,396957,1,0,1,3,0,3
2023-06-01,10786,2,0,2,3,0,3
2023-06-01,33660,19,88,107,66,5,66
2023-06-01,397849,11,3,14,12,6,13
2023-06-01,46802,5,0,5,2,0,2
2023-06-01,11475,5,1,6,3,1,3
2023-06-01,53560,3,0,3,3,0,3
2023-06-01,40882,4,0,4,3,0,3
2023-06-01,55100,2,0,2,2,0,2
2023-06-01,7381,85,3,88,32,4,33
2023-06-01,396157,1,0,1,2,0,2
2023-06-01,11071,25,7,32,17,6,17
2023-06-01,393971,2,0,2,3,0,3
2023-06-01,22687,11,0,11,7,0,7
2023-06-01,22442,59,1,60,13,1,13
2023-06-01,394936,2,0,2,3,0,3
2023-06-01,394804,1,0,1,2,0,2
2023-06-01,36636,1,0,1,3,0,3
2023-06-01,25956,52,6,58,43,4,43
2023-06-01,20035,4,0,4,3,0,3
2023-06-01,23071,2,0,2,2,0,2
2023-06-01,396446,2,0,2,2,0,2
2023-06-01,62738,17,0,17,3,0,3
2023-06-01,54338,1,0,1,2,0,2
2023-06-01,397107,1,0,1,3,0,3
2023-06-01,15229,3,0,3,5,0,5
2023-06-01,40614,4,0,4,2,0,2
2023-06-01,12179,39,1,40,31,14,31
2023-06-01,13791,22,1,23,14,4,14
2023-06-01,20465,3,0,3,3,0,3
2023-06-01,14184,17,0,17,2,0,2
2023-06-01,63283,3,0,3,3,0,3
2023-06-01,17378,379,50,429,154,24,158
2023-06-01,62044,115,3,118,20,2,20
2023-06-01,22616,158,9,167,19,2,19
2023-06-01,33570,6,0,6,7,0,7
2023-06-01,397425,1,0,1,3,0,3
2023-06-01,54906,2,0,2,1,0,1
2023-06-01,36134,3,0,3,2,0,2
2023-06-01,40636,1,0,1,3,0,3
2023-06-01,395782,1,0,1,2,0,2
2023-06-01,396243,4,0,4,1,0,1
2023-06-01,33695,32,2,34,7,4,8
2023-06-01,10969,4,0,4,2,0,2
2023-06-01,54976,2,1,3,3,1,3
2023-06-01,15359,39,0,39,4,0,4
2023-06-01,23384,3,0,3,2,0,2
2023-06-01,32278,16,18,34,5,1,5
2023-06-01,14877,16,7,23,61,20,61
2023-06-01,7324,2,1,3,3,1,3
2023-06-01,33659,31,211,242,53,5,55
2023-06-01,32752,1,0,1,3,0,3
2023-06-01,13475,1,0,1,1,0,1
2023-06-01,20077,44,0,44,2,0,2
2023-06-01,27632,4,2,6,5,1,5
2023-06-01,37282,8,4,12,114,26,117
2023-06-01,13750,18,3,21,7,5,8
2023-06-01,32912,13,0,13,3,0,3
2023-06-01,26447,4,0,4,3,0,3
2023-06-01,399054,4,0,4,2,0,2
2023-06-01,62613,2,0,2,3,0,3
2023-06-01,397274,2,0,2,1,0,1
2023-06-01,25871,6,0,6,3,0,3
2023-06-01,36047,1,0,1,1,0,1
2023-06-01,27447,5,0,5,5,0,5
2023-06-01,53831,11,0,11,7,0,7
2023-06-01,13458,5,0,5,6,0,6
2023-06-01,36848,1,0,1,1,0,1
2023-06-01,22952,8,1,9,3,2,3
2023-06-01,55256,193,0,193,63,0,63
2023-06-01,397440,2,0,2,3,0,3
2023-06-01,399313,2,0,2,2,0,2
2023-06-01,27381,44,9,53,8,4,8
2023-06-01,393552,42,1,43,8,1,8
2023-06-01,397142,11,10,21,5,3,5
2023-06-01,19256,28,5,33,9,3,9
2023-06-01,20381,5,4,9,6,7,9
2023-06-01,54389,2,0,2,1,0,1
2023-06-01,14155,14,1,15,8,4,8
2023-06-01,35963,2,0,2,2,0,2
2023-06-01,396506,1,0,1,1,0,1
2023-06-01,22065,16,0,16,7,0,7
2023-06-01,14239,5,0,5,2,0,2
2023-06-01,19768,1,0,1,3,0,3
2023-06-01,62783,1,0,1,2,0,2
2023-06-01,16491,30,1,31,8,1,8
2023-06-01,394861,3,0,3,2,0,2
2023-06-01,27306,1,0,1,2,0,2
2023-06-01,33422,12,0,12,16,0,16
2023-06-01,63111,16,0,16,4,0,4
2023-06-01,5088,6,0,6,1,0,1
2023-06-01,393728,2,0,2,1,0,1
2023-06-01,16779,1,0,1,2,0,2
2023-06-01,54994,649,119,768,84,52,91
2023-06-01,23178,1,0,1,1,0,1
2023-06-01,27205,20,0,20,7,0,7
2023-06-01,16504,141,4,145,23,4,23
2023-06-01,398080,1,0,1,1,0,1
2023-06-01,40807,3,0,3,3,0,3
2023-06-01,395726,1,0,1,3,0,3
2023-06-01,53436,2,0,2,2,0,2
2023-06-01,393362,6,0,6,3,0,3
2023-06-01,393579,3,0,3,2,0,2
2023-06-01,395195,1,0,1,2,0,2
2023-06-01,40803,2,0,2,1,0,1
2023-06-01,13454,2,0,2,2,0,2
2023-06-01,20003,2,0,2,3,0,3
2023-06-01,40412,8,0,8,3,0,3
2023-06-01,18756,20,0,20,1,0,1
2023-06-01,398571,2,0,2,2,0,2
2023-06-01,11019,26,16,42,31,14,31
2023-06-01,26975,5,0,5,2,0,2
2023-06-01,399937,7,0,7,4,0,4
2023-06-01,40222,4,0,4,2,0,2
2023-06-01,62802,13,0,13,6,0,6
2023-06-01,14109,9,0,9,4,0,4
2023-06-01,26667,13,5,18,13,9,16
2023-06-01,394265,6,1,7,7,2,7
2023-06-01,2639,39,10,49,9,3,9
2023-06-01,394973,8,0,8,9,0,9
2023-06-01,201935,17,0,17,5,0,5
2023-06-01,53966,1,0,1,2,0,2
2023-06-01,22928,3,0,3,3,0,3
2023-06-01,25672,1,0,1,2,0,2
2023-06-01,11732,2,0,2,1,0,1
2023-06-01,36234,10,0,10,2,0,2
2023-06-01,394170,3,0,3,1,0,1
2023-06-01,23233,3,0,3,4,0,4
2023-06-01,54024,2,0,2,2,0,2
2023-06-01,7795,117,2,119,89,9,91
2023-06-01,395257,2,0,2,4,0,4
2023-06-01,55155,3,0,3,1,0,1
2023-06-01,14652,10,0,10,5,0,5
2023-06-01,397174,3,0,3,3,0,3
2023-06-01,395120,1,0,1,2,0,2
2023-06-01,12193,3,0,3,2,0,2
2023-06-01,10355,17,0,17,5,0,5
2023-06-01,54396,2,0,2,4,0,4
2023-06-01,53719,2,0,2,2,0,2
2023-06-01,44735,15,3,18,42,20,44
2023-06-01,32256,5,0,5,3,0,3
2023-06-01,394756,1,1,2,1,1,1
2023-06-01,21777,52,7,59,11,5,11
2023-06-01,399869,12,0,12,3,0,3
2023-06-01,46810,2,0,2,2,0,2
2023-06-01,394118,1,1,2,2,1,2
2023-06-01,19551,736,519,1255,199,45,204
2023-06-01,394729,8,0,8,4,0,4
2023-06-01,396958,1,0,1,1,0,1
2023-06-01,29841,11,0,11,2,0,2
2023-06-01,393819,4,2,6,2,1,2
2023-06-01,30207,1,0,1,2,0,2
2023-06-01,31853,3,0,3,4,0,4
2023-06-01,399791,6,1,7,2,2,2
2023-06-01,18798,17,0,17,5,0,5
2023-06-01,398863,2,0,2,2,0,2
2023-06-01,12213,39,16,55,27,5,28
2023-06-01,22134,4,0,4,2,0,2
2023-06-01,395584,1,0,1,1,0,1
2023-06-01,40342,4,1,5,4,3,4
2023-06-01,55234,1,0,1,2,0,2
2023-06-01,32834,3,0,3,3,0,3
2023-06-01,395630,1,0,1,1,0,1
2023-06-01,35986,305,1,306,13,4,13
2023-06-01,13368,187,0,187,8,0,8
2023-06-01,394856,2,0,2,1,0,1
2023-06-01,395258,2,0,2,3,0,3
2023-06-01,32072,2,0,2,3,0,3
2023-06-01,26405,14,0,14,2,0,2
2023-06-01,13354,35,3,38,12,4,12
2023-06-01,394785,1,0,1,1,0,1
2023-06-01,4436,0,0,0,2,2,2
2023-06-01,15164,107,12,119,136,13,137
2023-06-01,27195,25,2,27,10,3,10
2023-06-01,33490,24,97,121,61,10,64
2023-06-01,17209,3,0,3,2,0,2
2023-06-01,33469,1,0,1,2,0,2
2023-06-01,397187,14,0,14,3,0,3
2023-06-01,32932,4,1,5,2,3,3
2023-06-01,396854,1,0,1,2,0,2
2023-06-01,395890,2,0,2,1,0,1
2023-06-01,11361,2,0,2,3,0,3
2023-06-01,198949,151,4,155,131,20,131
2023-06-01,6352,13,0,13,2,0,2
2023-06-01,54174,4,0,4,3,0,3
2023-06-01,22469,2,0,2,2,0,2
2023-06-01,394133,4,0,4,2,0,2
2023-06-01,13876,30,8,38,65,10,66
2023-06-01,26153,7,1,8,2,1,2
2023-06-01,53457,3,0,3,2,0,2
2023-06-01,30262,1,0,1,1,0,1
2023-06-01,395547,2,0,2,2,0,2
2023-06-01,40885,11,3,14,5,2,5
2023-06-01,399990,1,0,1,2,0,2
2023-06-01,9751,20,1,21,4,1,4
2023-06-01,26038,4,0,4,6,0,6
2023-06-01,400273,1,0,1,3,0,3
2023-06-01,47016,2,0,2,3,0,3
2023-06-01,63427,10,0,10,4,0,4
2023-06-01,13615,1,0,1,3,0,3
2023-06-01,30244,1,0,1,2,0,2
2023-06-01,26074,4,0,4,4,0,4
2023-06-01,13727,9,4,13,14,10,14
2023-06-01,23399,2,0,2,2,0,2
2023-06-01,393602,1,0,1,2,0,2
2023-06-01,1782,1,0,1,1,0,1
2023-06-01,31776,2,0,2,2,0,2
2023-06-01,393748,1,0,1,1,0,1
2023-06-01,395273,3,0,3,4,0,4
2023-06-01,393897,1,0,1,1,0,1
2023-06-01,27207,2,0,2,2,0,2
2023-06-01,26584,3,0,3,3,0,3
2023-06-01,63168,5,1,6,1,1,2
2023-06-01,6481,125,1,126,2,1,2
2023-06-01,13954,9,0,9,2,0,2
2023-06-01,16744,3,0,3,2,0,2
2023-06-01,63474,17,0,17,11,0,11
2023-06-01,12129,55,6,61,89,22,92
2023-06-01,62955,4,1,5,24,12,28
2023-06-01,26524,5,0,5,2,0,2
2023-06-01,17271,1,0,1,2,0,2
2023-06-01,18872,4,1,5,3,1,3
2023-06-01,54025,1,0,1,2,0,2
2023-06-01,15343,3,0,3,3,0,3
2023-06-01,11272,72,3,75,52,10,52
2023-06-01,53542,3,0,3,3,0,3
2023-06-01,395070,1,0,1,1,0,1
2023-06-01,23296,8,0,8,4,0,4
2023-06-01,395387,2,0,2,2,0,2
2023-06-01,13617,6,0,6,4,0,4
2023-06-01,395438,1,0,1,1,0,1
2023-06-01,395420,2,0,2,3,0,3
2023-06-01,13693,159,0,159,12,0,12
2023-06-01,395415,6,0,6,4,0,4
2023-06-01,393995,1,0,1,1,0,1
2023-06-01,393687,1,0,1,2,0,2
2023-06-01,19724,1,0,1,1,0,1
2023-06-01,54568,2,0,2,1,0,1
2023-06-01,19021,6,1,7,8,1,8
2023-06-01,394117,2,1,3,1,2,2
2023-06-01,25931,6,0,6,2,0,2
2023-06-01,36154,3,0,3,2,0,2
2023-06-01,17314,2,1,3,3,2,3
2023-06-01,21636,3,0,3,4,0,4
2023-06-01,12185,3,0,3,3,0,3
2023-06-01,26782,3,0,3,3,0,3
2023-06-01,46746,51,0,51,8,0,8
2023-06-01,22911,15,4,19,55,12,55
2023-06-01,63264,19,1,20,8,1,8
2023-06-01,12134,4,0,4,1,0,1
2023-06-01,394663,1,0,1,2,0,2
2023-06-01,395230,2,0,2,3,0,3
2023-06-01,395218,2,0,2,4,0,4
2023-06-01,29863,19,1,20,10,3,11
2023-06-01,395276,2,0,2,2,0,2
2023-06-01,40276,6,0,6,5,0,5
2023-06-01,395762,1,0,1,1,0,1
2023-06-01,54739,2,0,2,1,0,1
2023-06-01,203107,2,0,2,2,0,2
2023-06-01,13464,4,0,4,6,0,6
2023-06-01,26375,160,83,243,8,3,8
2023-06-01,22266,2,0,2,3,0,3
2023-06-01,46282,7,0,7,5,0,5
2023-06-01,394301,2,0,2,2,0,2
2023-06-01,397015,1,0,1,1,0,1
2023-06-01,32297,3,0,3,3,0,3
2023-06-01,17639,526,12,538,80,20,86
2023-06-01,394730,1,0,1,3,0,3
2023-06-01,397880,5,1,6,3,2,3
2023-06-01,21508,27,86,113,50,3,50
2023-06-01,11895,3,0,3,4,0,4
2023-06-01,35921,2,0,2,2,0,2
2023-06-01,18518,2,0,2,2,0,2
2023-06-01,33657,59,360,419,118,12,121
2023-06-01,22258,7,19,26,13,2,13
2023-06-01,33666,2,3,5,7,3,7
2023-06-01,398808,21,2,23,6,2,6
2023-06-01,7054,52,0,52,8,0,8
2023-06-01,395056,1,0,1,1,0,1
2023-06-01,18539,2,0,2,3,0,3
2023-06-01,393339,4,0,4,3,0,3
2023-06-01,395623,0,0,0,1,0,1
2023-06-01,394000,1,0,1,3,0,3
2023-06-01,395343,1,0,1,3,0,3
2023-06-01,395290,4,0,4,3,0,3
2023-06-01,16653,3,1,4,3,2,3
2023-06-01,40000,2,0,2,3,0,3
2023-06-01,395528,1,0,1,2,0,2
2023-06-01,396044,1,0,1,2,0,2
2023-06-01,32306,2,0,2,5,0,5
2023-06-01,32263,3,1,4,4,3,4
2023-06-01,40274,1,0,1,3,0,3
2023-06-01,26878,13,2,15,13,4,13
2023-06-01,26801,105,5,110,56,10,56
2023-06-01,396268,8,0,8,2,0,2
2023-06-01,27162,2,0,2,3,0,3
2023-06-01,22294,1,0,1,2,0,2
2023-06-01,399734,6,0,6,2,0,2
2023-06-01,22326,6,0,6,2,0,2
2023-06-01,21646,9,0,9,7,0,7
2023-06-01,14385,1,0,1,2,0,2
2023-06-01,397699,1,0,1,1,0,1
2023-06-01,395463,1,0,1,2,0,2
2023-06-01,22709,26,1,27,4,1,4
2023-06-01,46203,15,0,15,4,0,4
2023-06-01,33222,3,0,3,4,0,4
2023-06-01,32197,1,0,1,3,0,3
2023-06-01,394314,6,0,6,2,0,2
2023-06-01,62957,22,3,25,6,1,6
2023-06-01,53983,4,0,4,2,0,2
2023-06-01,17139,49,2,51,3,2,3
2023-06-01,395483,2,0,2,2,0,2
2023-06-01,399297,1,0,1,2,0,2
2023-06-01,398498,1,0,1,2,0,2
2023-06-01,33489,12,48,60,20,4,21
2023-06-01,395105,2,0,2,1,0,1
2023-06-01,63460,1,0,1,2,0,2
2023-06-01,53476,1,0,1,1,0,1
2023-06-01,17033,2,0,2,3,0,3
2023-06-01,8151,11348,391,11739,84,28,86
2023-06-01,202818,48,11,59,7,5,9
2023-06-01,3909,11,0,11,2,0,2
2023-06-01,4816,30,10,40,5,3,5
2023-06-01,135061,117,26,143,3,2,3
2023-06-01,17621,362,412,774,65,9,66
2023-06-01,4354,2,0,2,3,0,3
2023-06-01,32949,2,0,2,2,0,2
2023-06-01,3729,6,0,6,3,0,3
2023-06-01,7552,3679,2202,5881,106,37,110
2023-06-01,45903,343,75,418,86,25,87
2023-06-01,134963,145,0,145,3,0,3
2023-06-01,17984,1,0,1,11,0,11
2023-06-01,14785,1,0,1,1,0,1
2023-06-01,40917,1,0,1,3,0,3
2023-06-01,17356,4,1,5,12,2,12
2023-06-01,36746,1,0,1,3,0,3
2023-06-01,13602,3,3,6,3,3,3
2023-06-01,26647,1,0,1,3,0,3
2023-06-01,19951,1,0,1,3,0,3
2023-06-01,30650,4,0,4,2,0,2
2023-06-01,55204,4,0,4,2,0,2
2023-06-01,46404,2,0,2,1,0,1
2023-06-01,53694,2,0,2,3,0,3
2023-06-01,30334,5,0,5,2,0,2
2023-06-01,62821,5,1,6,2,1,2
2023-06-01,13747,2,0,2,2,0,2
2023-06-01,27753,2,0,2,1,0,1
2023-06-01,265855,10,7,17,5,4,5
2023-06-01,27951,152,44,196,30,16,35
2023-06-01,264646,9,11,20,5,3,5
2023-06-01,262217,0,0,0,2,0,2
2023-06-01,52263,108,1,109,10,2,10
2023-06-01,27947,266,577,843,43,28,47
2023-06-01,52468,311,105,416,280,112,291
2023-06-01,263756,17,3,20,5,2,5
2023-06-01,21575,168,3,171,16,6,16
2023-06-01,272106,2,0,2,2,0,2
2023-06-01,262248,10,1,11,9,3,9
2023-06-01,19978,2,1,3,2,1,2
2023-06-01,13631,8,0,8,10,0,10
2023-06-01,394122,8,0,8,6,0,6
2023-06-01,10111,9,2,11,8,4,8
2023-06-01,42,173,178,351,47,24,50
2023-06-01,19281,4,1,5,3,2,3
2023-06-01,45344,6,1,7,2,1,2
2023-06-01,27986,9,2,11,11,7,11
2023-06-01,27651,809,206,1015,1,1,1
2023-06-01,263237,15,1,16,39,17,42
2023-06-01,1742,16,6,22,5,3,5
2023-06-01,10578,4,7,11,27,13,27
2023-06-01,33311,2,0,2,5,0,5
2023-06-01,53840,3,0,3,2,0,2
2023-06-01,14203,17,4,21,11,4,11
2023-06-01,2386,538,2,540,16,2,16
2023-06-01,5097,1,0,1,1,0,1
2023-06-01,33354,4,0,4,3,0,3
2023-06-01,23170,9,0,9,2,0,2
2023-06-01,30659,1,0,1,2,0,2
2023-06-01,23306,1,0,1,1,0,1
2023-06-01,1642,3,0,3,1,0,1
2023-06-01,21822,2,0,2,2,0,2
2023-06-01,19930,20,2,22,31,6,31
2023-06-01,14381,40,3,43,7,4,7
2023-06-01,11806,3,0,3,1,0,1
2023-06-01,32319,4,0,4,8,0,8
2023-06-01,19826,4,0,4,3,0,3
2023-06-01,399880,2,0,2,2,0,2
2023-06-01,10998,12,0,12,3,0,3
2023-06-01,398159,1,0,1,2,0,2
2023-06-01,23404,114,18,132,29,10,29
2023-06-01,32498,1,0,1,1,0,1
2023-06-01,4985,1,0,1,1,0,1
2023-06-01,10721,3,0,3,3,0,3
2023-06-01,10392,15,2,17,4,2,4
2023-06-01,134537,2,0,2,2,0,2
2023-06-01,12085,47,6,53,67,11,67
2023-06-01,30327,2,0,2,3,0,3
2023-06-01,27268,6,0,6,3,0,3
2023-06-01,30029,39,1,40,20,5,20
2023-06-01,399702,3,0,3,4,0,4
2023-06-01,399014,3,0,3,1,0,1
2023-06-01,21569,1,0,1,1,0,1
2023-06-01,32672,1,0,1,3,0,3
2023-06-01,32368,2,0,2,2,0,2
2023-06-01,109,88,38,126,20,12,20
2023-06-01,13943,7,1,8,3,1,3
2023-06-01,395439,19,1,20,4,2,4
2023-06-01,17293,37,1,38,11,2,11
2023-06-01,63255,12,0,12,4,0,4
2023-06-01,18434,107,0,107,11,0,11
2023-06-01,30082,32,0,32,6,0,6
2023-06-01,20141,79,4,83,34,8,34
2023-06-01,25688,4,0,4,2,0,2
2023-06-01,40107,15,1,16,17,3,17
2023-06-01,22880,2,0,2,2,0,2
2023-06-01,30520,4,0,4,2,0,2
2023-06-01,396451,2,0,2,2,0,2
2023-06-01,394549,1,0,1,1,0,1
2023-06-01,393489,5,0,5,2,0,2
2023-06-01,399750,1,0,1,1,0,1
2023-06-01,20429,2,0,2,2,0,2
2023-06-01,30115,6,0,6,2,0,2
2023-06-01,12257,102,4,106,17,2,17
2023-06-01,17253,17,1,18,5,2,5
2023-06-01,36838,5,0,5,3,0,3
2023-06-01,30598,19,0,19,10,0,10
2023-06-01,398026,2,0,2,1,0,1
2023-06-01,4927,12,2,14,14,5,14
2023-06-01,33161,1,0,1,2,0,2
2023-06-01,17081,1,0,1,1,0,1
2023-06-01,30364,1,0,1,1,0,1
2023-06-01,399953,1,0,1,1,0,1
2023-06-01,14990,9,0,9,5,0,5
2023-06-01,15132,1,0,1,1,0,1
2023-06-01,395929,4,0,4,2,0,2
2023-06-01,7914,11,0,11,4,0,4
2023-06-01,23544,2,0,2,1,0,1
2023-06-01,26380,58,4,62,21,3,21
2023-06-01,54588,28,2,30,24,7,24
2023-06-01,395422,1,0,1,1,0,1
2023-06-01,22763,1,0,1,1,0,1
2023-06-01,40230,31,1,32,3,2,3
2023-06-01,11409,24,0,24,7,0,7
2023-06-01,18771,8,0,8,1,0,1
2023-06-01,22610,16,0,16,2,0,2
2023-06-01,6307,117,0,117,10,0,10
2023-06-01,396116,9,0,9,1,0,1
2023-06-01,393300,2,0,2,3,0,3
2023-06-01,14267,8,0,8,2,0,2
2023-06-01,393702,1,0,1,3,0,3
2023-06-01,32328,12,0,12,1,0,1
2023-06-01,398714,1,0,1,1,0,1
2023-06-01,32869,15,1,16,14,4,15
2023-06-01,19307,1,0,1,1,0,1
2023-06-01,21737,14,1,15,8,2,8
2023-06-01,33252,3,0,3,3,0,3
2023-06-01,30229,5,0,5,2,0,2
2023-06-01,398337,21,0,21,8,0,8
2023-06-01,399553,2,0,2,2,0,2
2023-06-01,19111,7,0,7,4,0,4
2023-06-01,399972,1,0,1,3,0,3
2023-06-01,4185,18,8,26,2,2,2
2023-06-01,396462,3,0,3,3,0,3
2023-06-01,23349,16,0,16,3,0,3
2023-06-01,32567,9,0,9,6,0,6
2023-06-01,62943,116,3,119,70,12,70
2023-06-01,54809,7,0,7,1,0,1
2023-06-01,12022,8,0,8,1,0,1
2023-06-01,19524,45,0,45,5,0,5
2023-06-01,398234,1,0,1,1,0,1
2023-06-01,18862,14,0,14,2,0,2
2023-06-01,54036,17,0,17,7,0,7
2023-06-01,7015,98,679,777,194,12,197
2023-06-01,12090,30,0,30,3,0,3
2023-06-01,399685,1,1,2,2,2,2
2023-06-01,31978,10,0,10,2,0,2
2023-06-01,12104,2,0,2,1,0,1
2023-06-01,13342,18,0,18,4,0,4
2023-06-01,14411,1,0,1,2,0,2
2023-06-01,40485,2,0,2,2,0,2
2023-06-01,397602,5,0,5,2,0,2
2023-06-01,17117,21,0,21,13,0,13
2023-06-01,11933,2,0,2,2,0,2
2023-06-01,4473,36,2,38,2,2,2
2023-06-01,26907,2,0,2,1,0,1
2023-06-01,13471,4,0,4,4,0,4
2023-06-01,17064,26,1,27,6,1,6
2023-06-01,19108,636,11,647,77,10,78
2023-06-01,399314,1,0,1,2,0,2
2023-06-01,20265,1,0,1,1,0,1
2023-06-01,394543,1,0,1,1,0,1
2023-06-01,29970,4,0,4,3,0,3
2023-06-01,3577,2,0,2,2,0,2
2023-06-01,29874,5,0,5,5,0,5
2023-06-01,16490,3,0,3,1,0,1
2023-06-01,17276,4,0,4,1,0,1
2023-06-01,36178,1,0,1,1,0,1
2023-06-01,11857,51,0,51,7,0,7
2023-06-01,40098,11,1,12,2,2,2
2023-06-01,14639,11,1,12,2,1,2
2023-06-01,396199,1,0,1,2,0,2
2023-06-01,22249,1,0,1,2,0,2
2023-06-01,30308,1,0,1,1,0,1
2023-06-01,26345,2,0,2,2,0,2
2023-06-01,54483,98,3,101,14,6,14
2023-06-01,14879,2,0,2,5,0,5
2023-06-01,53325,4,0,4,1,0,1
2023-06-01,3801,132,2,134,10,6,10
2023-06-01,30525,4,0,4,3,0,3
2023-06-01,400454,9,0,9,6,0,6
2023-06-01,22040,14,0,14,2,0,2
2023-06-01,13554,3,0,3,4,0,4
2023-06-01,30452,8,7,15,3,1,3
2023-06-01,18833,3,0,3,3,0,3
2023-06-01,27529,8,0,8,4,0,4
2023-06-01,36415,1,0,1,1,0,1
2023-06-01,32367,5,0,5,2,0,2
2023-06-01,396831,2,0,2,2,0,2
2023-06-01,53517,1,0,1,3,0,3
2023-06-01,32951,3,0,3,3,0,3
2023-06-01,2727,13,0,13,3,0,3
2023-06-01,397665,4,1,5,5,1,5
2023-06-01,26751,4,0,4,2,0,2
2023-06-01,4546,50,0,50,8,0,8
2023-06-01,16969,1,0,1,1,0,1
2023-06-01,33753,3,0,3,3,0,3
2023-06-01,21619,1,0,1,3,0,3
2023-06-01,397817,1,0,1,3,0,3
2023-06-01,394981,2,0,2,1,0,1
2023-06-01,31973,2,0,2,2,0,2
2023-06-01,19312,3,0,3,2,0,2
2023-06-01,22024,9,0,9,7,0,7
2023-06-01,6195,15,0,15,1,0,1
2023-06-01,3585,16,0,16,8,0,8
2023-06-01,11520,69,0,69,4,0,4
2023-06-01,26707,1,0,1,1,0,1
2023-06-01,16914,1,0,1,4,0,4
2023-06-01,54968,6,0,6,3,0,3
2023-06-01,6319,12,0,12,3,0,3
2023-06-01,33054,1,0,1,3,0,3
2023-06-01,5637,1,0,1,1,0,1
2023-06-01,22197,10,0,10,3,0,3
2023-06-01,394795,4,0,4,2,0,2
2023-06-01,15267,27,3,30,10,4,10
2023-06-01,393691,1,0,1,1,0,1
2023-06-01,20310,5,0,5,2,0,2
2023-06-01,19449,2,0,2,2,0,2
2023-06-01,16873,2,0,2,2,0,2
2023-06-01,62958,20,0,20,9,0,9
2023-06-01,54221,11,0,11,1,0,1
2023-06-01,21720,1,0,1,2,0,2
2023-06-01,46145,3,0,3,4,0,4
2023-06-01,25924,2,0,2,3,0,3
2023-06-01,46197,0,0,0,3,0,3
2023-06-01,100,7,0,7,7,0,7
2023-06-01,13628,16,0,16,7,0,7
2023-06-01,18889,4,1,5,2,1,2
2023-06-01,14056,3,0,3,4,0,4
2023-06-01,26311,27,0,27,3,0,3
2023-06-01,18671,35,0,35,6,0,6
2023-06-01,23087,1,0,1,1,0,1
2023-06-01,394878,1,0,1,2,0,2
2023-06-01,393599,1,1,2,1,1,1
2023-06-01,15215,6,0,6,3,0,3
2023-06-01,33662,33,86,119,52,8,54
2023-06-01,33331,2,0,2,1,0,1
2023-06-01,32041,2,0,2,1,0,1
2023-06-01,10788,10,0,10,4,0,4
2023-06-01,33544,50,6,56,14,4,14
2023-06-01,64202,1,0,1,2,0,2
2023-06-01,32687,1,0,1,2,0,2
2023-06-01,4181,1434,8,1442,56,10,58
2023-06-01,47039,2,0,2,3,0,3
2023-06-01,22209,1,0,1,1,0,1
2023-06-01,11273,142,0,142,3,0,3
2023-06-01,33160,3,0,3,2,0,2
2023-06-01,40607,1,0,1,1,0,1
2023-06-01,29733,10,0,10,5,0,5
2023-06-01,19998,1,0,1,1,0,1
2023-06-01,40934,129,7,136,21,3,21
2023-06-01,6253,38,0,38,11,0,11
2023-06-01,40233,1,0,1,2,0,2
2023-06-01,32009,2,0,2,3,0,3
2023-06-01,394819,2,0,2,3,0,3
2023-06-01,17178,4,0,4,4,0,4
2023-06-01,18848,3,0,3,2,0,2
2023-06-01,397762,1,0,1,2,0,2
2023-06-01,19215,11,0,11,2,0,2
2023-06-01,55257,0,0,0,2,0,2
2023-06-01,394733,2,0,2,2,0,2
2023-06-01,53768,17,0,17,3,0,3
2023-06-01,11030,10,2,12,7,3,7
2023-06-01,399761,6,0,6,1,0,1
2023-06-01,36297,7,0,7,3,0,3
2023-06-01,55200,1,0,1,2,0,2
2023-06-01,395183,3,0,3,3,0,3
2023-06-01,395476,3,0,3,3,0,3
2023-06-01,14888,4,0,4,2,0,2
2023-06-01,26915,2,0,2,1,0,1
2023-06-01,8119,26,0,26,5,0,5
2023-06-01,21861,2,0,2,1,0,1
2023-06-01,12152,14,0,14,8,0,8
2023-06-01,33684,2,0,2,3,0,3
2023-06-01,19229,190,2,192,16,8,19
2023-06-01,397934,5,0,5,8,0,8
2023-06-01,62861,6,7,13,4,1,4
2023-06-01,395190,2,0,2,3,0,3
2023-06-01,15007,2,0,2,2,0,2
2023-06-01,33176,8,0,8,3,0,3
2023-06-01,22528,19,0,19,1,0,1
2023-06-01,13453,3,0,3,2,0,2
2023-06-01,13814,2,0,2,2,0,2
2023-06-01,32326,7,0,7,4,0,4
2023-06-01,14103,39,1,40,19,2,19
2023-06-01,26330,2,0,2,1,0,1
2023-06-01,32774,1,0,1,1,0,1
2023-06-01,63144,1,0,1,1,0,1
2023-06-01,400643,2,0,2,3,0,3
2023-06-01,33025,6,0,6,2,0,2
2023-06-01,30182,10,0,10,2,0,2
2023-06-01,14792,32,0,32,3,0,3
2023-06-01,31824,3,0,3,1,0,1
2023-06-01,36150,1,0,1,2,0,2
2023-06-01,16961,2,0,2,1,0,1
2023-06-01,19275,9,0,9,2,0,2
2023-06-01,399240,7,0,7,5,0,5
2023-06-01,32129,1,0,1,2,0,2
2023-06-01,35841,1,0,1,2,0,2
2023-06-01,16711,13,3,16,4,3,4
2023-06-01,13893,11,6,17,4,4,4
2023-06-01,13932,2,0,2,3,0,3
2023-06-01,22792,15,1,16,15,2,15
2023-06-01,17310,9,1,10,7,1,7
2023-06-01,23453,1,0,1,1,0,1
2023-06-01,26479,7,1,8,10,2,10
2023-06-01,4188,3,0,3,3,0,3
2023-06-01,13317,1,0,1,1,0,1
2023-06-01,23502,1,0,1,2,0,2
2023-06-01,397306,1,0,1,2,0,2
2023-06-01,53320,3,0,3,2,0,2
2023-06-01,22234,1,0,1,1,0,1
2023-06-01,35858,1,0,1,2,0,2
2023-06-01,15262,2,0,2,3,0,3
2023-06-01,25622,1,0,1,2,0,2
2023-06-01,16782,1,0,1,3,0,3
2023-06-01,63335,17,0,17,4,0,4
2023-06-01,396380,1,0,1,1,0,1
2023-06-01,32382,21,0,21,4,0,4
2023-06-01,8161,16,0,16,5,0,5
2023-06-01,25991,2,0,2,1,0,1
2023-06-01,18839,0,0,0,2,0,2
2023-06-01,13812,6,0,6,4,0,4
2023-06-01,398144,3,0,3,1,0,1
2023-06-01,10584,20,0,20,5,0,5
2023-06-01,4366,5,0,5,2,0,2
2023-06-01,22184,4,0,4,4,0,4
2023-06-01,53741,16,0,16,7,0,7
2023-06-01,33598,17,0,17,1,0,1
2023-06-01,30573,1,0,1,1,0,1
2023-06-01,27562,4,0,4,3,0,3
2023-06-01,18974,4,0,4,2,0,2
2023-06-01,16508,1,0,1,2,0,2
2023-06-01,26536,3,0,3,2,0,2
2023-06-01,15251,4,0,4,2,0,2
2023-06-01,63305,1,0,1,1,0,1
2023-06-01,394540,5,0,5,3,0,3
2023-06-01,6569,20,0,20,4,0,4
2023-06-01,397757,2,0,2,2,0,2
2023-06-01,26777,3,1,4,3,1,3
2023-06-01,394763,1,0,1,2,0,2
2023-06-01,397603,1,0,1,2,0,2
2023-06-01,46375,71,2,73,17,6,17
2023-06-01,400010,2,0,2,3,0,3
2023-06-01,40743,1,0,1,2,0,2
2023-06-01,12083,828,1,829,49,10,49
2023-06-01,18934,11,0,11,6,0,6
2023-06-01,46668,4,0,4,2,0,2
2023-06-01,27482,34,0,34,4,0,4
2023-06-01,23016,2,0,2,3,0,3
2023-06-01,40584,6,0,6,5,0,5
2023-06-01,14748,1,0,1,1,0,1
2023-06-01,17231,44,0,44,4,0,4
2023-06-01,17227,24,0,24,1,0,1
2023-06-01,17229,11,0,11,2,0,2
2023-06-01,4264,15,0,15,1,0,1
2023-06-01,17233,9,0,9,1,0,1
2023-06-01,17226,7,0,7,1,0,1
2023-06-01,46752,1,0,1,1,0,1
2023-06-01,32140,2,0,2,2,0,2
2023-06-01,40844,15,0,15,1,0,1
2023-06-01,394845,2,0,2,2,0,2
2023-06-01,1444,4,0,4,2,0,2
2023-06-01,395975,2,0,2,2,0,2
2023-06-01,31893,4,0,4,6,0,6
2023-06-01,54731,1,0,1,3,0,3
2023-06-01,7046,269,33,302,21,3,22
2023-06-01,399604,6,0,6,4,0,4
2023-06-01,63047,2,0,2,1,0,1
2023-06-01,31781,1,0,1,1,0,1
2023-06-01,46229,1,0,1,1,0,1
2023-06-01,395069,1,0,1,3,0,3
2023-06-01,35910,3,0,3,3,0,3
2023-06-01,40919,2,0,2,1,0,1
2023-06-01,54142,24,2,26,5,1,5
2023-06-01,4466,131,1,132,1,1,1
2023-06-01,6389,662,0,662,9,0,9
2023-06-01,3423,10,3,13,2,2,2
2023-06-01,7743,15,6,21,7,5,7
2023-06-01,11496,5,0,5,1,0,1
2023-06-01,35944,1,0,1,2,0,2
2023-06-01,32617,2,0,2,2,0,2
2023-06-01,16593,2,0,2,2,0,2
2023-06-01,393508,18,0,18,1,0,1
2023-06-01,62721,1,0,1,2,0,2
2023-06-01,21945,6,0,6,3,0,3
2023-06-01,5730,0,0,0,2,2,2
2023-06-01,17224,86,1,87,1,1,1
2023-06-01,16669,12,0,12,6,0,6
2023-06-01,25930,2,0,2,3,0,3
2023-06-01,21842,3,0,3,2,0,2
2023-06-01,14119,1,0,1,1,0,1
2023-06-01,16618,17,0,17,3,0,3
2023-06-01,20170,11,0,11,3,0,3
2023-06-01,54690,9,0,9,4,0,4
2023-06-01,20426,18,0,18,4,0,4
2023-06-01,6431,13,10,23,1,1,1
2023-06-01,19240,9,0,9,5,0,5
2023-06-01,395971,5,0,5,6,0,6
2023-06-01,13396,1,0,1,1,0,1
2023-06-01,22302,25,9,34,15,4,15
2023-06-01,18585,3,0,3,3,0,3
2023-06-01,36059,1,0,1,2,0,2
2023-06-01,30356,11,0,11,2,0,2
2023-06-01,55083,7,4,11,4,2,4
2023-06-01,26964,1,0,1,1,0,1
2023-06-01,11066,6,0,6,2,0,2
2023-06-01,393469,1,0,1,1,0,1
2023-06-01,39945,4,0,4,5,0,5
2023-06-01,20034,4,0,4,3,0,3
2023-06-01,12101,1,0,1,2,0,2
2023-06-01,26829,1,0,1,1,0,1
2023-06-01,32206,2,0,2,1,0,1
2023-06-01,394633,1,0,1,2,0,2
2023-06-01,20133,1,0,1,2,0,2
2023-06-01,393896,1,0,1,2,0,2
2023-06-01,32258,2,0,2,2,0,2
2023-06-01,1080,1,0,1,2,0,2
2023-06-01,398801,4,0,4,3,0,3
2023-06-01,20217,3,0,3,3,0,3
2023-06-01,13976,1,0,1,1,0,1
2023-06-01,1609,2,0,2,2,0,2
2023-06-01,26295,3,0,3,2,0,2
2023-06-01,22048,4,0,4,6,0,6
2023-06-01,14010,66,0,66,23,0,23
2023-06-01,26075,1,0,1,1,0,1
2023-06-01,27271,3,0,3,1,0,1
2023-06-01,54753,1,0,1,1,0,1
2023-06-01,13695,15,0,15,3,0,3
2023-06-01,26144,7,0,7,2,0,2
2023-06-01,393321,4,0,4,3,0,3
2023-06-01,26789,5,0,5,2,0,2
2023-06-01,23094,4,0,4,2,0,2
2023-06-01,16763,1,0,1,2,0,2
2023-06-01,20055,29,5,34,80,25,81
2023-06-01,27017,14,0,14,5,2,6
2023-06-01,36803,3,0,3,2,0,2
2023-06-01,17232,15,0,15,1,0,1
2023-06-01,17228,5,0,5,3,0,3
2023-06-01,40631,7,0,7,2,0,2
2023-06-01,11539,7,0,7,2,0,2
2023-06-01,19615,11,0,11,5,0,5
2023-06-01,17349,1,0,1,2,0,2
2023-06-01,29944,15,2,17,11,4,11
2023-06-01,23189,1,0,1,3,0,3
2023-06-01,46803,1,0,1,1,0,1
2023-06-01,22840,2,0,2,4,0,4
2023-06-01,16966,11,0,11,1,0,1
2023-06-01,17225,11,0,11,3,0,3
2023-06-01,17088,36,0,36,16,0,16
2023-06-01,36271,7,1,8,4,1,4
2023-06-01,393255,1,0,1,1,0,1
2023-06-01,4266,55,0,55,2,0,2
2023-06-01,13788,15,0,15,2,0,2
2023-06-01,4265,11,0,11,1,0,1
2023-06-01,4262,2,0,2,1,0,1
2023-06-01,4263,4,0,4,2,0,2
2023-06-01,21621,18,0,18,3,0,3
2023-06-01,16931,15,0,15,11,0,11
2023-06-01,16967,19,0,19,1,0,1
2023-06-01,22538,2,0,2,1,0,1
2023-06-01,27358,4,0,4,3,0,3
2023-06-01,4057,2,0,2,2,0,2
2023-06-01,53396,3,0,3,3,0,3
2023-06-01,15023,1,0,1,2,0,2
2023-06-01,21791,1,0,1,2,0,2
2023-06-01,27309,5,0,5,2,0,2
2023-06-01,54420,5,0,5,4,0,4
2023-06-01,22916,3,0,3,2,0,2
2023-06-01,396911,1,0,1,2,0,2
2023-06-01,46676,1,0,1,1,0,1
2023-06-01,32300,2,0,2,2,0,2
2023-06-01,397593,3,0,3,1,0,1
2023-06-01,400267,1,0,1,1,0,1
2023-06-01,3379,35,1,36,3,1,3
2023-06-01,30091,19,0,19,4,0,4
2023-06-01,12246,2,0,2,1,0,1
2023-06-01,17365,3,1,4,2,1,2
2023-06-01,30450,2,0,2,1,0,1
2023-06-01,22535,3,0,3,1,0,1
2023-06-01,32486,1,0,1,3,0,3
2023-06-01,13994,34,0,34,7,0,7
2023-06-01,53432,1,0,1,2,0,2
2023-06-01,25823,1,0,1,3,0,3
2023-06-01,394194,7,0,7,3,0,3
2023-06-01,20138,1,0,1,2,0,2
2023-06-01,27329,1,0,1,2,0,2
2023-06-01,53610,24,5,29,24,11,24
2023-06-01,396281,3,0,3,2,0,2
2023-06-01,26881,17,0,17,6,0,6
2023-06-01,54230,2,0,2,3,0,3
2023-06-01,21651,8,0,8,2,0,2
2023-06-01,19244,9,0,9,2,0,2
2023-06-01,40506,1,0,1,2,0,2
2023-06-01,14858,35,1,36,4,1,4
2023-06-01,19663,2,0,2,2,0,2
2023-06-01,397079,2,0,2,2,0,2
2023-06-01,23093,3,0,3,3,0,3
2023-06-01,26289,2,0,2,2,0,2
2023-06-01,40265,1,0,1,2,0,2
2023-06-01,14047,1,0,1,1,0,1
2023-06-01,15106,5,0,5,3,0,3
2023-06-01,20120,1,0,1,1,0,1
2023-06-01,19299,11,0,11,3,0,3
2023-06-01,53738,2,0,2,1,0,1
2023-06-01,400069,4,0,4,2,0,2
2023-06-01,395491,4,0,4,1,0,1
2023-06-01,13652,9,1,10,4,1,4
2023-06-01,396300,0,0,0,8,0,8
2023-06-01,36136,15,0,15,4,0,4
2023-06-01,15059,1,0,1,1,0,1
2023-06-01,394325,3,0,3,5,0,5
2023-06-01,25932,15,0,15,3,0,3
2023-06-01,21923,1,0,1,1,0,1
2023-06-01,398402,1,0,1,1,0,1
2023-06-01,22959,2,0,2,2,0,2
2023-06-01,33358,5,0,5,5,0,5
2023-06-01,395535,8,0,8,3,0,3
2023-06-01,18903,3,0,3,4,0,4
2023-06-01,25921,38,0,38,8,0,8
2023-06-01,30175,33,0,33,9,0,9
2023-06-01,11722,18,2,20,11,4,11
2023-06-01,46901,1,0,1,3,0,3
2023-06-01,26854,43,0,43,5,0,5
2023-06-01,11709,1,0,1,1,0,1
2023-06-01,26244,8,0,8,4,0,4
2023-06-01,20242,1,0,1,1,0,1
2023-06-01,22602,2,0,2,2,0,2
2023-06-01,36180,20,34,54,4,2,4
2023-06-01,797,69,0,69,2,0,2
2023-06-01,20351,1,0,1,2,0,2
2023-06-01,40338,1,0,1,1,0,1
2023-06-01,36055,1,0,1,1,0,1
2023-06-01,396247,3,0,3,4,0,4
2023-06-01,30442,1,0,1,2,0,2
2023-06-01,18720,1,0,1,1,0,1
2023-06-01,396508,1,0,1,1,0,1
2023-06-01,14388,6,0,6,4,0,4
2023-06-01,54808,2,0,2,2,0,2
2023-06-01,395500,6,3,9,4,2,4
2023-06-01,32512,2,0,2,1,0,1
2023-06-01,54940,1,0,1,2,0,2
2023-06-01,395215,5,0,5,1,0,1
2023-06-01,18824,1,0,1,1,0,1
2023-06-01,395315,3,0,3,2,0,2
2023-06-01,26325,3,0,3,3,0,3
2023-06-01,399758,1,0,1,1,0,1
2023-06-01,11463,4,0,4,1,0,1
2023-06-01,399942,3,0,3,2,0,2
2023-06-01,27634,2,0,2,2,0,2
2023-06-01,27189,1,0,1,1,0,1
2023-06-01,23291,4,0,4,2,0,2
2023-06-01,395393,2,0,2,1,0,1
2023-06-01,19782,2,2,4,17,11,17
2023-06-01,1767,38,3,41,18,4,18
2023-06-01,20452,2,1,3,2,2,2
2023-06-01,393264,1,0,1,2,0,2
2023-06-01,14528,2,0,2,3,0,3
2023-06-01,400008,6,0,6,3,0,3
2023-06-01,21858,6,1,7,4,2,4
2023-06-01,11924,43,1,44,10,6,12
2023-06-01,18961,8,0,8,4,0,4
2023-06-01,33233,1,0,1,1,0,1
2023-06-01,32703,20,7,27,31,5,31
2023-06-01,25648,3,0,3,3,0,3
2023-06-01,36478,3,0,3,4,0,4
2023-06-01,23153,1,0,1,1,0,1
2023-06-01,32282,5,0,5,3,0,3
2023-06-01,17030,4,0,4,4,0,4
2023-06-01,17166,15,0,15,3,0,3
2023-06-01,10599,26,0,26,7,0,7
2023-06-01,395430,2,0,2,1,0,1
2023-06-01,23248,2,3,5,11,4,12
2023-06-01,22002,7,0,7,6,0,6
2023-06-01,54273,1,0,1,2,0,2
2023-06-01,63467,2,0,2,2,0,2
2023-06-01,19706,1,0,1,1,0,1
2023-06-01,393485,2,0,2,3,0,3
2023-06-01,33347,3,0,3,2,0,2
2023-06-01,20358,1,0,1,2,0,2
2023-06-01,11966,8,0,8,7,0,7
2023-06-01,763,2,0,2,1,0,1
2023-06-01,32583,2,0,2,2,0,2
2023-06-01,29767,3,0,3,3,0,3
2023-06-01,11575,2,0,2,2,0,2
2023-06-01,18636,2,0,2,1,0,1
2023-06-01,26171,1,0,1,1,0,1
2023-06-01,21981,6,1,7,5,2,5
2023-06-01,30291,1,0,1,1,0,1
2023-06-01,55219,4,9,13,12,7,13
2023-06-01,27619,1,0,1,1,0,1
2023-06-01,27231,1,0,1,2,0,2
2023-06-01,16405,3,0,3,1,0,1
2023-06-01,23424,2,0,2,1,0,1
2023-06-01,30572,7,0,7,1,0,1
2023-06-01,62951,1,0,1,2,0,2
2023-06-01,36726,1,1,2,3,1,3
2023-06-01,54857,7,0,7,1,0,1
2023-06-01,3655,5,0,5,2,0,2
2023-06-01,22785,3,0,3,3,0,3
2023-06-01,21947,16,4,20,23,9,24
2023-06-01,26507,2,0,2,3,0,3
2023-06-01,36712,51,0,51,3,0,3
2023-06-01,400269,1,0,1,1,0,1
2023-06-01,40458,6,0,6,4,0,4
2023-06-01,26694,3,0,3,2,0,2
2023-06-01,7723,3,0,3,3,0,3
2023-06-01,26842,6,0,6,4,0,4
2023-06-01,22312,2,0,2,2,0,2
2023-06-01,398189,1,0,1,2,0,2
2023-06-01,27202,17,0,17,7,0,7
2023-06-01,24115,0,0,0,5,0,5
2023-06-01,27015,8,0,8,7,0,7
2023-06-01,396169,3,0,3,2,0,2
2023-06-01,396907,1,0,1,2,0,2
2023-06-01,27288,14,1,15,4,1,4
2023-06-01,32352,2,0,2,1,0,1
2023-06-01,36111,4,0,4,2,0,2
2023-06-01,54959,2,0,2,2,0,2
2023-06-01,46439,1,0,1,1,0,1
2023-06-01,53420,9,0,9,2,0,2
2023-06-01,22471,2,0,2,3,0,3
2023-06-01,5661,1,1,2,6,3,6
2023-06-01,394888,1,0,1,3,0,3
2023-06-01,396993,1,0,1,1,0,1
2023-06-01,36189,1,0,1,2,0,2
2023-06-01,40656,5,0,5,1,0,1
2023-06-01,393787,2,0,2,2,0,2
2023-06-01,18544,1,0,1,1,0,1
2023-06-01,17096,3,0,3,2,0,2
2023-06-01,395850,1,0,1,1,0,1
2023-06-01,33461,2,0,2,2,0,2
2023-06-01,54239,13,0,13,3,0,3
2023-06-01,395210,1,0,1,4,0,4
2023-06-01,396184,4,0,4,1,0,1
2023-06-01,46562,378,46,424,36,15,37
2023-06-01,19716,2,0,2,1,0,1
2023-06-01,33286,1,0,1,2,0,2
2023-06-01,396944,3,0,3,2,0,2
2023-06-01,31902,7,0,7,5,0,5
2023-06-01,13457,2,0,2,1,0,1
2023-06-01,394701,1,0,1,3,0,3
2023-06-01,14067,1,0,1,1,0,1
2023-06-01,13740,13,0,13,2,0,2
2023-06-01,394152,2,0,2,2,0,2
2023-06-01,14244,40,9,49,28,3,29
2023-06-01,13480,31,0,31,6,0,6
2023-06-01,30610,3,0,3,1,0,1
2023-06-01,14561,10,0,10,4,0,4
2023-06-01,36723,2,0,2,2,0,2
2023-06-01,395572,2,0,2,4,0,4
2023-06-01,23045,2,0,2,2,0,2
2023-06-01,6618,1,0,1,3,0,3
2023-06-01,394143,1,0,1,3,0,3
2023-06-01,36603,1,0,1,3,0,3
2023-06-01,32859,1,0,1,4,0,4
2023-06-01,40183,2,0,2,2,0,2
2023-06-01,11550,12,0,12,16,0,16
2023-06-01,13729,12,0,12,7,0,7
2023-06-01,40110,1,0,1,2,0,2
2023-06-01,29992,21,4,25,2,1,2
2023-06-01,36105,20,0,20,4,0,4
2023-06-01,33722,1,0,1,1,0,1
2023-06-01,16994,1,0,1,2,0,2
2023-06-01,22617,2,1,3,2,1,2
2023-06-01,46569,2,0,2,3,0,3
2023-06-01,54834,2,0,2,1,0,1
2023-06-01,36308,1,0,1,2,0,2
2023-06-01,22772,15,1,16,13,6,13
2023-06-01,14139,4,0,4,3,0,3
2023-06-01,395550,2,0,2,1,0,1
2023-06-01,23542,1,0,1,3,0,3
2023-06-01,395227,3,0,3,2,0,2
2023-06-01,11760,2,0,2,1,0,1
2023-06-01,4917,17,0,17,5,0,5
2023-06-01,30187,7,0,7,3,0,3
2023-06-01,31921,7,1,8,5,2,5
2023-06-01,27025,2,0,2,1,0,1
2023-06-01,397619,1,0,1,3,0,3
2023-06-01,393475,1,0,1,3,0,3
2023-06-01,32461,7,0,7,7,0,7
2023-06-01,11796,25,19,44,59,23,63
2023-06-01,7268,9,0,9,4,0,4
2023-06-01,25990,1,0,1,3,0,3
2023-06-01,46481,1,0,1,1,0,1
2023-06-01,393505,2,0,2,2,0,2
2023-06-01,11286,28,0,28,3,0,3
2023-06-01,19599,2,0,2,2,0,2
2023-06-01,32412,2,0,2,2,0,2
2023-06-01,19417,2,0,2,4,0,4
2023-06-01,13977,885,7,892,50,4,50
2023-06-01,13672,48,0,48,2,0,2
2023-06-01,23521,3,0,3,1,0,1
2023-06-01,40740,3,0,3,1,0,1
2023-06-01,399510,3,0,3,2,0,2
2023-06-01,36488,4,0,4,2,0,2
2023-06-01,26306,10,0,10,1,0,1
2023-06-01,395626,1,0,1,1,0,1
2023-06-01,40726,1,0,1,1,0,1
2023-06-01,19754,25,14,39,46,11,47
2023-06-01,394702,1,0,1,2,0,2
2023-06-01,19622,3,0,3,4,0,4
2023-06-01,19095,1,0,1,1,0,1
2023-06-01,12007,77,0,77,6,0,6
2023-06-01,20152,1,0,1,1,0,1
2023-06-01,8030,48,0,48,1,0,1
2023-06-01,40886,4,0,4,2,0,2
2023-06-01,62620,4,0,4,2,0,2
2023-06-01,395380,1,0,1,2,0,2
2023-06-01,22260,85,0,85,3,0,3
2023-06-01,3663,53,1,54,17,6,17
2023-06-01,393377,2,0,2,2,0,2
2023-06-01,11974,1,0,1,1,0,1
2023-06-01,396301,1,0,1,2,0,2
2023-06-01,53341,1,0,1,3,0,3
2023-06-01,395567,23,1,24,12,4,12
2023-06-01,27426,2,0,2,1,0,1
2023-06-01,395521,1,0,1,1,0,1
2023-06-01,395377,1,0,1,2,0,2
2023-06-01,18937,2,0,2,3,0,3
2023-06-01,398667,1,0,1,2,0,2
2023-06-01,40805,15,1,16,8,7,11
2023-06-01,33000,4,6,10,2,1,2
2023-06-01,63069,17,1,18,7,4,8
2023-06-01,32892,1,0,1,3,0,3
2023-06-01,11208,1,0,1,2,0,2
2023-06-01,13968,7,0,7,4,0,4
2023-06-01,17058,5,0,5,1,0,1
2023-06-01,395941,2,0,2,2,0,2
2023-06-01,30672,2,0,2,1,0,1
2023-06-01,397281,2,0,2,2,0,2
2023-06-01,395484,1,0,1,1,0,1
2023-06-01,393788,2,0,2,1,0,1
2023-06-01,46847,12,0,12,12,0,12
2023-06-01,11219,1,0,1,3,0,3
2023-06-01,12020,1,0,1,1,0,1
2023-06-01,395767,1,0,1,1,0,1
2023-06-01,13641,10,0,10,2,0,2
2023-06-01,33735,2,0,2,1,0,1
2023-06-01,22317,12,13,25,7,9,11
2023-06-01,396337,2,0,2,4,0,4
2023-06-01,397872,2,0,2,2,0,2
2023-06-01,15077,1,0,1,1,0,1
2023-06-01,11212,3,0,3,3,0,3
2023-06-01,36835,1,0,1,3,0,3
2023-06-01,54199,2,0,2,2,0,2
2023-06-01,53806,1,0,1,2,0,2
2023-06-01,18641,4,0,4,1,0,1
2023-06-01,22034,4,0,4,4,0,4
2023-06-01,23120,1,0,1,1,0,1
2023-06-01,393674,5,0,5,3,0,3
2023-06-01,46870,2,0,2,2,0,2
2023-06-01,36173,2,0,2,1,0,1
2023-06-01,18569,6,0,6,2,0,2
2023-06-01,19957,46,20,66,3,2,3
2023-06-01,11992,30,2,32,18,2,18
2023-06-01,22888,3,0,3,2,0,2
2023-06-01,395936,1,0,1,1,0,1
2023-06-01,397926,1,0,1,2,0,2
2023-06-01,36721,1,0,1,2,0,2
2023-06-01,18531,3,2,5,3,3,3
2023-06-01,32375,1,0,1,2,0,2
2023-06-01,54240,15,0,15,8,0,8
2023-06-01,11417,1,0,1,6,0,6
2023-06-01,20315,3,0,3,4,0,4
2023-06-01,6325,92,1,93,46,5,46
2023-06-01,395757,1,0,1,3,0,3
2023-06-01,396437,4,0,4,4,0,4
2023-06-01,22106,4,0,4,3,0,3
2023-06-01,53765,1,0,1,1,0,1
2023-06-01,393707,3,0,3,3,0,3
2023-06-01,400125,2,0,2,2,0,2
2023-06-01,54411,4,0,4,2,0,2
2023-06-01,19932,2,0,2,3,0,3
2023-06-01,20072,2,0,2,3,0,3
2023-06-01,54428,1,0,1,1,0,1
2023-06-01,54747,2,0,2,1,0,1
2023-06-01,54710,4,1,5,4,1,4
2023-06-01,13351,15,16,31,6,2,6
2023-06-01,399148,3,0,3,3,0,3
2023-06-01,19641,2,0,2,2,0,2
2023-06-01,46286,7,0,7,4,0,4
2023-06-01,399328,1,0,1,1,0,1
2023-06-01,19015,1,0,1,1,0,1
2023-06-01,13621,4,0,4,5,0,5
2023-06-01,19443,25,0,25,7,0,7
2023-06-01,53946,1,0,1,1,0,1
2023-06-01,46216,1,0,1,1,0,1
2023-06-01,54638,9,1,10,1,1,1
2023-06-01,397977,1,0,1,2,0,2
2023-06-01,18541,3,1,4,6,4,6
2023-06-01,30069,1,1,2,4,1,4
2023-06-01,16571,1,0,1,1,0,1
2023-06-01,19309,2,0,2,3,0,3
2023-06-01,25993,41,3,44,1,1,1
2023-06-01,18610,1,0,1,1,0,1
2023-06-01,54448,20,0,20,2,0,2
2023-06-01,20181,1,0,1,3,0,3
2023-06-01,400511,61,1,62,7,2,7
2023-06-01,40842,1,0,1,2,0,2
2023-06-01,25632,1,0,1,3,0,3
2023-06-01,46826,4,0,4,1,0,1
2023-06-01,21900,2,0,2,2,0,2
2023-06-01,20408,2,0,2,2,0,2
2023-06-01,31806,1,0,1,1,0,1
2023-06-01,1641,2,0,2,2,0,2
2023-06-01,394777,2,0,2,2,0,2
2023-06-01,30258,2,0,2,3,0,3
2023-06-01,40037,1,0,1,1,0,1
2023-06-01,18651,1,0,1,1,0,1
2023-06-01,13624,4,0,4,4,0,4
2023-06-01,54357,2,0,2,1,0,1
2023-06-01,32219,1,0,1,1,0,1
2023-06-01,22261,2,0,2,1,0,1
2023-06-01,26151,3,0,3,5,0,5
2023-06-01,5752,1,0,1,1,0,1
2023-06-01,7116,6,0,6,3,0,3
2023-06-01,395234,1,0,1,2,0,2
2023-06-01,26437,6,0,6,2,0,2
2023-06-01,32158,10,0,10,2,0,2
2023-06-01,396089,2,0,2,1,0,1
2023-06-01,393950,23,7,30,13,7,14
2023-06-01,395742,3,1,4,2,1,2
2023-06-01,46605,2,0,2,1,0,1
2023-06-01,62813,4,0,4,5,0,5
2023-06-01,22418,26,2,28,14,4,14
2023-06-01,27257,82,3,85,17,7,18
2023-06-01,36313,2,0,2,2,0,2
2023-06-01,36406,2,0,2,1,0,1
2023-06-01,46827,1,0,1,2,0,2
2023-06-01,55265,4,0,4,2,0,2
2023-06-01,55196,1,1,2,2,1,2
2023-06-01,14623,1,0,1,2,0,2
2023-06-01,30483,1,0,1,2,0,2
2023-06-01,30101,1,0,1,2,0,2
2023-06-01,47047,1,0,1,1,0,1
2023-06-01,33631,100,1,101,4,1,4
2023-06-01,26662,19,0,19,5,0,5
2023-06-01,22390,18,0,18,3,0,3
2023-06-01,395959,5,0,5,3,0,3
2023-06-01,8068,56,39,95,1,1,1
2023-06-01,14340,32,3,35,25,13,27
2023-06-01,22606,12,0,12,1,0,1
2023-06-01,55391,5,2,7,7,7,7
2023-06-01,24088,91,1,92,40,9,41
2023-06-01,45899,3466,309,3775,125,35,132
2023-06-01,4761,616,6,622,197,31,200
2023-06-01,55805,4,2,6,27,15,30
2023-06-01,36408,24,1,25,6,1,6
2023-06-01,38107,60,0,60,3,0,3
2023-06-01,55392,5,2,7,5,5,5
2023-06-01,7679,36,2,38,27,13,29
2023-06-01,10000,19,1,20,5,3,6
2023-06-01,45437,22,3,25,28,12,29
2023-06-01,7296,269,1,270,12,3,12
2023-06-01,55778,7,0,7,1,0,1
2023-06-01,63018,93,9,102,8,7,8
2023-06-01,45177,63,53,116,51,13,53
2023-06-01,14593,273,40,313,30,24,33
2023-06-01,4229,11,10,21,23,17,28
2023-06-01,18013,15,0,15,20,2,20
2023-06-01,139009,29,20,49,168,33,170
2023-06-01,17557,1017,2,1019,126,41,128
2023-06-01,9541,556,149,705,20,4,20
2023-06-01,134929,10,0,10,2,0,2
2023-06-01,133720,71,1,72,25,7,25
2023-06-01,134881,6,0,6,2,0,2
2023-06-01,45960,141,41,182,8,7,10
2023-06-01,4739,479,9,488,9,5,9
2023-06-01,4685,62,2,64,8,3,9
2023-06-01,17858,201,0,201,1,0,1
2023-06-01,131927,5,0,5,3,0,3
2023-06-01,23624,12,1,13,5,2,5
2023-06-01,131933,5,1,6,3,2,3
2023-06-01,131959,5,0,5,3,0,3
2023-06-01,24279,6,1,7,5,3,5
2023-06-01,9696,24,0,24,2,0,2
2023-06-01,9578,62,0,62,2,0,2
2023-06-01,45404,4,0,4,2,0,2
2023-06-01,46009,37,0,37,2,0,2
2023-06-01,9530,76,0,76,4,0,4
2023-06-01,23554,7,0,7,4,0,4
2023-06-01,9703,5,0,5,2,0,2
2023-06-01,18032,2,0,2,2,0,2
2023-06-01,207898,4,0,4,2,0,2
2023-06-01,38124,4,0,4,2,0,2
2023-06-01,10190,19,0,19,2,0,2
2023-06-01,9708,28,0,28,3,0,3
2023-06-01,38705,9,0,9,1,0,1
2023-06-01,46006,2,0,2,1,0,1
2023-06-01,4040,1,0,1,2,0,2
2023-06-01,38674,4,0,4,2,0,2
2023-06-01,17578,20,0,20,2,0,2
2023-06-01,10176,24,0,24,1,0,1
2023-06-01,45407,3,0,3,2,0,2
2023-06-01,38417,21,0,21,1,0,1
2023-06-01,45972,5,0,5,1,0,1
2023-06-01,38692,40,0,40,3,0,3
2023-06-01,4790,20,0,20,2,0,2
2023-06-01,3976,1,0,1,2,0,2
2023-06-01,38683,5,0,5,2,0,2
2023-06-01,17762,436,11,447,85,17,85
2023-06-01,134540,129,4,133,2,1,2
2023-06-01,55740,1,5,6,2,2,2
2023-06-01,3758,407,34,441,109,21,110
2023-06-01,9506,76,44,120,2,1,2
2023-06-01,45143,73,41,114,2,1,2
2023-06-01,18002,238,8,246,46,13,46
2023-06-01,133647,93,1,94,13,2,13
2023-06-01,17534,21,2,23,10,4,11
2023-06-01,7600,52,2,54,8,1,8
2023-06-01,134190,2,0,2,14,0,14
2023-06-01,58552,21,11,32,111,43,113
2023-06-01,55653,27,1,28,4,3,4
2023-06-01,38158,4,1,5,91,41,94
2023-06-01,26512,23,1,24,11,3,11
2023-06-01,397325,28,0,28,7,0,7
2023-06-01,55786,1,0,1,1,0,1
2023-06-01,393423,18,3,21,10,3,11
2023-06-01,19893,54,4,58,22,3,23
2023-06-01,17625,175,17,192,21,7,21
2023-06-01,135025,10,2,12,12,4,12
2023-06-01,54578,10,0,10,5,0,5
2023-06-01,9381,534,3,537,80,23,83
2023-06-01,64033,8,0,8,3,0,3
2023-06-01,134316,40,4,44,13,4,13
2023-06-01,17665,185,92,277,64,17,64
2023-06-01,137120,8,0,8,2,0,2
2023-06-01,23637,22,1,23,5,3,7
2023-06-01,35916,125,4,129,22,8,22
2023-06-01,21769,90,8,98,1,1,1
2023-06-01,212609,50,0,50,3,0,3
2023-06-01,44547,69,0,69,5,0,5
2023-06-01,60602,9,1,10,9,1,9
2023-06-01,136923,32,0,32,1,0,1
2023-06-01,4648,162,7,169,75,19,76
2023-06-01,4771,611,71,682,5,2,6
2023-06-01,55759,3,0,3,1,0,1
2023-06-01,58955,34,3,37,4,4,6
2023-06-01,142565,2,0,2,1,0,1
2023-06-01,45413,10,0,10,2,0,2
2023-06-01,45629,88,5,93,71,35,76
2023-06-01,132884,1,1,2,9,7,9
2023-06-01,58656,29,2,31,55,18,57
2023-06-01,136514,8,1,9,4,1,4
2023-06-01,136246,9,0,9,3,0,3
2023-06-01,10075,21,2,23,162,53,164
2023-06-01,51847,28,13,41,20,12,21
2023-06-01,10013,279,2,281,3,3,4
2023-06-01,46003,9,0,9,2,0,2
2023-06-01,9457,67,1,68,35,1,35
2023-06-01,38676,130,0,130,3,0,3
2023-06-01,18126,87,2,89,8,6,8
2023-06-01,9269,198,1,199,30,13,32
2023-06-01,10103,235,5,240,87,11,87
2023-06-01,7594,23,2,25,24,11,25
2023-06-01,135409,23,0,23,23,0,23
2023-06-01,9443,68,4,72,3,1,3
2023-06-01,16637,98,4,102,49,17,51
2023-06-01,29465,421,16,437,40,2,40
2023-06-01,50304,58,25,83,36,21,38
2023-06-01,4694,138,6,144,12,6,12
2023-06-01,10036,479,0,479,8,0,8
2023-06-01,9943,112,0,112,2,0,2
2023-06-01,55824,141,97,238,76,23,76
2023-06-01,55847,13,1,14,4,1,4
2023-06-01,4758,136,63,199,8,5,9
2023-06-01,17813,95,3,98,6,2,6
2023-06-01,10199,88,0,88,1,0,1
2023-06-01,6421,49,0,49,23,5,23
2023-06-01,18221,2,0,2,2,0,2
2023-06-01,18229,389,15,404,109,26,110
2023-06-01,45916,328,117,445,13,8,13
2023-06-01,150576,12,1,13,1,1,1
2023-06-01,132717,33,3,36,14,4,14
2023-06-01,9829,1912,516,2428,88,26,91
2023-06-01,26658,110,0,110,2,0,2
2023-06-01,135542,19,0,19,1,0,1
2023-06-01,135772,21,3,24,6,6,8
2023-06-01,132825,40,2,42,18,3,19
2023-06-01,38182,113,12,125,37,13,39
2023-06-01,60725,45,0,45,37,0,37
2023-06-01,58460,41,3,44,9,2,9
2023-06-01,17828,10,1,11,28,1,28
2023-06-01,2518,34,2,36,39,28,41
2023-06-01,131934,8,1,9,3,3,4
2023-06-01,10010,187,7,194,45,18,46
2023-06-01,38193,82,1,83,91,39,92
2023-06-01,132165,354,16,370,20,5,20
2023-06-01,45814,66,1,67,2,1,2
2023-06-01,136030,36,4,40,10,2,10
2023-06-01,17918,15,2,17,3,1,4
2023-06-01,9534,93,19,112,35,12,36
2023-06-01,9824,229,63,292,20,8,20
2023-06-01,4721,162,2,164,1,1,1
2023-06-01,55441,32,5,37,2,2,3
2023-06-01,132252,4,0,4,6,0,6
2023-06-01,38701,125,0,125,3,0,3
2023-06-01,135905,281,36,317,26,7,26
2023-06-01,33,5,0,5,3,0,3
2023-06-01,13979,15,0,15,13,7,13
2023-06-01,11680,5,0,5,3,0,3
2023-06-01,30988,39,1,40,12,2,12
2023-06-01,25888,24,0,24,5,0,5
2023-06-01,21302,8,0,8,2,0,2
2023-06-01,2687,146,1,147,83,12,85
2023-06-01,21326,8,0,8,2,0,2
2023-06-01,71,27,3,30,4,1,4
2023-06-01,7430,18,0,18,3,0,3
2023-06-01,54680,4,0,4,2,0,2
2023-06-01,33383,35,0,35,9,0,9
2023-06-01,17062,8,0,8,3,0,3
2023-06-01,5073,5,0,5,1,0,1
2023-06-01,21877,14,0,14,3,0,3
2023-06-01,22562,20,0,20,3,0,3
2023-06-01,25951,11,0,11,8,0,8
2023-06-01,25886,6,0,6,3,0,3
2023-06-01,18106,26,4,30,42,15,45
2023-06-01,2161,2,0,2,3,0,3
2023-06-01,13013,6,0,6,2,0,2
2023-06-01,10782,16,0,16,1,0,1
2023-06-01,2165,30,4,34,1,1,1
2023-06-01,10396,146,1,147,26,6,26
2023-06-01,22149,3,0,3,1,0,1
2023-06-01,20096,3,0,3,1,0,1
2023-06-01,13014,4,0,4,4,0,4
2023-06-01,400624,1,0,1,1,0,1
2023-06-01,27510,3,0,3,2,0,2
2023-06-01,1033,1,0,1,1,0,1
2023-06-01,1034,1,0,1,1,0,1
2023-06-01,13481,1,0,1,1,0,1
2023-06-01,400737,3,0,3,1,0,1
2023-06-01,399610,8,0,8,1,0,1
2023-06-01,136106,7,8,15,180,62,182
2023-06-01,38753,33,5,38,15,2,15
2023-06-01,210873,5,0,5,4,0,4
2023-06-01,132876,3,4,7,32,17,36
2023-06-01,132280,150,22,172,36,5,37
2023-06-01,60410,2,0,2,2,0,2
2023-06-01,203329,13,3,16,14,9,17
2023-06-01,19647,14,0,14,3,0,3
2023-06-01,714,1238,312,1550,43,31,53
2023-06-01,18703,24,1,25,2,1,2
2023-06-01,6185,65,58,123,1,1,1
2023-06-01,3,107,8,115,19,2,19
2023-06-01,28729,1,1,2,2,2,2
2023-06-01,10146,3,1,4,6,1,6
2023-06-01,38809,73,8,81,23,6,24
2023-06-01,3389,7,2,9,3,2,3
2023-06-01,8069,273,0,273,8,0,8
2023-06-01,8070,15,2,17,1,1,1
2023-06-01,206,20,0,20,7,0,7
2023-06-01,2688,58,1,59,11,5,12
2023-06-01,11271,28,1,29,9,5,9
2023-06-01,4230,87,7,94,412,219,423
2023-06-01,5624,4,0,4,2,0,2
2023-06-01,17916,45,0,45,9,0,9
2023-06-01,4237,28,0,28,4,0,4
2023-06-01,28857,2,1,3,2,1,2
2023-06-01,15917,4,0,4,2,0,2
2023-06-01,29156,9,1,10,2,1,2
2023-06-01,30524,17,0,17,8,0,8
2023-06-01,46116,1,0,1,3,0,3
2023-06-01,293,14,3,17,47,37,50
2023-06-01,513,20,2,22,13,10,13
2023-06-01,35994,413,123,536,13,14,14
2023-06-01,20214,29,128,157,23,4,23
2023-06-01,27665,40,40,80,10,7,10
2023-06-01,27789,33,2,35,2,2,2
2023-06-01,45727,90,109,199,3,3,4
2023-06-01,24319,172,53,225,15,15,16
2023-06-01,18717,8,2,10,1,1,1
2023-06-01,18678,31,0,31,12,4,13
2023-06-01,45147,11,4,15,40,15,40
2023-06-01,55818,8,2,10,46,21,49
2023-06-01,7568,0,2,2,21,12,23
2023-06-01,4750,448,10,458,66,6,66
2023-06-01,52228,513,1,514,6,3,6
2023-06-01,263779,2,2,4,8,7,8
2023-06-01,395954,155,5,160,6,5,6
2023-06-01,396190,75,3,78,3,3,3
2023-06-01,205184,5,1,6,3,3,3
2023-06-01,136988,10,3,13,4,3,4
2023-06-01,59253,79,5,84,8,5,8
2023-06-01,394380,38,3,41,4,4,4
2023-06-01,396362,66,14,80,3,3,3
2023-06-01,7203,151,4,155,4,3,4
2023-06-01,27411,66,3,69,2,2,2
2023-06-01,205544,40,9,49,5,4,5
2023-06-01,393886,6,1,7,2,2,2
2023-06-01,19148,31,1,32,3,4,4
2023-06-01,398465,98,7,105,34,11,34
2023-06-01,393427,9,0,9,1,0,1
2023-06-01,19318,59,13,72,13,5,13
2023-06-01,53667,70,71,141,46,156,178
2023-06-01,212618,1,3,4,1,2,2
2023-06-01,206505,17,0,17,1,0,1
2023-06-01,35409,18,0,18,4,0,4
2023-06-01,198839,1,0,1,1,0,1
2023-06-01,20068,14,0,14,3,0,3
2023-06-01,33696,36,6,42,9,1,9
2023-06-01,32526,2,0,2,1,0,1
2023-06-01,209737,25,1,26,3,1,3
2023-06-01,211585,116,0,116,1,0,1
2023-06-01,211584,20,0,20,1,0,1
2023-06-01,271945,2,2,4,4,4,4
2023-06-01,139660,27,0,27,1,0,1
2023-06-01,19786,1,0,1,1,0,1
2023-06-01,149448,2,0,2,2,0,2
2023-06-01,1018,5,1,6,1,1,1
2023-06-01,140155,34,0,34,1,0,1
2023-06-01,62917,19,2,21,11,2,11
2023-06-01,18966,4,1,5,6,3,7
2023-06-01,205320,20,1,21,1,2,2
2023-06-01,148996,3,6,9,1,3,3
2023-06-01,212448,13,0,13,1,0,1
2023-06-01,7849,73,1,74,2,1,2
2023-06-01,26863,18,0,18,6,0,6
2023-06-01,210632,3,0,3,3,0,3
2023-06-01,199387,2,0,2,1,0,1
2023-06-01,400810,11,0,11,2,0,2
2023-06-01,400636,1,0,1,1,0,1
2023-06-01,395839,13,3,16,5,2,5
2023-06-01,203758,5,0,5,1,0,1
2023-06-01,13737,12,9,21,6,2,6
2023-06-01,393294,6,0,6,3,0,3
2023-06-01,399823,1,0,1,1,0,1
2023-06-01,10431,1,0,1,1,0,1
2023-06-01,54500,10,1,11,1,1,1
2023-06-01,398912,2,0,2,1,0,1
2023-06-01,209854,121,0,121,13,0,13
2023-06-01,54252,127,0,127,2,0,2
2023-06-01,18450,97,6,103,21,10,23
2023-06-01,149440,25,5,30,5,5,5
2023-06-01,26421,15,0,15,2,0,2
2023-06-01,54048,7,0,7,24,0,24
2023-06-01,2152,470,59,529,99,47,101
2023-06-01,2153,4,3,7,31,17,33
2023-06-01,26265,6,0,6,3,0,3
2023-06-01,400615,8,0,8,2,0,2
2023-06-01,54098,7,1,8,5,2,7
2023-06-01,53850,74,2,76,8,4,9
2023-06-01,13807,77,6,83,44,11,44
2023-06-01,32768,2,0,2,4,0,4
2023-06-01,16851,10,1,11,22,3,22
2023-06-01,62795,8,1,9,5,2,5
2023-06-01,32748,84,2,86,17,11,21
2023-06-01,394303,20,0,20,1,0,1
2023-06-01,47869,54,19,73,29,23,35
2023-06-01,54005,1,0,1,1,0,1
2023-06-01,22995,102,18,120,14,10,15
2023-06-01,36315,30,0,30,7,0,7
2023-06-01,133982,200,4,204,14,4,14
2023-06-01,135814,3,3,6,3,2,3
2023-06-01,9500,34,3,37,18,10,18
2023-06-01,6503,1303,10,1313,20,7,21
2023-06-01,24203,249,190,439,33,11,33
2023-06-01,131330,5,1,6,8,5,9
2023-06-01,7617,0,0,0,12,10,13
2023-06-01,4609,78,1,79,8,5,9
2023-06-01,7632,9,17,26,29,13,30
2023-06-01,23700,139,17,156,5,2,5
2023-06-01,55794,9,0,9,16,4,16
2023-06-01,23693,77,35,112,3,2,4
2023-06-01,204979,1,1,2,2,2,2
2023-06-01,17511,80,2,82,22,12,22
2023-06-01,7470,718,28,746,111,24,112
2023-06-01,19429,671,116,787,23,25,36
2023-06-01,20189,0,0,0,2,2,2
2023-06-01,18680,1,1,2,1,1,1
2023-06-01,812,810,273,1083,191,33,193
2023-06-01,45489,2,1,3,34,28,40
2023-06-01,9329,136,32,168,11,2,11
2023-06-01,18734,87,15,102,90,36,92
2023-06-01,4713,194,5,199,94,32,97
2023-06-01,264668,242,64,306,93,60,94
2023-06-01,27814,9,8,17,4,4,4
2023-06-01,7004,30,6,36,40,4,40
2023-06-01,7418,102,0,102,4,0,4
2023-06-01,14840,57,31,88,305,224,313
2023-06-01,268207,14,3,17,9,9,11
2023-06-01,23947,14,2,16,238,44,239
2023-06-01,18004,170,30,200,2,2,2
2023-06-01,9255,46,75,121,38,7,40
2023-06-01,28022,22,2,24,8,2,8
2023-06-01,134351,13,1,14,4,3,4
2023-06-01,63213,12,3,15,15,5,15
2023-06-01,25820,304,3,307,16,1,16
2023-06-01,19157,12,0,12,3,0,3
2023-06-01,10242,32,1,33,28,13,29
2023-06-01,36103,126,3,129,15,4,15
2023-06-01,394285,18,16,34,4,1,4
2023-06-01,13329,18,2,20,32,9,33
2023-06-01,138322,30,8,38,21,8,21
2023-06-01,38742,71,1,72,1,1,1
2023-06-01,13445,95,24,119,20,14,23
2023-06-01,139281,3,1,4,8,5,8
2023-06-01,62904,641,17,658,17,11,18
2023-06-01,49532,30,4,34,7,3,8
2023-06-01,47638,9,4,13,11,9,12
2023-06-01,8757,13,7,20,24,7,27
2023-06-01,32298,45,12,57,15,3,16
2023-06-01,62685,19,0,19,4,0,4
2023-06-01,17321,2,0,2,3,0,3
2023-06-01,32323,34,3,37,27,12,27
2023-06-01,6327,3523,110,3633,218,38,223
2023-06-01,397332,4,1,5,1,1,1
2023-06-01,12119,38,1,39,7,2,7
2023-06-01,32845,14,0,14,2,0,2
2023-06-01,16417,108,9,117,9,8,9
2023-06-01,30238,57,4,61,7,6,7
2023-06-01,30215,17,2,19,4,4,4
2023-06-01,36692,418,69,487,39,24,42
2023-06-01,51095,3,3,6,11,10,12
2023-06-01,7992,35,2,37,27,7,28
2023-06-01,135377,841,1,842,10,2,10
2023-06-01,38731,77,9,86,75,25,76
2023-06-01,36493,34,0,34,15,0,15
2023-06-01,11492,4521,2,4523,36,3,36
2023-06-01,11814,81,1,82,13,4,13
2023-06-01,62646,7,0,7,6,0,6
2023-06-01,62887,37,20,57,24,10,25
2023-06-01,63949,270,44,314,28,21,31
2023-06-01,399404,1,0,1,4,0,4
2023-06-01,394727,47,2,49,1,1,1
2023-06-01,13820,5,1,6,1,1,1
2023-06-01,19531,18,1,19,10,7,10
2023-06-01,39324,6,2,8,5,3,5
2023-06-01,46805,24,0,24,2,0,2
2023-06-01,22653,15,2,17,7,3,7
2023-06-01,63119,74,0,74,3,0,3
2023-06-01,40788,33,1,34,12,7,12
2023-06-01,63159,1,0,1,1,0,1
2023-06-01,14013,1,0,1,2,0,2
2023-06-01,32475,309,8,317,16,6,16
2023-06-01,36339,4,1,5,1,1,1
2023-06-01,33084,22,1,23,6,1,6
2023-06-01,26925,4,0,4,3,0,3
2023-06-01,17082,3,0,3,1,0,1
2023-06-01,14976,3,1,4,1,1,1
2023-06-01,31863,42,3,45,7,4,7
2023-06-01,64235,8,0,8,2,0,2
2023-06-01,4785,65,17,82,7,6,9
2023-06-01,56308,45,3,48,26,15,27
2023-06-01,6391,2,1,3,13,9,14
2023-06-01,54643,47,3,50,5,5,6
2023-06-01,11831,52,1,53,7,1,7
2023-06-01,393457,7,2,9,10,4,11
2023-06-01,21559,50,1,51,50,18,51
2023-06-01,397359,2,0,2,1,0,1
2023-06-01,15326,2,0,2,2,0,2
2023-06-01,53597,10,6,16,26,15,27
2023-06-01,400181,1,1,2,1,1,1
2023-06-01,400228,4,5,9,3,3,3
2023-06-01,397372,1,0,1,2,0,2
2023-06-01,964,9,2,11,9,8,10
2023-06-01,13780,1,10,11,2,3,3
2023-06-01,53758,1,1,2,1,1,1
2023-06-01,394414,1,3,4,2,2,4
2023-06-01,398987,1,1,2,10,9,14
2023-06-01,6373,8,1,9,3,1,3
2023-06-01,57695,23,20,43,45,52,74
2023-06-01,202265,2,9,11,9,9,10
2023-06-01,21700,27,1,28,21,23,32
2023-06-01,917,9,10,19,37,43,55
2023-06-01,835,5,2,7,25,25,41
2023-06-01,21557,39,3,42,3,1,3
2023-06-01,64283,2,0,2,2,0,2
2023-06-01,16552,57,68,125,27,24,33
2023-06-01,4459,29,1,30,11,2,11
2023-06-01,395734,5,0,5,1,0,1
2023-06-01,62809,22,0,22,3,0,3
2023-06-01,399679,2,1,3,1,1,1
2023-06-01,10929,50,2,52,22,9,23
2023-06-01,397181,1,1,2,2,2,2
2023-06-01,400154,1,1,2,1,1,1
2023-06-01,397411,1,0,1,1,0,1
2023-06-01,400200,2,1,3,2,1,2
2023-06-01,16696,98,3,101,16,5,17
2023-06-01,55077,4,0,4,2,0,2
2023-06-01,11635,4,1,5,3,3,3
2023-06-01,400202,2,1,3,1,1,1
2023-06-01,40545,21,1,22,7,1,7
2023-06-01,397120,1,0,1,1,0,1
2023-06-01,55103,5,2,7,3,1,3
2023-06-01,33588,32,10,42,17,3,18
2023-06-01,13590,1,0,1,2,0,2
2023-06-01,395549,1,0,1,3,0,3
2023-06-01,46525,10,1,11,6,3,6
2023-06-01,53356,34,226,260,30,39,52
2023-06-01,60011,4,2,6,11,4,11
2023-06-01,396507,4,4,8,3,1,3
2023-06-01,17177,11,2,13,5,1,5
2023-06-01,398879,3,0,3,1,0,1
2023-06-01,400201,1,1,2,1,1,1
2023-06-01,19841,1,0,1,2,0,2
2023-06-01,399132,1,1,2,1,1,1
2023-06-01,13855,9,1,10,18,10,18
2023-06-01,400132,3,0,3,1,0,1
2023-06-01,395033,1,1,2,1,1,1
2023-06-01,395777,3,1,4,3,1,3
2023-06-01,26827,26,1,27,29,11,29
2023-06-01,26943,2,2,4,2,1,2
2023-06-01,19255,5,2,7,9,4,9
2023-06-01,399587,9,10,19,3,7,9
2023-06-01,397399,1,1,2,1,1,1
2023-06-01,4138,1,6,7,1,2,2
2023-06-01,202044,14,8,22,1,1,1
2023-06-01,8047,30,1,31,26,10,29
2023-06-01,397349,1,1,2,1,1,1
2023-06-01,400305,1,0,1,1,0,1
2023-06-01,395655,2,0,2,2,0,2
2023-06-01,397418,1,0,1,2,0,2
2023-06-01,965,1,0,1,1,0,1
2023-06-01,400179,1,1,2,2,2,2
2023-06-01,400393,1,1,2,1,1,1
2023-06-01,62600,15,1,16,12,6,13
2023-06-01,398984,1,0,1,1,0,1
2023-06-01,14649,2,0,2,2,0,2
2023-06-01,136620,7,9,16,10,15,19
2023-06-01,32639,2,2,4,3,2,4
2023-06-01,398200,2,0,2,1,0,1
2023-06-01,400323,1,0,1,1,0,1
2023-06-01,46475,86,17,103,11,8,13
2023-06-01,398646,17,8,25,4,2,4
2023-06-01,4213,110,14,124,38,27,40
2023-06-01,62744,10,3,13,2,2,2
2023-06-01,23550,28,1,29,13,5,13
2023-06-01,46962,6,58,64,5,6,6
2023-06-01,400333,1,1,2,1,1,1
2023-06-01,26721,26,1,27,7,2,7
2023-06-01,52210,3,8,11,5,17,18
2023-06-01,212934,1,4,5,1,7,7
2023-06-01,12186,3,3,6,18,20,22
2023-06-01,397470,2,0,2,1,0,1
2023-06-01,64227,4,2,6,14,7,16
2023-06-01,12042,123,2,125,47,9,49
2023-06-01,400115,1,1,2,2,2,3
2023-06-01,7247,6,2,8,2,3,3
2023-06-01,394625,18,2,20,10,7,11
2023-06-01,400385,11,0,11,3,0,3
2023-06-01,394952,1,0,1,2,0,2
2023-06-01,15054,7,1,8,4,1,4
2023-06-01,20042,8,1,9,6,1,6
2023-06-01,400488,1,1,2,1,1,1
2023-06-01,21703,1,0,1,2,0,2
2023-06-01,15321,65,0,65,4,0,4
2023-06-01,32864,1,1,2,1,1,1
2023-06-01,149020,8,9,17,4,4,4
2023-06-01,36369,5,13,18,10,20,22
2023-06-01,54182,22,1,23,10,2,10
2023-06-01,400415,1,0,1,1,0,1
2023-06-01,399826,1,1,2,1,1,1
2023-06-01,396480,4,2,6,2,1,2
2023-06-01,399831,1,1,2,1,1,1
2023-06-01,16724,22,5,27,17,4,17
2023-06-01,16827,1,1,2,1,1,1
2023-06-01,400290,1,1,2,1,1,1
2023-06-01,23261,2,0,2,2,0,2
2023-06-01,395785,1,1,2,1,1,1
2023-06-01,13925,3,2,5,2,1,2
2023-06-01,400312,1,0,1,1,0,1
2023-06-01,22324,5,0,5,8,0,8
2023-06-01,31763,18,0,18,2,0,2
2023-06-01,395631,1,0,1,2,0,2
2023-06-01,3737,1094,96,1190,39,12,39
2023-06-01,30399,2,0,2,1,0,1
2023-06-01,25651,34,0,34,4,0,4
2023-06-01,399976,4,63,67,5,6,7
2023-06-01,11139,287,15,302,8,3,8
2023-06-01,397382,1,1,2,3,1,3
2023-06-01,36290,8,0,8,5,0,5
2023-06-01,63351,5,1,6,10,1,10
2023-06-01,19054,3,3,6,2,2,2
2023-06-01,397354,5,1,6,2,1,2
2023-06-01,11240,24,6,30,8,4,8
2023-06-01,22659,1,1,2,1,1,2
2023-06-01,397472,2,1,3,1,1,1
2023-06-01,16713,57,5,62,31,13,32
2023-06-01,395394,3,2,5,2,2,2
2023-06-01,13850,1,1,2,1,1,1
2023-06-01,36710,2,3,5,2,2,2
2023-06-01,400289,3,1,4,1,1,1
2023-06-01,397566,1,1,2,2,1,2
2023-06-01,7782,28,2,30,32,11,33
2023-06-01,400477,1,1,2,1,1,1
2023-06-01,22299,16,0,16,10,0,10
2023-06-01,20091,5,0,5,3,0,3
2023-06-01,46502,2,1,3,3,1,3
2023-06-01,396893,1,1,2,1,1,1
2023-06-01,400219,1,0,1,1,0,1
2023-06-01,42615,8,5,13,6,5,9
2023-06-01,53451,3,0,3,1,0,1
2023-06-01,397095,4,1,5,10,5,10
2023-06-01,400473,1,0,1,1,0,1
2023-06-01,398497,4,0,4,2,0,2
2023-06-01,397529,1,1,2,1,1,1
2023-06-01,400443,1,4,5,1,2,2
2023-06-01,39964,4,1,5,4,3,4
2023-06-01,40209,2,0,2,1,0,1
2023-06-01,400474,1,0,1,1,0,1
2023-06-01,18988,22,1,23,7,6,8
2023-06-01,54904,6,1,7,1,1,1
2023-06-01,56655,20,7,27,45,44,69
2023-06-01,211144,1,2,3,1,2,2
2023-06-01,29695,59,5,64,27,16,27
2023-06-01,30500,29,1,30,11,3,11
2023-06-01,7850,32,3,35,4,2,4
2023-06-01,27224,7,2,9,15,6,15
2023-06-01,400498,1,1,2,1,1,1
2023-06-01,396872,16,6,22,3,1,3
2023-06-01,40153,2,1,3,2,1,2
2023-06-01,3900,83,9,92,31,5,31
2023-06-01,46842,1,1,2,1,1,1
2023-06-01,398395,47,8,55,2,3,4
2023-06-01,398296,37,0,37,6,0,6
2023-06-01,62853,7,1,8,3,1,4
2023-06-01,20448,11,1,12,13,5,13
2023-06-01,393945,1,2,3,1,1,1
2023-06-01,398020,6,2,8,1,1,1
2023-06-01,400503,1,1,2,1,1,1
2023-06-01,394352,16,0,16,4,0,4
2023-06-01,19523,28,8,36,10,4,10
2023-06-01,397248,1,1,2,1,1,1
2023-06-01,400509,8,1,9,1,1,1
2023-06-01,393453,3,0,3,3,0,3
2023-06-01,400495,2,0,2,2,0,2
2023-06-01,20119,8,1,9,25,7,26
2023-06-01,25988,1,1,2,1,1,2
2023-06-01,10882,16,0,16,4,0,4
2023-06-01,400442,2,4,6,2,3,3
2023-06-01,400517,1,1,2,3,3,3
2023-06-01,400512,1,0,1,1,0,1
2023-06-01,396420,112,2,114,5,1,5
2023-06-01,46300,5,1,6,4,1,4
2023-06-01,400519,7,69,76,2,1,2
2023-06-01,400550,1,5,6,1,2,2
2023-06-01,54681,8,30,38,3,13,14
2023-06-01,8008,29,1,30,4,1,4
2023-06-01,394812,1,0,1,1,0,1
2023-06-01,398326,3,2,5,1,2,2
2023-06-01,393524,5,1,6,2,2,2
2023-06-01,4922,62,3,65,35,9,35
2023-06-01,400497,1,0,1,1,0,1
2023-06-01,394232,9,2,11,5,2,5
2023-06-01,22652,126,8,134,98,25,99
2023-06-01,64272,1,1,2,3,2,3
2023-06-01,5670,7,22,29,5,5,5
2023-06-01,400566,1,0,1,1,0,1
2023-06-01,924,7,7,14,9,17,20
2023-06-01,22188,5,1,6,2,2,2
2023-06-01,400586,2,0,2,1,0,1
2023-06-01,397592,1,2,3,1,2,2
2023-06-01,400554,1,0,1,1,0,1
2023-06-01,62529,1,1,2,1,1,1
2023-06-01,400564,2,1,3,1,1,1
2023-06-01,397554,2,1,3,1,1,1
2023-06-01,400585,3,0,3,2,0,2
2023-06-01,30549,16,0,16,4,0,4
2023-06-01,400402,3,1,4,1,1,1
2023-06-01,398496,7,0,7,3,0,3
2023-06-01,394177,3,1,4,7,3,7
2023-06-01,22462,3,1,4,5,3,5
2023-06-01,398836,5,0,5,3,0,3
2023-06-01,397460,2,2,4,3,3,3
2023-06-01,398900,1,1,2,1,1,1
2023-06-01,394548,7,0,7,4,0,4
2023-06-01,400559,1,0,1,1,0,1
2023-06-01,30036,2484,865,3349,39,5,39
2023-06-01,20213,6,1,7,2,1,2
2023-06-01,19969,17,4,21,12,6,13
2023-06-01,400659,1,1,2,2,2,2
2023-06-01,32329,41,1,42,6,3,6
2023-06-01,396935,1,0,1,1,0,1
2023-06-01,396107,16,0,16,1,0,1
2023-06-01,206203,1,0,1,1,0,1
2023-06-01,398482,2,0,2,3,0,3
2023-06-01,15290,143,54,197,83,7,84
2023-06-01,40870,1,0,1,2,0,2
2023-06-01,395475,5,1,6,3,1,3
2023-06-01,398115,1,0,1,1,0,1
2023-06-01,400656,2,1,3,2,1,3
2023-06-01,396842,2,0,2,3,0,3
2023-06-01,29933,12,2,14,32,12,33
2023-06-01,400669,1,0,1,1,0,1
2023-06-01,13415,27,3,30,22,6,22
2023-06-01,63072,2,1,3,1,1,1
2023-06-01,400555,1,1,2,1,1,1
2023-06-01,210,42,1,43,15,8,16
2023-06-01,400565,1,1,2,2,1,2
2023-06-01,40111,17,0,17,7,0,7
2023-06-01,397952,5,3,8,3,2,3
2023-06-01,400682,1,1,2,1,1,1
2023-06-01,397994,4,4,8,7,5,7
2023-06-01,396855,1,1,2,3,1,3
2023-06-01,15011,56,2,58,10,3,10
2023-06-01,27517,1,0,1,2,0,2
2023-06-01,16904,48,4,52,28,6,29
2023-06-01,399558,2,1,3,1,1,1
2023-06-01,396357,13,3,16,3,2,3
2023-06-01,14694,2,1,3,2,2,3
2023-06-01,400545,1,0,1,1,0,1
2023-06-01,54835,1,0,1,1,0,1
2023-06-01,396846,1,0,1,1,0,1
2023-06-01,55128,2,2,4,1,1,1
2023-06-01,400146,1,2,3,1,1,1
2023-06-01,30475,52,3,55,7,4,7
2023-06-01,22058,1,1,2,1,1,1
2023-06-01,400726,1,0,1,1,0,1
2023-06-01,29951,56,0,56,3,0,3
2023-06-01,399100,2,1,3,5,4,5
2023-06-01,14445,66,3,69,3,2,3
2023-06-01,394805,3,1,4,4,2,4
2023-06-01,21782,16,1,17,17,5,17
2023-06-01,62754,3,0,3,3,0,3
2023-06-01,14478,1,2,3,1,2,2
2023-06-01,22611,76,3,79,5,5,5
2023-06-01,23428,3,4,7,5,6,8
2023-06-01,54641,72,2,74,4,4,5
2023-06-01,397617,2,1,3,1,1,1
2023-06-01,396950,1,1,2,3,2,3
2023-06-01,886,1,1,2,1,1,1
2023-06-01,33185,13,5,18,22,8,22
2023-06-01,395214,4,1,5,1,1,1
2023-06-01,397097,1,1,2,3,1,3
2023-06-01,396123,5,0,5,3,0,3
2023-06-01,1002,7,0,7,2,0,2
2023-06-01,46537,4,0,4,3,0,3
2023-06-01,46280,3,1,4,2,2,2
2023-06-01,893,1,1,2,2,1,2
2023-06-01,397636,1,1,2,1,1,2
2023-06-01,53698,28,16,44,9,6,9
2023-06-01,32109,2,1,3,3,2,3
2023-06-01,396360,1,1,2,1,1,1
2023-06-01,32995,1,1,2,2,2,2
2023-06-01,11232,83,19,102,56,20,56
2023-06-01,916,1,0,1,1,0,1
2023-06-01,400710,1,0,1,1,0,1
2023-06-01,32505,119,6,125,46,8,46
2023-06-01,12089,11,1,12,8,2,8
2023-06-01,53274,25,3,28,9,5,9
2023-06-01,397646,1,3,4,1,1,1
2023-06-01,394715,1,1,2,2,2,2
2023-06-01,33361,3,1,4,7,3,7
2023-06-01,33554,8,1,9,9,4,10
2023-06-01,398143,6,1,7,5,3,5
2023-06-01,397614,1,1,2,1,1,1
2023-06-01,210630,8,12,20,5,5,6
2023-06-01,398491,3,3,6,4,6,6
2023-06-01,29768,1,1,2,1,1,2
2023-06-01,1001,1,1,2,3,3,4
2023-06-01,14078,5,0,5,1,0,1
2023-06-01,14979,97,2,99,8,2,8
2023-06-01,397674,1,0,1,1,0,1
2023-06-01,889,1,0,1,1,0,1
2023-06-01,400354,1,43,44,1,1,1
2023-06-01,14638,276,24,300,16,1,16
2023-06-01,36222,14,2,16,14,5,15
2023-06-01,267,4,1,5,3,2,3
2023-06-01,17149,3,1,4,4,2,4
2023-06-01,988,1,0,1,1,0,1
2023-06-01,53732,10,2,12,5,2,5
2023-06-01,13794,5,0,5,2,0,2
2023-06-01,394335,1,0,1,1,0,1
2023-06-01,31799,5,0,5,4,0,4
2023-06-01,395859,1,0,1,3,0,3
2023-06-01,934,1,0,1,1,0,1
2023-06-01,394740,6,1,7,2,1,2
2023-06-01,400424,4,0,4,2,0,2
2023-06-01,64260,5,2,7,4,3,4
2023-06-01,16164,3,1,4,19,7,20
2023-06-01,5555,36,3,39,8,1,8
2023-06-01,397696,2,0,2,2,0,2
2023-06-01,400282,1,1,2,6,5,6
2023-06-01,212276,1,1,2,1,1,1
2023-06-01,399392,1,1,2,3,2,3
2023-06-01,400189,3,2,5,1,1,1
2023-06-01,14727,1,1,2,2,2,2
2023-06-01,60326,4,15,19,5,23,25
2023-06-01,398355,7,5,12,9,7,9
2023-06-01,395332,1,3,4,1,4,5
2023-06-01,8025,23,0,23,11,0,11
2023-06-01,400429,1,3,4,1,2,2
2023-06-01,14860,25,2,27,13,4,13
2023-06-01,40090,4,1,5,1,1,1
2023-06-01,399244,8,1,9,5,3,5
2023-06-01,397244,1,5,6,2,2,3
2023-06-01,46432,6,3,9,2,2,2
2023-06-01,395494,11,2,13,1,1,1
2023-06-01,53812,5,0,5,3,0,3
2023-06-01,376,262,10,272,25,9,25
2023-06-01,395899,1,1,2,1,1,1
2023-06-01,1075,1,2,3,1,1,1
2023-06-01,26073,14,17,31,5,6,8
2023-06-01,63186,36,0,36,9,0,9
2023-06-01,19913,2,0,2,1,0,1
2023-06-01,1076,1,0,1,2,0,2
2023-06-01,40893,1,1,2,3,2,3
2023-06-01,134176,40,4,44,25,7,26
2023-06-01,394019,2,0,2,1,0,1
2023-06-01,394678,4,1,5,5,3,5
2023-06-01,63371,2,0,2,3,0,3
2023-06-01,398099,1,1,2,2,2,2
2023-06-01,204535,2,0,2,2,0,2
2023-06-01,267845,36,11,47,8,4,8
2023-06-01,30542,1,0,1,3,0,3
2023-06-01,47062,1,1,2,1,1,1
2023-06-01,62516,7,1,8,2,2,2
2023-06-01,395100,4,1,5,3,2,3
2023-06-01,32425,2,1,3,32,8,32
2023-06-01,54527,28,11,39,18,11,19
2023-06-01,394256,17,9,26,12,7,14
2023-06-01,398898,2,3,5,3,1,4
2023-06-01,400732,1,1,2,1,1,1
2023-06-01,397810,9,2,11,3,1,3
2023-06-01,400414,26,0,26,5,0,5
2023-06-01,400719,2,2,4,1,1,1
2023-06-01,32281,27,6,33,4,4,4
2023-06-01,396027,2,1,3,2,2,2
2023-06-01,400742,1,1,2,1,1,1
2023-06-01,40953,2,0,2,1,0,1
2023-06-01,11260,106,6,112,54,13,55
2023-06-01,400075,1,0,1,1,0,1
2023-06-01,395350,1,0,1,1,0,1
2023-06-01,400597,1,2,3,2,2,2
2023-06-01,400771,1,1,2,2,2,2
2023-06-01,62698,3,0,3,2,0,2
2023-06-01,19692,1,1,2,2,2,2
2023-06-01,32678,17,0,17,3,0,3
2023-06-01,3580,7,1,8,11,4,12
2023-06-01,396924,5,1,6,2,1,2
2023-06-01,8001,38,5,43,37,13,40
2023-06-01,395021,1,0,1,1,0,1
2023-06-01,399214,4,4,8,1,1,1
2023-06-01,34553,2,2,4,3,3,4
2023-06-01,29909,29,5,34,29,8,29
2023-06-01,395663,6,1,7,1,1,1
2023-06-01,397864,1,0,1,1,0,1
2023-06-01,46855,1,0,1,1,0,1
2023-06-01,205455,1,0,1,1,0,1
2023-06-01,397945,1,1,2,4,2,4
2023-06-01,400759,6,0,6,2,0,2
2023-06-01,398076,1,0,1,1,0,1
2023-06-01,31807,1,1,2,1,1,1
2023-06-01,36262,1,0,1,1,0,1
2023-06-01,61257,1,0,1,2,0,2
2023-06-01,205663,2,0,2,1,0,1
2023-06-01,30382,6,1,7,3,2,3
2023-06-01,398397,8,0,8,1,0,1
2023-06-01,397326,2,1,3,5,4,7
2023-06-01,32621,8,1,9,10,8,13
2023-06-01,400786,1,0,1,4,0,4
2023-06-01,395763,1,0,1,2,0,2
2023-06-01,150698,7,184,191,1,2,2
2023-06-01,203729,2,4,6,2,3,4
2023-06-01,11878,89,18,107,6,3,6
2023-06-01,397270,14,6,20,7,5,7
2023-06-01,398415,2,1,3,2,1,2
2023-06-01,46844,365,8,373,18,13,22
2023-06-01,396930,2,1,3,6,4,6
2023-06-01,398031,1,1,2,1,1,1
2023-06-01,210000,4,1,5,3,1,3
2023-06-01,400642,3,1,4,1,1,1
2023-06-01,395703,1,0,1,1,0,1
2023-06-01,55140,22,1,23,21,5,22
2023-06-01,1027,1,0,1,1,0,1
2023-06-01,151338,5,19,24,4,6,7
2023-06-01,50131,25,10,35,13,15,19
2023-06-01,208188,2,3,5,7,6,9
2023-06-01,6233,34,21,55,18,9,20
2023-06-01,54041,3,1,4,1,1,1
2023-06-01,394838,4,1,5,2,1,2
2023-06-01,16557,30,0,30,5,0,5
2023-06-01,393577,1,3,4,6,2,6
2023-06-01,38008,15,22,37,22,50,58
2023-06-01,395231,1,1,2,1,1,1
2023-06-01,396234,2,1,3,2,1,2
2023-06-01,396476,1,0,1,1,0,1
2023-06-01,40713,1,1,2,1,1,1
2023-06-01,1085,1,0,1,2,0,2
2023-06-01,803,46,2,48,30,9,32
2023-06-01,1003,2,11,13,3,9,9
2023-06-01,395852,1,1,2,1,1,1
2023-06-01,16553,13,1,14,22,4,22
2023-06-01,396968,1,0,1,2,0,2
2023-06-01,22120,2,0,2,2,0,2
2023-06-01,202528,1,1,2,1,1,1
2023-06-01,20326,42,19,61,23,15,25
2023-06-01,400798,1,1,2,2,2,2
2023-06-01,14534,1,1,2,1,1,1
2023-06-01,969,3,4,7,6,2,6
2023-06-01,23175,10,0,10,9,0,9
2023-06-01,398011,2,0,2,2,0,2
2023-06-01,397389,1,0,1,2,0,2
2023-06-01,5690,83,0,83,10,0,10
2023-06-01,62309,1,1,2,1,2,2
2023-06-01,395605,3,3,6,5,2,5
2023-06-01,63030,1,0,1,1,0,1
2023-06-01,395842,1,0,1,1,0,1
2023-06-01,32899,42,2,44,14,5,15
2023-06-01,397883,1,0,1,1,0,1
2023-06-01,212027,9,1,10,9,12,15
2023-06-01,101,8,5,13,32,19,33
2023-06-01,10430,29,1,30,23,5,23
2023-06-01,13539,1,1,2,1,1,1
2023-06-01,32354,14,3,17,9,5,9
2023-06-01,40401,14,5,19,14,6,14
2023-06-01,396865,1,1,2,1,1,1
2023-06-01,395646,1,1,2,1,1,1
2023-06-01,394590,1,1,2,1,1,1
2023-06-01,397990,2,1,3,1,1,1
2023-06-01,397573,18,0,18,4,0,4
2023-06-01,397911,4,0,4,1,0,1
2023-06-01,32727,2,0,2,1,0,1
2023-06-01,200775,2,6,8,2,2,2
2023-06-01,398707,1,1,2,1,1,1
2023-06-01,399029,1,1,2,1,1,1
2023-06-01,211051,1,1,2,1,1,1
2023-06-01,46307,1,3,4,1,1,1
2023-06-01,397845,1,1,2,1,1,1
2023-06-01,7871,4,1,5,3,1,4
2023-06-01,13428,113,0,113,17,0,17
2023-06-01,400587,2,3,5,1,1,1
2023-06-01,203453,1,5,6,1,3,3
2023-06-01,397666,9,16,25,2,2,2
2023-06-01,395044,1,1,2,1,1,1
2023-06-01,23379,7,14,21,24,9,24
2023-06-01,397939,1,0,1,1,0,1
2023-06-01,26042,1,0,1,2,0,2
2023-06-01,26576,2,1,3,1,1,1
2023-06-01,394144,6,2,8,3,2,3
2023-06-01,57406,3,6,9,7,7,11
2023-06-01,398065,4,1,5,1,1,1
2023-06-01,46689,1,1,2,1,1,1
2023-06-01,54116,4,3,7,2,2,2
2023-06-01,394828,6,2,8,4,1,4
2023-06-01,397427,8,1,9,2,1,2
2023-06-01,397582,5,0,5,2,0,2
2023-06-01,394109,5,1,6,3,2,3
2023-06-01,49585,3,3,6,2,3,4
2023-06-01,208949,6,0,6,4,0,4
2023-06-01,32473,6,1,7,4,2,4
2023-06-01,32463,2,1,3,3,3,3
2023-06-01,200105,1,16,17,1,24,24
2023-06-01,133846,2,10,12,4,6,7
2023-06-01,3204,0,0,0,11,41,42
2023-06-01,22961,1,0,1,1,0,1
2023-06-01,396002,4,0,4,5,0,5
2023-06-01,397391,7,1,8,3,1,3
2023-06-01,394626,1,1,2,1,1,1
2023-06-01,395823,3,3,6,8,7,9
2023-06-01,54429,1,1,2,3,4,4
2023-06-01,21804,237,3,240,13,8,14
2023-06-01,399820,3,2,5,3,2,3
2023-06-01,29770,1,0,1,1,0,1
2023-06-01,46664,27,0,27,2,0,2
2023-06-01,204844,1,7,8,3,1,3
2023-06-01,48024,120,16,136,43,18,45
2023-06-01,49304,0,3,3,5,25,27
2023-06-01,137443,272,6,278,22,4,23
2023-06-01,396971,1,0,1,1,0,1
2023-06-01,205421,1,0,1,1,0,1
2023-06-01,807,3,1,4,5,5,6
2023-06-01,398998,2,2,4,2,2,2
2023-06-01,398013,15,3,18,10,4,11
2023-06-01,202400,1,3,4,1,2,3
2023-06-01,11938,1,6,7,1,1,1
2023-06-01,398135,1,0,1,1,0,1
2023-06-01,400304,10,13,23,3,6,6
2023-06-01,395846,21,3,24,8,4,8
2023-06-01,200454,1,11,12,4,3,5
2023-06-01,398009,2,0,2,2,0,2
2023-06-01,13559,1,1,2,4,9,10
2023-06-01,62485,1,0,1,4,0,4
2023-06-01,212895,1,9,10,12,31,37
2023-06-01,398196,4,0,4,3,0,3
2023-06-01,138997,44,15,59,25,21,29
2023-06-01,203314,1,19,20,2,14,14
2023-06-01,398208,1,1,2,1,1,1
2023-06-01,62731,20,7,27,8,3,8
2023-06-01,398578,5,1,6,2,1,2
2023-06-01,60849,7,3,10,9,3,10
2023-06-01,397867,2,1,3,1,1,1
2023-06-01,212483,0,27,27,2,20,20
2023-06-01,210714,1,2,3,1,1,1
2023-06-01,59598,3,5,8,7,6,8
2023-06-01,57175,1,2,3,1,4,4
2023-06-01,398271,1,0,1,1,0,1
2023-06-01,393857,6,0,6,2,0,2
2023-06-01,398202,7,1,8,3,4,4
2023-06-01,396984,2,0,2,6,0,6
2023-06-01,400458,1,1,2,1,1,1
2023-06-01,54134,1,0,1,1,0,1
2023-06-01,395938,1,2,3,1,2,2
2023-06-01,31968,1,1,2,2,1,2
2023-06-01,399788,2,2,4,3,4,4
2023-06-01,32604,1,2,3,1,2,2
2023-06-01,199948,1,2,3,1,1,1
2023-06-01,397709,1,1,2,1,1,1
2023-06-01,54344,1,2,3,1,1,1
2023-06-01,59678,1,5,6,1,7,7
2023-06-01,35930,1,1,2,1,1,1
2023-06-01,398223,3,4,7,5,3,6
2023-06-01,27418,2,16,18,1,1,1
2023-06-01,25894,1,0,1,2,0,2
2023-06-01,30170,5,7,12,10,3,10
2023-06-01,53283,1,1,2,1,1,1
2023-06-01,397723,1,1,2,1,1,1
2023-06-01,40948,17,2,19,34,5,34
2023-06-01,46857,1,0,1,1,0,1
2023-06-01,12110,7,3,10,3,4,4
2023-06-01,11287,19,1,20,6,5,6
2023-06-01,395173,18,1,19,1,1,1
2023-06-01,30074,1,1,2,1,1,1
2023-06-01,20303,25,0,25,6,0,6
2023-06-01,394367,6,1,7,8,4,8
2023-06-01,32018,2,1,3,1,1,1
2023-06-01,400812,1,1,2,1,1,1
2023-06-01,395649,2,0,2,1,0,1
2023-06-01,16925,4,12,16,1,2,2
2023-06-01,18935,2,1,3,3,1,3
2023-06-01,394501,3,1,4,4,3,4
2023-06-01,7311,105,1,106,33,6,33
2023-06-01,945,8,5,13,7,7,8
2023-06-01,59538,1,1,2,1,1,1
2023-06-01,57974,1,4,5,1,3,3
2023-06-01,21738,1,1,2,4,5,7
2023-06-01,19006,5,1,6,3,2,3
2023-06-01,55154,66,0,66,3,0,3
2023-06-01,397122,3,1,4,2,2,2
2023-06-01,397064,0,1,1,2,1,2
2023-06-01,400830,5,0,5,1,0,1
2023-06-01,32334,2,1,3,5,4,5
2023-06-01,7883,5,0,5,1,0,1
2023-06-01,397031,14,3,17,5,3,5
2023-06-01,26077,245,4,249,11,3,11
2023-06-01,395163,5,0,5,1,0,1
2023-06-01,54295,1,0,1,1,0,1
2023-06-01,26692,1,2,3,1,2,2
2023-06-01,46793,2,2,4,1,1,1
2023-06-01,11721,2,4,6,1,2,2
2023-06-01,399533,3,1,4,1,1,1
2023-06-01,397134,3,6,9,2,2,3
2023-06-01,398157,1,0,1,1,0,1
2023-06-01,396422,15,6,21,5,5,5
2023-06-01,40694,1,0,1,1,0,1
2023-06-01,396325,1,1,2,2,1,2
2023-06-01,25862,1,2,3,2,2,3
2023-06-01,46427,1,7,8,1,3,3
2023-06-01,33014,2,1,3,4,2,4
2023-06-01,19855,74,6,80,35,7,35
2023-06-01,3214,96,56,152,23,17,26
2023-06-01,26110,30,0,30,8,0,8
2023-06-01,394989,6,3,9,1,1,2
2023-06-01,210645,1,5,6,6,2,6
2023-06-01,46924,2,2,4,3,3,3
2023-06-01,2722,10,2,12,11,3,11
2023-06-01,2721,5,1,6,8,1,8
2023-06-01,398270,1,0,1,1,0,1
2023-06-01,393684,10,0,10,2,0,2
2023-06-01,400846,2,3,5,1,3,3
2023-06-01,26095,2,1,3,2,1,2
2023-06-01,46167,1,0,1,1,0,1
2023-06-01,54434,17,0,17,6,0,6
2023-06-01,32998,1,0,1,1,0,1
2023-06-01,19881,26,1,27,5,1,5
2023-06-01,54506,1,0,1,7,0,7
2023-06-01,395898,1,1,2,1,1,1
2023-06-01,396097,17,2,19,7,4,7
2023-06-01,22951,1,0,1,1,0,1
2023-06-01,13795,5,1,6,2,2,2
2023-06-01,7034,2,2,4,3,2,4
2023-06-01,14265,359,8,367,39,6,39
2023-06-01,948,2,2,4,1,1,1
2023-06-01,395591,2,0,2,3,0,3
2023-06-01,19369,1,1,2,1,1,1
2023-06-01,53907,15,2,17,11,2,11
2023-06-01,30344,1,0,1,1,0,1
2023-06-01,25639,1,1,2,1,1,1
2023-06-01,400600,1,0,1,1,0,1
2023-06-01,958,1,0,1,1,0,1
2023-06-01,35008,2,2,4,4,3,4
2023-06-01,14756,1,0,1,1,0,1
2023-06-01,55286,633,3,636,6,3,6
2023-06-01,396142,1,1,2,1,1,1
2023-06-01,54987,1,1,2,1,1,2
2023-06-01,398124,1,1,2,1,1,1
2023-06-01,40237,11,1,12,5,3,5
2023-06-01,60841,5,0,5,2,0,2
2023-06-01,57870,1,21,22,1,4,5
2023-06-01,17045,1,3,4,1,1,1
2023-06-01,400861,1,1,2,1,1,1
2023-06-01,395921,8,0,8,1,0,1
2023-06-01,52025,2,19,21,11,12,17
2023-06-01,32217,3,1,4,19,4,20
2023-06-01,18470,1,2,3,1,2,2
2023-06-01,17024,1,1,2,1,1,1
2023-06-01,54113,412,782,1194,55,45,60
2023-06-01,213186,4,1,5,1,1,1
2023-06-01,54133,16,2,18,6,1,6
2023-06-01,4581,39,0,39,13,0,13
2023-06-01,397092,4,0,4,1,0,1
2023-06-01,54002,2,1,3,5,4,5
2023-06-01,63202,1,2,3,1,1,1
2023-06-01,16576,1,1,2,1,1,1
2023-06-01,397540,5,1,6,7,5,7
2023-06-01,57257,1,1,2,6,3,6
2023-06-01,399532,1,0,1,3,0,3
2023-06-01,51519,2,1,3,7,10,12
2023-06-01,396031,1,1,2,3,3,3
2023-06-01,14731,9,1,10,4,1,4
2023-06-01,397104,7,0,7,1,0,1
2023-06-01,398280,1,1,2,2,2,2
2023-06-01,395477,4,0,4,1,0,1
2023-06-01,400011,6,1,7,5,4,5
2023-06-01,63270,20,1,21,8,4,9
2023-06-01,36247,1,0,1,1,0,1
2023-06-01,36027,3,1,4,2,1,2
2023-06-01,6994,5,1,6,6,3,6
2023-06-01,396997,1,1,2,1,1,1
2023-06-01,2145,1,0,1,1,0,1
2023-06-01,395261,10,1,11,1,1,1
2023-06-01,398299,1,0,1,3,0,3
2023-06-01,21723,10,0,10,15,0,15
2023-06-01,26198,30,0,30,5,0,5
2023-06-01,396313,1,5,6,3,2,4
2023-06-01,397019,8,2,10,3,1,3
2023-06-01,397816,3,0,3,2,0,2
2023-06-01,35985,22,2,24,17,2,17
2023-06-01,46246,2,1,3,1,1,1
2023-06-01,398041,9,3,12,3,1,3
2023-06-01,32313,2,1,3,2,2,2
2023-06-01,27168,7,0,7,3,0,3
2023-06-01,398309,2,0,2,1,0,1
2023-06-01,54841,7,0,7,4,0,4
2023-06-01,396302,1,0,1,1,0,1
2023-06-01,398358,1,0,1,2,0,2
2023-06-01,29727,5,2,7,3,1,3
2023-06-01,30501,2,0,2,3,0,3
2023-06-01,21968,1,0,1,3,0,3
2023-06-01,36741,2,1,3,5,1,5
2023-06-01,31857,38,1,39,6,5,8
2023-06-01,30432,9,1,10,4,4,4
2023-06-01,394752,6,1,7,2,1,2
2023-06-01,62538,1,4,5,4,3,5
2023-06-01,396101,4,1,5,1,1,1
2023-06-01,398310,1,0,1,1,0,1
2023-06-01,21527,23,2,25,8,1,8
2023-06-01,5008,5,0,5,4,0,4
2023-06-01,395853,4,0,4,1,0,1
2023-06-01,398292,6,0,6,1,0,1
2023-06-01,63304,6,0,6,1,0,1
2023-06-01,35911,111,1,112,10,3,10
2023-06-01,22867,2,0,2,1,0,1
2023-06-01,400563,1,1,2,1,1,1
2023-06-01,36025,2,0,2,1,0,1
2023-06-01,398430,3,0,3,2,0,2
2023-06-01,4556,6,1,7,6,1,6
2023-06-01,47096,19,1,20,11,4,11
2023-06-01,53740,3,1,4,3,1,3
2023-06-01,7122,26,1,27,18,2,18
2023-06-01,33110,1,0,1,1,0,1
2023-06-01,397131,2,2,4,2,1,2
2023-06-01,46539,1,1,2,1,1,1
2023-06-01,40864,4,0,4,4,0,4
2023-06-01,46489,21,6,27,25,17,28
2023-06-01,6597,23,4,27,9,5,9
2023-06-01,18792,1,3,4,1,2,2
2023-06-01,800,9,1,10,5,1,6
2023-06-01,35868,1,0,1,2,0,2
2023-06-01,397041,15,4,19,2,2,2
2023-06-01,398330,2,1,3,1,1,1
2023-06-01,393398,54,6,60,11,4,11
2023-06-01,30277,24,4,28,3,2,3
2023-06-01,39618,4,1,5,2,1,2
2023-06-01,398328,2,1,3,3,1,3
2023-06-01,62668,3,1,4,4,2,4
2023-06-01,398425,1,1,2,1,1,1
2023-06-01,395512,5,1,6,3,2,3
2023-06-01,46918,4,0,4,1,0,1
2023-06-01,397598,1,0,1,1,0,1
2023-06-01,12131,1,1,2,1,1,1
2023-06-01,398422,3,0,3,1,0,1
2023-06-01,36140,1,1,2,1,1,1
2023-06-01,398447,3,5,8,3,3,5
2023-06-01,398493,5,4,9,1,1,1
2023-06-01,396262,1,0,1,1,0,1
2023-06-01,398568,2,1,3,3,1,3
2023-06-01,19575,1,1,2,1,1,1
2023-06-01,398565,1,6,7,1,4,4
2023-06-01,397165,1,65,66,1,1,1
2023-06-01,399895,9,0,9,2,0,2
2023-06-01,396860,6,0,6,2,0,2
2023-06-01,394972,29,50,79,4,1,4
2023-06-01,400391,32,0,32,3,0,3
2023-06-01,398638,3,0,3,2,0,2
2023-06-01,395565,5,0,5,3,0,3
2023-06-01,32444,101,2,103,6,1,6
2023-06-01,35892,1,0,1,2,0,2
2023-06-01,23114,4,2,6,13,6,13
2023-06-01,398567,1,0,1,1,0,1
2023-06-01,40033,6,2,8,1,1,1
2023-06-01,394140,9,0,9,4,0,4
2023-06-01,398549,3,44,47,5,9,10
2023-06-01,393336,18,5,23,2,2,2
2023-06-01,35859,1,1,2,1,1,1
2023-06-01,22751,1,1,2,1,1,1
2023-06-01,397896,2,0,2,1,0,1
2023-06-01,46980,1,1,2,1,1,1
2023-06-01,394814,8,2,10,3,2,3
2023-06-01,54721,2,5,7,1,1,1
2023-06-01,62969,9,1,10,1,1,1
2023-06-01,53925,3,0,3,2,0,2
2023-06-01,394247,2,0,2,2,0,2
2023-06-01,398764,1,0,1,5,0,5
2023-06-01,64290,2,0,2,1,0,1
2023-06-01,31998,11,1,12,2,1,2
2023-06-01,19382,6,10,16,4,4,4
2023-06-01,35932,6,0,6,1,0,1
2023-06-01,395348,2,3,5,4,5,5
2023-06-01,19529,6,5,11,2,2,2
2023-06-01,398795,1,6,7,1,2,2
2023-06-01,25815,1,0,1,2,0,2
2023-06-01,399226,10,0,10,4,0,4
2023-06-01,47085,1,0,1,1,0,1
2023-06-01,393434,5,1,6,5,4,5
2023-06-01,51765,51,3,54,13,9,13
2023-06-01,26383,50,14,64,8,7,8
2023-06-01,54241,7,1,8,2,1,2
2023-06-01,399611,1,1,2,1,1,1
2023-06-01,394012,4,0,4,4,0,4
2023-06-01,395662,10,1,11,13,5,13
2023-06-01,398193,2,0,2,1,0,1
2023-06-01,400097,0,24,24,2,13,14
2023-06-01,53666,1,0,1,1,0,1
2023-06-01,33436,3,2,5,1,1,1
2023-06-01,398698,1,1,2,3,4,5
2023-06-01,29924,1,0,1,1,0,1
2023-06-01,398712,16,2,18,2,3,3
2023-06-01,3367,13,6,19,11,3,11
2023-06-01,398639,1,1,2,1,1,1
2023-06-01,398717,2,1,3,3,3,3
2023-06-01,19366,12,0,12,14,0,14
2023-06-01,398832,1,0,1,1,0,1
2023-06-01,25892,18,2,20,2,2,2
2023-06-01,26272,2,2,4,2,2,2
2023-06-01,62707,15,12,27,3,3,4
2023-06-01,398942,2,1,3,1,1,1
2023-06-01,398838,1,1,2,2,2,2
2023-06-01,40531,1,0,1,1,0,1
2023-06-01,40202,3,0,3,2,0,2
2023-06-01,394743,3,1,4,1,1,1
2023-06-01,397103,1,0,1,1,0,1
2023-06-01,398930,1,1,2,5,2,5
2023-06-01,395774,1,1,2,3,1,3
2023-06-01,11043,1,1,2,2,2,2
2023-06-01,397654,3,0,3,2,0,2
2023-06-01,55016,10,1,11,2,1,3
2023-06-01,62766,2,4,6,1,1,1
2023-06-01,394419,3,1,4,3,1,4
2023-06-01,14971,6,0,6,2,0,2
2023-06-01,36165,11,1,12,3,2,3
2023-06-01,398960,3,3,6,4,3,5
2023-06-01,19681,2,1,3,3,3,3
2023-06-01,53856,12,0,12,4,0,4
2023-06-01,29757,16,2,18,5,2,5
2023-06-01,399016,1,2,3,1,1,1
2023-06-01,398908,1,0,1,1,0,1
2023-06-01,399463,1,0,1,1,0,1
2023-06-01,54980,7,1,8,3,3,3
2023-06-01,19045,26,0,26,5,0,5
2023-06-01,394119,1,2,3,1,2,2
2023-06-01,26744,54,2,56,25,8,25
2023-06-01,399006,4,0,4,2,0,2
2023-06-01,394378,2,1,3,2,2,2
2023-06-01,54958,1,0,1,1,0,1
2023-06-01,59893,1,3,4,1,1,1
2023-06-01,7806,8,2,10,6,1,6
2023-06-01,16970,15,1,16,2,2,4
2023-06-01,394969,1,1,2,1,1,1
2023-06-01,54632,2,2,4,4,4,5
2023-06-01,29844,14,0,14,5,0,5
2023-06-01,399584,2,0,2,1,0,1
2023-06-01,399724,3,2,5,2,1,2
2023-06-01,398901,1,0,1,1,0,1
2023-06-01,4906,20,2,22,2,2,2
2023-06-01,399091,3,1,4,1,1,1
2023-06-01,393582,7,0,7,1,0,1
2023-06-01,395502,3,3,6,7,4,7
2023-06-01,19568,1,1,2,3,1,3
2023-06-01,30162,29,1,30,3,2,3
2023-06-01,30168,1,1,2,1,1,1
2023-06-01,395585,1,0,1,2,0,2
2023-06-01,398368,1,0,1,1,0,1
2023-06-01,46384,2,0,2,2,0,2
2023-06-01,46995,1,1,2,1,1,1
2023-06-01,27213,2,0,2,1,0,1
2023-06-01,398468,2,0,2,1,0,1
2023-06-01,16400,1,1,2,1,1,1
2023-06-01,398962,9,51,60,11,11,12
2023-06-01,12243,7,3,10,8,4,8
2023-06-01,394968,5,1,6,16,3,16
2023-06-01,14928,12,1,13,9,3,9
2023-06-01,399428,2,1,3,1,1,2
2023-06-01,396502,12,5,17,2,2,2
2023-06-01,1024,1,14,15,4,2,4
2023-06-01,398882,1,0,1,1,0,1
2023-06-01,397268,12,0,12,2,0,2
2023-06-01,25948,4,2,6,4,3,4
2023-06-01,26035,1,0,1,2,0,2
2023-06-01,399289,1,1,2,1,1,1
2023-06-01,395568,1,3,4,2,3,3
2023-06-01,33452,7,0,7,2,0,2
2023-06-01,399228,1,1,2,1,1,1
2023-06-01,399242,1,1,2,1,1,1
2023-06-01,19740,45,3,48,9,3,10
2023-06-01,396026,35,2,37,4,3,4
2023-06-01,22062,5,0,5,7,2,7
2023-06-01,396279,2,2,4,2,2,2
2023-06-01,399219,1,0,1,1,0,1
2023-06-01,397072,1,1,2,1,1,1
2023-06-01,22697,87,13,100,24,13,26
2023-06-01,11281,8,2,10,1,1,1
2023-06-01,399200,12,7,19,2,1,2
2023-06-01,397672,6,5,11,2,2,2
2023-06-01,54364,1,1,2,1,1,1
2023-06-01,394868,5,1,6,3,1,3
2023-06-01,397736,1,1,2,3,3,3
2023-06-01,19829,1,0,1,1,0,1
2023-06-01,399338,1,1,2,1,1,1
2023-06-01,210907,17,2,19,2,2,3
2023-06-01,30323,2,1,3,2,2,2
2023-06-01,7794,25,1,26,10,8,10
2023-06-01,17018,11,1,12,9,7,10
2023-06-01,393737,32,1,33,6,1,6
2023-06-01,399372,3,0,3,1,0,1
2023-06-01,394233,9,0,9,8,0,8
2023-06-01,4508,3,1,4,5,2,5
2023-06-01,33044,6,2,8,7,3,8
2023-06-01,393626,6,1,7,4,1,4
2023-06-01,31775,54,13,67,2,2,2
2023-06-01,40001,3,0,3,1,0,1
2023-06-01,46920,17,18,35,4,3,4
2023-06-01,28624,75,3,78,12,4,12
2023-06-01,54476,1,0,1,2,0,2
2023-06-01,54316,2,2,4,1,1,1
2023-06-01,55009,4,1,5,2,1,2
2023-06-01,5056,249,3,252,57,15,58
2023-06-01,16722,1,1,2,1,1,1
2023-06-01,20029,16,2,18,7,1,7
2023-06-01,20220,3,1,4,3,3,3
2023-06-01,397327,1,1,2,1,1,1
2023-06-01,54509,3,1,4,2,2,2
2023-06-01,393301,5,1,6,3,3,3
2023-06-01,397376,3,1,4,1,1,1
2023-06-01,399478,1,0,1,2,0,2
2023-06-01,396304,17,2,19,4,2,4
2023-06-01,27298,3,1,4,3,3,4
2023-06-01,399306,2,1,3,3,2,3
2023-06-01,35990,1,0,1,2,0,2
2023-06-01,10920,1,0,1,1,0,1
2023-06-01,26677,47,4,51,41,10,41
2023-06-01,399825,2,0,2,1,0,1
2023-06-01,6509,5,1,6,15,13,18
2023-06-01,397321,1,0,1,1,0,1
2023-06-01,394767,1,0,1,2,0,2
2023-06-01,399504,1,1,2,2,2,2
2023-06-01,18943,35,0,35,10,0,10
2023-06-01,399476,1,0,1,1,0,1
2023-06-01,399377,4,0,4,2,0,2
2023-06-01,53334,38,28,66,16,15,21
2023-06-01,211544,3,3,6,4,2,4
2023-06-01,7489,85,42,127,12,10,13
2023-06-01,397347,5,0,5,2,0,2
2023-06-01,399571,3,1,4,1,1,1
2023-06-01,398778,15,0,15,2,0,2
2023-06-01,19518,3,1,4,6,4,7
2023-06-01,26370,5,2,7,5,4,6
2023-06-01,399517,1,0,1,1,0,1
2023-06-01,63297,7,3,10,3,1,3
2023-06-01,14007,14,2,16,15,2,15
2023-06-01,31798,88,1,89,6,1,6
2023-06-01,19850,1,0,1,6,0,6
2023-06-01,19383,24,0,24,6,0,6
2023-06-01,399562,1,0,1,1,0,1
2023-06-01,62838,23,0,23,5,0,5
2023-06-01,138628,0,0,0,3,0,3
2023-06-01,15017,3,1,4,1,1,1
2023-06-01,396182,1,0,1,2,0,2
2023-06-01,62611,6,2,8,5,1,5
2023-06-01,46841,77,2,79,2,2,2
2023-06-01,40216,2,2,4,1,1,1
2023-06-01,399717,1,0,1,1,0,1
2023-06-01,33541,8,1,9,4,2,4
2023-06-01,399401,1,0,1,1,0,1
2023-06-01,27597,2,0,2,2,0,2
2023-06-01,26253,12,1,13,3,2,3
2023-06-01,399663,1,1,2,1,1,1
2023-06-01,399581,1,1,2,1,1,1
2023-06-01,399568,1,1,2,1,1,1
2023-06-01,36198,5,4,9,3,4,6
2023-06-01,399676,1,0,1,2,0,2
2023-06-01,25819,1,1,2,3,3,4
2023-06-01,399747,1,3,4,1,1,1
2023-06-01,399728,6,1,7,7,2,7
2023-06-01,395043,2,0,2,1,0,1
2023-06-01,399419,2,0,2,1,0,1
2023-06-01,54919,1,0,1,1,0,1
2023-06-01,399599,3,35,38,1,2,2
2023-06-01,53561,3,0,3,2,0,2
2023-06-01,398978,1,0,1,1,0,1
2023-06-01,394887,5,4,9,3,3,3
2023-06-01,29857,1,1,2,1,1,1
2023-06-01,11448,4,1,5,3,2,3
2023-06-01,395657,10,0,10,5,0,5
2023-06-01,399868,5,4,9,3,4,5
2023-06-01,32494,1,1,2,1,2,2
2023-06-01,399675,2,0,2,1,0,1
2023-06-01,23498,40,3,43,29,4,29
2023-06-01,394656,2,0,2,2,0,2
2023-06-01,32267,2,1,3,2,1,2
2023-06-01,63394,85,1,86,3,1,3
2023-06-01,399889,2,0,2,1,0,1
2023-06-01,10963,1,0,1,1,0,1
2023-06-01,29852,31,0,31,7,0,7
2023-06-01,399032,1,1,2,2,2,2
2023-06-01,399525,1,0,1,1,0,1
2023-06-01,11114,9,2,11,12,9,14
2023-06-01,53989,24,1,25,5,1,5
2023-06-01,400005,2,2,4,4,2,4
2023-06-01,61414,13,0,13,5,0,5
2023-06-01,49466,5,0,5,2,0,2
2023-06-01,32315,2,0,2,1,0,1
2023-06-01,22020,2,0,2,3,0,3
2023-06-01,40139,17,0,17,2,0,2
2023-06-01,53810,3,0,3,2,0,2
2023-06-01,40945,13,1,14,3,1,3
2023-06-01,399915,5,0,5,1,0,1
2023-06-01,395678,2,1,3,2,2,2
2023-06-01,25899,51,1,52,60,20,62
2023-06-01,400657,1,0,1,2,0,2
2023-06-01,14051,47,2,49,30,4,30
2023-06-01,63375,4,0,4,2,0,2
2023-06-01,399897,1,0,1,1,0,1
2023-06-01,46978,3,3,6,3,2,3
2023-06-01,213073,1,8,9,1,4,4
2023-06-01,399951,5,2,7,2,2,2
2023-06-01,6315,23,6,29,17,9,19
2023-06-01,399223,1,0,1,1,0,1
2023-06-01,16437,11,1,12,1,1,1
2023-06-01,6977,12,1,13,2,2,2
2023-06-01,396990,9,0,9,2,0,2
2023-06-01,398909,1,0,1,1,0,1
2023-06-01,399803,1,0,1,1,0,1
2023-06-01,19465,10,1,11,4,4,4
2023-06-01,399989,2,0,2,1,0,1
2023-06-01,19625,3,4,7,3,4,4
2023-06-01,11996,4,1,5,12,5,12
2023-06-01,17077,9,0,9,7,0,7
2023-06-01,396136,2,0,2,1,0,1
2023-06-01,400070,2,0,2,1,0,1
2023-06-01,27593,6,0,6,1,0,1
2023-06-01,40156,4,1,5,1,1,1
2023-06-01,63393,3,1,4,1,1,1
2023-06-01,31898,1027,457,1484,67,52,70
2023-06-01,400148,1,1,2,1,1,1
2023-06-01,398810,6,1,7,3,1,3
2023-06-01,15146,70,273,343,10,2,10
2023-06-01,22357,2,0,2,2,0,2
2023-06-01,8014,20,0,20,4,0,4
2023-06-01,396472,6,1,7,3,2,3
2023-06-01,399606,21,4,25,12,2,13
2023-06-01,400087,1,1,2,1,1,1
2023-06-01,31843,4,1,5,1,1,1
2023-06-01,399551,1,1,2,1,1,1
2023-06-01,396316,6,1,7,1,1,2
2023-06-01,400050,8,0,8,1,0,1
2023-06-01,400142,1,0,1,1,0,1
2023-06-01,32708,188,2,190,14,5,15
2023-06-01,400383,3,0,3,1,0,1
2023-06-01,400080,5,0,5,1,0,1
2023-06-01,131702,8,3,11,2,1,2
2023-06-01,6147,1134,87,1221,16,6,17
2023-06-01,131976,1,1,2,4,4,4
2023-06-01,58952,32,273,305,24,9,26
2023-06-01,132148,8,2,10,7,5,8
2023-06-01,137955,2,1,3,6,4,6
2023-06-01,132167,37,0,37,22,0,22
2023-06-01,134739,16,1,17,11,3,11
2023-06-01,39138,6,3,9,9,7,10
2023-06-01,131445,186,109,295,2,2,2
2023-06-01,52376,6,3,9,30,8,30
2023-06-01,22927,110,7,117,159,29,161
2023-06-01,16814,200,33,233,52,13,52
2023-06-01,6057,585,32,617,43,30,45
2023-06-01,6400,89,1,90,12,9,13
2023-06-01,327952,16,0,16,4,0,4
2023-06-01,46650,56,18,74,7,5,7
2023-06-01,63528,3,2,5,5,5,5
2023-06-01,18001,76,229,305,34,9,35
2023-06-01,14522,206,56,262,14,8,14
2023-06-01,43766,461,501,962,20,8,20
2023-06-01,61010,5,1,6,11,5,11
2023-06-01,61399,5,1,6,3,1,3
2023-06-01,22047,402,1,403,5,2,5
2023-06-01,23881,89,3,92,9,3,9
2023-06-01,19194,60,1,61,2,1,2
2023-06-01,136800,164,0,164,6,0,6
2023-06-01,53755,187,2,189,7,5,7
2023-06-01,46687,295,8,303,6,3,6
2023-06-01,26076,17,0,17,8,0,8
2023-06-01,34779,34,8,42,97,29,102
2023-06-01,203618,4,1,5,1,1,1
2023-06-01,19347,1,0,1,2,0,2
2023-06-01,398946,10,4,14,3,1,3
2023-06-01,396418,1,1,2,1,1,1
2023-06-01,395040,11,0,11,2,0,2
2023-06-01,140641,34,2,36,19,8,19
2023-06-01,396904,4,0,4,2,0,2
2023-06-01,400633,18,0,18,2,0,2
2023-06-01,33725,4,0,4,3,0,3
2023-06-01,14640,3,0,3,1,0,1
2023-06-01,46231,47,2,49,10,1,10
2023-06-01,3842,50,12,62,9,7,10
2023-06-01,40430,7,0,7,1,0,1
2023-06-01,62650,6,0,6,6,0,6
2023-06-01,33548,17,1,18,5,2,5
2023-06-01,58064,1,0,1,1,0,1
2023-06-01,23316,48,0,48,11,0,11
2023-06-01,16591,220,1,221,7,4,7
2023-06-01,26496,490,9,499,18,11,20
2023-06-01,398101,222,3,225,1,1,1
2023-06-01,210715,4,0,4,4,0,4
2023-06-01,49661,34,0,34,1,0,1
2023-06-01,7819,31,3,34,18,8,18
2023-06-01,36327,31,1,32,15,1,15
2023-06-01,5769,266,12,278,35,7,36
2023-06-01,399150,11,0,11,1,0,1
2023-06-01,395681,12,1,13,3,1,3
2023-06-01,26724,14,0,14,2,0,2
2023-06-01,20398,15,0,15,5,0,5
2023-06-01,23096,3,0,3,3,0,3
2023-06-01,23442,10,0,10,4,0,4
2023-06-01,29742,4,0,4,1,0,1
2023-06-01,26058,4,0,4,4,0,4
2023-06-01,60558,26,1,27,3,1,3
2023-06-01,14813,264,1,265,6,1,6
2023-06-01,20329,2,0,2,1,0,1
2023-06-01,22892,8,0,8,2,0,2
2023-06-01,27008,1,1,2,8,9,9
2023-06-01,395378,3,1,4,1,2,2
2023-06-01,6134,104,5,109,12,7,14
2023-06-01,134835,41,9,50,17,18,22
2023-06-01,54290,74,3,77,6,7,7
2023-06-01,21866,3,0,3,5,0,5
2023-06-01,11776,1742,9,1751,30,3,30
2023-06-01,2906,187,211,398,39,30,50
2023-06-01,7049,75,1,76,219,51,220
2023-06-01,52374,1,1,2,4,5,6
2023-06-01,54503,9,0,9,3,0,3
2023-06-01,27630,21,1,22,14,7,15
2023-06-01,397086,40,2,42,2,1,2
2023-06-01,138152,50,0,50,4,0,4
2023-06-01,60024,4,4,8,4,2,4
2023-06-01,46997,12,18,30,4,18,18
2023-06-01,237,44,6,50,38,13,40
2023-06-01,397797,9,1,10,2,1,2
2023-06-01,46632,27,1,28,11,2,11
2023-06-01,400457,1,0,1,1,0,1
2023-06-01,53863,2,0,2,1,0,1
2023-06-01,36231,27,3,30,8,1,8
2023-06-01,142632,3,1,4,1,2,3
2023-06-01,398427,3,1,4,7,1,7
2023-06-01,32926,1,0,1,1,0,1
2023-06-01,54293,4,0,4,6,0,6
2023-06-01,400140,1,0,1,3,0,3
2023-06-01,13356,17,1,18,2,1,2
2023-06-01,400052,1,0,1,2,0,2
2023-06-01,395254,3,0,3,1,0,1
2023-06-01,18883,43,0,43,8,4,8
2023-06-01,400156,4,0,4,1,0,1
2023-06-01,34939,9,2,11,12,7,13
2023-06-01,31877,37,2,39,21,7,21
2023-06-01,16700,14,1,15,8,5,8
2023-06-01,400303,3,1,4,1,1,1
2023-06-01,54502,4,0,4,2,0,2
2023-06-01,399971,1,0,1,1,0,1
2023-06-01,986,1,0,1,2,0,2
2023-06-01,17017,5,2,7,7,8,8
2023-06-01,896,2,0,2,1,0,1
2023-06-01,400396,1,0,1,2,0,2
2023-06-01,23415,5,1,6,1,1,1
2023-06-01,30639,2,0,2,2,0,2
2023-06-01,399486,7,1,8,5,3,5
2023-06-01,400130,2,1,3,1,1,1
2023-06-01,138077,11,4,15,7,5,8
2023-06-01,131685,35,0,35,1,0,1
2023-06-01,55106,35,5,40,6,2,6
2023-06-01,19812,26,0,26,9,0,9
2023-06-01,396497,6,0,6,2,0,2
2023-06-01,18254,4,1,5,3,1,4
2023-06-01,25710,4,1,5,1,1,1
2023-06-01,18467,1,0,1,3,0,3
2023-06-01,25645,46,6,52,28,6,28
2023-06-01,21724,66,0,66,2,0,2
2023-06-01,62627,34,0,34,4,0,4
2023-06-01,398880,2,0,2,3,0,3
2023-06-01,27602,5,1,6,2,2,2
2023-06-01,400113,1,1,2,5,2,5
2023-06-01,53587,57,3,60,31,2,31
2023-06-01,22552,35,1,36,3,1,3
2023-06-01,12188,28,2,30,4,4,4
2023-06-01,57795,34,15,49,15,8,16
2023-06-01,55129,1,1,2,3,1,3
2023-06-01,14302,4,0,4,1,0,1
2023-06-01,54905,3,0,3,1,0,1
2023-06-01,62610,45,0,45,13,0,13
2023-06-01,18615,7,1,8,4,3,4
2023-06-01,398766,26,1,27,3,2,3
2023-06-01,53896,6,0,6,1,0,1
2023-06-01,54858,48,4,52,1,1,1
2023-06-01,59447,36,0,36,1,0,1
2023-06-01,62814,4,0,4,2,0,2
2023-06-01,62886,23,1,24,2,1,2
2023-06-01,53848,7,1,8,5,2,5
2023-06-01,46455,5,3,8,24,7,24
2023-06-01,12056,2,0,2,1,0,1
2023-06-01,46849,5,1,6,20,2,20
2023-06-01,16823,23,0,23,4,0,4
2023-06-01,19994,75,1,76,2,1,2
2023-06-01,33070,110,1,111,1,1,1
2023-06-01,27357,63,1,64,2,1,2
2023-06-01,13343,11,1,12,1,1,1
2023-06-01,16787,60,12,72,4,3,4
2023-06-01,19115,43,21,64,7,6,7
2023-06-01,40285,370,1,371,7,1,7
2023-06-01,21615,15,0,15,4,0,4
2023-06-01,11976,347,1,348,12,1,12
2023-06-01,13825,12,0,12,18,0,18
2023-06-01,33759,2,0,2,3,0,3
2023-06-01,33141,2,0,2,3,0,3
2023-06-01,400423,4,0,4,2,0,2
2023-06-01,399034,2,0,2,1,0,1
2023-06-01,32195,1,0,1,1,0,1
2023-06-01,22362,11,0,11,7,0,7
2023-06-01,398463,1,0,1,3,0,3
2023-06-01,836,1,0,1,1,0,1
2023-06-01,18960,2,0,2,1,0,1
2023-06-01,36681,1,0,1,1,0,1
2023-06-01,30104,4,0,4,2,0,2
2023-06-01,53482,2,0,2,3,0,3
2023-06-01,53639,3,0,3,1,0,1
2023-06-01,53555,1,0,1,1,0,1
2023-06-01,53271,16,0,16,3,0,3
2023-06-01,14008,2,0,2,1,0,1
2023-06-01,18474,8,1,9,5,4,6
2023-06-01,397866,8,0,8,5,0,5
2023-06-01,398913,13,1,14,2,1,2
2023-06-01,10011,7,1,8,4,2,4
2023-06-01,18081,38,1,39,7,5,7
2023-06-01,62931,2,0,2,2,0,2
2023-06-01,20412,227,1,228,5,2,5
2023-06-01,29866,106,1,107,5,2,5
2023-06-01,395761,21,0,21,3,0,3
2023-06-01,14291,26,0,26,7,0,7
2023-06-01,1246,130,1,131,1,1,1
2023-06-01,22646,410,1,411,9,2,10
2023-06-01,11290,86,4,90,9,6,10
2023-06-01,46449,16,1,17,3,1,3
2023-06-01,20347,22,0,22,7,0,7
2023-06-01,30612,70,5,75,6,3,6
2023-06-01,4474,12,1,13,7,8,8
2023-06-01,30404,21,3,24,7,5,7
2023-06-01,15198,10,1,11,2,1,2
2023-06-01,11176,3,1,4,1,1,2
2023-06-01,32776,3,1,4,1,3,3
2023-06-01,13490,665,1,666,17,4,17
2023-06-01,55198,2,0,2,2,0,2
2023-06-01,53749,1,0,1,1,0,1
2023-06-01,27180,1,0,1,2,0,2
2023-06-01,36814,1,0,1,2,0,2
2023-06-01,10971,19,1,20,6,1,6
2023-06-01,33230,4,1,5,4,2,4
2023-06-01,397027,11,0,11,3,0,3
2023-06-01,7522,53,1,54,14,9,16
2023-06-01,18260,21,1,22,10,7,10
2023-06-01,9607,18,2,20,27,21,28
2023-06-01,35843,3,1,4,1,1,1
2023-06-01,14288,82,1,83,8,3,8
2023-06-01,22827,10,0,10,1,0,1
2023-06-01,18643,2,0,2,3,0,3
2023-06-01,21882,2,1,3,2,1,2
2023-06-01,32779,3,1,4,1,1,2
2023-06-01,20368,3,0,3,1,0,1
2023-06-01,33700,3,1,4,1,1,1
2023-06-01,11582,2,0,2,3,0,3
2023-06-01,600,84,2,86,58,11,60
2023-06-01,18601,5,1,6,1,1,1
2023-06-01,36392,3,0,3,3,0,3
2023-06-01,18444,4,1,5,1,1,1
2023-06-01,32686,3,0,3,1,0,1
2023-06-01,10949,2,0,2,1,0,1
2023-06-01,54565,2,0,2,1,0,1
2023-06-01,23278,3,1,4,3,1,3
2023-06-01,23279,3,1,4,1,1,2
2023-06-01,31939,34,1,35,7,2,7
2023-06-01,46123,4,0,4,3,0,3
2023-06-01,14423,1,0,1,1,0,1
2023-06-01,19709,4,0,4,2,0,2
2023-06-01,32133,47,16,63,22,19,23
2023-06-01,23138,50,3,53,7,4,8
2023-06-01,30299,1,0,1,2,0,2
2023-06-01,25853,16,1,17,5,2,5
2023-06-01,32775,4,1,5,2,1,2
2023-06-01,13395,2,0,2,4,0,4
2023-06-01,53508,113,2,115,5,2,5
2023-06-01,1651,12,0,12,2,0,2
2023-06-01,11568,4,0,4,1,0,1
2023-06-01,15344,74,16,90,2,1,2
2023-06-01,11955,36,15,51,1,1,1
2023-06-01,46236,1,0,1,2,0,2
2023-06-01,13524,15,0,15,12,0,12
2023-06-01,27364,44,2,46,14,4,14
2023-06-01,11662,1,0,1,3,0,3
2023-06-01,23389,2,1,3,2,1,2
2023-06-01,11633,4,0,4,4,0,4
2023-06-01,11270,1,0,1,1,0,1
2023-06-01,14299,46,0,46,4,0,4
2023-06-01,14149,2,0,2,3,0,3
2023-06-01,30236,43,1,44,5,2,5
2023-06-01,32953,9,0,9,3,0,3
2023-06-01,21801,3,0,3,2,0,2
2023-06-01,26720,1,0,1,1,0,1
2023-06-01,35884,1,0,1,1,0,1
2023-06-01,397124,1,0,1,3,0,3
2023-06-01,10838,48,9,57,1,1,1
2023-06-01,16739,6,0,6,1,0,1
2023-06-01,396066,2,0,2,3,0,3
2023-06-01,40224,3,0,3,3,0,3
2023-06-01,22799,10,0,10,2,0,2
2023-06-01,47524,560,171,731,4,1,4
2023-06-01,16495,12,0,12,1,0,1
2023-06-01,30440,1,0,1,1,0,1
2023-06-01,12097,25,1,26,6,1,6
2023-06-01,19036,7,0,7,2,0,2
2023-06-01,3848,92,0,92,3,0,3
2023-06-01,53280,20,1,21,4,1,4
2023-06-01,16895,12,0,12,2,0,2
2023-06-01,12231,13,0,13,3,0,3
2023-06-01,400136,5,0,5,3,0,3
2023-06-01,399898,170,8,178,6,5,6
2023-06-01,33258,21,0,21,2,0,2
2023-06-01,61745,6,1,7,33,30,34
2023-06-01,270480,3,1,4,1,1,1
2023-06-01,7738,605,2,607,175,107,179
2023-06-01,8167,340,1,341,144,83,150
2023-06-01,268248,5,1,6,5,5,5
2023-06-01,270494,5,1,6,2,1,2
2023-06-01,266583,8,19,27,53,42,59
2023-06-01,28158,49,1,50,37,25,38
2023-06-01,270470,3,3,6,2,1,2
2023-06-01,53062,68,12,80,326,203,331
2023-06-01,28329,28,14,42,215,167,225
2023-06-01,270471,4,1,5,1,1,1
2023-06-01,262355,4,1,5,54,42,56
2023-06-01,263155,5,1,6,6,6,9
2023-06-01,270495,3,0,3,4,0,4
2023-06-01,14868,48,3,51,68,36,73
2023-06-01,22689,74,17,91,18,8,20
2023-06-01,28305,16,3,19,5,1,5
2023-06-01,14282,9,4,13,33,23,36
2023-06-01,264996,14,5,19,36,25,36
2023-06-01,273717,5,1,6,5,2,5
2023-06-01,265442,1,7,8,32,28,33
2023-06-01,266038,2,1,3,8,6,9
2023-06-01,265269,6,3,9,61,42,64
2023-06-01,263558,18,1,19,33,14,37
2023-06-01,264997,3,3,6,50,37,52
2023-06-01,270501,2,1,3,1,1,1
2023-06-01,52771,26,3,29,11,10,12
2023-06-01,61812,14,1,15,2,2,2
2023-06-01,264354,5,1,6,5,4,6
2023-06-01,270563,4,8,12,2,1,2
2023-06-01,270384,9,0,9,3,0,3
2023-06-01,270481,3,0,3,1,0,1
2023-06-01,270564,7,1,8,4,1,4
2023-06-01,21574,5,1,6,102,62,111
2023-06-01,269976,1,1,2,1,1,1
2023-06-01,265078,7,2,9,15,13,16
2023-06-01,61512,23,4,27,29,19,31
2023-06-01,267700,4,1,5,2,2,2
2023-06-01,269965,4,1,5,4,5,5
2023-06-01,264821,13,1,14,12,8,13
2023-06-01,265684,12,3,15,11,4,11
2023-06-01,269964,4,1,5,2,1,2
2023-06-01,269991,2,0,2,2,0,2
2023-06-01,52361,17,1,18,160,30,166
2023-06-01,269970,1,0,1,1,0,1
2023-06-01,262468,49,52,101,41,28,43
2023-06-01,270513,3,1,4,1,1,1
2023-06-01,266414,7,7,14,9,6,9
2023-06-01,270484,4,4,8,2,2,2
2023-06-01,263444,12,5,17,71,63,75
2023-06-01,28663,9,5,14,31,22,34
2023-06-01,23106,59,1,60,191,117,198
2023-06-01,267613,2,1,3,162,136,168
2023-06-01,262409,5,3,8,9,7,9
2023-06-01,270485,3,1,4,1,1,1
2023-06-01,265239,2,1,3,7,4,7
2023-06-01,270486,1,1,2,1,1,1
2023-06-01,52559,8,2,10,12,8,12
2023-06-01,270487,1,0,1,1,0,1
2023-06-01,263009,16,19,35,103,88,117
2023-06-01,266438,3,1,4,17,13,18
2023-06-01,270518,1,1,2,2,1,2
2023-06-01,25933,81,6,87,82,33,88
2023-06-01,270488,1,1,2,1,1,1
2023-06-01,264367,28,3,31,13,12,15
2023-06-01,270489,3,0,3,1,0,1
2023-06-01,11432,158,9,167,187,147,211
2023-06-01,270503,4,0,4,1,0,1
2023-06-01,52573,37,4,41,30,19,30
2023-06-01,270490,2,1,3,1,1,1
2023-06-01,270491,7,1,8,2,1,2
2023-06-01,52842,10,1,11,13,9,13
2023-06-01,266105,5,1,6,5,3,5
2023-06-01,265447,7,2,9,8,4,8
2023-06-01,270519,7,2,9,1,1,1
2023-06-01,263276,35,24,59,46,15,46
2023-06-01,61832,10,18,28,258,180,265
2023-06-01,262537,14,19,33,14,8,15
2023-06-01,270496,1,1,2,3,2,3
2023-06-01,264486,3,1,4,6,3,7
2023-06-01,270504,3,1,4,1,1,1
2023-06-01,270497,3,3,6,8,9,10
2023-06-01,269194,21,42,63,45,30,48
2023-06-01,263362,14,3,17,14,11,15
2023-06-01,263073,41,18,59,72,49,74
2023-06-01,270498,4,0,4,1,0,1
2023-06-01,28598,77,14,91,143,77,148
2023-06-01,265330,5,6,11,17,12,19
2023-06-01,270525,1,0,1,1,0,1
2023-06-01,40850,5,3,8,50,30,51
2023-06-01,28260,20,31,51,78,52,87
2023-06-01,393756,1,0,1,3,0,3
2023-06-01,64281,7,0,7,2,0,2
2023-06-01,54614,202,1,203,4,2,4
2023-06-01,54120,2,0,2,3,0,3
2023-06-01,1785,0,0,0,4,2,4
2023-06-01,17051,2,0,2,2,0,2
2023-06-01,13639,2,0,2,1,0,1
2023-06-01,53993,1,0,1,1,0,1
2023-06-01,53771,1,0,1,2,0,2
2023-06-01,63248,1,0,1,1,0,1
2023-06-01,10352,6,1,7,7,2,7
2023-06-01,14334,4,0,4,2,0,2
2023-06-01,21955,4,0,4,2,0,2
2023-06-01,18834,7,0,7,2,0,2
2023-06-01,29809,2,0,2,2,0,2
2023-06-01,394320,1,0,1,1,0,1
2023-06-01,11904,36,5,41,5,1,5
2023-06-01,40534,2,0,2,3,0,3
2023-06-01,22415,2,0,2,1,0,1
2023-06-01,62790,1,0,1,1,0,1
2023-06-01,22925,42,5,47,37,9,37
2023-06-01,53657,1,0,1,1,0,1
2023-06-01,8092,87,0,87,17,0,17
2023-06-01,394487,5,1,6,3,1,3
2023-06-01,21928,276,218,494,14,12,17
2023-06-01,398006,2,0,2,2,0,2
2023-06-01,13659,19,0,19,9,0,9
2023-06-01,15108,38,1,39,19,4,19
2023-06-01,54934,14,0,14,5,0,5
2023-06-01,12208,152,20,172,3,1,3
2023-06-01,10821,37,1,38,3,3,3
2023-06-01,16832,5,1,6,9,3,9
2023-06-01,394846,1,0,1,2,0,2
2023-06-01,10972,1,0,1,4,0,4
2023-06-01,33362,15,1,16,8,4,9
2023-06-01,33234,16,1,17,4,3,4
2023-06-01,398847,2,0,2,2,0,2
2023-06-01,27325,10,1,11,5,3,5
2023-06-01,132418,3,0,3,3,0,3
2023-06-01,22423,57,1,58,4,2,4
2023-06-01,32220,2,1,3,2,2,2
2023-06-01,3763,1,1,2,1,1,1
2023-06-01,15191,8,1,9,14,4,14
2023-06-01,398777,4,0,4,1,0,1
2023-06-01,19635,86,1,87,2,1,2
2023-06-01,35937,10,1,11,8,3,8
2023-06-01,13776,29,1,30,11,3,12
2023-06-01,27239,5,0,5,3,0,3
2023-06-01,396896,1,0,1,3,0,3
2023-06-01,17223,22,1,23,15,5,15
2023-06-01,394384,7,2,9,4,4,4
2023-06-01,398346,1,0,1,1,0,1
2023-06-01,59103,13,7,20,20,17,21
2023-06-01,36599,3,0,3,1,0,1
2023-06-01,2907,602,2,604,99,38,99
2023-06-01,32896,1,0,1,1,0,1
2023-06-01,393775,11,2,13,8,2,8
2023-06-01,55098,2,0,2,1,0,1
2023-06-01,36724,3,0,3,3,0,3
2023-06-01,1646,1,0,1,1,0,1
2023-06-01,26994,9,2,11,3,1,3
2023-06-01,203872,72,0,72,2,0,2
2023-06-01,133772,59,1,60,2,1,2
2023-06-01,40383,3,1,4,1,1,1
2023-06-01,58430,1,0,1,13,7,13
2023-06-01,9507,5,4,9,39,12,39
2023-06-01,11172,923,5492,6415,99,14,99
2023-06-01,19332,16,15,31,32,11,35
2023-06-01,14178,295,1,296,21,6,22
2023-06-01,20028,3,0,3,3,0,3
2023-06-01,393723,1,0,1,1,0,1
2023-06-01,395286,1,0,1,2,0,2
2023-06-01,32989,1,0,1,3,0,3
2023-06-01,16949,10,0,10,5,0,5
2023-06-01,19821,2,0,2,1,0,1
2023-06-01,19016,31,2,33,12,6,13
2023-06-01,53488,36,1,37,3,1,3
2023-06-01,40918,32,1,33,2,1,2
2023-06-01,40077,1,0,1,1,0,1
2023-06-01,398408,1,0,1,2,0,2
2023-06-01,7818,2,0,2,3,0,3
2023-06-01,15013,4,0,4,4,0,4
2023-06-01,36860,2,0,2,2,0,2
2023-06-01,13980,3,0,3,1,0,1
2023-06-01,20102,2,0,2,1,0,1
2023-06-01,35851,2,0,2,1,0,1
2023-06-01,395397,1,0,1,2,0,2
2023-06-01,206747,9,9,18,5,5,5
2023-06-01,210536,4,4,8,2,1,2
2023-06-01,55420,2,11,13,2,2,2
2023-06-01,132354,3,1,4,3,2,4
2023-06-01,45544,43,1,44,3,2,3
2023-06-01,55900,21,1,22,10,6,10
2023-06-01,17514,67,1,68,6,2,6
2023-06-01,45415,73,1,74,6,1,6
2023-06-01,132573,12,0,12,2,0,2
2023-06-01,18101,582,4,586,46,15,46
2023-06-01,135884,1,0,1,2,0,2
2023-06-01,138915,227,41,268,55,38,62
2023-06-01,133774,262,23,285,3,1,3
2023-06-01,58854,10,0,10,2,0,2
2023-06-01,132954,5,0,5,2,0,2
2023-06-01,131607,64,0,64,3,0,3
2023-06-01,10133,0,0,0,17,0,17
2023-06-01,63614,8,0,8,1,0,1
2023-06-01,45942,31,1,32,7,2,7
2023-06-01,132971,2,0,2,1,0,1
2023-06-01,49635,65,0,65,4,0,4
2023-06-01,24435,58,15,73,7,2,7
2023-06-01,38496,79,30,109,38,15,39
2023-06-01,138838,2,0,2,3,0,3
2023-06-01,59288,7,0,7,5,0,5
2023-06-01,4800,640,14,654,164,19,166
2023-06-01,55685,77,8,85,129,38,134
2023-06-01,17670,56,9,65,11,3,11
2023-06-01,9905,86,18,104,45,2,45
2023-06-01,17439,520,32,552,37,15,39
2023-06-01,23650,101,5,106,5,18,19
2023-06-01,58678,160,15,175,31,6,32
2023-06-01,134871,7,0,7,1,0,1
2023-06-01,133752,35,5,40,7,5,7
2023-06-01,200514,18,0,18,3,0,3
2023-06-01,45543,76,7,83,19,5,19
2023-06-01,135273,23,1,24,10,4,10
2023-06-01,7602,192,0,192,9,0,9
2023-06-01,17488,1261,48,1309,6,3,6
2023-06-01,137266,1,3,4,1,1,2
2023-06-01,58563,100,29,129,3,2,3
2023-06-01,150145,2,2,4,1,1,1
2023-06-01,136192,6,2,8,1,1,1
2023-06-01,148981,21,0,21,2,0,2
2023-06-01,133372,2,1,3,5,3,5
2023-06-01,17501,216,30,246,20,4,21
2023-06-01,9597,26,1,27,2,2,2
2023-06-01,9993,9,1,10,5,4,5
2023-06-01,38333,180,0,180,7,0,7
2023-06-01,45648,42,26,68,4,1,4
2023-06-01,10175,51,0,51,2,0,2
2023-06-01,7623,82,0,82,1,0,1
2023-06-01,17816,134,61,195,5,2,5
2023-06-01,136959,90,23,113,1,1,1
2023-06-01,17623,810,1448,2258,14,1,14
2023-06-01,17622,362,2311,2673,7,2,8
2023-06-01,134543,140,629,769,1,1,1
2023-06-01,137125,101,1,102,3,1,3
2023-06-01,55303,270,524,794,10,7,10
2023-06-01,55448,6,0,6,4,0,4
2023-06-01,131111,355,11,366,6,1,6
2023-06-01,38186,265,0,265,8,0,8
2023-06-01,9280,5,1,6,11,6,11
2023-06-01,45671,209,26,235,26,11,26
2023-06-01,4780,770,9,779,67,18,67
2023-06-01,9674,65,37,102,3,1,3
2023-06-01,138345,76,59,135,2,1,2
2023-06-01,9874,4,0,4,3,0,3
2023-06-01,9336,17,1,18,19,5,19
2023-06-01,132848,8,0,8,2,0,2
2023-06-01,38790,0,0,0,6,2,6
2023-06-01,7628,4,12,16,7,3,7
2023-06-01,38719,91,12,103,13,9,13
2023-06-01,45687,6,1,7,5,2,5
2023-06-01,131219,1,0,1,15,8,17
2023-06-01,149684,1,0,1,7,3,8
2023-06-01,58396,6,3,9,14,7,14
2023-06-01,58401,2,1,3,3,1,3
2023-06-01,38264,225,8,233,24,4,24
2023-06-01,55453,17,3,20,4,1,4
2023-06-01,24541,10,2,12,10,2,10
2023-06-01,58717,35,9,44,315,108,318
2023-06-01,133854,19,4,23,5,1,5
2023-06-01,45117,352,145,497,71,16,71
2023-06-01,132061,114,258,372,1,1,1
2023-06-01,45609,1902,2490,4392,6,4,7
2023-06-01,24560,2403,120,2523,2,2,2
2023-06-01,45690,1,0,1,1,0,1
2023-06-01,38022,18,2,20,38,17,40
2023-06-01,55524,1,0,1,1,0,1
2023-06-01,17689,5,1,6,2,2,2
2023-06-01,38901,154,1,155,2,1,2
2023-06-01,134913,16,1,17,3,1,3
2023-06-01,17547,57,4,61,31,9,32
2023-06-01,135354,119,0,119,16,0,16
2023-06-01,18390,247,11,258,7,4,7
2023-06-01,17809,58,16,74,6,1,6
2023-06-01,9416,41,1,42,10,6,10
2023-06-01,17709,62,6,68,38,21,38
2023-06-01,9283,5,0,5,2,0,2
2023-06-01,45455,21,0,21,3,0,3
2023-06-01,56096,1,0,1,1,0,1
2023-06-01,18068,41,2,43,7,3,7
2023-06-01,136946,13,0,13,2,0,2
2023-06-01,59179,13,0,13,5,0,5
2023-06-01,55378,1,0,1,2,0,2
2023-06-01,45458,487,24,511,48,9,49
2023-06-01,23805,4,1,5,5,4,5
2023-06-01,18049,213,1,214,3,1,3
2023-06-01,9946,131,0,131,2,0,2
2023-06-01,18338,3,0,3,2,0,2
2023-06-01,4773,79,56,135,16,10,18
2023-06-01,18182,93,1,94,5,1,5
2023-06-01,45474,94,7,101,60,9,61
2023-06-01,56013,13,0,13,4,0,4
2023-06-01,38325,66,0,66,5,0,5
2023-06-01,6648,252,4,256,15,2,15
2023-06-01,23944,164,13,177,31,6,32
2023-06-01,45754,38,0,38,5,0,5
2023-06-01,4779,0,0,0,25,4,26
2023-06-01,18129,7,0,7,5,0,5
2023-06-01,45763,167,0,167,11,0,11
2023-06-01,45498,19,25,44,8,4,8
2023-06-01,136255,83,1,84,39,9,39
2023-06-01,7529,15,1,16,22,8,22
2023-06-01,18097,21,1,22,3,1,3
2023-06-01,10021,53,4,57,20,1,20
2023-06-01,9221,31,6,37,7,4,7
2023-06-01,23783,18,2,20,7,7,8
2023-06-01,9790,64,8,72,94,23,95
2023-06-01,23655,137,97,234,25,5,25
2023-06-01,18115,5,0,5,3,0,3
2023-06-01,14499,24,0,24,6,0,6
2023-06-01,137417,1,0,1,1,0,1
2023-06-01,21433,296,110,406,69,40,78
2023-06-01,24092,1,0,1,1,0,1
2023-06-01,24492,109,31,140,23,6,24
2023-06-01,63979,2,0,2,2,0,2
2023-06-01,55561,18,0,18,5,0,5
2023-06-01,141047,16,1,17,42,24,42
2023-06-01,24550,58,8,66,10,3,10
2023-06-01,45157,0,0,0,5,0,5
2023-06-01,4613,70,0,70,3,0,3
2023-06-01,18351,14,1,15,32,4,32
2023-06-01,24532,45,0,45,7,0,7
2023-06-01,17922,1,0,1,66,12,71
2023-06-01,45768,10,0,10,5,0,5
2023-06-01,24186,338,70,408,22,5,22
2023-06-01,135132,1,1,2,2,2,2
2023-06-01,17596,36,0,36,3,0,3
2023-06-01,9989,36,2,38,37,8,39
2023-06-01,46063,8,0,8,1,0,1
2023-06-01,55564,4,2,6,1,1,1
2023-06-01,140482,5,0,5,2,0,2
2023-06-01,138608,19,1,20,5,2,5
2023-06-01,136052,70,1,71,6,1,6
2023-06-01,45084,7,0,7,1,0,1
2023-06-01,63997,9,0,9,2,0,2
2023-06-01,18310,16,0,16,1,0,1
2023-06-01,9781,65,0,65,3,0,3
2023-06-01,9354,33,1,34,22,9,22
2023-06-01,9351,27,1,28,10,1,10
2023-06-01,9378,36,0,36,1,0,1
2023-06-01,131215,34,1,35,4,1,4
2023-06-01,7642,130,11,141,21,11,23
2023-06-01,9971,6,0,6,1,0,1
2023-06-01,17857,236,0,236,1,0,1
2023-06-01,45582,50,1,51,15,10,16
2023-06-01,17940,4,1,5,6,1,6
2023-06-01,55581,25,0,25,7,0,7
2023-06-01,55636,14,0,14,2,0,2
2023-06-01,17854,50,0,50,1,0,1
2023-06-01,17608,81,0,81,4,0,4
2023-06-01,10164,10,0,10,1,0,1
2023-06-01,9756,42,0,42,1,0,1
2023-06-01,55376,9,0,9,3,0,3
2023-06-01,55313,29,5,34,3,2,3
2023-06-01,45896,39,1,40,29,10,29
2023-06-01,11690,5,0,5,4,0,4
2023-06-01,199569,2,1,3,5,1,5
2023-06-01,17573,13,0,13,1,0,1
2023-06-01,17877,22,0,22,2,0,2
2023-06-01,23563,194,0,194,1,0,1
2023-06-01,17864,29,0,29,1,0,1
2023-06-01,23578,5,0,5,1,0,1
2023-06-01,24446,16,1,17,1,2,3
2023-06-01,55652,10,1,11,5,1,5
2023-06-01,133840,4,9,13,68,17,69
2023-06-01,55752,25,0,25,5,0,5
2023-06-01,23616,3,1,4,3,1,3
2023-06-01,56304,24,3,27,1,1,1
2023-06-01,140866,5,0,5,6,0,6
2023-06-01,56111,7,2,9,15,5,15
2023-06-01,136978,3,1,4,4,5,6
2023-06-01,139664,16,0,16,4,0,4
2023-06-01,18092,50,1,51,6,2,6
2023-06-01,55536,7,4,11,2,2,2
2023-06-01,55792,44,0,44,4,0,4
2023-06-01,63916,28,11,39,23,11,25
2023-06-01,9374,22,1,23,5,2,5
2023-06-01,58868,11,1,12,7,2,7
2023-06-01,4668,61,0,61,3,0,3
2023-06-01,55655,2,0,2,149,35,150
2023-06-01,45706,13,0,13,10,0,10
2023-06-01,38638,24,0,24,4,0,4
2023-06-01,135069,17,1,18,60,25,61
2023-06-01,133090,6,1,7,2,1,2
2023-06-01,17457,7,2,9,8,7,8
2023-06-01,45863,1,1,2,1,1,1
2023-06-01,10310,111,29,140,69,60,78
2023-06-01,24506,19,4,23,3,3,3
2023-06-01,7280,9,9,18,2,2,2
2023-06-01,38442,19,1,20,13,4,13
2023-06-01,132827,48,0,48,2,0,2
2023-06-01,132220,92,12,104,9,1,9
2023-06-01,55832,78,1,79,2,1,3
2023-06-01,58369,122,0,122,14,0,14
2023-06-01,132146,58,0,58,17,0,17
2023-06-01,132116,119,32,151,28,8,29
2023-06-01,137085,63,3,66,38,4,38
2023-06-01,44103,17,6,23,15,29,38
2023-06-01,133278,23,1,24,14,3,14
2023-06-01,134113,8,0,8,3,0,3
2023-06-01,58715,127,56,183,125,31,132
2023-06-01,38527,17,0,17,6,0,6
2023-06-01,64315,25,1,26,51,12,53
2023-06-01,138089,13,6,19,16,7,16
2023-06-01,138840,0,1,1,200,63,201
2023-06-01,45718,7,1,8,9,3,9
2023-06-01,141062,2,0,2,3,0,3
2023-06-01,135450,5,0,5,1,0,1
2023-06-01,138128,4,2,6,40,10,41
2023-06-01,139949,5,14,19,6,1,6
2023-06-01,55811,5,0,5,6,0,6
2023-06-01,38109,7,0,7,1,0,1
2023-06-01,45372,22,0,22,2,0,2
2023-06-01,55430,89,300,389,2,1,2
2023-06-01,45879,14,0,14,1,0,1
2023-06-01,10024,115,1,116,9,6,10
2023-06-01,55814,15,9,24,3,1,3
2023-06-01,55383,8,0,8,1,0,1
2023-06-01,7575,174,9,183,110,33,115
2023-06-01,24437,5,1,6,3,2,3
2023-06-01,55813,1,0,1,1,0,1
2023-06-01,38466,30,1,31,8,3,8
2023-06-01,38133,41,0,41,3,0,3
2023-06-01,38387,16,0,16,2,0,2
2023-06-01,38680,45,0,45,3,0,3
2023-06-01,18136,18,0,18,1,0,1
2023-06-01,55819,16,1,17,2,2,2
2023-06-01,55821,54,22,76,35,11,36
2023-06-01,139750,8,0,8,11,0,11
2023-06-01,59268,40,0,40,5,0,5
2023-06-01,7524,105,1,106,12,6,12
2023-06-01,9652,158,2,160,7,2,7
2023-06-01,55388,2,1,3,2,2,2
2023-06-01,140903,22,0,22,1,0,1
2023-06-01,58539,77,0,77,1,0,1
2023-06-01,141771,52,2,54,1,1,1
2023-06-01,38636,2,3,5,2,2,2
2023-06-01,150178,9,8,17,52,11,52
2023-06-01,55492,20,19,39,7,5,7
2023-06-01,141731,14,21,35,114,25,115
2023-06-01,132602,3,2,5,44,19,45
2023-06-01,23629,13,1,14,6,2,6
2023-06-01,23678,101,4,105,8,4,8
2023-06-01,45121,12,1,13,1,1,1
2023-06-01,38880,40,11,51,24,9,25
2023-06-01,24187,84,1,85,7,4,7
2023-06-01,136158,2,0,2,3,0,3
2023-06-01,45197,2,0,2,3,0,3
2023-06-01,7693,83,1,84,27,3,27
2023-06-01,45775,41,0,41,3,0,3
2023-06-01,59092,16,0,16,2,0,2
2023-06-01,9370,38,5,43,11,6,11
2023-06-01,7672,20,1,21,5,4,5
2023-06-01,24284,6,3,9,6,4,6
2023-06-01,17707,24,4,28,6,4,6
2023-06-01,58793,12,3,15,3,2,3
2023-06-01,17552,185,419,604,2,2,2
2023-06-01,18429,45,3,48,1,1,1
2023-06-01,58788,3,0,3,2,0,2
2023-06-01,23642,1,1,2,5,2,5
2023-06-01,9622,23,1,24,7,4,8
2023-06-01,17661,98,0,98,4,0,4
2023-06-01,23688,256,8,264,26,3,26
2023-06-01,58599,1,1,2,12,6,12
2023-06-01,17494,23,1,24,76,8,77
2023-06-01,133775,48,34,82,1,1,1
2023-06-01,133776,40,19,59,1,1,1
2023-06-01,58772,9,19,28,1,1,1
2023-06-01,9644,33,2,35,1,1,1
2023-06-01,134760,29,4,33,2,1,2
2023-06-01,55387,2,0,2,2,0,2
2023-06-01,138422,2,0,2,2,0,2
2023-06-01,133063,2,0,2,2,0,2
2023-06-01,9891,83,7,90,6,4,6
2023-06-01,4827,3,0,3,4,0,4
2023-06-01,55325,3,0,3,4,0,4
2023-06-01,24214,2,0,2,3,0,3
2023-06-01,63989,21,3,24,8,5,8
2023-06-01,63940,12,0,12,1,0,1
2023-06-01,59374,9,1,10,2,1,2
2023-06-01,45958,2,0,2,3,0,3
2023-06-01,138344,2,0,2,2,0,2
2023-06-01,133956,2,0,2,3,0,3
2023-06-01,24455,8,0,8,3,0,3
2023-06-01,38820,2,0,2,3,0,3
2023-06-01,132013,2,0,2,3,0,3
2023-06-01,38718,2,0,2,3,0,3
2023-06-01,134064,2,0,2,3,0,3
2023-06-01,38326,2,0,2,3,0,3
2023-06-01,45382,65,0,65,3,0,3
2023-06-01,38424,9,0,9,2,0,2
2023-06-01,17917,356,2,358,15,2,15
2023-06-01,21243,4,0,4,2,0,2
2023-06-01,21245,26,2,28,24,5,25
2023-06-01,5524,11,6,17,15,8,17
2023-06-01,47747,8,2,10,7,3,7
2023-06-01,25159,65,5,70,85,6,85
2023-06-01,47989,1,1,2,4,4,4
2023-06-01,28952,12,2,14,12,6,12
2023-06-01,60819,62,3,65,7,3,7
2023-06-01,48564,8,1,9,4,2,4
2023-06-01,49685,6,2,8,18,14,22
2023-06-01,35470,46,98,144,3,3,3
2023-06-01,197731,4,2,6,9,5,11
2023-06-01,766,34,3,37,28,13,28
2023-06-01,2114,1,0,1,3,0,3
2023-06-01,199662,4,0,4,2,0,2
2023-06-01,12857,0,2,2,10,2,11
2023-06-01,51720,5,1,6,3,1,3
2023-06-01,41321,4,1,5,2,1,2
2023-06-01,51430,42,18,60,15,9,17
2023-06-01,208685,5,2,7,1,1,1
2023-06-01,201789,6,1,7,14,10,14
2023-06-01,200043,15,0,15,12,0,12
2023-06-01,197743,1,0,1,1,0,1
2023-06-01,200468,1,0,1,1,0,1
2023-06-01,22363,355,0,355,14,0,14
2023-06-01,39869,8,1,9,11,5,11
2023-06-01,59491,13,5,18,1,1,1
2023-06-01,34555,17,1,18,5,3,5
2023-06-01,34758,15,1,16,7,6,8
2023-06-01,50606,26,1,27,60,13,60
2023-06-01,44643,1,0,1,1,0,1
2023-06-01,20847,15,7,22,22,9,24
2023-06-01,8676,8,3,11,9,5,9
2023-06-01,35063,6,1,7,4,3,4
2023-06-01,49221,2,0,2,1,0,1
2023-06-01,43440,5,8,13,7,5,7
2023-06-01,51852,15,2,17,2,1,2
2023-06-01,8339,30,3,33,17,5,18
2023-06-01,213121,2,0,2,1,0,1
2023-06-01,56632,12,0,12,1,0,1
2023-06-01,49360,4,0,4,1,0,1
2023-06-01,42109,31,0,31,3,0,3
2023-06-01,56635,2,1,3,4,1,4
2023-06-01,8744,2,0,2,3,0,3
2023-06-01,39289,7,0,7,3,0,3
2023-06-01,21430,66,4,70,14,9,14
2023-06-01,28812,12,1,13,6,1,6
2023-06-01,48503,114,127,241,4,5,5
2023-06-01,207728,11,1,12,1,1,1
2023-06-01,51028,4,2,6,22,7,26
2023-06-01,211933,1,0,1,1,0,1
2023-06-01,208349,9,1,10,7,4,7
2023-06-01,35140,8,0,8,4,0,4
2023-06-01,34709,7,0,7,3,0,3
2023-06-01,8749,14,1,15,11,4,12
2023-06-01,12387,3,1,4,28,14,31
2023-06-01,56653,1,0,1,2,0,2
2023-06-01,42004,6,1,7,9,5,9
2023-06-01,5396,22,0,22,8,0,8
2023-06-01,196845,3,1,4,1,1,1
2023-06-01,35271,2,1,3,7,2,7
2023-06-01,21453,16,2,18,18,10,19
2023-06-01,6772,6,1,7,11,7,13
2023-06-01,41114,15,7,22,13,11,15
2023-06-01,211559,19,0,19,2,0,2
2023-06-01,13205,20,0,20,2,0,2
2023-06-01,29287,11,1,12,6,1,6
2023-06-01,8968,39,1,40,37,7,38
2023-06-01,3313,13,1,14,5,1,5
2023-06-01,61352,1,1,2,3,3,3
2023-06-01,211945,3,0,3,6,0,6
2023-06-01,202708,2,0,2,3,0,3
2023-06-01,8422,40,13,53,41,29,49
2023-06-01,212472,2,2,4,1,1,1
2023-06-01,200456,3,0,3,2,0,2
2023-06-01,141193,0,2,2,7,5,7
2023-06-01,42695,91,15,106,13,8,15
2023-06-01,209258,1,0,1,1,0,1
2023-06-01,197784,3,0,3,1,0,1
2023-06-01,32934,131,203,334,39,33,48
2023-06-01,202150,2,0,2,2,0,2
2023-06-01,199624,6,2,8,20,2,20
2023-06-01,202832,1,0,1,1,0,1
2023-06-01,197765,24,1,25,3,2,3
2023-06-01,16345,105,24,129,5,1,5
2023-06-01,44356,27,2,29,26,8,28
2023-06-01,196819,8,1,9,3,2,3
2023-06-01,24811,5,0,5,9,0,9
2023-06-01,202284,1,0,1,1,0,1
2023-06-01,57634,23,0,23,5,0,5
2023-06-01,44851,33,2,35,1,1,2
2023-06-01,42794,17,0,17,5,0,5
2023-06-01,29030,14,0,14,6,0,6
2023-06-01,203201,9,1,10,19,7,19
2023-06-01,208808,21,1,22,2,1,2
2023-06-01,202685,3,3,6,1,2,2
2023-06-01,43548,23,1,24,3,1,3
2023-06-01,47748,21,3,24,6,2,7
2023-06-01,210211,3,3,6,5,1,6
2023-06-01,60784,4,0,4,1,0,1
2023-06-01,61437,6,1,7,5,3,6
2023-06-01,60349,1,1,2,7,2,8
2023-06-01,204469,1,0,1,2,0,2
2023-06-01,60230,2,1,3,3,4,5
2023-06-01,208224,1,0,1,2,0,2
2023-06-01,199483,11,4,15,15,6,17
2023-06-01,207430,2,0,2,1,0,1
2023-06-01,33925,4,0,4,2,0,2
2023-06-01,42731,4,0,4,2,0,2
2023-06-01,201401,9,3,12,7,8,11
2023-06-01,44043,49,0,49,1,0,1
2023-06-01,49774,6,1,7,7,1,7
2023-06-01,40994,10,2,12,7,6,8
2023-06-01,34358,44,0,44,7,0,7
2023-06-01,57098,1,0,1,1,0,1
2023-06-01,2614,96,3,99,31,4,32
2023-06-01,206451,10,1,11,1,1,1
2023-06-01,39829,2,0,2,3,0,3
2023-06-01,56550,18,0,18,10,0,10
2023-06-01,60981,5,2,7,2,2,2
2023-06-01,204156,1,0,1,1,0,1
2023-06-01,19624,12,8,20,3,2,3
2023-06-01,31362,31,0,31,6,0,6
2023-06-01,39543,57,1,58,18,4,18
2023-06-01,209711,21,0,21,1,0,1
2023-06-01,208179,1,0,1,1,0,1
2023-06-01,203053,30,0,30,2,0,2
2023-06-01,33977,21,0,21,1,0,1
2023-06-01,203346,138,0,138,11,0,11
2023-06-01,21409,19,1,20,13,7,14
2023-06-01,20857,26,4,30,13,6,14
2023-06-01,200960,7,0,7,4,0,4
2023-06-01,62226,1,0,1,1,0,1
2023-06-01,39105,2,0,2,4,0,4
2023-06-01,34081,19,4,23,4,4,4
2023-06-01,62282,31,3,34,9,6,9
2023-06-01,212531,17,1,18,1,1,1
2023-06-01,207375,42,2,44,9,8,11
2023-06-01,206617,23,1,24,4,2,4
2023-06-01,34428,1,1,2,23,5,23
2023-06-01,133499,161,0,161,2,0,2
2023-06-01,41537,4,0,4,4,0,4
2023-06-01,50369,9,0,9,7,0,7
2023-06-01,42568,18,0,18,3,0,3
2023-06-01,201198,4,1,5,6,5,6
2023-06-01,13287,49,4,53,25,8,27
2023-06-01,48336,8,0,8,1,0,1
2023-06-01,56478,88,2,90,6,5,6
2023-06-01,25234,5,3,8,8,7,10
2023-06-01,199803,2,1,3,17,6,17
2023-06-01,41628,2,0,2,3,0,3
2023-06-01,48823,7,1,8,4,3,4
2023-06-01,31333,5,1,6,1,1,1
2023-06-01,44513,7,0,7,4,0,4
2023-06-01,29497,58,2,60,1,1,1
2023-06-01,48862,4,0,4,1,0,1
2023-06-01,56704,5,1,6,15,10,16
2023-06-01,50290,5,0,5,3,0,3
2023-06-01,34119,11,2,13,10,6,11
2023-06-01,208189,2,1,3,8,6,8
2023-06-01,56837,3,4,7,3,3,3
2023-06-01,35071,7,0,7,9,0,9
2023-06-01,42313,65,17,82,23,8,23
2023-06-01,50616,21,0,21,1,0,1
2023-06-01,197803,2,0,2,1,0,1
2023-06-01,8607,26,4,30,18,3,18
2023-06-01,30893,6,9,15,7,6,10
2023-06-01,13214,3,0,3,2,0,2
2023-06-01,398826,12,2,14,7,3,8
2023-06-01,1241,68,12,80,47,9,49
2023-06-01,197746,10,1,11,1,1,1
2023-06-01,42863,9,1,10,3,1,3
2023-06-01,212229,1,0,1,2,0,2
2023-06-01,42232,21,0,21,3,0,3
2023-06-01,49814,3,1,4,9,3,9
2023-06-01,56517,1,0,1,1,0,1
2023-06-01,61307,12,1,13,3,2,3
2023-06-01,197617,4,0,4,8,0,8
2023-06-01,48803,17,3,20,3,2,3
2023-06-01,43668,10,3,13,38,21,54
2023-06-01,211199,9,0,9,1,0,1
2023-06-01,198401,19,1,20,6,3,6
2023-06-01,35112,13,1,14,2,1,2
2023-06-01,60672,27,3,30,6,3,6
2023-06-01,44806,8,3,11,3,1,3
2023-06-01,30950,2,1,3,7,9,9
2023-06-01,8542,9,2,11,5,6,6
2023-06-01,29486,3,1,4,1,1,1
2023-06-01,203489,9,2,11,8,6,11
2023-06-01,49855,7,3,10,4,3,4
2023-06-01,200831,2,1,3,1,1,1
2023-06-01,197729,2,1,3,3,2,3
2023-06-01,44789,8,1,9,3,1,3
2023-06-01,8990,15,2,17,14,5,14
2023-06-01,15497,17,1,18,21,2,21
2023-06-01,12837,6,1,7,4,1,4
2023-06-01,12727,10,2,12,8,6,8
2023-06-01,211398,0,8,8,3,12,13
2023-06-01,199839,1,7,8,2,3,3
2023-06-01,205876,5,1,6,2,1,2
2023-06-01,57271,19,1,20,1,1,1
2023-06-01,39153,4,1,5,22,1,22
2023-06-01,15672,86,1,87,13,4,13
2023-06-01,41484,20,1,21,6,4,7
2023-06-01,64199,3,0,3,1,0,1
2023-06-01,35637,5,0,5,1,0,1
2023-06-01,209307,7,0,7,25,0,25
2023-06-01,35815,3,0,3,6,0,6
2023-06-01,60294,17,4,21,17,12,20
2023-06-01,205542,1,0,1,2,0,2
2023-06-01,41175,12,1,13,2,3,3
2023-06-01,51089,7,3,10,3,1,3
2023-06-01,41881,113,2,115,16,1,16
2023-06-01,202391,41,0,41,6,0,6
2023-06-01,48309,98,0,98,3,0,3
2023-06-01,46700,4,0,4,5,0,5
2023-06-01,56521,1,0,1,1,0,1
2023-06-01,29884,19,3,22,30,6,30
2023-06-01,61174,5,1,6,5,4,6
2023-06-01,197882,28,1,29,7,1,7
2023-06-01,48299,5,1,6,2,2,2
2023-06-01,197637,25,4,29,3,5,5
2023-06-01,8902,5,1,6,6,4,7
2023-06-01,197654,2,0,2,1,0,1
2023-06-01,40824,41,1,42,8,7,8
2023-06-01,394094,10,1,11,1,1,1
2023-06-01,43567,10,0,10,5,0,5
2023-06-01,16349,2,1,3,2,2,2
2023-06-01,56828,4,1,5,4,3,4
2023-06-01,197068,14,1,15,67,3,67
2023-06-01,56528,8,0,8,1,0,1
2023-06-01,49683,31,3,34,6,1,6
2023-06-01,39741,12,0,12,3,0,3
2023-06-01,28678,3,1,4,2,1,2
2023-06-01,204039,1,0,1,2,0,2
2023-06-01,12616,20,1,21,1,1,1
2023-06-01,204041,2,0,2,2,0,2
2023-06-01,48524,30,1,31,5,2,5
2023-06-01,12997,34,0,34,3,0,3
2023-06-01,56479,1,0,1,1,0,1
2023-06-01,34863,15,3,18,9,6,11
2023-06-01,197618,5,0,5,1,0,1
2023-06-01,1547,41,1,42,27,14,29
2023-06-01,31252,32,3,35,27,10,28
2023-06-01,5394,21,1,22,16,10,18
2023-06-01,57329,2,2,4,2,3,4
2023-06-01,197019,5,1,6,7,6,9
2023-06-01,47292,25,5,30,10,7,10
2023-06-01,198934,5,0,5,2,0,2
2023-06-01,198479,15,0,15,5,0,5
2023-06-01,15364,5,0,5,3,0,3
2023-06-01,6876,31,1,32,17,8,18
2023-06-01,199095,13,0,13,9,0,9
2023-06-01,42160,25,2,27,5,1,5
2023-06-01,59702,21,1,22,2,1,2
2023-06-01,39561,1,0,1,8,4,8
2023-06-01,9188,6,2,8,4,2,4
2023-06-01,197686,9,1,10,5,1,5
2023-06-01,16246,15,4,19,18,12,18
2023-06-01,12570,11,3,14,25,17,25
2023-06-01,56566,1,1,2,1,1,1
2023-06-01,58303,4,0,4,2,0,2
2023-06-01,56703,2,0,2,1,0,1
2023-06-01,197131,6,0,6,6,0,6
2023-06-01,59668,7,1,8,1,1,1
2023-06-01,210222,0,0,0,2,0,2
2023-06-01,21001,4,0,4,1,0,1
2023-06-01,49776,5,0,5,2,0,2
2023-06-01,50174,16,0,16,1,0,1
2023-06-01,42132,88,0,88,12,0,12
2023-06-01,56779,6,0,6,2,0,2
2023-06-01,35352,7,0,7,4,0,4
2023-06-01,28832,4,1,5,2,1,2
2023-06-01,56761,3,0,3,1,0,1
2023-06-01,59823,2,0,2,3,0,3
2023-06-01,204791,2,0,2,2,0,2
2023-06-01,213191,8,0,8,1,0,1
2023-06-01,204144,24,0,24,2,0,2
2023-06-01,58000,2,0,2,1,0,1
2023-06-01,211867,1,0,1,1,0,1
2023-06-01,39529,9,0,9,3,0,3
2023-06-01,48882,10,1,11,8,1,8
2023-06-01,209747,1,0,1,1,0,1
2023-06-01,57679,2,0,2,1,0,1
2023-06-01,48330,83,0,83,1,0,1
2023-06-01,209720,2,0,2,2,0,2
2023-06-01,394896,9,3,12,6,2,6
2023-06-01,27988,24,2,26,21,11,22
2023-06-01,136258,26,16,42,12,8,13
2023-06-01,198433,19,4,23,3,1,3
2023-06-01,25145,74,62,136,13,4,13
2023-06-01,209919,1,0,1,1,0,1
2023-06-01,50612,4,0,4,1,0,1
2023-06-01,43226,5,1,6,13,1,14
2023-06-01,43830,7,0,7,1,0,1
2023-06-01,42104,4,0,4,6,0,6
2023-06-01,44540,5,0,5,3,0,3
2023-06-01,41034,54,0,54,15,0,15
2023-06-01,61382,3,0,3,3,0,3
2023-06-01,197658,1,0,1,1,0,1
2023-06-01,56546,4,0,4,1,0,1
2023-06-01,56575,2,0,2,4,0,4
2023-06-01,39728,6,0,6,4,0,4
2023-06-01,212982,2,0,2,2,0,2
2023-06-01,212744,3,2,5,1,1,1
2023-06-01,209279,3,0,3,1,0,1
2023-06-01,34872,3,8,11,44,61,81
2023-06-01,203772,1,1,2,1,1,1
2023-06-01,8470,4,8,12,45,10,48
2023-06-01,56577,3,3,6,2,2,2
2023-06-01,56652,1,0,1,1,0,1
2023-06-01,197311,16,0,16,2,0,2
2023-06-01,50648,9,0,9,3,0,3
2023-06-01,48919,2,1,3,11,5,12
2023-06-01,39056,4,0,4,3,0,3
2023-06-01,41084,3,0,3,1,0,1
2023-06-01,197667,7,0,7,9,0,9
2023-06-01,41820,33,1,34,28,9,31
2023-06-01,47397,4,1,5,3,2,3
2023-06-01,51034,4,1,5,14,3,14
2023-06-01,49465,3,0,3,2,0,2
2023-06-01,35365,2,0,2,2,0,2
2023-06-01,12963,53,1,54,86,11,88
2023-06-01,43576,6,1,7,10,2,11
2023-06-01,48485,5,0,5,4,0,4
2023-06-01,12985,2,0,2,4,0,4
2023-06-01,57896,4,1,5,3,3,5
2023-06-01,205671,4,1,5,4,4,4
2023-06-01,197718,1,0,1,2,0,2
2023-06-01,197811,7,0,7,2,0,2
2023-06-01,197724,1,0,1,3,0,3
2023-06-01,42574,31,1,32,5,3,7
2023-06-01,43708,5,1,6,7,5,7
2023-06-01,42655,16,1,17,2,1,2
2023-06-01,57944,6,1,7,4,2,4
2023-06-01,197499,1,0,1,2,0,2
2023-06-01,60018,1,0,1,3,0,3
2023-06-01,197734,3,0,3,1,0,1
2023-06-01,12418,194,2,196,28,4,28
2023-06-01,51977,1,0,1,2,0,2
2023-06-01,50299,8,0,8,8,0,8
2023-06-01,197394,18,1,19,9,1,9
2023-06-01,50164,1,0,1,3,0,3
2023-06-01,31359,4,0,4,3,0,3
2023-06-01,42862,2,0,2,2,0,2
2023-06-01,201394,2,0,2,3,0,3
2023-06-01,57678,2,0,2,1,0,1
2023-06-01,209520,2,1,3,2,2,2
2023-06-01,8905,21,0,21,4,0,4
2023-06-01,41162,1,0,1,3,0,3
2023-06-01,21418,1,0,1,4,0,4
2023-06-01,57996,1,0,1,4,0,4
2023-06-01,399641,31,0,31,3,0,3
2023-06-01,49528,3,0,3,5,0,5
2023-06-01,20714,7,0,7,2,0,2
2023-06-01,205318,5,0,5,5,0,5
2023-06-01,203008,4,1,5,3,1,4
2023-06-01,49883,1,0,1,5,0,5
2023-06-01,48641,1,1,2,27,8,29
2023-06-01,210541,6,0,6,3,0,3
2023-06-01,44996,2,0,2,2,0,2
2023-06-01,29688,2,0,2,1,0,1
2023-06-01,24589,39,1,40,28,4,28
2023-06-01,15899,17,0,17,1,0,1
2023-06-01,15596,5,0,5,1,0,1
2023-06-01,206943,12,0,12,2,0,2
2023-06-01,49461,16,0,16,10,0,10
2023-06-01,8779,4,1,5,5,2,5
2023-06-01,43641,19,9,28,14,2,14
2023-06-01,212604,1,0,1,4,0,4
2023-06-01,28773,2,1,3,18,3,19
2023-06-01,57049,5,0,5,7,0,7
2023-06-01,44866,2,0,2,1,0,1
2023-06-01,205228,1,0,1,2,0,2
2023-06-01,197520,9,0,9,6,0,6
2023-06-01,58057,58,72,130,33,181,195
2023-06-01,25229,183,0,183,18,0,18
2023-06-01,35680,17,0,17,14,0,14
2023-06-01,48648,6,2,8,27,5,28
2023-06-01,202302,11,0,11,1,0,1
2023-06-01,56476,33,0,33,2,0,2
2023-06-01,50060,4,0,4,6,0,6
2023-06-01,50004,3,1,4,2,1,2
2023-06-01,15577,3,0,3,7,0,7
2023-06-01,29107,23,2,25,17,2,18
2023-06-01,56433,4,0,4,1,0,1
2023-06-01,48438,7,1,8,5,1,5
2023-06-01,34056,3,1,4,19,7,20
2023-06-01,42512,24,1,25,8,4,10
2023-06-01,211757,2,2,4,1,1,1
2023-06-01,211395,1,0,1,1,0,1
2023-06-01,51822,2,0,2,1,0,1
2023-06-01,207656,2,1,3,4,9,11
2023-06-01,211736,1,0,1,1,0,1
2023-06-01,212041,9,1,10,2,1,2
2023-06-01,211741,1,0,1,1,0,1
2023-06-01,6886,3,1,4,17,3,17
2023-06-01,205048,3,0,3,1,0,1
2023-06-01,210848,2,0,2,1,0,1
2023-06-01,47370,1,0,1,4,0,4
2023-06-01,56487,1,0,1,1,0,1
2023-06-01,43764,2,0,2,6,0,6
2023-06-01,208951,38,1,39,8,2,8
2023-06-01,197506,5,1,6,4,2,4
2023-06-01,35047,29,3,32,16,1,16
2023-06-01,197954,3,0,3,3,0,3
2023-06-01,42925,21,11,32,5,5,6
2023-06-01,31263,39,5,44,13,5,15
2023-06-01,29456,8,0,8,6,0,6
2023-06-01,197633,4,0,4,1,0,1
2023-06-01,3259,31,0,31,5,0,5
2023-06-01,44527,7,1,8,8,1,8
2023-06-01,56535,7,0,7,2,0,2
2023-06-01,50187,15,0,15,6,0,6
2023-06-01,57277,0,0,0,13,3,14
2023-06-01,42971,2,0,2,3,0,3
2023-06-01,5547,19,0,19,2,0,2
2023-06-01,198086,1,0,1,1,0,1
2023-06-01,199110,2,0,2,3,0,3
2023-06-01,15994,11,1,12,62,6,62
2023-06-01,12810,22,1,23,1,1,1
2023-06-01,199433,1,0,1,2,0,2
2023-06-01,51120,1,0,1,1,0,1
2023-06-01,205285,14,0,14,1,0,1
2023-06-01,202632,24,1,25,1,1,1
2023-06-01,199486,5,1,6,2,1,2
2023-06-01,38176,35,5,40,10,2,10
2023-06-01,8427,13,0,13,2,0,2
2023-06-01,57849,1,0,1,1,0,1
2023-06-01,57491,1,0,1,1,0,1
2023-06-01,34385,3,1,4,5,4,5
2023-06-01,49435,5,2,7,3,2,3
2023-06-01,6871,69,3,72,1,1,1
2023-06-01,56515,55,1,56,4,2,5
2023-06-01,49055,21,0,21,4,0,4
2023-06-01,42041,1,0,1,3,0,3
2023-06-01,6702,3,2,5,23,3,23
2023-06-01,212821,1,0,1,2,0,2
2023-06-01,21219,4,0,4,39,0,39
2023-06-01,211455,1,0,1,1,0,1
2023-06-01,51032,7,0,7,6,0,6
2023-06-01,41344,20,0,20,4,0,4
2023-06-01,39442,29,0,29,8,0,8
2023-06-01,48738,11,0,11,1,0,1
2023-06-01,208139,7,0,7,6,0,6
2023-06-01,203016,1,0,1,1,0,1
2023-06-01,42719,2,0,2,3,0,3
2023-06-01,39199,9,0,9,10,0,10
2023-06-01,41789,65,0,65,6,0,6
2023-06-01,210512,43,1,44,1,1,1
2023-06-01,45027,48,20,68,2,2,2
2023-06-01,51069,3,0,3,3,0,3
2023-06-01,42029,1,0,1,3,0,3
2023-06-01,210942,1,0,1,3,0,3
2023-06-01,199169,1,0,1,3,0,3
2023-06-01,24637,9,1,10,43,10,44
2023-06-01,34453,1,0,1,2,0,2
2023-06-01,59822,1,0,1,2,0,2
2023-06-01,48347,86,1,87,35,15,36
2023-06-01,58207,2,0,2,4,0,4
2023-06-01,204117,1,0,1,1,0,1
2023-06-01,51669,26,0,26,4,0,4
2023-06-01,24872,3,0,3,4,0,4
2023-06-01,47286,1,0,1,4,0,4
2023-06-01,50130,18,0,18,7,0,7
2023-06-01,50012,10,0,10,1,0,1
2023-06-01,56716,3,0,3,2,0,2
2023-06-01,207422,3,0,3,2,0,2
2023-06-01,207416,3,0,3,1,0,1
2023-06-01,47844,13,0,13,1,0,1
2023-06-01,44020,7,0,7,15,0,15
2023-06-01,49583,8,0,8,5,0,5
2023-06-01,15673,13,0,13,3,0,3
2023-06-01,56709,3,0,3,9,0,9
2023-06-01,56626,1,0,1,1,0,1
2023-06-01,56676,6,0,6,1,0,1
2023-06-01,34602,17,6,23,15,6,18
2023-06-01,15935,13,3,16,28,16,29
2023-06-01,56747,1,0,1,2,0,2
2023-06-01,39650,19,0,19,4,0,4
2023-06-01,56749,2,0,2,1,0,1
2023-06-01,57123,1,0,1,2,0,2
2023-06-01,56740,26,4,30,8,3,9
2023-06-01,201284,5,0,5,4,0,4
2023-06-01,39507,23,0,23,6,0,6
2023-06-01,56554,1,2,3,1,1,1
2023-06-01,56443,2,0,2,8,0,8
2023-06-01,206273,6,1,7,4,2,4
2023-06-01,51158,2,0,2,2,0,2
2023-06-01,43588,4,0,4,4,0,4
2023-06-01,43289,11,4,15,12,6,13
2023-06-01,6282,32,0,32,2,0,2
2023-06-01,59577,7,0,7,10,0,10
2023-06-01,56851,37,0,37,6,0,6
2023-06-01,12700,6,0,6,3,0,3
2023-06-01,49074,12,0,12,5,0,5
2023-06-01,56940,6,0,6,1,0,1
2023-06-01,56887,7,0,7,1,0,1
2023-06-01,48464,5,1,6,14,2,14
2023-06-01,199936,1,0,1,2,0,2
2023-06-01,43936,5,0,5,1,0,1
2023-06-01,42498,49,0,49,8,0,8
2023-06-01,56889,13,0,13,1,0,1
2023-06-01,58269,4,0,4,18,0,18
2023-06-01,202280,4,0,4,2,0,2
2023-06-01,20910,29,4,33,10,3,10
2023-06-01,41871,11,0,11,3,0,3
2023-06-01,12773,7,0,7,13,0,13
2023-06-01,48595,3,0,3,3,0,3
2023-06-01,52213,3,0,3,3,0,3
2023-06-01,43319,5,0,5,3,0,3
2023-06-01,51474,20,0,20,1,0,1
2023-06-01,49785,5,0,5,8,0,8
2023-06-01,20670,3,0,3,5,0,5
2023-06-01,56909,11,0,11,2,0,2
2023-06-01,206904,5,1,6,4,3,4
2023-06-01,205641,1,0,1,2,0,2
2023-06-01,56917,1,0,1,1,0,1
2023-06-01,202717,2,2,4,4,1,4
2023-06-01,56933,1,0,1,1,0,1
2023-06-01,57294,2,1,3,1,1,1
2023-06-01,204326,3,3,6,5,3,6
2023-06-01,210144,2,1,3,4,2,4
2023-06-01,56945,1,0,1,4,0,4
2023-06-01,50245,13,1,14,21,9,24
2023-06-01,56956,1,0,1,1,0,1
2023-06-01,47438,10,1,11,5,3,6
2023-06-01,209767,20,0,20,2,0,2
2023-06-01,56953,3,1,4,4,3,5
2023-06-01,56624,2,0,2,1,0,1
2023-06-01,30838,22,0,22,4,0,4
2023-06-01,56646,1,0,1,1,0,1
2023-06-01,34744,12,2,14,2,1,2
2023-06-01,8854,0,0,0,4,0,4
2023-06-01,56766,3,0,3,1,0,1
2023-06-01,61965,1,0,1,2,0,2
2023-06-01,61695,0,0,0,1,0,1
2023-06-01,44660,2,0,2,1,0,1
2023-06-01,208435,1,0,1,1,0,1
2023-06-01,202279,4,0,4,3,0,3
2023-06-01,39089,1,0,1,2,0,2
2023-06-01,43361,4,0,4,1,0,1
2023-06-01,25052,7,0,7,1,0,1
2023-06-01,25549,47,3,50,38,5,38
2023-06-01,197768,1,0,1,3,0,3
2023-06-01,56623,7,0,7,4,0,4
2023-06-01,31277,7,0,7,11,0,11
2023-06-01,61152,5,0,5,4,0,4
2023-06-01,57181,14,0,14,3,0,3
2023-06-01,47211,2,1,3,4,4,5
2023-06-01,56592,21,0,21,6,0,6
2023-06-01,51428,2,0,2,2,0,2
2023-06-01,50467,7,1,8,4,3,4
2023-06-01,202103,3,0,3,4,0,4
2023-06-01,56656,2,0,2,6,0,6
2023-06-01,48323,11,0,11,7,0,7
2023-06-01,49561,5,0,5,2,0,2
2023-06-01,41985,9,1,10,4,1,5
2023-06-01,56668,1,0,1,1,0,1
2023-06-01,42668,4,0,4,6,0,6
2023-06-01,35539,13,0,13,7,0,7
2023-06-01,56802,1,0,1,1,0,1
2023-06-01,25082,5,0,5,9,0,9
2023-06-01,56823,17,1,18,3,1,3
2023-06-01,41030,7,0,7,1,0,1
2023-06-01,205655,9,1,10,2,1,2
2023-06-01,29182,140,13,153,13,8,15
2023-06-01,56983,1,0,1,4,0,4
2023-06-01,48327,7,1,8,6,1,6
2023-06-01,43865,10,0,10,4,0,4
2023-06-01,57456,10,0,10,6,0,6
2023-06-01,42239,4,1,5,4,3,5
2023-06-01,20539,18,1,19,7,1,7
2023-06-01,21312,7,0,7,11,0,11
2023-06-01,57718,6,0,6,3,0,3
2023-06-01,197923,1,0,1,2,0,2
2023-06-01,41932,4,0,4,3,0,3
2023-06-01,204722,2,0,2,2,0,2
2023-06-01,59595,13,0,13,4,0,4
2023-06-01,57789,2,0,2,2,0,2
2023-06-01,57016,4,0,4,2,0,2
2023-06-01,33922,92,1,93,21,6,21
2023-06-01,51388,4,0,4,1,0,1
2023-06-01,44056,14,0,14,9,0,9
2023-06-01,56330,32,1,33,1,1,1
2023-06-01,210109,6,0,6,5,0,5
2023-06-01,15480,6,0,6,1,0,1
2023-06-01,209154,3,0,3,2,0,2
2023-06-01,51585,1,0,1,1,0,1
2023-06-01,204209,5,0,5,2,0,2
2023-06-01,206409,2,0,2,3,0,3
2023-06-01,60083,1,0,1,1,0,1
2023-06-01,60096,3,0,3,2,0,2
2023-06-01,33830,5,0,5,4,0,4
2023-06-01,50875,7,0,7,1,0,1
2023-06-01,47185,1,0,1,1,0,1
2023-06-01,206806,1,0,1,3,0,3
2023-06-01,202557,3,0,3,1,0,1
2023-06-01,8386,720,2,722,2,1,2
2023-06-01,2108,7,1,8,4,4,6
2023-06-01,44546,11,0,11,2,0,2
2023-06-01,44975,3,0,3,3,0,3
2023-06-01,51685,11,0,11,5,0,5
2023-06-01,60075,1,0,1,2,0,2
2023-06-01,60028,1,0,1,1,0,1
2023-06-01,62069,2,0,2,3,0,3
2023-06-01,59738,1,1,2,2,2,2
2023-06-01,212571,1,0,1,2,0,2
2023-06-01,61372,7,0,7,6,0,6
2023-06-01,31514,12,1,13,6,1,6
2023-06-01,49342,2,0,2,4,0,4
2023-06-01,62423,3,1,4,8,1,8
2023-06-01,49811,6,0,6,2,0,2
2023-06-01,204889,3,0,3,3,0,3
2023-06-01,201469,3,0,3,1,0,1
2023-06-01,49393,3,0,3,1,0,1
2023-06-01,49038,1,0,1,5,0,5
2023-06-01,48709,1,0,1,2,0,2
2023-06-01,61312,5,0,5,1,0,1
2023-06-01,59475,6,0,6,3,0,3
2023-06-01,47673,1,0,1,3,0,3
2023-06-01,44343,1,0,1,2,0,2
2023-06-01,41575,7,0,7,4,0,4
2023-06-01,207228,2,0,2,3,0,3
2023-06-01,47909,12,1,13,4,1,4
2023-06-01,64490,2,0,2,3,0,3
2023-06-01,59392,7,0,7,2,0,2
2023-06-01,35196,0,1,1,6,4,6
2023-06-01,212913,11,1,12,1,1,1
2023-06-01,34718,17,1,18,22,1,22
2023-06-01,43533,13,0,13,2,0,2
2023-06-01,15428,6,0,6,4,0,4
2023-06-01,60165,9,0,9,4,0,4
2023-06-01,41712,1,0,1,2,0,2
2023-06-01,50084,3,1,4,7,2,7
2023-06-01,49491,3,0,3,1,0,1
2023-06-01,41124,66,0,66,6,0,6
2023-06-01,212463,2,0,2,3,0,3
2023-06-01,35004,8,0,8,9,0,9
2023-06-01,202353,1,0,1,3,0,3
2023-06-01,202290,1,0,1,1,0,1
2023-06-01,202198,1,0,1,3,0,3
2023-06-01,60245,8,0,8,7,0,7
2023-06-01,203553,2,0,2,1,0,1
2023-06-01,57903,2,0,2,1,0,1
2023-06-01,210519,4,0,4,1,0,1
2023-06-01,56965,1,0,1,1,0,1
2023-06-01,51841,1,0,1,1,0,1
2023-06-01,62331,3,0,3,4,0,4
2023-06-01,43301,3,0,3,2,0,2
2023-06-01,50025,23,0,23,1,0,1
2023-06-01,34503,2,0,2,1,0,1
2023-06-01,41119,1,0,1,4,0,4
2023-06-01,51962,1,0,1,3,0,3
2023-06-01,50459,2,0,2,3,0,3
2023-06-01,59679,1,1,2,1,1,1
2023-06-01,204408,1,0,1,3,0,3
2023-06-01,210188,2,0,2,3,0,3
2023-06-01,58347,11,0,11,4,0,4
2023-06-01,50334,6,1,7,1,1,1
2023-06-01,47702,18,1,19,11,3,11
2023-06-01,213187,1,1,2,1,1,1
2023-06-01,213145,11,0,11,3,0,3
2023-06-01,6810,47,19,66,4,4,4
2023-06-01,60194,23,0,23,1,0,1
2023-06-01,197492,10,0,10,5,0,5
2023-06-01,39405,43,4,47,18,11,20
2023-06-01,15447,10,1,11,11,7,12
2023-06-01,56582,21,1,22,1,1,1
2023-06-01,62095,6,0,6,3,0,3
2023-06-01,34476,10,0,10,4,0,4
2023-06-01,42926,278,4,282,8,3,9
2023-06-01,62059,3,1,4,3,2,3
2023-06-01,197845,3,0,3,3,0,3
2023-06-01,199283,23,1,24,3,3,3
2023-06-01,44212,7,4,11,4,5,5
2023-06-01,197696,6,4,10,5,5,7
2023-06-01,51109,0,0,0,2,0,2
2023-06-01,42099,4,0,4,1,0,1
2023-06-01,50986,6,0,6,3,0,3
2023-06-01,12679,59,1,60,3,1,3
2023-06-01,8887,1,1,2,1,1,1
2023-06-01,204122,2,0,2,2,0,2
2023-06-01,24634,52,0,52,7,0,7
2023-06-01,201942,99,0,99,7,0,7
2023-06-01,209365,6,1,7,3,1,3
2023-06-01,42526,4,0,4,2,0,2
2023-06-01,42714,7,0,7,4,0,4
2023-06-01,43022,14,0,14,13,0,13
2023-06-01,31724,8,0,8,2,0,2
2023-06-01,25880,19,0,19,2,0,2
2023-06-01,200446,14,0,14,1,0,1
2023-06-01,50274,4,0,4,2,0,2
2023-06-01,207251,11,0,11,2,0,2
2023-06-01,197742,2,1,3,2,2,2
2023-06-01,197706,31,17,48,2,1,2
2023-06-01,59583,22,0,22,13,0,13
2023-06-01,60411,36,0,36,1,0,1
2023-06-01,205516,20,2,22,15,2,15
2023-06-01,60072,3,0,3,5,0,5
2023-06-01,60764,8,2,10,23,6,23
2023-06-01,56583,1,1,2,6,3,6
2023-06-01,200137,1,1,2,1,1,1
2023-06-01,41627,6,0,6,2,0,2
2023-06-01,50837,48,10,58,19,11,20
2023-06-01,559,114,9,123,18,11,20
2023-06-01,44051,1,0,1,1,0,1
2023-06-01,12337,51,8,59,36,24,41
2023-06-01,60955,6,2,8,1,2,2
2023-06-01,44963,19,0,19,5,0,5
2023-06-01,48176,43,1,44,8,3,8
2023-06-01,41540,4,0,4,10,0,10
2023-06-01,24685,19,0,19,2,0,2
2023-06-01,8632,12,1,13,11,4,12
2023-06-01,5577,4,2,6,5,3,5
2023-06-01,198024,17,10,27,2,2,2
2023-06-01,41370,1,0,1,1,0,1
2023-06-01,199575,2,1,3,1,1,1
2023-06-01,41765,11,3,14,8,4,8
2023-06-01,15967,61,2,63,13,8,15
2023-06-01,31242,56,2,58,94,5,95
2023-06-01,43700,10,0,10,5,0,5
2023-06-01,57694,2,0,2,1,0,1
2023-06-01,34920,13,1,14,1,1,1
2023-06-01,31224,33,4,37,3,2,3
2023-06-01,6854,8,0,8,2,0,2
2023-06-01,29648,125,3,128,24,2,24
2023-06-01,31195,56,1,57,16,1,16
2023-06-01,35298,4,2,6,1,1,1
2023-06-01,31163,202,22,224,12,2,12
2023-06-01,31205,53,4,57,2,1,2
2023-06-01,50962,3,0,3,1,0,1
2023-06-01,197651,10,0,10,2,0,2
2023-06-01,47868,2,1,3,6,1,6
2023-06-01,25512,13,1,14,26,12,27
2023-06-01,16039,38,0,38,1,0,1
2023-06-01,56910,23,2,25,26,9,27
2023-06-01,25472,323,14,337,29,6,30
2023-06-01,48287,47,3,50,16,11,17
2023-06-01,5537,1,0,1,6,6,8
2023-06-01,43489,4,2,6,3,2,3
2023-06-01,47595,1,0,1,4,3,4
2023-06-01,39494,9,7,16,3,3,3
2023-06-01,44512,10,2,12,13,6,13
2023-06-01,43372,15,2,17,15,8,17
2023-06-01,201046,1,0,1,1,0,1
2023-06-01,202100,2,0,2,5,0,5
2023-06-01,16342,11,1,12,17,2,17
2023-06-01,57292,11,0,11,2,0,2
2023-06-01,21170,1,0,1,1,0,1
2023-06-01,43696,1,0,1,2,0,2
2023-06-01,198620,1,0,1,1,0,1
2023-06-01,47528,2,0,2,1,0,1
2023-06-01,48573,4,0,4,2,0,2
2023-06-01,48544,68,0,68,6,0,6
2023-06-01,43847,8,3,11,4,3,4
2023-06-01,197720,16,0,16,1,0,1
2023-06-01,44473,26,0,26,5,0,5
2023-06-01,12764,59,0,59,22,0,22
2023-06-01,198110,20,0,20,3,0,3
2023-06-01,57367,43,3,46,3,2,3
2023-06-01,34087,21,3,24,18,10,21
2023-06-01,31020,1,0,1,1,0,1
2023-06-01,198477,13,1,14,19,4,19
2023-06-01,198188,8,1,9,2,2,2
2023-06-01,29239,18,2,20,3,1,3
2023-06-01,35467,17,1,18,7,5,7
2023-06-01,29583,3,0,3,5,0,5
2023-06-01,393954,17,20,37,16,7,17
2023-06-01,26931,4,0,4,7,0,7
2023-06-01,55096,6,0,6,2,0,2
2023-06-01,22239,2,0,2,2,0,2
2023-06-01,14148,20,7,27,10,7,10
2023-06-01,210269,2,2,4,4,4,4
2023-06-01,63473,66,18,84,14,12,14
2023-06-01,21057,22,1,23,8,1,8
2023-06-01,25259,8,0,8,5,0,5
2023-06-01,61102,36,5,41,9,3,9
2023-06-01,29413,14,2,16,9,7,10
2023-06-01,201964,2,0,2,2,0,2
2023-06-01,24739,78,5,83,22,10,26
2023-06-01,200685,1,0,1,3,0,3
2023-06-01,35526,6,1,7,11,1,11
2023-06-01,48223,1,0,1,6,0,6
2023-06-01,201602,40,0,40,7,0,7
2023-06-01,24608,4,0,4,1,0,1
2023-06-01,34797,21,1,22,19,4,19
2023-06-01,49129,8,0,8,1,0,1
2023-06-01,197798,2,1,3,3,1,3
2023-06-01,21267,45,1,46,10,6,12
2023-06-01,48684,4,1,5,1,1,1
2023-06-01,35154,7,1,8,1,1,1
2023-06-01,209127,1,1,2,1,1,1
2023-06-01,42846,25,1,26,2,1,2
2023-06-01,56682,1,0,1,3,0,3
2023-06-01,8323,5,2,7,19,5,19
2023-06-01,44493,20,1,21,7,2,8
2023-06-01,42837,20,0,20,1,0,1
2023-06-01,15433,75,0,75,8,0,8
2023-06-01,56675,1,0,1,1,0,1
2023-06-01,28767,2,0,2,2,0,2
2023-06-01,47359,29,1,30,3,1,3
2023-06-01,44695,6,0,6,3,0,3
2023-06-01,15738,5,1,6,8,1,8
2023-06-01,13119,3,1,4,18,7,18
2023-06-01,8286,5,1,6,3,2,3
2023-06-01,31708,34,5,39,19,7,19
2023-06-01,58221,1,0,1,6,0,6
2023-06-01,212560,1,0,1,1,0,1
2023-06-01,208666,2,1,3,2,1,2
2023-06-01,39246,33,0,33,1,0,1
2023-06-01,43811,57,2,59,12,3,12
2023-06-01,197799,1,1,2,2,2,2
2023-06-01,207044,38,17,55,13,7,13
2023-06-01,29644,10,4,14,5,3,5
2023-06-01,8273,4,0,4,1,0,1
2023-06-01,56711,1,0,1,3,0,3
2023-06-01,12978,154,1,155,5,1,5
2023-06-01,13280,68,0,68,8,0,8
2023-06-01,28825,1,0,1,2,0,2
2023-06-01,200020,2,1,3,30,8,34
2023-06-01,196949,4,0,4,4,0,4
2023-06-01,60494,20,0,20,1,0,1
2023-06-01,61400,72,4,76,36,8,38
2023-06-01,204385,1,1,2,1,1,1
2023-06-01,50147,2,0,2,2,0,2
2023-06-01,31726,12,2,14,6,5,6
2023-06-01,51906,14,3,17,7,3,7
2023-06-01,39578,5,0,5,3,0,3
2023-06-01,8585,20,1,21,7,3,8
2023-06-01,41230,14,1,15,9,3,9
2023-06-01,60146,5,0,5,1,0,1
2023-06-01,209519,76,0,76,1,0,1
2023-06-01,210403,15,0,15,1,0,1
2023-06-01,29045,3,0,3,5,0,5
2023-06-01,20495,8,3,11,18,115,119
2023-06-01,203822,2,0,2,1,0,1
2023-06-01,19127,0,1,1,3,2,3
2023-06-01,395401,4,5,9,1,1,1
2023-06-01,53440,1,0,1,1,0,1
2023-06-01,45037,25,0,25,4,0,4
2023-06-01,20811,19,3,22,25,13,28
2023-06-01,57469,10,0,10,3,0,3
2023-06-01,44558,212,1,213,4,2,4
2023-06-01,33763,105,6,111,47,6,48
2023-06-01,327870,5,0,5,3,0,3
2023-06-01,43256,13,6,19,8,3,11
2023-06-01,12491,231,3,234,27,9,29
2023-06-01,6677,12,1,13,29,13,31
2023-06-01,51896,7,1,8,2,2,2
2023-06-01,56737,2,1,3,6,1,6
2023-06-01,197788,2,0,2,1,0,1
2023-06-01,211220,1,1,2,1,1,1
2023-06-01,210854,1,0,1,1,0,1
2023-06-01,42910,173,2,175,16,1,16
2023-06-01,49334,14,0,14,1,0,1
2023-06-01,207326,10,0,10,1,0,1
2023-06-01,39537,22,1,23,13,2,13
2023-06-01,47441,18,1,19,5,1,6
2023-06-01,43885,10,2,12,8,2,8
2023-06-01,394923,7,1,8,3,1,3
2023-06-01,199608,9,1,10,1,1,1
2023-06-01,16205,8,1,9,14,13,18
2023-06-01,197793,6,0,6,4,0,4
2023-06-01,25455,10,4,14,10,10,12
2023-06-01,39318,3,0,3,3,0,3
2023-06-01,42666,15,0,15,1,0,1
2023-06-01,31220,15,0,15,1,0,1
2023-06-01,44305,4,0,4,2,0,2
2023-06-01,25588,4,0,4,1,0,1
2023-06-01,31036,7,0,7,3,0,3
2023-06-01,56707,8,0,8,4,0,4
2023-06-01,47938,3,0,3,1,0,1
2023-06-01,41313,24,3,27,44,9,45
2023-06-01,29582,139,1,140,9,3,9
2023-06-01,197897,59,0,59,1,0,1
2023-06-01,56745,1,1,2,3,2,3
2023-06-01,197943,2,1,3,3,3,3
2023-06-01,203986,4,1,5,2,2,2
2023-06-01,44974,5,3,8,9,9,11
2023-06-01,33885,16,3,19,3,2,3
2023-06-01,41421,19,2,21,18,4,18
2023-06-01,197071,69,8,77,19,13,20
2023-06-01,13101,29,3,32,19,10,21
2023-06-01,208988,14,1,15,3,1,3
2023-06-01,211886,0,0,0,2,0,2
2023-06-01,58329,9,2,11,3,3,3
2023-06-01,57910,120,3,123,9,2,10
2023-06-01,59908,2,1,3,13,7,14
2023-06-01,57356,33,0,33,8,0,8
2023-06-01,48461,5,0,5,3,0,3
2023-06-01,31736,19,8,27,9,4,10
2023-06-01,6758,16,5,21,13,5,13
2023-06-01,15805,101,0,101,10,0,10
2023-06-01,212961,3,1,4,2,2,2
2023-06-01,61146,4,0,4,1,0,1
2023-06-01,203055,8,3,11,4,3,4
2023-06-01,197807,8,1,9,2,1,2
2023-06-01,28769,20,2,22,2,1,2
2023-06-01,48479,25,1,26,12,3,12
2023-06-01,196660,2,0,2,3,0,3
2023-06-01,42571,19,1,20,4,1,4
2023-06-01,50904,4,1,5,2,1,2
2023-06-01,56767,2,0,2,4,0,4
2023-06-01,58003,10,1,11,4,2,4
2023-06-01,31121,3,0,3,2,0,2
2023-06-01,197999,3,1,4,2,2,2
2023-06-01,29357,213,75,288,10,8,10
2023-06-01,43852,4,0,4,8,3,8
2023-06-01,21050,296,1,297,34,1,34
2023-06-01,198392,2,0,2,1,0,1
2023-06-01,20900,16,1,17,11,3,11
2023-06-01,49567,7,1,8,4,5,5
2023-06-01,5416,161,9,170,29,13,30
2023-06-01,210968,1,0,1,1,0,1
2023-06-01,7578,4,2,6,1,1,1
2023-06-01,51522,17,0,17,1,0,1
2023-06-01,33171,1,1,2,1,1,1
2023-06-01,204311,3,0,3,4,0,4
2023-06-01,31317,12,6,18,8,2,8
2023-06-01,15817,25,1,26,7,7,10
2023-06-01,31078,3,1,4,9,7,9
2023-06-01,205898,3,0,3,1,0,1
2023-06-01,198913,19,4,23,6,4,7
2023-06-01,50330,2,0,2,3,0,3
2023-06-01,59675,14,7,21,10,8,12
2023-06-01,213038,15,0,15,6,0,6
2023-06-01,29072,38,1,39,3,2,3
2023-06-01,197846,2,0,2,2,0,2
2023-06-01,57665,2,0,2,4,0,4
2023-06-01,208305,4,0,4,2,0,2
2023-06-01,44736,3,0,3,2,0,2
2023-06-01,33924,56,9,65,3,1,3
2023-06-01,198279,12,3,15,17,7,18
2023-06-01,209924,6,0,6,1,0,1
2023-06-01,21110,3,0,3,2,0,2
2023-06-01,47448,8,0,8,1,0,1
2023-06-01,12678,20,2,22,11,6,12
2023-06-01,204817,5,1,6,4,2,4
2023-06-01,197816,27,2,29,6,4,6
2023-06-01,44149,5,0,5,3,0,3
2023-06-01,210665,1,0,1,1,0,1
2023-06-01,48108,25,7,32,4,2,6
2023-06-01,208569,5,0,5,8,0,8
2023-06-01,210670,1,0,1,1,0,1
2023-06-01,3262,19,1,20,33,6,34
2023-06-01,210668,1,0,1,1,0,1
2023-06-01,212667,40,0,40,1,0,1
2023-06-01,34047,4,0,4,1,0,1
2023-06-01,28878,24,4,28,8,3,8
2023-06-01,60268,6,4,10,10,2,10
2023-06-01,56787,8,0,8,3,0,3
2023-06-01,51151,27,0,27,2,0,2
2023-06-01,21107,14,2,16,6,3,6
2023-06-01,41320,1,1,2,5,2,6
2023-06-01,29062,11,3,14,6,1,7
2023-06-01,47116,4,1,5,4,3,4
2023-06-01,47902,60,2,62,7,3,7
2023-06-01,395735,14,0,14,1,0,1
2023-06-01,134534,2,0,2,3,0,3
2023-06-01,134530,2,0,2,3,0,3
2023-06-01,134533,1,0,1,1,0,1
2023-06-01,134536,4,0,4,3,0,3
2023-06-01,134535,2,0,2,2,0,2
2023-06-01,23190,6,0,6,2,0,2
2023-06-01,18440,5,0,5,3,0,3
2023-06-01,19604,12,1,13,3,1,3
2023-06-01,14904,7,0,7,3,3,4
2023-06-01,706,24,1,25,3,1,3
2023-06-01,20057,1478,184,1662,2,2,2
2023-06-01,46690,18,2,20,2,1,2
2023-06-01,65535,25,0,25,3,0,3
2023-06-01,19527,68,1,69,14,4,15
2023-06-01,43515,5,2,7,7,8,9
2023-06-01,139070,2,1,3,3,2,3
2023-06-01,139190,1,1,2,1,1,1
2023-06-01,22394,311,153,464,3,3,3
2023-06-01,6167,1605,999,2604,7,4,7
2023-06-01,36375,20,1,21,2,2,2
2023-06-01,62676,2,0,2,1,0,1
2023-06-01,231,7,2,9,4,3,4
2023-06-01,400066,1,1,2,1,1,1
2023-06-01,27274,3,1,4,1,1,1
2023-06-01,62618,3,0,3,1,0,1
2023-06-01,395638,1,0,1,1,0,1
2023-06-01,399636,2,0,2,2,0,2
2023-06-01,32456,1,0,1,1,0,1
2023-06-01,30415,5,0,5,3,0,3
2023-06-01,400676,2,0,2,3,0,3
2023-06-01,397752,1,0,1,1,0,1
2023-06-01,27459,2,0,2,1,0,1
2023-06-01,8149,7,0,7,4,0,4
2023-06-01,36513,3,0,3,2,0,2
2023-06-01,45274,0,0,0,3,3,3
2023-06-01,45170,3,1,4,3,2,4
2023-06-01,140485,5,7,12,1,14,14
2023-06-01,136190,176,8,184,1,1,1
2023-06-01,140726,124,229,353,4,4,5
2023-06-01,17962,27,0,27,3,0,3
2023-06-01,131718,1,0,1,2,0,2
2023-06-01,38513,22,0,22,1,0,1
2023-06-01,38623,526,0,526,22,0,22
2023-06-01,45365,40,0,40,1,0,1
2023-06-01,17586,45,0,45,1,0,1
2023-06-01,9698,111,0,111,1,0,1
2023-06-01,4835,109,12,121,2,1,2
2023-06-01,37936,7,5,12,1,2,2
2023-06-01,55355,29,0,29,10,0,10
2023-06-01,137019,5,0,5,1,0,1
2023-06-01,64503,2,4,6,1,1,1
2023-06-01,64501,4,18,22,2,2,3
2023-06-01,137694,106,26,132,1,1,1
2023-06-01,140061,721,33,754,2,1,2
2023-06-01,134761,41,14,55,2,2,2
2023-06-01,137695,54,9,63,2,3,3
2023-06-01,17638,559,16,575,3,1,3
2023-06-01,140553,79,7,86,1,1,1
2023-06-01,4812,414,87,501,45,17,47
2023-06-01,139220,68,5,73,1,1,1
2023-06-01,58519,164,17,181,4,3,5
2023-06-01,63835,89,23,112,1,2,2
2023-06-01,137689,69,68,137,1,1,1
2023-06-01,140638,59,18,77,1,1,1
2023-06-01,56044,345,978,1323,1,2,2
2023-06-01,58807,21,2,23,18,8,19
2023-06-01,132525,281,87,368,1,1,1
2023-06-01,56047,1515,718,2233,2,1,2
2023-06-01,24445,488,317,805,3,1,3
2023-06-01,56041,1461,450,1911,4,2,4
2023-06-01,38019,133,40,173,1,1,1
2023-06-01,134810,222,58,280,2,1,2
2023-06-01,56042,176,64,240,2,1,2
2023-06-01,24547,712,1827,2539,2,1,2
2023-06-01,56046,1428,1132,2560,3,1,3
2023-06-01,56040,409,116,525,16,3,18
2023-06-01,139080,56,5,61,1,1,1
2023-06-01,24444,794,431,1225,2,1,2
2023-06-01,9394,857,0,857,6,0,6
2023-06-01,24138,227,0,227,2,0,2
2023-06-01,45057,47,0,47,1,0,1
2023-06-01,38565,61,7,68,4,4,4
2023-06-01,46071,18,0,18,12,0,12
2023-06-01,9911,100,6,106,4,2,4
2023-06-01,135086,6,0,6,3,0,3
2023-06-01,24440,21,0,21,1,0,1
2023-06-01,134067,21,0,21,10,0,10
2023-06-01,135092,9,0,9,3,0,3
2023-06-01,135253,14,1,15,4,1,4
2023-06-01,132563,12,1,13,6,1,6
2023-06-01,137654,9,0,9,2,0,2
2023-06-01,132267,7,1,8,11,3,11
2023-06-01,58923,32,1,33,16,1,16
2023-06-01,396073,59,3,62,4,3,4
2023-06-01,136732,8,1,9,2,1,2
2023-06-01,132559,15,3,18,14,3,14
2023-06-01,134823,72,8,80,31,5,31
2023-06-01,58895,212,2,214,5,1,5
2023-06-01,136238,6,1,7,1,1,1
2023-06-01,134431,5,2,7,1,1,1
2023-06-01,24554,198,11,209,11,3,12
2023-06-01,24139,71,1,72,2,1,2
2023-06-01,131259,20,0,20,2,0,2
2023-06-01,63570,2,1,3,2,1,2
2023-06-01,133275,111,4,115,16,4,16
2023-06-01,138730,20,1,21,3,1,3
2023-06-01,58913,4,0,4,2,0,2
2023-06-01,56050,12,0,12,1,0,1
2023-06-01,38235,96,7,103,41,10,43
2023-06-01,38566,25,2,27,11,5,11
2023-06-01,213059,3,1,4,3,2,3
2023-06-01,136915,2,1,3,1,1,1
2023-06-01,135718,27,6,33,24,6,24
2023-06-01,63571,1,0,1,1,0,1
2023-06-01,55352,193,47,240,38,14,42
2023-06-01,138790,8,0,8,4,0,4
2023-06-01,135269,7,16,23,10,2,10
2023-06-01,39486,22,0,22,1,0,1
2023-06-01,38047,14,16,30,17,9,17
2023-06-01,134927,3,0,3,3,0,3
2023-06-01,33438,246,117,363,57,42,62
2023-06-01,54203,71,28,99,2,2,2
2023-06-01,133269,8,0,8,3,0,3
2023-06-01,14163,5,0,5,9,0,9
2023-06-01,24295,36,1,37,8,4,8
2023-06-01,132547,6,0,6,1,0,1
2023-06-01,134053,20,2,22,5,1,5
2023-06-01,134293,10,0,10,4,0,4
2023-06-01,136634,13,8,21,17,6,17
2023-06-01,134672,10,13,23,9,2,10
2023-06-01,142033,3,3,6,3,2,3
2023-06-01,134899,21,1,22,1,1,1
2023-06-01,135133,9,3,12,5,2,5
2023-06-01,198301,4,0,4,4,0,4
2023-06-01,200451,2,0,2,5,0,5
2023-06-01,50794,2,1,3,2,1,2
2023-06-01,35393,29,4,33,6,4,6
2023-06-01,28685,35,1,36,9,2,9
2023-06-01,198312,5,0,5,1,0,1
2023-06-01,57074,7,0,7,2,0,2
2023-06-01,10780,20,1,21,22,3,22
2023-06-01,207360,2,0,2,3,0,3
2023-06-01,30889,16,2,18,12,7,15
2023-06-01,34456,36,0,36,6,0,6
2023-06-01,50763,5,4,9,12,8,14
2023-06-01,41887,29,8,37,15,11,17
2023-06-01,49250,12,4,16,4,4,4
2023-06-01,198089,35,2,37,12,6,14
2023-06-01,57618,1,0,1,1,0,1
2023-06-01,50941,30,0,30,5,0,5
2023-06-01,12322,19,12,31,12,11,15
2023-06-01,51207,4,1,5,1,1,1
2023-06-01,48072,52,1,53,10,2,10
2023-06-01,210595,2,0,2,1,0,1
2023-06-01,41112,2,0,2,2,0,2
2023-06-01,211762,3,0,3,3,0,3
2023-06-01,25408,34,1,35,22,6,24
2023-06-01,198295,2,0,2,1,0,1
2023-06-01,199571,2,1,3,3,2,3
2023-06-01,31477,54,6,60,20,14,23
2023-06-01,51013,13,3,16,10,6,10
2023-06-01,43352,38,5,43,4,2,4
2023-06-01,207693,3,2,5,2,2,2
2023-06-01,57626,6,3,9,4,2,4
2023-06-01,205185,5,2,7,13,2,13
2023-06-01,57816,2,0,2,1,0,1
2023-06-01,13231,6,0,6,1,0,1
2023-06-01,43833,4,1,5,20,3,21
2023-06-01,212228,6,1,7,3,2,3
2023-06-01,40509,120,54,174,3,2,3
2023-06-01,30081,38,42,80,41,27,46
2023-06-01,210863,1,1,2,1,1,1
2023-06-01,9110,12,1,13,8,1,8
2023-06-01,198728,1,0,1,1,0,1
2023-06-01,58229,1,0,1,1,0,1
2023-06-01,198700,1,0,1,3,0,3
2023-06-01,49770,9,2,11,6,3,6
2023-06-01,201119,8,3,11,14,8,18
2023-06-01,48200,3,1,4,18,13,20
2023-06-01,200548,28,4,32,2,1,2
2023-06-01,51691,2,1,3,1,4,4
2023-06-01,60109,3,2,5,1,2,2
2023-06-01,57664,2,1,3,1,1,1
2023-06-01,42772,271,14,285,12,2,12
2023-06-01,200865,9,0,9,2,0,2
2023-06-01,20845,114,1,115,6,2,6
2023-06-01,57657,4,0,4,2,0,2
2023-06-01,30836,13,2,15,7,3,7
2023-06-01,212910,10,0,10,1,0,1
2023-06-01,61998,14,2,16,1,1,1
2023-06-01,6279,5,4,9,1,1,1
2023-06-01,48832,456,3,459,23,2,23
2023-06-01,42912,145,0,145,1,0,1
2023-06-01,48324,5,1,6,3,3,3
2023-06-01,58272,94,1,95,4,3,5
2023-06-01,60598,1,0,1,1,0,1
2023-06-01,51444,15,0,15,4,0,4
2023-06-01,208677,48,1,49,4,2,4
2023-06-01,47586,13,1,14,12,3,12
2023-06-01,48275,4,0,4,1,0,1
2023-06-01,204720,40,12,52,13,11,15
2023-06-01,205675,3,0,3,11,0,11
2023-06-01,49320,10,0,10,11,0,11
2023-06-01,205657,1,0,1,1,0,1
2023-06-01,62283,4,0,4,5,0,5
2023-06-01,210706,1,0,1,2,0,2
2023-06-01,31430,31,1,32,24,6,24
2023-06-01,60042,8,0,8,8,0,8
2023-06-01,205611,1,0,1,3,0,3
2023-06-01,44895,24,1,25,5,2,5
2023-06-01,205616,2,0,2,3,0,3
2023-06-01,61276,9,0,9,4,0,4
2023-06-01,60535,1,0,1,1,0,1
2023-06-01,198541,6,0,6,5,0,5
2023-06-01,199991,1,0,1,1,0,1
2023-06-01,201468,1,0,1,1,0,1
2023-06-01,41750,23,0,23,11,0,11
2023-06-01,207250,1,0,1,2,0,2
2023-06-01,205528,1,0,1,2,0,2
2023-06-01,206965,1,0,1,1,0,1
2023-06-01,48188,2,0,2,3,0,3
2023-06-01,206385,5,0,5,2,0,2
2023-06-01,204273,14,1,15,3,2,3
2023-06-01,8818,25,2,27,1,1,1
2023-06-01,31169,19,5,24,7,6,7
2023-06-01,210150,7,1,8,3,3,3
2023-06-01,48585,5,2,7,4,4,4
2023-06-01,203622,24,1,25,5,1,5
2023-06-01,50257,13,0,13,11,0,11
2023-06-01,204496,1,0,1,3,0,3
2023-06-01,58094,2,0,2,1,0,1
2023-06-01,202700,2,0,2,3,0,3
2023-06-01,201411,37,3,40,2,1,2
2023-06-01,198770,18,6,24,5,2,5
2023-06-01,25513,44,2,46,19,1,19
2023-06-01,58071,1,0,1,1,0,1
2023-06-01,24774,4,0,4,4,0,4
2023-06-01,203517,1,1,2,2,2,2
2023-06-01,204231,1,0,1,1,0,1
2023-06-01,209773,1,0,1,2,0,2
2023-06-01,61991,1,0,1,4,0,4
2023-06-01,34849,2,0,2,1,0,1
2023-06-01,20632,39,2,41,63,3,64
2023-06-01,62056,1,0,1,1,0,1
2023-06-01,210160,1,0,1,1,0,1
2023-06-01,3284,2,0,2,3,0,3
2023-06-01,60826,5,0,5,3,0,3
2023-06-01,200976,4,0,4,5,0,5
2023-06-01,49354,3,0,3,3,0,3
2023-06-01,203712,8,1,9,7,3,8
2023-06-01,210472,5,0,5,3,0,3
2023-06-01,198370,5,0,5,4,0,4
2023-06-01,201047,3,0,3,4,0,4
2023-06-01,198347,8,0,8,3,0,3
2023-06-01,198355,7,0,7,3,0,3
2023-06-01,198354,10,1,11,2,1,2
2023-06-01,60846,2,0,2,2,0,2
2023-06-01,12684,144,1,145,19,7,20
2023-06-01,34267,11,0,11,2,0,2
2023-06-01,42322,5,1,6,1,1,1
2023-06-01,206065,73,1,74,3,1,3
2023-06-01,44143,11,3,14,7,3,7
2023-06-01,8309,4,1,5,26,14,30
2023-06-01,211612,2,2,4,2,2,3
2023-06-01,16116,63,56,119,2,1,2
2023-06-01,57642,3,0,3,3,0,3
2023-06-01,42525,30,5,35,1,1,1
2023-06-01,57633,6,1,7,2,1,2
2023-06-01,6821,97,1,98,16,1,16
2023-06-01,13122,24,1,25,11,5,11
2023-06-01,12663,177,0,177,2,0,2
2023-06-01,201917,26,0,26,2,0,2
2023-06-01,47443,1,1,2,3,1,3
2023-06-01,207916,5,0,5,3,0,3
2023-06-01,21246,11,1,12,10,2,11
2023-06-01,25467,70,17,87,27,9,28
2023-06-01,206666,8,0,8,3,0,3
2023-06-01,208730,3,0,3,2,0,2
2023-06-01,49056,16,0,16,5,0,5
2023-06-01,31742,9,2,11,10,7,11
2023-06-01,52148,10,1,11,1,1,1
2023-06-01,198484,16,3,19,1,1,1
2023-06-01,48093,2,1,3,2,1,2
2023-06-01,47623,5,0,5,1,0,1
2023-06-01,48504,13,4,17,6,3,6
2023-06-01,34337,39,0,39,5,0,5
2023-06-01,29414,6,0,6,18,0,18
2023-06-01,28748,9,1,10,7,4,8
2023-06-01,57660,5,1,6,4,1,4
2023-06-01,52126,7,3,10,3,3,3
2023-06-01,49173,4,0,4,2,0,2
2023-06-01,198368,1,0,1,1,0,1
2023-06-01,31213,37,3,40,2,1,2
2023-06-01,31208,67,3,70,11,1,11
2023-06-01,44285,37,1,38,4,1,4
2023-06-01,210818,3,1,4,1,1,1
2023-06-01,3177,12,2,14,7,2,8
2023-06-01,35132,16,3,19,5,4,5
2023-06-01,50796,5,0,5,1,0,1
2023-06-01,50371,1,0,1,3,0,3
2023-06-01,57675,10,1,11,3,1,3
2023-06-01,13099,3,0,3,2,0,2
2023-06-01,211995,8,1,9,4,1,4
2023-06-01,200154,7,4,11,5,1,5
2023-06-01,208410,1,0,1,1,0,1
2023-06-01,202636,23,0,23,6,0,6
2023-06-01,57477,1,0,1,1,0,1
2023-06-01,207630,2,8,10,2,1,2
2023-06-01,50558,4,0,4,1,0,1
2023-06-01,199633,1,0,1,1,0,1
2023-06-01,5408,41,3,44,33,21,33
2023-06-01,50428,2,0,2,1,0,1
2023-06-01,49940,13,1,14,3,1,3
2023-06-01,198399,21,1,22,7,3,7
2023-06-01,43925,35,1,36,9,1,9
2023-06-01,200640,2,0,2,3,0,3
2023-06-01,29104,15,1,16,4,2,4
2023-06-01,39194,4,1,5,2,1,2
2023-06-01,201909,4,0,4,1,0,1
2023-06-01,211143,10,0,10,2,0,2
2023-06-01,33983,46,1,47,12,1,12
2023-06-01,16376,15,2,17,7,1,7
2023-06-01,49974,8,2,10,4,5,6
2023-06-01,57146,6,1,7,5,4,5
2023-06-01,198403,4,1,5,1,1,1
2023-06-01,16234,4,1,5,1,1,1
2023-06-01,204895,1,0,1,1,0,1
2023-06-01,25466,1,0,1,5,2,5
2023-06-01,13189,37,3,40,10,7,11
2023-06-01,42306,7,3,10,9,7,9
2023-06-01,211283,2,0,2,1,0,1
2023-06-01,211439,45,0,45,2,0,2
2023-06-01,48996,1,0,1,2,0,2
2023-06-01,34783,3,0,3,3,0,3
2023-06-01,209912,5,0,5,4,0,4
2023-06-01,34534,9,1,10,1,1,1
2023-06-01,207290,6,0,6,1,0,1
2023-06-01,43193,4,1,5,1,1,1
2023-06-01,209749,1,0,1,2,0,2
2023-06-01,48956,8,0,8,6,0,6
2023-06-01,14062,4,0,4,4,0,4
2023-06-01,43370,15,0,15,2,0,2
2023-06-01,200864,12,0,12,2,0,2
2023-06-01,15699,24,4,28,11,2,12
2023-06-01,29134,9,4,13,8,3,8
2023-06-01,57929,1,0,1,2,0,2
2023-06-01,56568,15,1,16,2,2,2
2023-06-01,198561,4,0,4,3,0,3
2023-06-01,12459,1,0,1,7,5,7
2023-06-01,13004,4,1,5,23,22,34
2023-06-01,25151,17,3,20,11,8,13
2023-06-01,48806,35,2,37,5,3,5
2023-06-01,57677,1,0,1,1,0,1
2023-06-01,34222,2,1,3,3,2,3
2023-06-01,197451,8,4,12,9,9,10
2023-06-01,13188,1607,74,1681,14,6,15
2023-06-01,13036,30,2,32,1,1,1
2023-06-01,198440,17,5,22,8,8,10
2023-06-01,206347,21,0,21,8,0,8
2023-06-01,61124,4,1,5,10,6,10
2023-06-01,35549,16,0,16,4,0,4
2023-06-01,48954,20,0,20,2,0,2
2023-06-01,31512,4,0,4,1,0,1
2023-06-01,21127,51,3,54,19,3,20
2023-06-01,213371,15,3,18,4,2,4
2023-06-01,212370,1,0,1,1,0,1
2023-06-01,208673,4,1,5,3,1,3
2023-06-01,211238,3,0,3,1,0,1
2023-06-01,57734,2,1,3,6,4,7
2023-06-01,6849,1989,0,1989,51,0,51
2023-06-01,6877,35,1,36,1,1,2
2023-06-01,49333,5,0,5,1,0,1
2023-06-01,198570,16,1,17,8,7,9
2023-06-01,60572,2,0,2,7,0,7
2023-06-01,24990,0,0,0,12,0,12
2023-06-01,198594,5,0,5,2,0,2
2023-06-01,208848,1,0,1,1,0,1
2023-06-01,207539,1,0,1,1,0,1
2023-06-01,49158,6,0,6,8,0,8
2023-06-01,42956,16,0,16,1,0,1
2023-06-01,34577,24,0,24,5,0,5
2023-06-01,60590,1,0,1,3,0,3
2023-06-01,29608,18,5,23,15,8,16
2023-06-01,201080,8,1,9,4,3,4
2023-06-01,47297,6,1,7,5,2,5
2023-06-01,12605,9,1,10,10,5,10
2023-06-01,16047,2,0,2,1,0,1
2023-06-01,29513,8,2,10,4,3,4
2023-06-01,1126,5,1,6,9,4,10
2023-06-01,197932,2,0,2,3,0,3
2023-06-01,209360,2,0,2,1,0,1
2023-06-01,202491,14,0,14,2,0,2
2023-06-01,57710,22,3,25,3,3,3
2023-06-01,51813,7,0,7,3,0,3
2023-06-01,203541,1,0,1,3,0,3
2023-06-01,57913,1,1,2,4,2,4
2023-06-01,22612,225,3,228,11,3,11
2023-06-01,58040,7,0,7,2,0,2
2023-06-01,210123,3,0,3,4,0,4
2023-06-01,12716,54,0,54,1,0,1
2023-06-01,29580,505,0,505,1,0,1
2023-06-01,200723,1,1,2,2,1,2
2023-06-01,199482,9,0,9,2,0,2
2023-06-01,198434,18,0,18,3,0,3
2023-06-01,24945,13,1,14,5,3,5
2023-06-01,198436,16,0,16,1,0,1
2023-06-01,50071,4,0,4,1,0,1
2023-06-01,61029,5,5,10,5,7,7
2023-06-01,39591,31,7,38,14,7,15
2023-06-01,38987,3,1,4,9,4,9
2023-06-01,56485,20,2,22,5,3,5
2023-06-01,24700,4,0,4,8,2,8
2023-06-01,200628,5,0,5,1,0,1
2023-06-01,210733,1,0,1,1,0,1
2023-06-01,199242,13,0,13,1,0,1
2023-06-01,60098,23,0,23,6,0,6
2023-06-01,34058,96,4,100,7,2,7
2023-06-01,34139,19,2,21,7,3,7
2023-06-01,33874,56,2,58,7,2,7
2023-06-01,57763,7,8,15,4,3,4
2023-06-01,59451,10,0,10,10,0,10
2023-06-01,8452,2111,6,2117,79,21,79
2023-06-01,20928,148,1,149,26,5,26
2023-06-01,50596,15,1,16,5,3,5
2023-06-01,198508,6,1,7,3,2,3
2023-06-01,34625,4,0,4,1,0,1
2023-06-01,58081,3,2,5,1,1,1
2023-06-01,8324,2,0,2,3,0,3
2023-06-01,13056,11,0,11,3,0,3
2023-06-01,202588,1,0,1,3,0,3
2023-06-01,210636,20,0,20,2,0,2
2023-06-01,60064,16,0,16,12,0,12
2023-06-01,39739,1,0,1,1,0,1
2023-06-01,212417,11,1,12,4,2,4
2023-06-01,49121,12,3,15,22,14,24
2023-06-01,50809,8,0,8,1,0,1
2023-06-01,55331,4,0,4,1,0,1
2023-06-01,197075,11,4,15,5,5,6
2023-06-01,43281,10,0,10,6,0,6
2023-06-01,210133,2,0,2,2,0,2
2023-06-01,20521,69,5,74,11,2,11
2023-06-01,201711,1,0,1,1,0,1
2023-06-01,198623,3,0,3,2,0,2
2023-06-01,60351,6,3,9,2,2,2
2023-06-01,28929,7,1,8,5,1,5
2023-06-01,202237,1,1,2,1,1,1
2023-06-01,8399,33,4,37,12,6,13
2023-06-01,207023,28,8,36,2,1,2
2023-06-01,50835,36,0,36,3,0,3
2023-06-01,57732,4,0,4,1,0,1
2023-06-01,8851,38,5,43,13,1,13
2023-06-01,51346,10,0,10,19,5,19
2023-06-01,204106,2,0,2,3,0,3
2023-06-01,24722,88,0,88,3,0,3
2023-06-01,208592,4,0,4,6,0,6
2023-06-01,47241,211,0,211,3,0,3
2023-06-01,57794,22,0,22,2,0,2
2023-06-01,25447,31,2,33,13,4,14
2023-06-01,201704,4,1,5,1,1,1
2023-06-01,60051,2,0,2,13,5,14
2023-06-01,203214,990,14,1004,18,2,18
2023-06-01,50597,37,5,42,18,1,18
2023-06-01,206611,8,0,8,4,0,4
2023-06-01,212692,0,0,0,8,2,8
2023-06-01,16839,70,26,96,21,17,23
2023-06-01,47794,122,9,131,25,8,26
2023-06-01,48695,537,427,964,8,2,8
2023-06-01,48500,7,1,8,5,1,5
2023-06-01,45015,7,0,7,6,0,6
2023-06-01,59413,1,0,1,1,0,1
2023-06-01,41872,20,1,21,6,3,8
2023-06-01,41202,14,0,14,1,0,1
2023-06-01,48475,9,0,9,4,0,4
2023-06-01,50538,4,1,5,5,3,5
2023-06-01,198781,31,1,32,12,4,13
2023-06-01,133385,53,4,57,29,10,31
2023-06-01,24499,74,10,84,12,1,12
2023-06-01,58682,14,12,26,138,35,139
2023-06-01,24389,83,33,116,6,4,6
2023-06-01,58601,12,2,14,35,11,35
2023-06-01,50544,50,1,51,1,1,1
2023-06-01,21176,42,1,43,6,4,6
2023-06-01,41341,4,0,4,1,0,1
2023-06-01,57433,5,53,58,5,4,6
2023-06-01,60461,21,1,22,1,1,1
2023-06-01,59592,6,1,7,2,1,2
2023-06-01,47637,3,0,3,1,0,1
2023-06-01,49540,3,0,3,2,0,2
2023-06-01,198514,11,0,11,2,0,2
2023-06-01,41984,6,0,6,2,0,2
2023-06-01,3210,2,0,2,2,0,2
2023-06-01,13210,3,0,3,4,0,4
2023-06-01,51815,23,9,32,6,3,6
2023-06-01,60662,3,0,3,5,0,5
2023-06-01,57131,13,0,13,2,0,2
2023-06-01,47962,8,2,10,3,1,3
2023-06-01,57862,1,0,1,1,0,1
2023-06-01,206405,5,0,5,1,0,1
2023-06-01,205262,8,0,8,2,0,2
2023-06-01,57844,60,1,61,4,2,4
2023-06-01,35378,6,0,6,4,0,4
2023-06-01,57172,8,0,8,2,0,2
2023-06-01,50289,27,0,27,4,0,4
2023-06-01,49232,4,2,6,3,2,3
2023-06-01,61000,12,0,12,1,0,1
2023-06-01,12835,7,1,8,7,2,7
2023-06-01,197902,7,1,8,5,4,5
2023-06-01,8865,8,1,9,3,2,3
2023-06-01,57832,2,0,2,2,0,2
2023-06-01,24723,13,4,17,19,6,21
2023-06-01,41418,2,0,2,1,0,1
2023-06-01,39451,4,0,4,1,0,1
2023-06-01,210654,2,0,2,1,0,1
2023-06-01,9384,11,0,11,4,0,4
2023-06-01,15874,3,1,4,6,4,6
2023-06-01,42739,18,1,19,27,6,27
2023-06-01,34296,161,0,161,3,0,3
2023-06-01,205868,2,1,3,1,1,1
2023-06-01,199478,40,0,40,5,0,5
2023-06-01,57846,1,0,1,4,0,4
2023-06-01,34545,5,0,5,4,0,4
2023-06-01,37153,46,3,49,25,8,25
2023-06-01,58318,3,2,5,5,2,5
2023-06-01,35766,3,0,3,2,0,2
2023-06-01,49650,7,0,7,3,0,3
2023-06-01,205330,17,0,17,4,0,4
2023-06-01,202020,10,0,10,7,0,7
2023-06-01,51375,313,15,328,14,11,19
2023-06-01,31452,138,0,138,11,0,11
2023-06-01,35745,12,1,13,11,2,11
2023-06-01,199234,6,0,6,2,0,2
2023-06-01,60522,14,2,16,7,7,9
2023-06-01,12329,14,1,15,16,11,17
2023-06-01,15763,32,2,34,24,12,26
2023-06-01,25375,6,2,8,4,3,5
2023-06-01,61157,225,18,243,20,16,23
2023-06-01,15743,17,3,20,12,9,14
2023-06-01,9074,10,2,12,2,1,2
2023-06-01,34592,3,0,3,2,0,2
2023-06-01,199790,3,0,3,13,0,13
2023-06-01,57010,9,2,11,5,3,5
2023-06-01,41944,13,0,13,1,0,1
2023-06-01,205454,1,0,1,1,0,1
2023-06-01,200000,33,17,50,13,5,13
2023-06-01,44053,2,0,2,7,0,7
2023-06-01,35026,15,0,15,1,0,1
2023-06-01,12850,11,1,12,9,4,11
2023-06-01,57961,2,1,3,2,2,3
2023-06-01,57877,4,1,5,7,4,9
2023-06-01,61302,15,839,854,8,9,14
2023-06-01,206003,42,259,301,2,2,3
2023-06-01,198538,4,1,5,1,1,1
2023-06-01,25133,98,1,99,7,5,9
2023-06-01,33894,12,0,12,2,0,2
2023-06-01,8947,3,0,3,2,0,2
2023-06-01,49424,2,0,2,3,0,3
2023-06-01,3169,15,0,15,4,0,4
2023-06-01,210936,1,0,1,1,0,1
2023-06-01,207199,21,1,22,4,3,4
2023-06-01,3308,27,8,35,22,10,25
2023-06-01,44407,33,1,34,8,6,9
2023-06-01,57872,1,0,1,1,0,1
2023-06-01,211183,9,0,9,1,0,1
2023-06-01,49648,1,0,1,1,0,1
2023-06-01,199699,1,1,2,1,1,1
2023-06-01,211031,1,0,1,2,0,2
2023-06-01,210649,1,0,1,1,0,1
2023-06-01,60341,7,2,9,7,3,7
2023-06-01,208715,8,0,8,1,0,1
2023-06-01,34373,17,5,22,3,2,3
2023-06-01,39702,15,7,22,17,11,19
2023-06-01,57607,2,0,2,3,0,3
2023-06-01,20546,67,49,116,10,12,15
2023-06-01,29492,11,1,12,14,6,14
2023-06-01,198507,9,9,18,5,3,6
2023-06-01,200715,1,0,1,3,0,3
2023-06-01,57873,2,0,2,2,0,2
2023-06-01,2586,17,2,19,28,7,29
2023-06-01,199235,3,1,4,2,2,3
2023-06-01,8343,9,2,11,4,2,4
2023-06-01,48926,4,1,5,1,1,1
2023-06-01,196777,8,1,9,2,1,2
2023-06-01,196745,6,5,11,3,2,3
2023-06-01,60670,8,1,9,10,2,10
2023-06-01,58256,51,0,51,2,0,2
2023-06-01,57881,3,0,3,3,0,3
2023-06-01,51793,2,1,3,3,1,3
2023-06-01,34304,26,1,27,17,3,17
2023-06-01,34714,9,2,11,8,6,9
2023-06-01,52023,10,1,11,2,1,2
2023-06-01,205087,1,0,1,1,0,1
2023-06-01,48571,6,1,7,8,3,8
2023-06-01,39211,1,0,1,2,0,2
2023-06-01,29056,16,1,17,18,8,19
2023-06-01,43205,51,1,52,12,5,14
2023-06-01,12615,52,1,53,35,13,38
2023-06-01,3253,25,0,25,9,0,9
2023-06-01,65100,5,0,5,3,0,3
2023-06-01,8371,9,0,9,7,0,7
2023-06-01,34968,14,1,15,13,11,17
2023-06-01,204427,3,0,3,1,0,1
2023-06-01,8285,18,1,19,11,2,12
2023-06-01,210817,1,0,1,3,0,3
2023-06-01,61044,3,1,4,6,4,8
2023-06-01,34619,114,0,114,4,0,4
2023-06-01,64126,1,1,2,24,16,25
2023-06-01,271932,3,1,4,1,1,1
2023-06-01,43509,5,0,5,3,0,3
2023-06-01,39180,15,1,16,30,10,32
2023-06-01,47332,15,0,15,1,0,1
2023-06-01,198583,5,0,5,1,0,1
2023-06-01,62238,1,0,1,1,0,1
2023-06-01,34993,12,2,14,3,3,3
2023-06-01,57907,2,0,2,6,0,6
2023-06-01,198815,2,0,2,1,0,1
2023-06-01,211589,1,0,1,1,0,1
2023-06-01,49467,32,0,32,1,0,1
2023-06-01,201735,21,1,22,3,2,3
2023-06-01,57970,29,0,29,2,0,2
2023-06-01,198569,12,0,12,1,0,1
2023-06-01,196750,2,0,2,8,0,8
2023-06-01,41655,4,1,5,2,1,2
2023-06-01,26464,67,0,67,20,0,20
2023-06-01,226464,0,0,0,1,0,1
2023-06-01,206364,2,1,3,1,1,1
2023-06-01,39409,2,3,5,6,6,8
2023-06-01,50917,1,1,2,5,3,6
2023-06-01,38995,2,0,2,3,0,3
2023-06-01,58276,1,0,1,1,0,1
2023-06-01,44252,48,0,48,1,0,1
2023-06-01,48881,7,1,8,2,1,2
2023-06-01,62342,2,0,2,2,0,2
2023-06-01,39861,4,0,4,5,0,5
2023-06-01,39425,5,0,5,1,0,1
2023-06-01,200651,20,6,26,4,4,4
2023-06-01,60405,5,1,6,4,1,4
2023-06-01,8751,29,2,31,26,2,26
2023-06-01,206206,31,2,33,3,2,3
2023-06-01,206565,6,0,6,3,0,3
2023-06-01,205624,54,1,55,3,1,3
2023-06-01,1653,53,3,56,32,13,33
2023-06-01,41496,41,1,42,5,4,5
2023-06-01,198622,14,13,27,13,5,13
2023-06-01,57928,3,2,5,5,3,5
2023-06-01,6863,12,0,12,4,0,4
2023-06-01,200551,2,0,2,1,0,1
2023-06-01,57276,19,0,19,2,0,2
2023-06-01,31472,11,2,13,11,6,12
2023-06-01,57943,2,0,2,1,0,1
2023-06-01,42688,2,0,2,4,0,4
2023-06-01,211092,1,0,1,1,0,1
2023-06-01,42845,35,1,36,7,5,7
2023-06-01,42676,5,0,5,3,0,3
2023-06-01,29447,6,2,8,5,4,5
2023-06-01,50889,30,0,30,19,0,19
2023-06-01,57951,1,1,2,4,2,4
2023-06-01,16247,50,3,53,13,10,14
2023-06-01,42973,32,1,33,9,1,9
2023-06-01,202193,1,0,1,3,0,3
2023-06-01,213208,1,5,6,1,1,1
2023-06-01,213270,1,1,2,2,2,2
2023-06-01,210588,1,0,1,1,0,1
2023-06-01,34011,224,7,231,1,1,1
2023-06-01,24958,27,1,28,6,2,6
2023-06-01,24663,19,0,19,12,0,12
2023-06-01,6672,3,1,4,2,1,2
2023-06-01,47531,4,0,4,8,0,8
2023-06-01,201443,1,0,1,1,0,1
2023-06-01,212443,1,0,1,2,0,2
2023-06-01,196818,5,0,5,1,0,1
2023-06-01,6823,18,0,18,8,0,8
2023-06-01,12993,20,1,21,20,10,24
2023-06-01,44332,4,2,6,4,3,4
2023-06-01,33459,12,2,14,5,3,5
2023-06-01,51173,16,0,16,3,0,3
2023-06-01,50295,5,2,7,8,4,9
2023-06-01,199309,3,0,3,2,0,2
2023-06-01,44964,6,1,7,15,4,15
2023-06-01,50384,0,0,0,21,8,24
2023-06-01,199430,1,0,1,3,0,3
2023-06-01,202079,1,0,1,1,0,1
2023-06-01,205978,1,0,1,3,0,3
2023-06-01,21040,9,2,11,7,6,8
2023-06-01,211225,8,0,8,1,0,1
2023-06-01,198626,1,0,1,2,0,2
2023-06-01,59396,3,0,3,1,0,1
2023-06-01,198641,5,0,5,2,0,2
2023-06-01,41811,15,1,16,11,3,11
2023-06-01,15660,6,0,6,2,0,2
2023-06-01,198612,4,1,5,5,3,5
2023-06-01,57752,21,1,22,10,5,10
2023-06-01,34704,18,0,18,2,0,2
2023-06-01,9031,23,31,54,14,8,15
2023-06-01,48137,8,1,9,2,2,2
2023-06-01,41896,9,0,9,1,0,1
2023-06-01,202964,5,0,5,1,0,1
2023-06-01,44579,5,0,5,2,0,2
2023-06-01,41822,36,0,36,5,0,5
2023-06-01,58010,13,3,16,10,7,12
2023-06-01,205617,2,1,3,1,1,1
2023-06-01,25086,40,1,41,13,1,13
2023-06-01,56882,13,0,13,2,0,2
2023-06-01,29084,148,2,150,13,6,16
2023-06-01,199221,3,1,4,2,1,3
2023-06-01,204266,1,0,1,2,0,2
2023-06-01,57840,1,0,1,1,0,1
2023-06-01,12008,33,31,64,34,28,36
2023-06-01,397232,66,40,106,1,1,1
2023-06-01,397234,97,0,97,1,0,1
2023-06-01,397238,66,0,66,1,0,1
2023-06-01,397239,97,0,97,1,0,1
2023-06-01,397222,63,21,84,1,1,1
2023-06-01,397233,64,39,103,1,1,1
2023-06-01,397219,49,28,77,1,1,1
2023-06-01,397215,64,38,102,1,1,1
2023-06-01,397225,66,40,106,1,1,1
2023-06-01,397220,63,27,90,1,1,1
2023-06-01,397237,64,38,102,1,1,1
2023-06-01,397218,62,39,101,1,1,1
2023-06-01,397231,65,39,104,1,1,1
2023-06-01,397213,47,39,86,1,1,1
2023-06-01,397228,14,40,54,1,1,1
2023-06-01,49284,3,0,3,2,0,2
2023-06-01,16285,53,9,62,4,2,4
2023-06-01,58045,6,0,6,6,0,6
2023-06-01,61113,2,0,2,3,0,3
2023-06-01,43356,28,0,28,4,0,4
2023-06-01,201700,3,0,3,3,0,3
2023-06-01,25274,12,1,13,1,1,1
2023-06-01,47172,11,1,12,7,3,7
2023-06-01,209829,2,0,2,1,0,1
2023-06-01,199493,22,0,22,1,0,1
2023-06-01,47264,38,2,40,15,4,16
2023-06-01,41206,3,1,4,13,6,13
2023-06-01,50261,11,2,13,5,3,5
2023-06-01,61294,1,0,1,1,0,1
2023-06-01,34430,6,0,6,2,0,2
2023-06-01,196742,17,0,17,3,0,3
2023-06-01,34879,61,1,62,15,1,15
2023-06-01,205312,1,0,1,1,0,1
2023-06-01,47775,4,1,5,8,5,9
2023-06-01,43238,2,1,3,3,1,3
2023-06-01,202757,12,0,12,3,0,3
2023-06-01,201730,35,4,39,6,1,6
2023-06-01,208751,2,2,4,1,1,1
2023-06-01,62007,16,0,16,1,0,1
2023-06-01,200873,7,0,7,9,0,9
2023-06-01,198537,34,1,35,7,2,7
2023-06-01,212261,0,0,0,9,4,11
2023-06-01,48131,2,2,4,1,1,1
2023-06-01,62384,2,0,2,1,0,1
2023-06-01,43940,6,1,7,7,1,7
2023-06-01,198961,14,0,14,2,0,2
2023-06-01,200276,1,0,1,4,0,4
2023-06-01,60861,1,0,1,1,0,1
2023-06-01,58084,8,0,8,8,0,8
2023-06-01,15974,19,3,22,5,4,6
2023-06-01,51514,2,1,3,6,4,7
2023-06-01,198965,2,0,2,2,0,2
2023-06-01,198760,50,0,50,1,0,1
2023-06-01,31586,8,2,10,2,3,3
2023-06-01,34352,10,1,11,9,2,9
2023-06-01,47569,17,0,17,5,0,5
2023-06-01,205595,1,0,1,2,0,2
2023-06-01,199171,2,0,2,1,0,1
2023-06-01,21837,10,2,12,4,4,4
2023-06-01,39832,17,4,21,14,8,15
2023-06-01,50873,6,4,10,6,4,6
2023-06-01,204035,17,2,19,4,4,4
2023-06-01,209400,5,1,6,7,1,7
2023-06-01,15945,1,1,2,9,3,9
2023-06-01,34432,2,0,2,2,0,2
2023-06-01,198672,4,0,4,1,0,1
2023-06-01,203600,14,1,15,5,1,5
2023-06-01,201205,7,1,8,5,4,6
2023-06-01,210226,6,1,7,1,1,1
2023-06-01,200197,1,0,1,8,0,8
2023-06-01,204402,12,2,14,3,2,3
2023-06-01,202547,1,0,1,2,0,2
2023-06-01,197309,9,0,9,3,0,3
2023-06-01,12683,10,0,10,4,0,4
2023-06-01,57064,5,0,5,1,0,1
2023-06-01,48219,13,0,13,10,0,10
2023-06-01,203725,2,0,2,2,0,2
2023-06-01,60568,1,0,1,2,0,2
2023-06-01,197535,7,0,7,5,0,5
2023-06-01,35810,15,1,16,12,3,13
2023-06-01,57652,2,0,2,1,0,1
2023-06-01,62268,3,0,3,3,0,3
2023-06-01,60872,1,0,1,1,0,1
2023-06-01,200161,8,1,9,11,5,11
2023-06-01,206153,1,1,2,1,1,1
2023-06-01,60062,4,0,4,4,0,4
2023-06-01,42521,3,0,3,3,0,3
2023-06-01,49070,2,0,2,4,0,4
2023-06-01,199530,1,0,1,1,0,1
2023-06-01,208388,1,0,1,2,0,2
2023-06-01,39167,1,0,1,4,0,4
2023-06-01,203831,1,0,1,2,0,2
2023-06-01,48558,1,0,1,4,0,4
2023-06-01,200764,1,0,1,2,0,2
2023-06-01,204159,1,0,1,2,0,2
2023-06-01,29528,1,0,1,2,0,2
2023-06-01,60779,1,0,1,1,0,1
2023-06-01,197998,6,0,6,1,0,1
2023-06-01,39811,13,6,19,13,1,13
2023-06-01,204112,1,0,1,2,0,2
2023-06-01,44724,57,1,58,6,2,6
2023-06-01,62413,1,0,1,2,0,2
2023-06-01,200922,3,0,3,1,0,1
2023-06-01,202781,1,0,1,2,0,2
2023-06-01,201825,11,1,12,6,4,8
2023-06-01,44657,1,0,1,2,0,2
2023-06-01,8901,33,1,34,5,1,5
2023-06-01,56928,1,0,1,3,0,3
2023-06-01,200095,1,0,1,3,0,3
2023-06-01,51698,18,0,18,5,0,5
2023-06-01,34597,2,0,2,2,0,2
2023-06-01,42938,2,0,2,2,0,2
2023-06-01,56627,1,0,1,3,0,3
2023-06-01,43215,2,0,2,4,0,4
2023-06-01,211932,2,0,2,2,0,2
2023-06-01,47589,206,8,214,8,2,8
2023-06-01,9155,443,1,444,29,6,29
2023-06-01,42678,5,0,5,4,0,4
2023-06-01,198717,1,0,1,1,0,1
2023-06-01,12709,180,2,182,15,4,15
2023-06-01,212769,4,0,4,4,0,4
2023-06-01,51453,3,0,3,1,0,1
2023-06-01,30818,3,0,3,13,7,15
2023-06-01,50613,18,2,20,1,1,1
2023-06-01,57169,47,5,52,15,8,18
2023-06-01,28099,13,2,15,3,3,3
2023-06-01,24851,5,1,6,1,1,1
2023-06-01,58109,1,0,1,1,0,1
2023-06-01,56860,1,0,1,1,0,1
2023-06-01,21427,1,0,1,1,0,1
2023-06-01,43779,1,0,1,1,0,1
2023-06-01,43242,9,1,10,2,1,2
2023-06-01,62187,1,0,1,1,0,1
2023-06-01,58075,22,2,24,8,1,8
2023-06-01,24935,15,2,17,1,1,1
2023-06-01,35332,10,2,12,10,7,11
2023-06-01,41268,4,2,6,7,4,8
2023-06-01,199739,23,15,38,2,1,2
2023-06-01,50710,11,0,11,3,0,3
2023-06-01,29060,34,0,34,2,0,2
2023-06-01,25459,18,5,23,8,5,9
2023-06-01,34971,21,3,24,10,7,12
2023-06-01,20836,14,2,16,21,11,22
2023-06-01,210538,9,0,9,1,0,1
2023-06-01,57811,9,1,10,12,9,13
2023-06-01,59627,7,0,7,6,0,6
2023-06-01,34702,12,1,13,5,4,5
2023-06-01,58095,4,0,4,9,0,9
2023-06-01,13037,29,2,31,18,11,20
2023-06-01,61006,8,2,10,1,1,1
2023-06-01,196752,11,1,12,10,7,12
2023-06-01,48885,10,1,11,7,3,7
2023-06-01,29990,44,9,53,10,5,10
2023-06-01,44133,4,2,6,2,1,2
2023-06-01,198719,1,0,1,1,0,1
2023-06-01,44654,18,8,26,5,4,5
2023-06-01,211262,1,2,3,1,1,1
2023-06-01,211210,1,1,2,1,1,1
2023-06-01,393442,70,0,70,5,0,5
2023-06-01,395129,6,0,6,3,0,3
2023-06-01,11594,30,0,30,3,0,3
2023-06-01,399279,11,0,11,5,0,5
2023-06-01,7250,64,0,64,4,0,4
2023-06-01,395127,26,0,26,7,0,7
2023-06-01,139076,16,1,17,17,3,17
2023-06-01,398993,21,1,22,3,1,3
2023-06-01,398823,56,0,56,9,0,9
2023-06-01,139646,516,3,519,14,3,14
2023-06-01,58931,17,0,17,3,0,3
2023-06-01,55020,48,0,48,1,0,1
2023-06-01,140096,36,8,44,7,3,7
2023-06-01,400618,2,0,2,2,0,2
2023-06-01,206888,10,0,10,2,0,2
2023-06-01,58879,121,4,125,10,2,10
2023-06-01,61461,33,20,53,27,13,28
2023-06-01,271899,3,1,4,3,1,3
2023-06-01,52419,40,1,41,3,2,3
2023-06-01,27903,17,0,17,4,0,4
2023-06-01,28398,24,2,26,6,4,6
2023-06-01,270169,2,0,2,2,0,2
2023-06-01,263725,22,1,23,6,1,6
2023-06-01,52354,9,0,9,1,0,1
2023-06-01,61510,13,1,14,3,1,3
2023-06-01,269816,36,4,40,2,3,3
2023-06-01,141664,3,0,3,3,0,3
2023-06-01,271979,4,1,5,2,1,2
2023-06-01,270175,2,1,3,2,1,2
2023-06-01,272045,1,1,2,2,1,2
2023-06-01,265867,29,1,30,6,1,6
2023-06-01,400229,7,1,8,2,1,3
2023-06-01,272149,1,0,1,1,0,1
2023-06-01,272195,1,3,4,3,3,4
2023-06-01,272040,1,0,1,1,0,1
2023-06-01,61726,9,8,17,3,2,3
2023-06-01,62658,11,0,11,1,0,1
2023-06-01,38740,0,0,0,20,14,22
2023-06-01,141680,3,2,5,1,1,1
2023-06-01,53087,52,3,55,92,60,97
2023-06-01,263940,7,3,10,3,2,3
2023-06-01,400337,4,0,4,1,0,1
2023-06-01,399622,1,0,1,1,0,1
2023-06-01,207136,4,1,5,1,1,1
2023-06-01,9260,124,5,129,14,6,14
2023-06-01,136384,114,1,115,2,1,2
2023-06-01,135523,22,0,22,21,0,21
2023-06-01,263702,43,9,52,49,17,50
2023-06-01,271896,14,17,31,1,1,1
2023-06-01,52511,8,1,9,1,1,1
2023-06-01,271777,10,0,10,1,0,1
2023-06-01,268205,48,1,49,5,2,5
2023-06-01,56087,9,0,9,6,0,6
2023-06-01,264397,12,4,16,6,3,6
2023-06-01,268029,4,5,9,10,6,10
2023-06-01,212400,4,0,4,2,0,2
2023-06-01,265933,4,1,5,17,9,18
2023-06-01,272747,2,2,4,1,2,2
2023-06-01,272112,5,7,12,9,3,9
2023-06-01,272887,1,0,1,1,0,1
2023-06-01,272762,3,7,10,1,1,1
2023-06-01,271934,8,1,9,9,2,9
2023-06-01,272015,4,1,5,1,1,1
2023-06-01,270868,5,2,7,6,3,7
2023-06-01,271941,1,1,2,2,1,2
2023-06-01,23487,217,15,232,11,5,11
2023-06-01,268698,5,9,14,7,5,7
2023-06-01,272573,3,3,6,6,4,8
2023-06-01,266931,12,17,29,57,47,63
2023-06-01,55839,28,0,28,4,0,4
2023-06-01,17426,67,7,74,8,2,8
2023-06-01,58322,56,0,56,5,0,5
2023-06-01,266475,15,9,24,10,6,10
2023-06-01,264275,21,4,25,23,16,23
2023-06-01,264409,5,8,13,59,25,65
2023-06-01,61884,21,13,34,20,19,22
2023-06-01,268976,129,15,144,21,19,22
2023-06-01,264582,6,3,9,1,2,2
2023-06-01,210838,4,0,4,1,0,1
2023-06-01,264009,21,1,22,10,6,11
2023-06-01,23679,99,20,119,15,5,15
2023-06-01,38506,8,6,14,11,3,11
2023-06-01,27901,138,17,155,10,4,10
2023-06-01,54936,97,1,98,4,2,4
2023-06-01,32204,35,0,35,1,0,1
2023-06-01,54328,2,1,3,3,1,3
2023-06-01,63100,4,0,4,2,0,2
2023-06-01,136244,7,0,7,6,0,6
2023-06-01,267521,6,5,11,14,10,14
2023-06-01,270375,5,3,8,8,3,8
2023-06-01,272823,1,8,9,2,3,4
2023-06-01,264962,5,7,12,8,3,8
2023-06-01,263189,16,4,20,4,2,4
2023-06-01,263684,9,0,9,10,0,10
2023-06-01,25890,1,0,1,1,0,1
2023-06-01,272488,0,5,5,5,3,5
2023-06-01,267648,5,0,5,5,0,5
2023-06-01,211396,1,0,1,1,0,1
2023-06-01,27887,22,2,24,5,3,5
2023-06-01,28007,23,5,28,53,16,53
2023-06-01,272958,1,0,1,1,0,1
2023-06-01,26029,0,0,0,3,0,3
2023-06-01,1423,4,0,4,3,0,3
2023-06-01,271659,3,13,16,2,3,4
2023-06-01,53586,9,0,9,1,0,1
2023-06-01,269730,16,0,16,5,0,5
2023-06-01,263703,40,6,46,22,6,23
2023-06-01,271855,4,0,4,3,0,3
2023-06-01,266809,2,1,3,9,2,9
2023-06-01,27611,13,0,13,7,0,7
2023-06-01,25668,51,1,52,9,4,10
2023-06-01,399438,2,0,2,1,0,1
2023-06-01,29914,26,0,26,1,0,1
2023-06-01,6405,10,1,11,5,2,5
2023-06-01,399930,2,0,2,1,0,1
2023-06-01,398721,38,0,38,4,0,4
2023-06-01,32012,4,0,4,2,0,2
2023-06-01,19816,34,0,34,3,0,3
2023-06-01,32277,15,1,16,5,3,5
2023-06-01,40281,24,2,26,3,2,3
2023-06-01,12105,3,0,3,3,0,3
2023-06-01,395795,5,1,6,4,1,4
2023-06-01,395111,79,1,80,1,1,1
2023-06-01,393511,3,0,3,2,0,2
2023-06-01,63131,14,0,14,5,0,5
2023-06-01,397468,9,0,9,9,0,9
2023-06-01,132847,8,1,9,14,3,14
2023-06-01,395122,5,0,5,1,0,1
2023-06-01,397545,23,0,23,6,0,6
2023-06-01,399337,8,1,9,3,3,3
2023-06-01,209968,21,21,42,3,4,4
2023-06-01,62513,0,2,2,3,32,32
2023-06-01,13692,55,1,56,6,1,6
2023-06-01,11738,7,2,9,1,1,1
2023-06-01,903,16,0,16,2,0,2
2023-06-01,36295,47,12,59,7,4,8
2023-06-01,15153,35,0,35,4,0,4
2023-06-01,21624,3,1,4,3,2,3
2023-06-01,16468,9,0,9,2,0,2
2023-06-01,399301,3,0,3,4,0,4
2023-06-01,33028,22,3,25,3,3,3
2023-06-01,46320,49,0,49,8,0,8
2023-06-01,270133,3,1,4,5,3,5
2023-06-01,395690,1,0,1,1,0,1
2023-06-01,28439,2,0,2,1,0,1
2023-06-01,7438,112,1,113,23,8,23
2023-06-01,265605,8,2,10,5,2,5
2023-06-01,397446,22,1,23,5,2,5
2023-06-01,400180,13,0,13,3,0,3
2023-06-01,16604,61,3,64,6,2,6
2023-06-01,21554,63,2,65,8,4,8
2023-06-01,27843,218,4,222,23,5,23
2023-06-01,265691,57,1,58,1,1,1
2023-06-01,17025,73,4,77,7,3,7
2023-06-01,53338,23,1,24,5,4,5
2023-06-01,397596,2,0,2,1,0,1
2023-06-01,395717,17,0,17,7,0,7
2023-06-01,396168,13,0,13,2,0,2
2023-06-01,394922,3,0,3,3,0,3
2023-06-01,14277,8,0,8,6,0,6
2023-06-01,11713,5,0,5,4,0,4
2023-06-01,26558,11,7,18,13,11,13
2023-06-01,16639,2,1,3,1,1,2
2023-06-01,207967,20,0,20,7,0,7
2023-06-01,36360,3,0,3,3,0,3
2023-06-01,29783,1,0,1,3,0,3
2023-06-01,7057,8,1,9,10,6,10
2023-06-01,398720,1,0,1,2,0,2
2023-06-01,32100,8,1,9,5,3,5
2023-06-01,11686,66,7,73,21,6,22
2023-06-01,393662,7,0,7,3,0,3
2023-06-01,2637,13,4,17,2,2,2
2023-06-01,399288,2,0,2,2,0,2
2023-06-01,62592,10,0,10,2,0,2
2023-06-01,46294,17,0,17,3,0,3
2023-06-01,395160,1,0,1,2,0,2
2023-06-01,395579,1,0,1,3,0,3
2023-06-01,46957,20,0,20,3,0,3
2023-06-01,139330,36,0,36,1,0,1
2023-06-01,140224,378,5,383,26,13,27
2023-06-01,140869,56,0,56,2,0,2
2023-06-01,33164,18,0,18,8,0,8
2023-06-01,265509,22,5,27,5,2,5
2023-06-01,263127,6,1,7,5,2,5
2023-06-01,270236,10,0,10,3,0,3
2023-06-01,265570,4,1,5,4,3,4
2023-06-01,13999,2358,249,2607,46,18,48
2023-06-01,20432,32,1,33,3,1,3
2023-06-01,22060,7,0,7,2,0,2
2023-06-01,4877,4,0,4,3,0,3
2023-06-01,12132,14,0,14,6,0,6
2023-06-01,4540,40,0,40,9,0,9
2023-06-01,203223,7,1,8,5,4,5
2023-06-01,397311,7,0,7,2,0,2
2023-06-01,400194,5,9,14,2,2,2
2023-06-01,269832,43,9,52,8,4,8
2023-06-01,271900,3,2,5,2,2,2
2023-06-01,196749,4,0,4,9,0,9
2023-06-01,202761,3,0,3,1,0,1
2023-06-01,271791,5,11,16,4,2,4
2023-06-01,61588,16,1,17,14,9,14
2023-06-01,267219,1,4,5,3,3,3
2023-06-01,269261,6,5,11,3,2,3
2023-06-01,53181,14,14,28,89,72,94
2023-06-01,28658,7,6,13,11,8,12
2023-06-01,271986,1,0,1,2,0,2
2023-06-01,64979,0,0,0,2,0,2
2023-06-01,397422,29,1,30,2,1,2
2023-06-01,53256,4,1,5,1,1,1
2023-06-01,133652,28,1,29,3,1,3
2023-06-01,207620,6,0,6,1,0,1
2023-06-01,26202,17,0,17,2,0,2
2023-06-01,266445,14,38,52,32,25,33
2023-06-01,264169,7,6,13,6,2,6
2023-06-01,52900,6,1,7,25,17,27
2023-06-01,271751,10,1,11,4,2,4
2023-06-01,52783,4,1,5,17,13,17
2023-06-01,266044,7,1,8,5,4,5
2023-06-01,203667,3,1,4,4,1,5
2023-06-01,40029,17,1,18,6,2,6
2023-06-01,264764,8,1,9,4,1,4
2023-06-01,394449,22,2,24,4,6,6
2023-06-01,264273,8,1,9,10,5,10
2023-06-01,9129,65,0,65,16,0,16
2023-06-01,327786,10,0,10,6,0,6
2023-06-01,328605,4,0,4,12,0,12
2023-06-01,266409,5,7,12,33,21,35
2023-06-01,268952,4,1,5,5,5,8
2023-06-01,61448,0,1,1,6,5,7
2023-06-01,272005,1,1,2,1,1,1
2023-06-01,19037,61,5,66,11,8,11
2023-06-01,11664,1101,638,1739,115,18,116
2023-06-01,264689,6,0,6,2,0,2
2023-06-01,269501,10,1,11,6,4,7
2023-06-01,262847,24,15,39,60,42,66
2023-06-01,262596,13,10,23,16,14,18
2023-06-01,263137,8,6,14,6,9,10
2023-06-01,272004,6,1,7,4,1,4
2023-06-01,269898,9,0,9,7,0,7
2023-06-01,33139,37,0,37,4,0,4
2023-06-01,262253,67,1,68,15,5,15
2023-06-01,271814,39,1,40,1,1,1
2023-06-01,269820,23,3,26,5,1,5
2023-06-01,21826,775,1,776,23,9,24
2023-06-01,272083,35,8,43,1,1,1
2023-06-01,208591,5,5,10,7,6,9
2023-06-01,60667,3,0,3,3,0,3
2023-06-01,213362,2,0,2,1,0,1
2023-06-01,52251,160,0,160,14,3,14
2023-06-01,263737,6,0,6,1,0,1
2023-06-01,11014,178,2,180,101,24,104
2023-06-01,11556,126,16,142,27,3,27
2023-06-01,269736,5,41,46,3,3,3
2023-06-01,272109,1,1,2,1,1,1
2023-06-01,37517,24,1,25,5,2,5
2023-06-01,8057,41,1,42,15,2,15
2023-06-01,1378,19,0,19,3,0,3
2023-06-01,267722,6,0,6,1,0,1
2023-06-01,266798,3,0,3,2,0,2
2023-06-01,272097,5,1,6,4,1,4
2023-06-01,19114,49,33,82,24,11,26
2023-06-01,267846,36,1,37,4,1,4
2023-06-01,396305,5,0,5,4,0,4
2023-06-01,47028,10,0,10,2,0,2
2023-06-01,269838,7,4,11,3,2,3
2023-06-01,272104,1,1,2,1,1,1
2023-06-01,64134,20,0,20,10,0,10
2023-06-01,267705,19,1,20,5,3,5
2023-06-01,267862,1,0,1,3,0,3
2023-06-01,263689,2,17,19,5,4,7
2023-06-01,397285,21,0,21,2,0,2
2023-06-01,400343,1,0,1,1,0,1
2023-06-01,393632,16,0,16,3,0,3
2023-06-01,23252,23,1,24,5,1,5
2023-06-01,13319,26,6,32,6,5,6
2023-06-01,272122,3,0,3,2,0,2
2023-06-01,272110,8,0,8,2,0,2
2023-06-01,271915,3,4,7,6,2,7
2023-06-01,270160,5,2,7,3,1,3
2023-06-01,28458,50,3,53,14,7,14
2023-06-01,272063,1,1,2,1,1,1
2023-06-01,393883,1,0,1,1,0,1
2023-06-01,52041,5,6,11,5,5,8
2023-06-01,200636,2,1,3,2,1,2
2023-06-01,137182,13,3,16,9,3,9
2023-06-01,9294,34,0,34,3,0,3
2023-06-01,14713,12,1,13,10,4,10
2023-06-01,397137,4,0,4,4,0,4
2023-06-01,398371,27,1,28,2,2,2
2023-06-01,200827,2,19,21,2,2,3
2023-06-01,30529,2,0,2,2,0,2
2023-06-01,270176,1,0,1,1,0,1
2023-06-01,270158,19,2,21,6,4,6
2023-06-01,270187,4,1,5,2,1,2
2023-06-01,46414,1,0,1,1,0,1
2023-06-01,398576,8,0,8,2,0,2
2023-06-01,399130,17,0,17,2,0,2
2023-06-01,393670,3,1,4,3,2,3
2023-06-01,46972,1,0,1,1,0,1
2023-06-01,21682,4,0,4,1,0,1
2023-06-01,398816,8,1,9,3,2,3
2023-06-01,142591,5,0,5,2,0,2
2023-06-01,140570,14,1,15,27,7,27
2023-06-01,149641,7,0,7,1,0,1
2023-06-01,150117,1,0,1,1,0,1
2023-06-01,150337,1,0,1,1,0,1
2023-06-01,136491,1,0,1,1,0,1
2023-06-01,137962,16,1,17,5,3,7
2023-06-01,151061,2,1,3,1,1,1
2023-06-01,132641,23,0,23,6,0,6
2023-06-01,59134,28,0,28,2,0,2
2023-06-01,979,81,0,81,7,0,7
2023-06-01,147019,42,0,42,3,0,3
2023-06-01,38553,46,1,47,13,2,13
2023-06-01,140443,42,2,44,14,6,15
2023-06-01,18059,99,2,101,31,9,33
2023-06-01,140227,157,0,157,11,0,11
2023-06-01,20135,12,1,13,2,1,2
2023-06-01,400735,4,1,5,3,3,3
2023-06-01,37315,54,5,59,11,2,11
2023-06-01,328608,104,3,107,11,3,11
2023-06-01,328615,3,0,3,6,2,6
2023-06-01,328073,24,1,25,5,1,5
2023-06-01,21003,100,1,101,6,1,6
2023-06-01,266815,14,2,16,1,1,1
2023-06-01,271931,2,0,2,1,0,1
2023-06-01,272132,2,1,3,2,2,2
2023-06-01,207594,10,2,12,12,8,14
2023-06-01,212891,2,0,2,2,0,2
2023-06-01,262191,175,28,203,39,14,42
2023-06-01,263681,4,4,8,2,2,3
2023-06-01,13576,172,12,184,41,8,41
2023-06-01,264329,3,2,5,13,11,14
2023-06-01,263262,10,5,15,8,3,8
2023-06-01,28368,108,3,111,80,3,81
2023-06-01,264758,17,0,17,7,0,7
2023-06-01,263834,46,1,47,5,4,5
2023-06-01,266539,6,5,11,9,7,11
2023-06-01,271939,7,0,7,3,0,3
2023-06-01,8048,448,0,448,26,0,26
2023-06-01,264628,18,1,19,11,2,11
2023-06-01,271988,2,1,3,2,2,2
2023-06-01,393814,3,0,3,3,0,3
2023-06-01,398149,3,0,3,2,0,2
2023-06-01,397772,2,0,2,1,0,1
2023-06-01,19734,3,0,3,1,0,1
2023-06-01,264622,4,0,4,2,0,2
2023-06-01,269795,5,0,5,3,0,3
2023-06-01,272870,2,0,2,1,0,1
2023-06-01,264685,8,0,8,5,0,5
2023-06-01,269995,2,0,2,4,0,4
2023-06-01,22724,299,121,420,25,8,25
2023-06-01,272011,4,1,5,4,3,5
2023-06-01,135567,5,0,5,2,0,2
2023-06-01,271942,1,4,5,1,1,1
2023-06-01,263238,42,15,57,9,5,9
2023-06-01,272808,1,1,2,2,1,2
2023-06-01,272101,2,0,2,1,0,1
2023-06-01,272119,1,0,1,1,0,1
2023-06-01,266730,1,0,1,1,0,1
2023-06-01,271950,1,1,2,1,1,1
2023-06-01,27813,154,0,154,5,0,5
2023-06-01,11203,11,0,11,4,0,4
2023-06-01,27717,83,7,90,13,6,15
2023-06-01,272102,4,0,4,3,0,3
2023-06-01,263891,14,7,21,11,8,11
2023-06-01,272555,7,1,8,2,1,2
2023-06-01,28202,844,15,859,25,17,25
2023-06-01,61595,3,1,4,28,14,28
2023-06-01,398317,5,0,5,1,0,1
2023-06-01,272142,1,1,2,1,1,1
2023-06-01,6306,82,1,83,10,1,10
2023-06-01,272809,21,0,21,6,0,6
2023-06-01,272266,2,3,5,3,2,3
2023-06-01,262517,14,5,19,21,9,21
2023-06-01,272896,3,0,3,1,0,1
2023-06-01,272822,3,0,3,3,0,3
2023-06-01,52554,15,3,18,67,46,73
2023-06-01,270749,4,1,5,5,3,5
2023-06-01,272604,1,17,18,1,1,1
2023-06-01,262342,18,20,38,34,21,37
2023-06-01,267809,9,1,10,9,6,10
2023-06-01,267708,9,13,22,4,3,4
2023-06-01,271907,11,1,12,2,1,2
2023-06-01,37678,12,2,14,23,6,24
2023-06-01,327776,3,0,3,1,0,1
2023-06-01,272869,1,0,1,1,0,1
2023-06-01,263759,5,1,6,1,1,1
2023-06-01,33152,37,4,41,4,1,4
2023-06-01,20207,144,11,155,37,11,37
2023-06-01,12150,43,1,44,4,2,4
2023-06-01,264837,12,0,12,5,0,5
2023-06-01,272851,10,2,12,3,2,3
2023-06-01,272827,1,0,1,1,0,1
2023-06-01,269656,9,5,14,9,8,9
2023-06-01,269266,1,8,9,32,23,34
2023-06-01,28283,6,2,8,177,127,181
2023-06-01,271930,2,5,7,1,1,1
2023-06-01,27839,61,3,64,6,4,6
2023-06-01,263242,10,0,10,5,0,5
2023-06-01,271108,3,0,3,8,2,8
2023-06-01,265561,17,3,20,8,1,8
2023-06-01,265592,6,0,6,4,0,4
2023-06-01,264836,6,1,7,6,3,7
2023-06-01,272818,2,1,3,1,1,1
2023-06-01,23158,23,0,23,8,0,8
2023-06-01,55320,5,1,6,3,1,3
2023-06-01,138678,7,0,7,7,0,7
2023-06-01,24323,92,0,92,47,0,47
2023-06-01,63139,15,0,15,1,0,1
2023-06-01,138546,1,0,1,4,2,4
2023-06-01,14430,41,0,41,7,0,7
2023-06-01,32840,6,0,6,1,0,1
2023-06-01,42960,17,3,20,3,1,3
2023-06-01,136933,37,2,39,25,4,25
2023-06-01,135056,0,0,0,2,0,2
2023-06-01,8888,27,22,49,21,19,27
2023-06-01,207190,11,0,11,3,0,3
2023-06-01,210129,3,1,4,6,4,6
2023-06-01,271965,2,1,3,1,1,1
2023-06-01,22121,3,1,4,2,1,2
2023-06-01,266734,2,1,3,2,2,2
2023-06-01,139390,3,0,3,3,0,3
2023-06-01,272775,1,1,2,3,2,3
2023-06-01,272703,1,2,3,3,2,3
2023-06-01,56231,3,1,4,1,1,1
2023-06-01,52323,73,6,79,17,4,17
2023-06-01,271810,7,0,7,1,0,1
2023-06-01,28452,1,0,1,1,0,1
2023-06-01,272813,1,0,1,2,0,2
2023-06-01,8053,35,5,40,18,9,18
2023-06-01,272854,3,4,7,2,3,3
2023-06-01,64116,6,1,7,4,2,4
2023-06-01,271842,6,0,6,6,0,6
2023-06-01,272836,8,1,9,6,3,6
2023-06-01,272848,4,3,7,4,2,5
2023-06-01,272979,1,0,1,2,0,2
2023-06-01,273595,7,2,9,2,3,3
2023-06-01,269804,4,4,8,4,2,4
2023-06-01,272948,1,0,1,1,0,1
2023-06-01,22411,86,5,91,11,3,11
2023-06-01,8948,15,0,15,1,0,1
2023-06-01,61770,6,1,7,3,3,3
2023-06-01,28343,305,35,340,84,63,89
2023-06-01,268077,9,1,10,5,2,5
2023-06-01,28451,2,1,3,2,1,2
2023-06-01,30355,1,0,1,1,0,1
2023-06-01,398779,30,0,30,3,0,3
2023-06-01,22549,4,3,7,6,3,6
2023-06-01,46917,4,0,4,5,0,5
2023-06-01,19246,16,0,16,4,0,4
2023-06-01,399467,1,1,2,1,1,1
2023-06-01,54329,17,1,18,4,1,4
2023-06-01,399233,1,1,2,2,2,2
2023-06-01,212371,8,0,8,2,0,2
2023-06-01,150120,1,0,1,1,0,1
2023-06-01,140709,1,0,1,1,0,1
2023-06-01,200373,7,0,7,1,0,1
2023-06-01,398478,25,0,25,5,0,5
2023-06-01,23486,9,0,9,13,0,13
2023-06-01,54960,3,0,3,2,0,2
2023-06-01,36472,6,1,7,2,2,2
2023-06-01,395924,10,0,10,3,0,3
2023-06-01,14460,2,0,2,3,0,3
2023-06-01,11160,3,0,3,4,0,4
2023-06-01,27641,2,0,2,1,0,1
2023-06-01,36062,7,0,7,12,0,12
2023-06-01,16633,24,0,24,4,0,4
2023-06-01,394844,35,2,37,4,1,4
2023-06-01,46477,1,0,1,1,0,1
2023-06-01,6220,75,0,75,15,0,15
2023-06-01,46430,10,0,10,3,0,3
2023-06-01,395248,1,0,1,2,0,2
2023-06-01,32586,77,0,77,2,0,2
2023-06-01,40635,2,0,2,3,0,3
2023-06-01,18997,4,0,4,3,0,3
2023-06-01,19842,60,1,61,3,2,3
2023-06-01,20799,3,2,5,8,3,8
2023-06-01,397905,1,0,1,1,0,1
2023-06-01,21570,114,2,116,5,3,6
2023-06-01,63122,3,0,3,3,0,3
2023-06-01,47027,41,1,42,6,4,6
2023-06-01,33007,48,0,48,2,0,2
2023-06-01,394284,10,0,10,6,0,6
2023-06-01,26523,5,2,7,10,4,10
2023-06-01,14812,2,0,2,2,0,2
2023-06-01,18919,9,0,9,3,0,3
2023-06-01,395513,2,0,2,3,0,3
2023-06-01,1419,1,0,1,1,0,1
2023-06-01,55049,2,0,2,3,0,3
2023-06-01,17317,2,0,2,4,0,4
2023-06-01,394334,5,0,5,5,0,5
2023-06-01,394765,7,0,7,3,0,3
2023-06-01,395948,10,0,10,3,0,3
2023-06-01,17267,7,1,8,1,1,1
2023-06-01,395434,7,1,8,4,2,4
2023-06-01,62682,23,0,23,4,0,4
2023-06-01,19211,2,0,2,2,0,2
2023-06-01,63275,4,0,4,2,0,2
2023-06-01,263157,46,0,46,4,0,4
2023-06-01,28399,6,0,6,3,0,3
2023-06-01,43009,34,2,36,25,5,25
2023-06-01,28445,2,0,2,1,0,1
2023-06-01,28409,55,0,55,13,0,13
2023-06-01,270126,5,2,7,7,3,7
2023-06-01,28545,45,4,49,12,4,12
2023-06-01,32270,2,1,3,10,7,10
2023-06-01,265550,4,0,4,5,0,5
2023-06-01,265539,3,1,4,2,1,2
2023-06-01,265540,13,2,15,7,3,7
2023-06-01,65132,1,0,1,3,0,3
2023-06-01,265620,5,0,5,7,2,7
2023-06-01,53550,7,2,9,7,3,7
2023-06-01,36498,36,0,36,5,0,5
2023-06-01,13452,2,0,2,1,0,1
2023-06-01,26970,2,0,2,2,0,2
2023-06-01,21666,4,0,4,3,0,3
2023-06-01,395540,4,0,4,2,0,2
2023-06-01,7734,46,0,46,8,0,8
2023-06-01,33097,8,1,9,4,1,4
2023-06-01,46970,10,0,10,3,0,3
2023-06-01,400531,1,0,1,3,0,3
2023-06-01,1086,9,0,9,2,0,2
2023-06-01,46935,3,0,3,1,0,1
2023-06-01,25821,3,0,3,1,0,1
2023-06-01,40781,1,0,1,1,0,1
2023-06-01,23515,4,0,4,2,0,2
2023-06-01,30641,3,1,4,2,1,2
2023-06-01,33257,4,0,4,8,0,8
2023-06-01,397364,1,0,1,2,0,2
2023-06-01,29972,2,0,2,2,0,2
2023-06-01,46658,2,0,2,1,0,1
2023-06-01,14775,3,0,3,1,0,1
2023-06-01,53959,54,0,54,3,0,3
2023-06-01,40510,6,0,6,2,0,2
2023-06-01,14319,2,0,2,2,0,2
2023-06-01,32863,2,0,2,2,0,2
2023-06-01,36054,2,0,2,5,0,5
2023-06-01,394459,5,0,5,3,0,3
2023-06-01,18859,155,1,156,5,1,5
2023-06-01,45432,41,1,42,10,1,10
2023-06-01,394876,1,0,1,1,0,1
2023-06-01,20205,9,1,10,4,4,5
2023-06-01,54650,10,1,11,7,2,7
2023-06-01,395314,1,0,1,1,0,1
2023-06-01,397843,1,1,2,3,1,3
2023-06-01,400479,1,0,1,1,0,1
2023-06-01,398269,1,0,1,2,0,2
2023-06-01,398398,1,0,1,2,0,2
2023-06-01,27451,2,0,2,2,0,2
2023-06-01,32438,2,0,2,2,0,2
2023-06-01,892,2,0,2,3,0,3
2023-06-01,393484,1,0,1,1,0,1
2023-06-01,398348,1,0,1,1,0,1
2023-06-01,394346,5,2,7,1,1,1
2023-06-01,40220,15,5,20,15,8,15
2023-06-01,26476,7,0,7,4,0,4
2023-06-01,400409,5,0,5,3,0,3
2023-06-01,10298,12,0,12,4,0,4
2023-06-01,54583,3,0,3,3,0,3
2023-06-01,21788,27,2,29,7,1,7
2023-06-01,63130,3,0,3,1,0,1
2023-06-01,36225,5,0,5,6,0,6
2023-06-01,11077,4,0,4,6,0,6
2023-06-01,12212,36,2,38,10,5,10
2023-06-01,1100,8,0,8,5,0,5
2023-06-01,398488,7,3,10,1,1,1
2023-06-01,21552,27,0,27,2,0,2
2023-06-01,62717,1,0,1,2,0,2
2023-06-01,46686,1,0,1,1,0,1
2023-06-01,22113,31,1,32,5,1,5
2023-06-01,40362,2,0,2,4,0,4
2023-06-01,33604,5,1,6,8,3,8
2023-06-01,393515,1,0,1,1,0,1
2023-06-01,16413,5,1,6,1,2,2
2023-06-01,395019,2,1,3,2,1,2
2023-06-01,393346,1,0,1,3,0,3
2023-06-01,398745,1,0,1,3,0,3
2023-06-01,18929,3,0,3,3,0,3
2023-06-01,22554,2,0,2,2,0,2
2023-06-01,399765,2,0,2,2,0,2
2023-06-01,400453,2,0,2,1,0,1
2023-06-01,12183,15,1,16,3,1,3
2023-06-01,1996,4,1,5,4,1,4
2023-06-01,397473,3,0,3,4,0,4
2023-06-01,399275,12,0,12,5,0,5
2023-06-01,203410,2,0,2,5,0,5
2023-06-01,36445,36,0,36,5,0,5
2023-06-01,399647,10,0,10,11,0,11
2023-06-01,21644,1,0,1,1,0,1
2023-06-01,393989,3,0,3,2,0,2
2023-06-01,26441,3,0,3,1,0,1
2023-06-01,32212,30,0,30,3,0,3
2023-06-01,400302,3,1,4,2,2,2
2023-06-01,30622,3,1,4,3,1,4
2023-06-01,1065,1,0,1,2,0,2
2023-06-01,16664,14,0,14,2,0,2
2023-06-01,54531,2,0,2,4,0,4
2023-06-01,397162,7,0,7,5,0,5
2023-06-01,399462,1,1,2,4,2,4
2023-06-01,4905,4,0,4,2,0,2
2023-06-01,398211,2,0,2,4,0,4
2023-06-01,30216,2,0,2,1,0,1
2023-06-01,11586,1,0,1,1,0,1
2023-06-01,26215,5,0,5,2,0,2
2023-06-01,33540,2,0,2,4,0,4
2023-06-01,54751,1,0,1,3,0,3
2023-06-01,54620,3,0,3,4,0,4
2023-06-01,63252,10,2,12,4,2,4
2023-06-01,396175,1,0,1,1,0,1
2023-06-01,54441,2,0,2,1,0,1
2023-06-01,395096,1,0,1,1,0,1
2023-06-01,63071,3,0,3,2,0,2
2023-06-01,395282,3,1,4,3,1,3
2023-06-01,13469,2,0,2,4,0,4
2023-06-01,17397,8,0,8,3,0,3
2023-06-01,26932,13,0,13,1,0,1
2023-06-01,394830,8,0,8,3,0,3
2023-06-01,46251,2,0,2,2,0,2
2023-06-01,32945,9,1,10,4,4,4
2023-06-01,399527,8,0,8,2,0,2
2023-06-01,11804,3,0,3,3,0,3
2023-06-01,15050,1,0,1,1,0,1
2023-06-01,31769,6,1,7,7,3,7
2023-06-01,393329,1,0,1,1,0,1
2023-06-01,399311,1,0,1,1,0,1
2023-06-01,394005,5,0,5,3,0,3
2023-06-01,54431,7,1,8,3,3,3
2023-06-01,398230,5,1,6,3,1,3
2023-06-01,394883,10,0,10,2,0,2
2023-06-01,400111,4,0,4,3,0,3
2023-06-01,23438,2,0,2,4,0,4
2023-06-01,397377,5,0,5,1,0,1
2023-06-01,400206,1,0,1,1,0,1
2023-06-01,14016,1,0,1,2,0,2
2023-06-01,395374,1,0,1,1,0,1
2023-06-01,132283,1,0,1,1,0,1
2023-06-01,395743,18,0,18,8,0,8
2023-06-01,46394,2,0,2,4,0,4
2023-06-01,14120,12,0,12,3,0,3
2023-06-01,54566,2,0,2,2,0,2
2023-06-01,54748,3,0,3,4,0,4
2023-06-01,57624,28,0,28,4,0,4
2023-06-01,46806,2,0,2,3,0,3
2023-06-01,133010,6,0,6,3,0,3
2023-06-01,54183,15,0,15,2,0,2
2023-06-01,63241,1,0,1,3,0,3
2023-06-01,27390,2,0,2,4,0,4
2023-06-01,30967,20,0,20,5,0,5
2023-06-01,54897,1,0,1,3,0,3
2023-06-01,396078,1,0,1,1,0,1
2023-06-01,26154,1,0,1,3,0,3
2023-06-01,36100,16,0,16,2,0,2
2023-06-01,53591,4,2,6,7,4,7
2023-06-01,15320,5,0,5,3,0,3
2023-06-01,63104,4,0,4,2,0,2
2023-06-01,15065,90,1,91,4,1,4
2023-06-01,394771,3,0,3,2,0,2
2023-06-01,395719,5,1,6,3,2,3
2023-06-01,32455,1,0,1,2,0,2
2023-06-01,141167,41,2,43,14,3,14
2023-06-01,399077,542,9,551,19,9,20
2023-06-01,399064,4,0,4,1,0,1
2023-06-01,32890,44,1,45,7,3,8
2023-06-01,398479,7,1,8,5,2,5
2023-06-01,36223,59,9,68,1,2,2
2023-06-01,33001,4,0,4,5,0,5
2023-06-01,4374,3,0,3,3,0,3
2023-06-01,400299,1,0,1,1,0,1
2023-06-01,53769,2,0,2,4,0,4
2023-06-01,400137,2,0,2,2,0,2
2023-06-01,36684,1,0,1,1,0,1
2023-06-01,393278,12,1,13,4,1,4
2023-06-01,27499,1,0,1,1,0,1
2023-06-01,36326,2,1,3,1,1,1
2023-06-01,26413,6,1,7,3,3,3
2023-06-01,400014,1,0,1,1,0,1
2023-06-01,33621,5,0,5,3,0,3
2023-06-01,33557,1,0,1,1,0,1
2023-06-01,398644,1,0,1,2,0,2
2023-06-01,400183,4,0,4,2,0,2
2023-06-01,22754,2,0,2,1,0,1
2023-06-01,54343,1,0,1,1,0,1
2023-06-01,395748,32,5,37,6,3,6
2023-06-01,22742,73,2,75,30,7,30
2023-06-01,14144,9,0,9,2,0,2
2023-06-01,18762,4,0,4,1,0,1
2023-06-01,46979,3,0,3,3,0,3
2023-06-01,394717,2,0,2,2,0,2
2023-06-01,397836,8,1,9,4,2,4
2023-06-01,36249,3,0,3,6,0,6
2023-06-01,20378,2,0,2,1,0,1
2023-06-01,23356,2,0,2,3,0,3
2023-06-01,63430,16,1,17,5,2,5
2023-06-01,46644,1,1,2,1,2,2
2023-06-01,398480,2,0,2,1,0,1
2023-06-01,52438,15,2,17,2,2,2
2023-06-01,142580,5,1,6,7,3,7
2023-06-01,40784,6,0,6,2,0,2
2023-06-01,17216,28,4,32,11,7,13
2023-06-01,6231,6,0,6,2,0,2
2023-06-01,396408,1,0,1,1,0,1
2023-06-01,400164,3,1,4,1,1,1
2023-06-01,63219,8,0,8,2,0,2
2023-06-01,394108,1,0,1,1,0,1
2023-06-01,395798,2,0,2,1,0,1
2023-06-01,8097,2,0,2,4,0,4
2023-06-01,394984,7,0,7,5,0,5
2023-06-01,396916,1,0,1,2,0,2
2023-06-01,396041,3,0,3,4,0,4
2023-06-01,32810,3,0,3,2,0,2
2023-06-01,5108,6,0,6,2,0,2
2023-06-01,19098,2,0,2,1,0,1
2023-06-01,54744,7,0,7,3,0,3
2023-06-01,394869,16,0,16,6,0,6
2023-06-01,138571,39,3,42,10,4,10
2023-06-01,13444,13,0,13,3,0,3
2023-06-01,24373,12,2,14,10,1,10
2023-06-01,138527,15,0,15,4,0,4
2023-06-01,33137,1,0,1,2,0,2
2023-06-01,400427,2,1,3,3,3,3
2023-06-01,394356,6,1,7,2,1,2
2023-06-01,25920,1,0,1,2,0,2
2023-06-01,40604,2,0,2,2,0,2
2023-06-01,400431,1,0,1,1,0,1
2023-06-01,35978,2,0,2,3,0,3
2023-06-01,23103,1,0,1,2,0,2
2023-06-01,53818,3,0,3,2,0,2
2023-06-01,32646,1,0,1,1,0,1
2023-06-01,62672,1,0,1,3,0,3
2023-06-01,395252,2,0,2,3,0,3
2023-06-01,395668,2,0,2,2,0,2
2023-06-01,39944,6,0,6,3,0,3
2023-06-01,26831,79,2,81,5,2,5
2023-06-01,396368,2,0,2,1,0,1
2023-06-01,46691,3,1,4,3,3,3
2023-06-01,399595,1,0,1,1,0,1
2023-06-01,393871,2,0,2,3,0,3
2023-06-01,397536,3,0,3,3,0,3
2023-06-01,26126,2,0,2,2,0,2
2023-06-01,26653,1,0,1,3,0,3
2023-06-01,26508,1,0,1,1,0,1
2023-06-01,15249,1,0,1,1,0,1
2023-06-01,33236,17,1,18,3,1,3
2023-06-01,54594,2,1,3,2,1,2
2023-06-01,25840,10,0,10,3,0,3
2023-06-01,399188,2,0,2,1,0,1
2023-06-01,395088,12,0,12,4,0,4
2023-06-01,36435,2,1,3,1,1,1
2023-06-01,36640,3,0,3,4,0,4
2023-06-01,262184,10,0,10,1,0,1
2023-06-01,54078,1,0,1,1,0,1
2023-06-01,398362,2,0,2,1,0,1
2023-06-01,46265,3,0,3,1,0,1
2023-06-01,26968,12,3,15,7,3,7
2023-06-01,393544,8,4,12,5,3,5
2023-06-01,207893,1,2,3,3,4,5
2023-06-01,30394,2,0,2,3,0,3
2023-06-01,25837,2,0,2,4,0,4
2023-06-01,400407,1,0,1,2,0,2
2023-06-01,62523,22,0,22,8,0,8
2023-06-01,18807,2,0,2,4,0,4
2023-06-01,394205,4,0,4,3,0,3
2023-06-01,53980,4,0,4,3,0,3
2023-06-01,55284,2,0,2,3,0,3
2023-06-01,393664,1,0,1,2,0,2
2023-06-01,27385,21,6,27,9,5,9
2023-06-01,50881,10,6,16,3,3,3
2023-06-01,398409,1,0,1,3,0,3
2023-06-01,397496,0,1,1,3,2,3
2023-06-01,31753,15,1,16,1,1,1
2023-06-01,398347,3,0,3,2,0,2
2023-06-01,3653,2,1,3,5,4,5
2023-06-01,30212,6,0,6,1,0,1
2023-06-01,393783,2,0,2,3,0,3
2023-06-01,30247,11,5,16,8,3,8
2023-06-01,136744,64,1,65,17,2,18
2023-06-01,18480,3,0,3,1,0,1
2023-06-01,20007,3,0,3,3,0,3
2023-06-01,19746,24,0,24,2,0,2
2023-06-01,27775,393,1,394,7,5,7
2023-06-01,399642,1,0,1,2,0,2
2023-06-01,395916,4,0,4,1,0,1
2023-06-01,27759,32,1,33,6,3,6
2023-06-01,27029,2,0,2,2,0,2
2023-06-01,26446,2,0,2,4,0,4
2023-06-01,18778,5,0,5,3,0,3
2023-06-01,396449,1,0,1,1,0,1
2023-06-01,11959,1,0,1,2,0,2
2023-06-01,6924,2,0,2,3,0,3
2023-06-01,17355,1,0,1,1,0,1
2023-06-01,62631,4,0,4,5,0,5
2023-06-01,27360,2,1,3,3,1,3
2023-06-01,396939,1,0,1,2,0,2
2023-06-01,395466,3,1,4,6,6,7
2023-06-01,46281,24,0,24,3,0,3
2023-06-01,19367,8,4,12,2,3,4
2023-06-01,33089,6,1,7,2,2,2
2023-06-01,395392,1,0,1,2,0,2
2023-06-01,63353,8,0,8,2,0,2
2023-06-01,26725,14,0,14,7,0,7
2023-06-01,54488,5,0,5,2,0,2
2023-06-01,27578,3,0,3,4,0,4
2023-06-01,20474,22,0,22,5,0,5
2023-06-01,393570,1,0,1,2,0,2
2023-06-01,55080,3,0,3,2,0,2
2023-06-01,62820,2,0,2,3,0,3
2023-06-01,398404,1,0,1,3,0,3
2023-06-01,40853,1,0,1,3,0,3
2023-06-01,14669,8,0,8,5,0,5
2023-06-01,40118,2,0,2,2,0,2
2023-06-01,63070,1,0,1,2,0,2
2023-06-01,25630,1,0,1,2,0,2
2023-06-01,32534,1,0,1,3,0,3
2023-06-01,27335,1,0,1,1,0,1
2023-06-01,393642,2,0,2,2,0,2
2023-06-01,6434,1,0,1,2,0,2
2023-06-01,393800,1,0,1,2,0,2
2023-06-01,395085,1,0,1,1,0,1
2023-06-01,14300,3,0,3,2,0,2
2023-06-01,400664,1,0,1,1,0,1
2023-06-01,46799,2,0,2,4,0,4
2023-06-01,14238,14,0,14,3,0,3
2023-06-01,394295,1,0,1,2,0,2
2023-06-01,397312,6,1,7,3,1,3
2023-06-01,19730,6,0,6,3,0,3
2023-06-01,395495,1,0,1,1,0,1
2023-06-01,40128,7,0,7,11,0,11
2023-06-01,62923,1,0,1,1,0,1
2023-06-01,398854,2,0,2,1,0,1
2023-06-01,397048,2,0,2,4,0,4
2023-06-01,16986,2,0,2,3,0,3
2023-06-01,395730,2,2,4,3,3,3
2023-06-01,394342,3,0,3,4,0,4
2023-06-01,21581,20,3,23,5,6,6
2023-06-01,53382,1,0,1,2,0,2
2023-06-01,36484,1,0,1,3,0,3
2023-06-01,40255,1,0,1,1,0,1
2023-06-01,63256,1,0,1,2,0,2
2023-06-01,46548,2,0,2,1,0,1
2023-06-01,40303,1,0,1,3,0,3
2023-06-01,394442,1,0,1,2,0,2
2023-06-01,30038,3,0,3,2,0,2
2023-06-01,40296,1,0,1,1,0,1
2023-06-01,18689,2,0,2,1,0,1
2023-06-01,396085,2,0,2,4,0,4
2023-06-01,26686,1,0,1,2,0,2
2023-06-01,11888,420,2,422,11,5,11
2023-06-01,63051,3,1,4,2,1,2
2023-06-01,396122,62,0,62,3,0,3
2023-06-01,13837,4,1,5,8,2,8
2023-06-01,398213,1,0,1,1,0,1
2023-06-01,14761,1,0,1,3,0,3
2023-06-01,29786,1,0,1,3,0,3
2023-06-01,10653,2,1,3,3,1,3
2023-06-01,18684,2,0,2,4,0,4
2023-06-01,23406,2,0,2,3,0,3
2023-06-01,19359,1,0,1,1,0,1
2023-06-01,19543,1,0,1,3,0,3
2023-06-01,29746,2,0,2,4,0,4
2023-06-01,396527,3,0,3,1,0,1
2023-06-01,30140,6,0,6,3,0,3
2023-06-01,11847,71,2,73,7,2,7
2023-06-01,62695,9,1,10,2,2,2
2023-06-01,11291,1,0,1,1,0,1
2023-06-01,53454,5,1,6,5,3,6
2023-06-01,397571,1,0,1,4,0,4
2023-06-01,40511,35,1,36,12,1,12
2023-06-01,30471,2,0,2,2,0,2
2023-06-01,35960,8,1,9,3,1,3
2023-06-01,63294,3,1,4,1,1,1
2023-06-01,15266,1,0,1,1,0,1
2023-06-01,54270,3,0,3,1,0,1
2023-06-01,25952,3,0,3,2,0,2
2023-06-01,17357,1,0,1,1,0,1
2023-06-01,397067,1,0,1,3,0,3
2023-06-01,396405,1,0,1,2,0,2
2023-06-01,27457,1,0,1,3,0,3
2023-06-01,18543,1,0,1,1,0,1
2023-06-01,46390,1,0,1,3,0,3
2023-06-01,39957,4,0,4,3,0,3
2023-06-01,32772,1,0,1,1,0,1
2023-06-01,18698,1,0,1,3,0,3
2023-06-01,394178,1,0,1,2,0,2
2023-06-01,395673,1,0,1,3,0,3
2023-06-01,395029,6,0,6,2,0,2
2023-06-01,36661,1,0,1,2,0,2
2023-06-01,36539,3,0,3,3,0,3
2023-06-01,27245,1,0,1,3,0,3
2023-06-01,399521,11,1,12,6,3,6
2023-06-01,32884,2,0,2,2,0,2
2023-06-01,395321,2,0,2,4,0,4
2023-06-01,19860,3,0,3,3,0,3
2023-06-01,32446,4,0,4,1,0,1
2023-06-01,7415,2,0,2,3,0,3
2023-06-01,55152,1,0,1,3,0,3
2023-06-01,22722,1,0,1,1,0,1
2023-06-01,395988,2,0,2,2,0,2
2023-06-01,393600,1,0,1,1,0,1
2023-06-01,33480,64,10,74,10,5,10
2023-06-01,53577,10,0,10,2,0,2
2023-06-01,53579,1,0,1,1,0,1
2023-06-01,53381,2,0,2,2,0,2
2023-06-01,393500,1,0,1,3,0,3
2023-06-01,40167,1,0,1,1,0,1
2023-06-01,394975,2,0,2,2,0,2
2023-06-01,394434,21,0,21,7,0,7
2023-06-01,53268,3,0,3,4,0,4
2023-06-01,55075,2,0,2,1,0,1
2023-06-01,22389,1,0,1,3,0,3
2023-06-01,30469,1,0,1,1,0,1
2023-06-01,32355,1,0,1,2,0,2
2023-06-01,32452,3,0,3,2,0,2
2023-06-01,19214,3,1,4,5,4,5
2023-06-01,30266,1,0,1,1,0,1
2023-06-01,36776,40,0,40,9,0,9
2023-06-01,394993,3,0,3,4,0,4
2023-06-01,36323,2,0,2,1,0,1
2023-06-01,54185,2,0,2,5,0,5
2023-06-01,394557,2,0,2,3,0,3
2023-06-01,26455,6,0,6,3,0,3
2023-06-01,393229,2,0,2,1,0,1
2023-06-01,11636,1,0,1,2,0,2
2023-06-01,36615,1,0,1,1,0,1
2023-06-01,22626,3,0,3,1,0,1
2023-06-01,46447,1,0,1,1,0,1
2023-06-01,28431,5,5,10,4,3,4
2023-06-01,398235,1,1,2,2,1,2
2023-06-01,395507,1,0,1,1,0,1
2023-06-01,40353,4,0,4,3,0,3
2023-06-01,19316,2,0,2,2,0,2
2023-06-01,396989,4,0,4,2,0,2
2023-06-01,394957,4,0,4,4,0,4
2023-06-01,63142,5,0,5,5,0,5
2023-06-01,63261,1,0,1,3,0,3
2023-06-01,32565,1,0,1,3,0,3
2023-06-01,54480,1,1,2,1,1,1
2023-06-01,32936,1,0,1,1,0,1
2023-06-01,397655,2,0,2,3,0,3
2023-06-01,11597,36,0,36,2,0,2
2023-06-01,400684,6,0,6,1,0,1
2023-06-01,33509,14,2,16,4,2,4
2023-06-01,55214,15,0,15,5,0,5
2023-06-01,32650,1,0,1,1,0,1
2023-06-01,15092,5,3,8,6,4,7
2023-06-01,18457,1,0,1,1,0,1
2023-06-01,26778,1,0,1,3,0,3
2023-06-01,54143,1,0,1,3,0,3
2023-06-01,17388,2,0,2,2,0,2
2023-06-01,393351,1,0,1,1,0,1
2023-06-01,29787,17,0,17,4,0,4
2023-06-01,36246,2,0,2,1,0,1
2023-06-01,396051,1,0,1,1,0,1
2023-06-01,33100,1,0,1,1,0,1
2023-06-01,36340,1,0,1,2,0,2
2023-06-01,208621,8,6,14,11,11,14
2023-06-01,14725,17,0,17,6,0,6
2023-06-01,64208,17,0,17,8,0,8
2023-06-01,5022,2,0,2,2,0,2
2023-06-01,17145,2,0,2,3,0,3
2023-06-01,36033,3,0,3,2,0,2
2023-06-01,18608,6,0,6,7,0,7
2023-06-01,13985,1,0,1,1,0,1
2023-06-01,7219,2,1,3,8,3,9
2023-06-01,16560,4,0,4,5,0,5
2023-06-01,20081,16,0,16,7,0,7
2023-06-01,32938,2,0,2,1,0,1
2023-06-01,25677,3,0,3,2,0,2
2023-06-01,33215,2,0,2,3,0,3
2023-06-01,22187,2,0,2,2,0,2
2023-06-01,26832,22,1,23,2,2,2
2023-06-01,23471,5,0,5,2,0,2
2023-06-01,394369,3,0,3,3,0,3
2023-06-01,11627,1,0,1,1,0,1
2023-06-01,398249,2,0,2,2,0,2
2023-06-01,19024,19,1,20,37,7,37
2023-06-01,40695,4,0,4,6,0,6
2023-06-01,40930,1,0,1,3,0,3
2023-06-01,29748,19,2,21,11,3,12
2023-06-01,26483,1,0,1,2,0,2
2023-06-01,33407,1,0,1,1,0,1
2023-06-01,33577,1,0,1,3,0,3
2023-06-01,55289,1,0,1,1,0,1
2023-06-01,63231,1,0,1,1,0,1
2023-06-01,36106,3,0,3,3,0,3
2023-06-01,21886,19,0,19,8,0,8
2023-06-01,7226,65,1,66,7,6,7
2023-06-01,16626,1,1,2,1,1,1
2023-06-01,398256,2,0,2,1,0,1
2023-06-01,54149,2,0,2,1,0,1
2023-06-01,15301,6,2,8,7,2,7
2023-06-01,53708,4,3,7,6,3,7
2023-06-01,14380,6,1,7,14,4,15
2023-06-01,205329,2,8,10,5,12,12
2023-06-01,983,2,0,2,18,14,24
2023-06-01,25849,2,0,2,1,0,1
2023-06-01,16843,24,1,25,2,1,2
2023-06-01,11457,1,0,1,2,0,2
2023-06-01,44431,4,0,4,4,0,4
2023-06-01,9658,546,1,547,51,9,52
2023-06-01,11088,1,0,1,1,0,1
2023-06-01,46314,4,0,4,3,0,3
2023-06-01,22830,2,0,2,1,0,1
2023-06-01,21986,1,0,1,1,0,1
2023-06-01,398968,27,0,27,5,0,5
2023-06-01,1825,2,0,2,3,0,3
2023-06-01,12157,2,0,2,4,0,4
2023-06-01,53331,1,0,1,2,0,2
2023-06-01,23325,1,0,1,3,0,3
2023-06-01,16407,1,0,1,2,0,2
2023-06-01,26997,1,0,1,1,0,1
2023-06-01,46587,2,0,2,3,0,3
2023-06-01,23194,1,0,1,1,0,1
2023-06-01,33709,1,0,1,2,0,2
2023-06-01,26738,1,0,1,2,0,2
2023-06-01,32761,1,0,1,3,0,3
2023-06-01,19427,1,0,1,2,0,2
2023-06-01,11903,1,0,1,3,0,3
2023-06-01,19601,1,0,1,3,0,3
2023-06-01,40577,1,0,1,3,0,3
2023-06-01,397119,1,0,1,3,0,3
2023-06-01,32663,1,0,1,3,0,3
2023-06-01,40825,1,0,1,1,0,1
2023-06-01,14360,4,0,4,3,0,3
2023-06-01,18564,9,0,9,4,0,4
2023-06-01,14969,13,0,13,10,0,10
2023-06-01,17028,1,0,1,3,0,3
2023-06-01,22478,1,0,1,3,0,3
2023-06-01,397266,1,0,1,1,0,1
2023-06-01,19970,7,0,7,4,0,4
2023-06-01,40827,2,0,2,3,0,3
2023-06-01,30593,2,0,2,4,0,4
2023-06-01,22651,1,1,2,1,1,1
2023-06-01,55799,72,1,73,14,5,16
2023-06-01,397826,1,0,1,2,0,2
2023-06-01,397719,3,0,3,4,0,4
2023-06-01,131917,5,0,5,3,0,3
2023-06-01,46185,4,0,4,3,0,3
2023-06-01,30202,7,0,7,4,0,4
2023-06-01,16752,1,0,1,1,0,1
2023-06-01,397508,1,0,1,1,0,1
2023-06-01,26208,2,0,2,2,0,2
2023-06-01,398287,2,0,2,1,0,1
2023-06-01,19955,54,0,54,4,0,4
2023-06-01,396850,1,0,1,3,0,3
2023-06-01,26660,2,0,2,4,0,4
2023-06-01,399112,1,0,1,1,0,1
2023-06-01,33151,4,0,4,1,0,1
2023-06-01,27387,1,0,1,1,0,1
2023-06-01,25614,1,0,1,2,0,2
2023-06-01,32612,1,0,1,3,0,3
2023-06-01,46226,1,0,1,3,0,3
2023-06-01,46436,3,0,3,5,0,5
2023-06-01,46503,1,0,1,1,0,1
2023-06-01,15069,7,0,7,4,0,4
2023-06-01,54642,1,0,1,1,0,1
2023-06-01,53259,32,2,34,2,2,2
2023-06-01,46952,2,0,2,2,0,2
2023-06-01,394601,2,0,2,3,0,3
2023-06-01,53865,3,0,3,5,0,5
2023-06-01,27229,57,0,57,4,0,4
2023-06-01,20159,1,0,1,2,0,2
2023-06-01,394229,6,1,7,4,1,4
2023-06-01,33345,3,1,4,2,2,2
2023-06-01,33154,26,2,28,44,9,44
2023-06-01,396117,1,0,1,1,0,1
2023-06-01,36414,1,0,1,1,0,1
2023-06-01,26189,3,0,3,2,0,2
2023-06-01,30018,2,0,2,4,0,4
2023-06-01,973,2,0,2,1,0,1
2023-06-01,13907,3,0,3,2,0,2
2023-06-01,54418,1,0,1,1,0,1
2023-06-01,63114,1,0,1,3,0,3
2023-06-01,63470,2,1,3,1,1,1
2023-06-01,400073,1,0,1,3,0,3
2023-06-01,27566,8,3,11,15,5,15
2023-06-01,26688,1,0,1,4,0,4
2023-06-01,36725,1,0,1,2,0,2
2023-06-01,32942,1,0,1,3,0,3
2023-06-01,62966,3,0,3,5,0,5
2023-06-01,53559,62,0,62,3,0,3
2023-06-01,54993,4,0,4,4,0,4
2023-06-01,40879,1,0,1,1,0,1
2023-06-01,46355,1,0,1,1,0,1
2023-06-01,395147,1,0,1,2,0,2
2023-06-01,46397,1,0,1,3,0,3
2023-06-01,393731,5,0,5,7,0,7
2023-06-01,46667,6,0,6,6,0,6
2023-06-01,46993,1,0,1,1,0,1
2023-06-01,1622,1,0,1,2,0,2
2023-06-01,25788,1,0,1,1,0,1
2023-06-01,6244,1,0,1,3,0,3
2023-06-01,30050,1,0,1,3,0,3
2023-06-01,40841,16,0,16,7,0,7
2023-06-01,16665,1,0,1,1,0,1
2023-06-01,53516,1,0,1,3,0,3
2023-06-01,27204,5,0,5,5,0,5
2023-06-01,398294,1,0,1,1,0,1
2023-06-01,30565,1,0,1,1,0,1
2023-06-01,42228,6,2,8,12,6,12
2023-06-01,54087,1,0,1,3,0,3
2023-06-01,46287,1,0,1,1,0,1
2023-06-01,30590,1,0,1,2,0,2
2023-06-01,40811,1,0,1,3,0,3
2023-06-01,20078,1,0,1,3,0,3
2023-06-01,22151,2,0,2,3,0,3
2023-06-01,36266,1,0,1,3,0,3
2023-06-01,17078,2,0,2,3,0,3
2023-06-01,27585,3,0,3,2,0,2
2023-06-01,54795,1,0,1,1,0,1
2023-06-01,396868,2,0,2,2,0,2
2023-06-01,22044,1,0,1,1,0,1
2023-06-01,23004,3,0,3,4,0,4
2023-06-01,4136,18,1,19,15,4,15
2023-06-01,32467,3,0,3,2,0,2
2023-06-01,14742,30,1,31,18,7,19
2023-06-01,26654,14,0,14,6,0,6
2023-06-01,393415,4,0,4,4,0,4
2023-06-01,395654,2,0,2,1,0,1
2023-06-01,64201,1,0,1,1,0,1
2023-06-01,32503,2,0,2,1,0,1
2023-06-01,40437,3,0,3,4,0,4
2023-06-01,36703,4,0,4,3,0,3
2023-06-01,13790,6,1,7,8,4,8
2023-06-01,26550,6,0,6,2,0,2
2023-06-01,26747,17,0,17,3,0,3
2023-06-01,400707,1,0,1,1,0,1
2023-06-01,11128,3,0,3,3,0,3
2023-06-01,64250,3,0,3,3,0,3
2023-06-01,30503,1,0,1,2,0,2
2023-06-01,54435,1,0,1,1,0,1
2023-06-01,64261,5,0,5,2,0,2
2023-06-01,2728,3,1,4,5,1,5
2023-06-01,23015,2,0,2,5,0,5
2023-06-01,230105,1,0,1,1,0,1
2023-06-01,30417,14,0,14,10,0,10
2023-06-01,46763,1,0,1,1,0,1
2023-06-01,395792,1,0,1,2,0,2
2023-06-01,33748,31,0,31,5,0,5
2023-06-01,14705,2,0,2,2,0,2
2023-06-01,209479,7,0,7,3,0,3
2023-06-01,397758,1,0,1,3,0,3
2023-06-01,63404,3,0,3,1,0,1
2023-06-01,33063,1,0,1,1,0,1
2023-06-01,54693,1,0,1,1,0,1
2023-06-01,18724,1,0,1,1,0,1
2023-06-01,15027,3,0,3,3,0,3
2023-06-01,393333,2,0,2,2,0,2
2023-06-01,30474,1,0,1,2,0,2
2023-06-01,395225,3,0,3,3,0,3
2023-06-01,32489,71,26,97,8,7,10
2023-06-01,36529,49,0,49,3,0,3
2023-06-01,62563,17,4,21,8,6,8
2023-06-01,62550,4,0,4,2,0,2
2023-06-01,46822,1,0,1,3,0,3
2023-06-01,4897,1,0,1,2,0,2
2023-06-01,398169,3,0,3,2,0,2
2023-06-01,54932,24,0,24,3,0,3
2023-06-01,31957,9,0,9,2,0,2
2023-06-01,19188,1,0,1,3,0,3
2023-06-01,63141,2,0,2,4,0,4
2023-06-01,23013,1,0,1,1,0,1
2023-06-01,50088,3,0,3,3,0,3
2023-06-01,14991,9,0,9,3,0,3
2023-06-01,32756,2,0,2,2,0,2
2023-06-01,46734,2,0,2,2,0,2
2023-06-01,29873,53,1,54,5,2,5
2023-06-01,22904,6,0,6,3,0,3
2023-06-01,36737,3,0,3,2,0,2
2023-06-01,26750,1,0,1,1,0,1
2023-06-01,14611,3,0,3,2,0,2
2023-06-01,22926,15,1,16,3,1,3
2023-06-01,46906,17,0,17,2,0,2
2023-06-01,27208,1,0,1,1,0,1
2023-06-01,397550,7,1,8,3,2,3
2023-06-01,54336,1,0,1,1,0,1
2023-06-01,27166,1,0,1,2,0,2
2023-06-01,32744,2,0,2,2,0,2
2023-06-01,34,3,0,3,5,0,5
2023-06-01,27361,1,0,1,1,0,1
2023-06-01,26629,1,0,1,1,0,1
2023-06-01,32654,20,1,21,1,1,1
2023-06-01,32846,1,0,1,1,0,1
2023-06-01,25975,9,0,9,4,0,4
2023-06-01,394821,2,0,2,1,0,1
2023-06-01,11703,1,0,1,1,0,1
2023-06-01,394085,7,0,7,2,0,2
2023-06-01,40474,5,2,7,2,2,2
2023-06-01,203177,7,0,7,3,0,3
2023-06-01,4373,11,0,11,1,0,1
2023-06-01,32607,3,0,3,4,0,4
2023-06-01,14418,8,0,8,2,0,2
2023-06-01,27533,5,0,5,1,0,1
2023-06-01,30489,2,0,2,2,0,2
2023-06-01,32171,1,0,1,1,0,1
2023-06-01,14465,1,0,1,3,0,3
2023-06-01,18885,13,0,13,6,0,6
2023-06-01,32493,1,0,1,3,0,3
2023-06-01,22449,2,0,2,3,0,3
2023-06-01,12218,2,0,2,2,0,2
2023-06-01,15235,1,1,2,1,1,1
2023-06-01,19116,16,1,17,6,4,7
2023-06-01,398704,25,30,55,13,9,13
2023-06-01,9246,12,1,13,13,7,14
2023-06-01,41032,18,2,20,13,4,14
2023-06-01,207138,6,0,6,5,0,5
2023-06-01,398044,3,1,4,5,2,5
2023-06-01,40683,3,0,3,2,0,2
2023-06-01,13845,9,1,10,5,1,5
2023-06-01,22890,3,0,3,1,0,1
2023-06-01,62680,1,0,1,1,0,1
2023-06-01,399503,3,0,3,4,0,4
2023-06-01,53900,1,0,1,3,0,3
2023-06-01,25831,1,0,1,1,0,1
2023-06-01,12072,1,0,1,3,0,3
2023-06-01,23499,1,0,1,1,0,1
2023-06-01,36227,1,0,1,3,0,3
2023-06-01,394065,38,0,38,9,0,9
2023-06-01,40719,1,0,1,3,0,3
2023-06-01,14310,1,0,1,3,0,3
2023-06-01,46208,34,6,40,12,6,12
2023-06-01,14606,2,0,2,2,0,2
2023-06-01,36048,6,2,8,2,1,2
2023-06-01,398494,1,0,1,3,0,3
2023-06-01,40166,2,0,2,1,0,1
2023-06-01,265524,18,9,27,6,4,6
2023-06-01,36443,24,0,24,8,0,8
2023-06-01,6343,3,0,3,2,0,2
2023-06-01,397384,3,2,5,2,1,2
2023-06-01,396839,3,0,3,2,0,2
2023-06-01,263812,24,19,43,17,16,19
2023-06-01,263167,15,2,17,7,3,7
2023-06-01,14237,20,1,21,5,4,5
2023-06-01,53721,4,0,4,3,0,3
2023-06-01,394187,2,0,2,2,0,2
2023-06-01,32391,8,1,9,5,4,5
2023-06-01,1355,2,0,2,1,0,1
2023-06-01,393285,1,0,1,2,0,2
2023-06-01,26018,1,0,1,1,0,1
2023-06-01,11428,3,0,3,3,0,3
2023-06-01,397125,1,0,1,1,0,1
2023-06-01,29886,4,1,5,2,1,2
2023-06-01,399790,4,0,4,1,0,1
2023-06-01,36716,1,0,1,3,0,3
2023-06-01,270150,4,0,4,2,0,2
2023-06-01,270179,1,1,2,1,1,2
2023-06-01,20075,3,0,3,3,0,3
2023-06-01,19931,6,0,6,2,0,2
2023-06-01,10886,9,4,13,28,19,28
2023-06-01,54514,1,0,1,3,0,3
2023-06-01,394980,1,0,1,1,0,1
2023-06-01,397394,14,0,14,2,0,2
2023-06-01,16764,1,0,1,3,0,3
2023-06-01,14350,2,0,2,2,0,2
2023-06-01,54894,1,0,1,1,0,1
2023-06-01,30339,1,0,1,1,0,1
2023-06-01,393925,2,0,2,4,0,4
2023-06-01,394427,4,0,4,3,0,3
2023-06-01,396174,1,0,1,1,0,1
2023-06-01,55253,2,0,2,2,0,2
2023-06-01,53552,1,0,1,3,0,3
2023-06-01,395603,1,0,1,1,0,1
2023-06-01,53521,2,0,2,2,0,2
2023-06-01,11931,2,0,2,3,0,3
2023-06-01,61429,18,0,18,4,0,4
2023-06-01,22917,1,0,1,3,0,3
2023-06-01,4058,213,21,234,36,11,37
2023-06-01,14483,1,0,1,1,0,1
2023-06-01,54096,1,0,1,1,0,1
2023-06-01,16754,2,0,2,1,0,1
2023-06-01,64243,3,0,3,3,0,3
2023-06-01,63438,1,0,1,1,0,1
2023-06-01,4903,1,0,1,1,0,1
2023-06-01,32913,5,4,9,3,2,3
2023-06-01,395620,1,0,1,1,0,1
2023-06-01,1422,2,0,2,1,0,1
2023-06-01,27399,8,0,8,4,0,4
2023-06-01,11825,2,0,2,4,0,4
2023-06-01,35901,4,0,4,2,0,2
2023-06-01,46131,6,0,6,5,0,5
2023-06-01,398670,2,0,2,1,0,1
2023-06-01,265264,33,3,36,9,3,9
2023-06-01,32056,2,0,2,2,0,2
2023-06-01,400272,1,0,1,1,0,1
2023-06-01,963,1,0,1,1,0,1
2023-06-01,397578,1,0,1,1,0,1
2023-06-01,399907,2,0,2,1,0,1
2023-06-01,396410,4,0,4,3,0,3
2023-06-01,396914,1,0,1,3,0,3
2023-06-01,40593,2,0,2,2,0,2
2023-06-01,395436,1,0,1,3,0,3
2023-06-01,25829,6,1,7,6,2,6
2023-06-01,400467,1,0,1,1,0,1
2023-06-01,18670,2,0,2,4,0,4
2023-06-01,63191,3,0,3,1,0,1
2023-06-01,394326,11,0,11,2,0,2
2023-06-01,13545,1,0,1,1,0,1
2023-06-01,36666,12,2,14,5,3,5
2023-06-01,400032,2,0,2,2,0,2
2023-06-01,53414,6,0,6,2,0,2
2023-06-01,395479,16,0,16,3,0,3
2023-06-01,20171,3,0,3,3,0,3
2023-06-01,398286,1,0,1,1,0,1
2023-06-01,30174,11,1,12,6,3,6
2023-06-01,200904,16,0,16,10,0,10
2023-06-01,62826,1,0,1,1,0,1
2023-06-01,32545,1,0,1,1,0,1
2023-06-01,29952,2,0,2,3,0,3
2023-06-01,14726,7,0,7,3,0,3
2023-06-01,395862,1,0,1,1,0,1
2023-06-01,63242,18,0,18,5,0,5
2023-06-01,4890,1,0,1,3,0,3
2023-06-01,3112,42,0,42,39,0,39
2023-06-01,30298,2,0,2,3,0,3
2023-06-01,11191,76,0,76,7,0,7
2023-06-01,22075,9,0,9,5,0,5
2023-06-01,54882,4,0,4,3,0,3
2023-06-01,16534,2,0,2,2,0,2
2023-06-01,40221,6,0,6,1,0,1
2023-06-01,25841,2,0,2,3,0,3
2023-06-01,399654,1,0,1,3,0,3
2023-06-01,212158,1,0,1,3,0,3
2023-06-01,396534,2,0,2,2,0,2
2023-06-01,62789,1,0,1,3,0,3
2023-06-01,53664,3,0,3,3,0,3
2023-06-01,397017,1,0,1,1,0,1
2023-06-01,16830,3,0,3,5,0,5
2023-06-01,39979,2,0,2,2,0,2
2023-06-01,63064,1,0,1,1,0,1
2023-06-01,64277,3,0,3,4,0,4
2023-06-01,210800,1,0,1,2,0,2
2023-06-01,55061,1,0,1,1,0,1
2023-06-01,26821,1,0,1,1,0,1
2023-06-01,22369,3,0,3,3,0,3
2023-06-01,63383,11,0,11,10,0,10
2023-06-01,394225,3,0,3,2,0,2
2023-06-01,395371,2,0,2,2,0,2
2023-06-01,46212,1,0,1,1,0,1
2023-06-01,4888,1,0,1,1,0,1
2023-06-01,397341,1,0,1,1,0,1
2023-06-01,26398,1,0,1,2,0,2
2023-06-01,399390,1,0,1,1,0,1
2023-06-01,395390,2,0,2,1,0,1
2023-06-01,23657,42,0,42,2,0,2
2023-06-01,397530,1,0,1,1,0,1
2023-06-01,393802,2,1,3,2,2,2
2023-06-01,63237,1,0,1,1,0,1
2023-06-01,396406,3,0,3,3,0,3
2023-06-01,398267,1,0,1,2,0,2
2023-06-01,15234,8,0,8,4,0,4
2023-06-01,393446,1,0,1,1,0,1
2023-06-01,133661,155,6,161,10,2,11
2023-06-01,396010,31,0,31,2,0,2
2023-06-01,31762,1,0,1,1,0,1
2023-06-01,26223,16,1,17,14,7,16
2023-06-01,395478,1,0,1,4,0,4
2023-06-01,397442,1,0,1,3,0,3
2023-06-01,394273,4,0,4,2,0,2
2023-06-01,36126,2,0,2,3,0,3
2023-06-01,396509,15,1,16,3,1,3
2023-06-01,62667,3,0,3,4,0,4
2023-06-01,19752,39,3,42,23,6,23
2023-06-01,16698,19,0,19,4,0,4
2023-06-01,395891,3,0,3,3,0,3
2023-06-01,54384,2,0,2,3,0,3
2023-06-01,40955,2,1,3,2,2,2
2023-06-01,21785,2,1,3,2,1,2
2023-06-01,23235,4,0,4,1,0,1
2023-06-01,394093,1,0,1,2,0,2
2023-06-01,398448,2,0,2,4,0,4
2023-06-01,397533,1,0,1,3,0,3
2023-06-01,23078,3,0,3,3,0,3
2023-06-01,18646,2,0,2,2,0,2
2023-06-01,46660,1,0,1,2,0,2
2023-06-01,397761,1,0,1,1,0,1
2023-06-01,62683,2,0,2,2,0,2
2023-06-01,19984,2,0,2,2,0,2
2023-06-01,394563,11,0,11,5,0,5
2023-06-01,33599,1,0,1,1,0,1
2023-06-01,139659,30,0,30,3,0,3
2023-06-01,133861,19,0,19,2,0,2
2023-06-01,133199,246,0,246,11,0,11
2023-06-01,399353,2,0,2,1,0,1
2023-06-01,7341,6,0,6,9,0,9
2023-06-01,202662,9,2,11,6,5,7
2023-06-01,56030,27,3,30,17,11,19
2023-06-01,269096,9,1,10,71,48,72
2023-06-01,52762,41,5,46,5,4,5
2023-06-01,266178,6,3,9,8,7,8
2023-06-01,141642,5,2,7,6,2,6
2023-06-01,272156,1,1,2,2,2,2
2023-06-01,269558,7,7,14,9,9,11
2023-06-01,271746,3,7,10,1,1,1
2023-06-01,265622,3,2,5,2,2,2
2023-06-01,271327,6,3,9,1,1,1
2023-06-01,263097,13,7,20,18,11,20
2023-06-01,266584,4,4,8,11,6,11
2023-06-01,264509,8,5,13,7,4,8
2023-06-01,265435,10,3,13,7,5,7
2023-06-01,271668,1,4,5,6,7,7
2023-06-01,45804,128,24,152,13,5,13
2023-06-01,27458,1,0,1,1,0,1
2023-06-01,272739,3,5,8,4,3,4
2023-06-01,263966,17,37,54,45,27,47
2023-06-01,202561,13,0,13,3,0,3
2023-06-01,263726,9,4,13,4,2,4
2023-06-01,268798,4,2,6,5,2,6
2023-06-01,272943,1,1,2,1,1,1
2023-06-01,273678,1,1,2,1,1,1
2023-06-01,267833,5,0,5,4,0,4
2023-06-01,272046,2,0,2,2,0,2
2023-06-01,272137,2,4,6,1,2,2
2023-06-01,264195,5,2,7,6,3,6
2023-06-01,262740,22,7,29,49,32,51
2023-06-01,52965,95,55,150,123,73,132
2023-06-01,142307,3,1,4,4,1,4
2023-06-01,265606,8,1,9,3,1,3
2023-06-01,272534,3,2,5,2,1,2
2023-06-01,269946,3,1,4,4,3,4
2023-06-01,272946,2,1,3,1,1,1
2023-06-01,272882,10,1,11,1,1,1
2023-06-01,272013,1,1,2,1,1,1
2023-06-01,262907,203,8,211,68,46,72
2023-06-01,52547,19,8,27,8,7,9
2023-06-01,272157,1,2,3,1,1,1
2023-06-01,272940,1,0,1,1,0,1
2023-06-01,272819,1,1,2,2,1,2
2023-06-01,33647,56,0,56,4,0,4
2023-06-01,398052,24,1,25,3,1,3
2023-06-01,272838,2,1,3,2,2,2
2023-06-01,271977,1,2,3,2,1,2
2023-06-01,273658,3,3,6,7,7,9
2023-06-01,262490,7,3,10,9,8,11
2023-06-01,265695,4,3,7,4,4,4
2023-06-01,272867,5,1,6,1,1,1
2023-06-01,265856,13,1,14,2,1,2
2023-06-01,52465,35,0,35,7,0,7
2023-06-01,25798,2,0,2,2,0,2
2023-06-01,6300,55,1,56,21,3,21
2023-06-01,63001,2,0,2,1,0,1
2023-06-01,54340,2,0,2,1,0,1
2023-06-01,11943,4,0,4,1,0,1
2023-06-01,394911,5,0,5,3,0,3
2023-06-01,271996,2,1,3,2,1,2
2023-06-01,28447,3,1,4,1,1,1
2023-06-01,135300,16,1,17,17,4,18
2023-06-01,396055,2,1,3,5,2,5
2023-06-01,27976,29,1,30,6,1,6
2023-06-01,270668,3,7,10,8,3,8
2023-06-01,271728,1,1,2,2,1,2
2023-06-01,263080,30,4,34,11,6,11
2023-06-01,263462,6,2,8,11,7,12
2023-06-01,266904,8,1,9,4,2,4
2023-06-01,63000,1,0,1,2,0,2
2023-06-01,394432,10,0,10,4,0,4
2023-06-01,40177,2,0,2,1,0,1
2023-06-01,272012,4,1,5,1,1,1
2023-06-01,14754,398,177,575,31,10,32
2023-06-01,399195,6,0,6,1,0,1
2023-06-01,150400,1,0,1,1,0,1
2023-06-01,135097,65,0,65,8,0,8
2023-06-01,133180,4,0,4,1,0,1
2023-06-01,147293,18,6,24,2,1,2
2023-06-01,149767,2,0,2,4,0,4
2023-06-01,967,1,1,2,1,1,1
2023-06-01,46472,1,0,1,1,0,1
2023-06-01,23028,26,13,39,11,7,12
2023-06-01,36336,3,0,3,4,0,4
2023-06-01,25808,10,0,10,3,0,3
2023-06-01,395697,1,0,1,2,0,2
2023-06-01,40004,1,0,1,2,0,2
2023-06-01,395213,5,1,6,3,1,3
2023-06-01,54255,1,0,1,1,0,1
2023-06-01,48945,46,1,47,7,2,7
2023-06-01,270068,13,2,15,4,5,5
2023-06-01,262354,19,6,25,9,7,11
2023-06-01,52613,36,10,46,18,9,18
2023-06-01,264209,13,3,16,15,12,15
2023-06-01,18046,71,1,72,15,1,15
2023-06-01,133741,2,0,2,3,0,3
2023-06-01,18412,12,0,12,1,0,1
2023-06-01,136525,136,1,137,1,1,1
2023-06-01,141450,8,0,8,1,0,1
2023-06-01,141031,31,4,35,3,1,3
2023-06-01,136969,75,2,77,14,1,14
2023-06-01,142300,23,0,23,1,0,1
2023-06-01,4515,308,8,316,58,12,59
2023-06-01,132585,20,1,21,17,6,17
2023-06-01,149175,7,1,8,3,2,3
2023-06-01,141768,14,1,15,3,2,3
2023-06-01,136733,7,1,8,5,2,5
2023-06-01,45250,40,6,46,30,5,30
2023-06-01,133115,89,1,90,14,2,15
2023-06-01,142403,79,0,79,4,0,4
2023-06-01,136970,24,0,24,3,0,3
2023-06-01,2527,298,2,300,11,4,12
2023-06-01,38708,3,0,3,3,0,3
2023-06-01,38089,6,0,6,4,0,4
2023-06-01,38100,2,0,2,2,0,2
2023-06-01,17851,2,0,2,1,0,1
2023-06-01,131810,4,0,4,2,0,2
2023-06-01,131821,1,0,1,2,0,2
2023-06-01,9981,81,0,81,2,0,2
2023-06-01,45363,21,0,21,3,0,3
2023-06-01,38702,2,0,2,2,0,2
2023-06-01,24400,235,37,272,24,6,25
2023-06-01,4249,287,0,287,6,0,6
2023-06-01,58593,37,4,41,5,4,5
2023-06-01,30373,1,0,1,2,0,2
2023-06-01,54673,1,0,1,3,0,3
2023-06-01,7896,7,1,8,7,5,9
2023-06-01,57,4,2,6,29,12,29
2023-06-01,394877,1,0,1,2,0,2
2023-06-01,1818,9,0,9,3,0,3
2023-06-01,32103,1,0,1,1,0,1
2023-06-01,21609,1,0,1,1,0,1
2023-06-01,7181,17,2,19,3,2,3
2023-06-01,395382,4,0,4,3,0,3
2023-06-01,11958,2,0,2,3,0,3
2023-06-01,63189,1,0,1,1,0,1
2023-06-01,5466,28,3,31,25,13,29
2023-06-01,36994,125,5,130,32,13,36
2023-06-01,29975,134,0,134,2,0,2
2023-06-01,328062,1,0,1,1,0,1
2023-06-01,37168,44,0,44,5,0,5
2023-06-01,37105,48,2,50,7,6,8
2023-06-01,37239,59,2,61,14,4,14
2023-06-01,22750,90,0,90,2,0,2
2023-06-01,327688,3,0,3,1,0,1
2023-06-01,37204,60,2,62,24,7,25
2023-06-01,37442,6,0,6,2,0,2
2023-06-01,36986,18,0,18,2,0,2
2023-06-01,37410,28,0,28,2,0,2
2023-06-01,36866,52,1,53,11,2,11
2023-06-01,37472,4,0,4,3,0,3
2023-06-01,36937,42,2,44,13,4,13
2023-06-01,206283,45,5,50,5,1,5
2023-06-01,37613,7,0,7,41,7,42
2023-06-01,37103,11,0,11,1,0,1
2023-06-01,36923,112,0,112,4,0,4
2023-06-01,33765,112,1,113,20,4,20
2023-06-01,327795,17,1,18,5,1,5
2023-06-01,37146,11,0,11,2,0,2
2023-06-01,30969,47,2,49,5,1,5
2023-06-01,36943,5,1,6,5,3,5
2023-06-01,2609,76,3,79,8,6,10
2023-06-01,5438,0,0,0,9,2,9
2023-06-01,37705,105,5,110,3,1,3
2023-06-01,36944,1,1,2,20,17,25
2023-06-01,37532,2,1,3,1,1,1
2023-06-01,26506,22,9,31,20,8,20
2023-06-01,55429,7,3,10,3,2,3
2023-06-01,37037,106,1,107,4,1,4
2023-06-01,11259,9,1,10,16,6,17
2023-06-01,36907,49,1,50,9,1,9
2023-06-01,37009,14,1,15,11,6,12
2023-06-01,36992,1341,565,1906,19,5,20
2023-06-01,15475,10,0,10,1,0,1
2023-06-01,29571,1033,4,1037,19,4,19
2023-06-01,51265,15,1,16,6,1,6
2023-06-01,37179,14,1,15,30,9,31
2023-06-01,29614,69,1,70,20,2,20
2023-06-01,36974,241,5,246,10,1,10
2023-06-01,24863,1570,5,1575,19,3,19
2023-06-01,30998,221,1,222,6,3,6
2023-06-01,37148,89,2,91,36,2,36
2023-06-01,198504,18,0,18,1,0,1
2023-06-01,24835,1533,10,1543,33,5,33
2023-06-01,37215,36,4,40,1,1,1
2023-06-01,37187,49,2,51,11,5,11
2023-06-01,37081,6,0,6,3,0,3
2023-06-01,37053,144,1,145,5,2,5
2023-06-01,17400,63,1,64,7,3,7
2023-06-01,37155,15,0,15,1,0,1
2023-06-01,20459,0,1,1,15,6,16
2023-06-01,37154,75,1,76,6,2,6
2023-06-01,6713,550,4,554,14,9,14
2023-06-01,16058,51,1,52,4,1,4
2023-06-01,37169,3,0,3,1,0,1
2023-06-01,37004,24,1,25,1,1,1
2023-06-01,8346,148,1,149,16,8,16
2023-06-01,30985,124,4,128,6,2,6
2023-06-01,36965,6,1,7,4,2,4
2023-06-01,327708,3,0,3,25,9,25
2023-06-01,37133,80,1,81,10,2,10
2023-06-01,36926,113,1,114,14,3,14
2023-06-01,37035,40,1,41,10,5,10
2023-06-01,36930,35,1,36,10,3,10
2023-06-01,16284,105,4,109,18,2,18
2023-06-01,328290,4,0,4,1,0,1
2023-06-01,37292,3,0,3,4,0,4
2023-06-01,37544,6,0,6,2,0,2
2023-06-01,36963,29,0,29,2,0,2
2023-06-01,37263,1,0,1,1,0,1
2023-06-01,37288,1,2,3,13,2,13
2023-06-01,37349,26,1,27,12,5,12
2023-06-01,327771,20,0,20,3,0,3
2023-06-01,2018,382,15,397,19,15,21
2023-06-01,20080,7,3,10,17,11,18
2023-06-01,37273,8,1,9,17,5,17
2023-06-01,37619,6,1,7,12,2,12
2023-06-01,37228,119,0,119,7,0,7
2023-06-01,36890,25,1,26,8,1,8
2023-06-01,37235,9,2,11,3,2,3
2023-06-01,39588,12,2,14,3,3,3
2023-06-01,136792,13,2,15,6,2,6
2023-06-01,30031,21,5,26,3,3,3
2023-06-01,42427,16,2,18,3,3,3
2023-06-01,33538,7,2,9,3,3,3
2023-06-01,33781,4,0,4,2,0,2
2023-06-01,33786,23,0,23,4,0,4
2023-06-01,36924,22,14,36,6,5,7
2023-06-01,37281,8,0,8,3,0,3
2023-06-01,37276,42,0,42,9,0,9
2023-06-01,327693,5,1,6,32,10,32
2023-06-01,36968,53,1,54,5,2,5
2023-06-01,37165,2,0,2,1,0,1
2023-06-01,37113,28,0,28,3,0,3
2023-06-01,37027,66,1,67,17,5,18
2023-06-01,15399,530,4,534,14,7,14
2023-06-01,42235,5,1,6,3,1,3
2023-06-01,37503,2,0,2,1,0,1
2023-06-01,37057,37,0,37,3,0,3
2023-06-01,328983,34,0,34,2,0,2
2023-06-01,37012,1,0,1,11,0,11
2023-06-01,37162,1,0,1,1,0,1
2023-06-01,37333,19,8,27,4,3,4
2023-06-01,30999,154,4,158,19,9,19
2023-06-01,37525,7,1,8,2,2,3
2023-06-01,37194,1,0,1,1,0,1
2023-06-01,37209,13,0,13,8,0,8
2023-06-01,37236,13,4,17,11,10,11
2023-06-01,37334,21,3,24,2,2,2
2023-06-01,328832,0,0,0,25,0,25
2023-06-01,37497,5,1,6,33,14,33
2023-06-01,327979,31,8,39,4,3,4
2023-06-01,11845,211,1,212,20,8,20
2023-06-01,37172,27,1,28,8,2,8
2023-06-01,37199,23,1,24,4,3,4
2023-06-01,36874,23,1,24,22,10,22
2023-06-01,37223,62,1,63,4,1,4
2023-06-01,37230,18,1,19,2,1,2
2023-06-01,37219,6,1,7,5,1,5
2023-06-01,12455,141,4,145,7,5,7
2023-06-01,37225,31,0,31,5,0,5
2023-06-01,37280,8,0,8,5,0,5
2023-06-01,328457,5,0,5,2,0,2
2023-06-01,37611,10,2,12,2,3,3
2023-06-01,37254,30,5,35,8,5,8
2023-06-01,37286,9,0,9,1,0,1
2023-06-01,37287,47,0,47,5,0,5
2023-06-01,37440,24,1,25,8,1,8
2023-06-01,37098,20,0,20,4,0,4
2023-06-01,37303,18,0,18,2,0,2
2023-06-01,37673,7,0,7,7,0,7
2023-06-01,328333,2,1,3,17,9,18
2023-06-01,22355,4,1,5,16,7,16
2023-06-01,37345,7,0,7,1,0,1
2023-06-01,37670,6,1,7,5,3,5
2023-06-01,36985,9,1,10,5,2,5
2023-06-01,37320,1,0,1,1,0,1
2023-06-01,37063,68,5,73,8,1,8
2023-06-01,20294,34,0,34,10,0,10
2023-06-01,327741,7,1,8,2,1,3
2023-06-01,37515,41,0,41,3,0,3
2023-06-01,37358,23,1,24,25,2,25
2023-06-01,37110,52,1,53,2,2,2
2023-06-01,33785,12,1,13,1,1,1
2023-06-01,59895,14,4,18,1,1,1
2023-06-01,32653,12,3,15,10,5,10
2023-06-01,37398,5,0,5,2,0,2
2023-06-01,328107,1,1,2,13,2,13
2023-06-01,37430,3,0,3,1,0,1
2023-06-01,37475,4,0,4,1,0,1
2023-06-01,37447,27,0,27,13,0,13
2023-06-01,19711,18,0,18,18,0,18
2023-06-01,37510,1,0,1,1,0,1
2023-06-01,35251,28,1,29,3,1,4
2023-06-01,37353,13,1,14,2,1,2
2023-06-01,36873,229,3,232,29,4,29
2023-06-01,37106,8,0,8,3,0,3
2023-06-01,37404,1,0,1,1,0,1
2023-06-01,37119,34,4,38,20,5,21
2023-06-01,37191,16,0,16,5,0,5
2023-06-01,37156,6,0,6,1,0,1
2023-06-01,37159,2,1,3,3,1,3
2023-06-01,37157,11,0,11,6,0,6
2023-06-01,37721,67,3,70,23,8,26
2023-06-01,37163,9,0,9,3,0,3
2023-06-01,36908,6,0,6,8,0,8
2023-06-01,37218,1,0,1,1,0,1
2023-06-01,327732,3,3,6,7,1,7
2023-06-01,37371,17,0,17,8,0,8
2023-06-01,30990,91,2,93,23,5,23
2023-06-01,37184,12,1,13,1,1,1
2023-06-01,37018,25,4,29,9,2,9
2023-06-01,327903,3,1,4,17,4,17
2023-06-01,37208,4,0,4,1,0,1
2023-06-01,37192,1,0,1,3,0,3
2023-06-01,14988,94,4,98,7,4,8
2023-06-01,37200,18,0,18,2,0,2
2023-06-01,28683,74,2,76,14,2,14
2023-06-01,37205,9,0,9,4,0,4
2023-06-01,37385,9,0,9,5,0,5
2023-06-01,22351,73,3,76,17,3,17
2023-06-01,328659,4,0,4,3,0,3
2023-06-01,37232,4,0,4,2,0,2
2023-06-01,37589,5,1,6,1,1,1
2023-06-01,37229,5,0,5,3,0,3
2023-06-01,37054,46,1,47,16,4,16
2023-06-01,24691,56,4,60,6,2,6
2023-06-01,37275,1,0,1,1,0,1
2023-06-01,37249,2,0,2,3,0,3
2023-06-01,36909,42,1,43,3,1,3
2023-06-01,36920,52,0,52,6,0,6
2023-06-01,409,14,0,14,2,0,2
2023-06-01,37675,46,1,47,7,1,7
2023-06-01,37453,34,0,34,3,0,3
2023-06-01,37688,16,0,16,7,0,7
2023-06-01,37308,32,1,33,7,1,7
2023-06-01,327698,1,1,2,1,2,3
2023-06-01,37713,3,0,3,2,0,2
2023-06-01,37317,4,1,5,5,1,5
2023-06-01,37443,2,0,2,1,0,1
2023-06-01,37661,7,0,7,5,0,5
2023-06-01,37491,2,0,2,2,0,2
2023-06-01,37302,2,1,3,5,3,5
2023-06-01,327987,4,1,5,4,1,4
2023-06-01,37294,53,2,55,4,1,4
2023-06-01,37296,1,0,1,1,0,1
2023-06-01,37305,16,1,17,16,4,16
2023-06-01,37314,15,5,20,10,3,11
2023-06-01,37406,12,0,12,5,0,5
2023-06-01,37329,15,2,17,2,1,2
2023-06-01,327760,4,0,4,2,0,2
2023-06-01,37336,7,0,7,2,0,2
2023-06-01,37529,4,1,5,8,1,8
2023-06-01,37337,8,0,8,2,0,2
2023-06-01,327770,3,0,3,2,0,2
2023-06-01,37183,59,1,60,11,1,11
2023-06-01,37343,25,0,25,4,0,4
2023-06-01,37347,32,1,33,4,1,4
2023-06-01,37352,2,0,2,3,0,3
2023-06-01,37084,22,1,23,36,14,36
2023-06-01,327941,9,2,11,6,3,6
2023-06-01,37712,3,1,4,1,1,1
2023-06-01,37363,2,1,3,9,6,10
2023-06-01,37373,6,0,6,1,0,1
2023-06-01,37368,1,0,1,4,0,4
2023-06-01,37377,4,0,4,1,0,1
2023-06-01,37376,4,0,4,3,0,3
2023-06-01,37575,3,1,4,4,1,4
2023-06-01,37395,5,1,6,6,1,6
2023-06-01,37403,5,0,5,5,0,5
2023-06-01,37387,7,1,8,1,1,1
2023-06-01,198394,15,0,15,1,0,1
2023-06-01,37411,6,0,6,2,0,2
2023-06-01,132692,7,1,8,3,3,4
2023-06-01,37412,4,1,5,4,2,4
2023-06-01,328471,357,8,365,6,5,7
2023-06-01,37425,5,1,6,5,1,5
2023-06-01,37427,7,0,7,2,0,2
2023-06-01,37437,1,0,1,2,0,2
2023-06-01,328366,50,1,51,10,4,10
2023-06-01,37424,13,2,15,2,1,2
2023-06-01,327794,34,0,34,3,0,3
2023-06-01,205996,1,1,2,4,3,4
2023-06-01,37677,9,0,9,7,0,7
2023-06-01,37451,31,0,31,9,0,9
2023-06-01,6,35,0,35,6,0,6
2023-06-01,37141,2,0,2,1,0,1
2023-06-01,37137,3,0,3,1,0,1
2023-06-01,33771,88,13,101,14,7,14
2023-06-01,37061,109,1,110,30,1,30
2023-06-01,19676,1,0,1,1,0,1
2023-06-01,328418,12,0,12,2,0,2
2023-06-01,329046,2,0,2,2,0,2
2023-06-01,4200000000,1,0,1,1,0,1
2023-06-01,328228,15,0,15,1,0,1
2023-06-01,37203,2,0,2,2,0,2
2023-06-01,36958,34,1,35,8,1,8
2023-06-01,12258,27,0,27,1,0,1
2023-06-01,37480,155,0,155,10,0,10
2023-06-01,37182,5,1,6,6,1,6
2023-06-01,22354,2,0,2,2,0,2
2023-06-01,26106,5,0,5,3,0,3
2023-06-01,37090,17,1,18,6,2,6
2023-06-01,36969,35,0,35,2,0,2
2023-06-01,30619,31,0,31,4,0,4
2023-06-01,37248,8,0,8,4,0,4
2023-06-01,36925,172,9,181,14,6,14
2023-06-01,37257,6,0,6,1,0,1
2023-06-01,37621,17,0,17,1,0,1
2023-06-01,36914,252,12,264,4,3,5
2023-06-01,37069,142,1,143,2,2,2
2023-06-01,36955,5,1,6,4,1,4
2023-06-01,328866,15,0,15,1,0,1
2023-06-01,37034,1,0,1,1,0,1
2023-06-01,327700,41,5,46,6,3,6
2023-06-01,36998,63,0,63,3,0,3
2023-06-01,204523,1,1,2,5,2,5
2023-06-01,15706,109,0,109,5,2,6
2023-06-01,36947,352,2,354,14,11,14
2023-06-01,12091,19,1,20,1,1,1
2023-06-01,6127,57,0,57,4,0,4
2023-06-01,23889,207,2,209,20,12,21
2023-06-01,36884,156,1,157,12,9,13
2023-06-01,37075,82,1,83,13,3,13
2023-06-01,37124,14,0,14,3,0,3
2023-06-01,37136,8,0,8,1,0,1
2023-06-01,36916,67,2,69,12,2,12
2023-06-01,25543,87,1,88,5,1,5
2023-06-01,37541,48,0,48,2,0,2
2023-06-01,20598,59,0,59,10,0,10
2023-06-01,36932,3,0,3,10,0,10
2023-06-01,37122,12,0,12,8,0,8
2023-06-01,327783,5,0,5,4,0,4
2023-06-01,37019,35,1,36,3,1,3
2023-06-01,35091,40,0,40,1,0,1
2023-06-01,36903,1242,1,1243,1,1,1
2023-06-01,37167,2,0,2,1,0,1
2023-06-01,37079,1,0,1,1,0,1
2023-06-01,328312,2,0,2,2,0,2
2023-06-01,37006,50,1,51,1,1,1
2023-06-01,64631,4,0,4,1,0,1
2023-06-01,65510,3,0,3,2,0,2
2023-06-01,328646,5,0,5,2,0,2
2023-06-01,33789,4,0,4,1,0,1
2023-06-01,31065,22,1,23,5,1,5
2023-06-01,37680,19,1,20,9,1,9
2023-06-01,36996,38,0,38,2,0,2
2023-06-01,37028,21,1,22,6,1,6
2023-06-01,29091,93,1,94,19,1,19
2023-06-01,29544,14,0,14,3,0,3
2023-06-01,208428,2,0,2,3,0,3
2023-06-01,198247,26,0,26,1,0,1
2023-06-01,198381,23,0,23,1,0,1
2023-06-01,19232,2,0,2,1,0,1
2023-06-01,30986,104,3,107,8,3,8
2023-06-01,27822,22,0,22,9,0,9
2023-06-01,37102,10,0,10,5,0,5
2023-06-01,327738,12,0,12,8,0,8
2023-06-01,50293,1,1,2,3,3,3
2023-06-01,328442,19,16,35,14,5,14
2023-06-01,22690,14,1,15,7,1,7
2023-06-01,37076,28,0,28,5,0,5
2023-06-01,31856,41,1,42,4,1,4
2023-06-01,37189,10,0,10,2,0,2
2023-06-01,37024,2,0,2,1,0,1
2023-06-01,37032,2,0,2,1,0,1
2023-06-01,37026,3,0,3,2,0,2
2023-06-01,30896,9,0,9,2,0,2
2023-06-01,37030,24,0,24,4,0,4
2023-06-01,37140,11,0,11,1,0,1
2023-06-01,36999,3,0,3,2,0,2
2023-06-01,26130,12,0,12,5,0,5
2023-06-01,37038,4,0,4,1,0,1
2023-06-01,37463,15,0,15,5,0,5
2023-06-01,37638,14,0,14,7,0,7
2023-06-01,37604,2,0,2,1,0,1
2023-06-01,37190,15,0,15,2,0,2
2023-06-01,37066,5,0,5,4,0,4
2023-06-01,37116,4,0,4,1,0,1
2023-06-01,327814,25,1,26,14,3,15
2023-06-01,37087,10,0,10,2,0,2
2023-06-01,37089,3,0,3,2,0,2
2023-06-01,37094,15,0,15,2,0,2
2023-06-01,37185,10,0,10,2,0,2
2023-06-01,37052,10,0,10,3,0,3
2023-06-01,37123,5,1,6,1,1,1
2023-06-01,37164,28,0,28,3,0,3
2023-06-01,36934,1,0,1,1,0,1
2023-06-01,25818,38,8,46,30,10,30
2023-06-01,18922,4,0,4,1,0,1
2023-06-01,36877,37,0,37,1,0,1
2023-06-01,37379,5,0,5,1,0,1
2023-06-01,39356,54,7,61,12,8,14
2023-06-01,328306,6,1,7,5,2,5
2023-06-01,36912,97,5,102,4,1,4
2023-06-01,328198,6,0,6,7,0,7
2023-06-01,327782,16,14,30,26,8,26
2023-06-01,328309,12,0,12,1,0,1
2023-06-01,36993,2,0,2,1,0,1
2023-06-01,37025,5,0,5,2,0,2
2023-06-01,37001,2,0,2,3,0,3
2023-06-01,37056,2,0,2,4,0,4
2023-06-01,37104,2,0,2,1,0,1
2023-06-01,36970,3,0,3,4,0,4
2023-06-01,37269,20,0,20,2,0,2
2023-06-01,37233,20,0,20,3,0,3
2023-06-01,29918,3,0,3,5,0,5
2023-06-01,33567,18,0,18,6,0,6
2023-06-01,36864,23,1,24,9,6,10
2023-06-01,36902,70,0,70,10,0,10
2023-06-01,32398,21,0,21,5,0,5
2023-06-01,328411,51,1,52,6,1,6
2023-06-01,327945,2,0,2,1,0,1
2023-06-01,328766,1,0,1,3,0,3
2023-06-01,36911,31,0,31,3,0,3
2023-06-01,30992,85,0,85,6,0,6
2023-06-01,36905,3,0,3,3,0,3
2023-06-01,30993,25,0,25,1,0,1
2023-06-01,36928,10,0,10,1,0,1
2023-06-01,15808,54,1,55,24,4,24
2023-06-01,36935,917,5,922,2,1,2
2023-06-01,36915,40,1,41,4,3,5
2023-06-01,36868,43,2,45,19,2,19
2023-06-01,36898,6,0,6,2,0,2
2023-06-01,37540,6,1,7,2,1,2
2023-06-01,64512,61,3,64,7,2,9
2023-06-01,327765,14,0,14,2,0,2
2023-06-01,64518,1,17,18,1,1,2
2023-06-01,33762,4,0,4,1,0,1
2023-06-01,36959,5,0,5,1,0,1
2023-06-01,36962,44,0,44,5,0,5
2023-06-01,28698,37,0,37,3,0,3
2023-06-01,18931,1,1,2,2,2,2
2023-06-01,328316,4,1,5,15,1,15
2023-06-01,37073,16,0,16,2,0,2
2023-06-01,37088,66,7,73,14,3,14
2023-06-01,37714,77,3,80,4,1,4
2023-06-01,212738,1,0,1,1,0,1
2023-06-01,149938,1,1,2,3,2,3
2023-06-01,139989,3,4,7,5,4,6
2023-06-01,211459,4,1,5,5,6,6
2023-06-01,210537,1,5,6,3,6,7
2023-06-01,213166,2,1,3,2,1,2
2023-06-01,136175,6,0,6,6,0,6
2023-06-01,327980,2,1,3,2,1,2
2023-06-01,208102,8,0,8,2,0,2
2023-06-01,5377,19,2,21,13,3,13
2023-06-01,37101,7,0,7,1,0,1
2023-06-01,36941,3,1,4,3,1,3
2023-06-01,37672,5,0,5,1,0,1
2023-06-01,328154,6,1,7,6,1,6
2023-06-01,37264,4,0,4,3,0,3
2023-06-01,37340,184,1,185,4,1,4
2023-06-01,37125,10,0,10,5,0,5
2023-06-01,37109,19,1,20,2,1,2
2023-06-01,37031,16,0,16,2,0,2
2023-06-01,37482,17,16,33,6,2,6
2023-06-01,25576,33,0,33,5,0,5
2023-06-01,37196,29,0,29,5,0,5
2023-06-01,29032,24,0,24,2,0,2
2023-06-01,25139,25,1,26,8,1,8
2023-06-01,36900,1,0,1,1,0,1
2023-06-01,37506,9,0,9,2,0,2
2023-06-01,327931,142,1,143,1,1,1
2023-06-01,31810,6,0,6,3,0,3
2023-06-01,36945,9,0,9,2,0,2
2023-06-01,36865,28,0,28,1,0,1
2023-06-01,36977,16,0,16,1,0,1
2023-06-01,40123,5,0,5,6,0,6
2023-06-01,36917,7,1,8,4,2,4
2023-06-01,37143,4,1,5,6,4,6
2023-06-01,37584,5,0,5,3,0,3
2023-06-01,36938,2,1,3,2,1,2
2023-06-01,37126,30,1,31,2,1,2
2023-06-01,37622,7,0,7,5,0,5
2023-06-01,36983,10,0,10,6,0,6
2023-06-01,15766,16,1,17,12,5,13
2023-06-01,37173,11,0,11,1,0,1
2023-06-01,328446,12,0,12,5,0,5
2023-06-01,37049,12,1,13,4,3,4
2023-06-01,25163,22,0,22,6,0,6
2023-06-01,37044,15,0,15,1,0,1
2023-06-01,36913,20,0,20,3,0,3
2023-06-01,37020,50,0,50,13,0,13
2023-06-01,37593,6,0,6,1,0,1
2023-06-01,37016,3,0,3,2,0,2
2023-06-01,37415,4,1,5,2,1,2
2023-06-01,37055,34,1,35,3,1,4
2023-06-01,37011,10,1,11,1,1,1
2023-06-01,37010,2,0,2,2,0,2
2023-06-01,36872,3,0,3,4,0,4
2023-06-01,328527,3,1,4,5,1,5
2023-06-01,37665,1,0,1,2,0,2
2023-06-01,37014,7,0,7,2,0,2
2023-06-01,37508,5,0,5,2,0,2
2023-06-01,37414,8,0,8,5,0,5
2023-06-01,328250,11,0,11,5,0,5
2023-06-01,36951,1,2,3,6,4,7
2023-06-01,17645,12,1,13,19,5,20
2023-06-01,32017,1,0,1,3,0,3
2023-06-01,36957,2,0,2,1,0,1
2023-06-01,36988,5,0,5,1,0,1
2023-06-01,37077,4,0,4,2,0,2
2023-06-01,36979,2,0,2,1,0,1
2023-06-01,36967,2,0,2,1,0,1
2023-06-01,36972,25,1,26,1,1,1
2023-06-01,36976,5,0,5,4,0,4
2023-06-01,37460,14,0,14,3,0,3
2023-06-01,36990,1,0,1,3,0,3
2023-06-01,36867,12,0,12,1,0,1
2023-06-01,37309,21,3,24,4,2,4
2023-06-01,37013,4,0,4,2,0,2
2023-06-01,37008,7,0,7,5,0,5
2023-06-01,30995,4,0,4,4,0,4
2023-06-01,32437,16,1,17,8,4,8
2023-06-01,37492,163,14,177,12,2,12
2023-06-01,37671,50,0,50,2,0,2
2023-06-01,31245,66,2,68,1,1,2
2023-06-01,37693,386,6,392,16,3,16
2023-06-01,37717,22,1,23,2,1,2
2023-06-01,199354,1,1,2,6,5,6
2023-06-01,37504,63,0,63,4,0,4
2023-06-01,328880,11,0,11,1,0,1
2023-06-01,327969,1,0,1,3,0,3
2023-06-01,327934,52,1,53,5,1,5
2023-06-01,37684,7,4,11,5,2,5
2023-06-01,37685,1,0,1,1,0,1
2023-06-01,37566,16,0,16,3,0,3
2023-06-01,37605,14,0,14,1,0,1
2023-06-01,328036,1,1,2,3,1,3
2023-06-01,37612,10,0,10,1,0,1
2023-06-01,37608,1,0,1,1,0,1
2023-06-01,37614,4,0,4,2,0,2
2023-06-01,327933,4,0,4,1,0,1
2023-06-01,328594,6,5,11,13,2,13
2023-06-01,37620,11,0,11,1,0,1
2023-06-01,24432,41,225,266,7,3,7
2023-06-01,56140,5,1,6,3,1,3
2023-06-01,138449,7,0,7,1,0,1
2023-06-01,46015,22,1,23,5,1,5
2023-06-01,131429,203,528,731,9,9,9
2023-06-01,56005,9,0,9,1,0,1
2023-06-01,55690,4,0,4,4,0,4
2023-06-01,17421,159,33,192,1,1,1
2023-06-01,58542,63,10,73,3,1,3
2023-06-01,18135,34,1,35,6,4,6
2023-06-01,56167,53,360,413,1,2,2
2023-06-01,1280,97,1,98,11,7,13
2023-06-01,24409,16,12,28,5,3,6
2023-06-01,135918,28,0,28,2,0,2
2023-06-01,135967,28,9,37,1,1,1
2023-06-01,63737,25,0,25,2,0,2
2023-06-01,38732,35,3,38,7,2,7
2023-06-01,38733,27,2,29,7,3,7
2023-06-01,136195,42,14,56,2,2,2
2023-06-01,139767,1,1,2,1,1,1
2023-06-01,137691,36,14,50,2,1,2
2023-06-01,137698,24,7,31,1,1,1
2023-06-01,23661,12,1,13,4,3,4
2023-06-01,38322,86,31,117,3,1,3
2023-06-01,136474,10,0,10,2,0,2
2023-06-01,134763,8,6,14,1,1,1
2023-06-01,140292,470,300,770,3,2,3
2023-06-01,45062,127,6,133,5,5,6
2023-06-01,17682,9,4,13,4,3,5
2023-06-01,139183,1,0,1,1,0,1
2023-06-01,131337,2,0,2,5,0,5
2023-06-01,17888,17,1,18,6,1,6
2023-06-01,133111,19,62,81,2,18,20
2023-06-01,137735,25,11,36,4,4,4
2023-06-01,137688,12,0,12,1,0,1
2023-06-01,134762,53,0,53,1,0,1
2023-06-01,134766,41,0,41,1,0,1
2023-06-01,17799,28,4,32,3,1,3
2023-06-01,134729,96,0,96,1,0,1
2023-06-01,135596,4,0,4,2,0,2
2023-06-01,139341,204,63,267,46,32,49
2023-06-01,137187,2,0,2,3,3,3
2023-06-01,4818,12,6,18,8,3,8
2023-06-01,4787,387,9,396,84,21,87
2023-06-01,132591,1,1,2,2,1,2
2023-06-01,9873,122,11,133,17,6,17
2023-06-01,10206,7,2,9,2,2,2
2023-06-01,135629,56,20,76,3,3,3
2023-06-01,55960,64,23,87,3,3,3
2023-06-01,131161,5,3,8,3,3,3
2023-06-01,38631,68,81,149,7,4,7
2023-06-01,58397,45,1,46,3,1,3
2023-06-01,131273,8,0,8,10,0,10
2023-06-01,136209,50,0,50,5,0,5
2023-06-01,132721,24,0,24,5,0,5
2023-06-01,9931,147,55,202,49,19,50
2023-06-01,45558,4,0,4,45,5,45
2023-06-01,9988,46,1,47,1,1,1
2023-06-01,138950,75,5,80,4,2,4
2023-06-01,140716,84,21,105,1,1,1
2023-06-01,17559,42,4,46,15,2,16
2023-06-01,133847,196,0,196,23,0,23
2023-06-01,58965,46,3,49,12,5,13
2023-06-01,59161,15,0,15,1,0,1
2023-06-01,9441,33,0,33,3,0,3
2023-06-01,132347,13,1,14,3,2,3
2023-06-01,132124,3,0,3,2,0,2
2023-06-01,38229,9,1,10,7,2,7
2023-06-01,56268,3,1,4,7,1,7
2023-06-01,132335,69,9,78,15,7,15
2023-06-01,132925,38,0,38,2,0,2
2023-06-01,133073,25,2,27,8,1,8
2023-06-01,139021,29,1,30,5,1,5
2023-06-01,132556,87,29,116,7,3,7
2023-06-01,45701,31,3,34,9,6,11
2023-06-01,132778,19,0,19,1,0,1
2023-06-01,18200,16,5,21,18,14,18
2023-06-01,133234,14,3,17,8,2,8
2023-06-01,142574,4,0,4,1,0,1
2023-06-01,63915,2,0,2,3,0,3
2023-06-01,63855,3,0,3,3,0,3
2023-06-01,131291,6,3,9,3,1,3
2023-06-01,64006,9,3,12,3,2,3
2023-06-01,55862,54,0,54,2,0,2
2023-06-01,133685,12,1,13,5,1,5
2023-06-01,150008,8,0,8,3,0,3
2023-06-01,63920,11,5,16,4,3,4
2023-06-01,137990,12,2,14,11,7,13
2023-06-01,140984,3,1,4,1,1,1
2023-06-01,137184,12,0,12,3,0,3
2023-06-01,133929,63,2,65,10,5,10
2023-06-01,24516,25,1,26,37,15,39
2023-06-01,63953,0,0,0,4,2,4
2023-06-01,135352,7,1,8,3,1,3
2023-06-01,58495,41,0,41,5,0,5
2023-06-01,59162,71,2,73,17,5,17
2023-06-01,133676,70,1,71,30,6,30
2023-06-01,142488,14,1,15,2,1,2
2023-06-01,133865,27,7,34,13,4,13
2023-06-01,9557,20,0,20,2,0,2
2023-06-01,4594,12,1,13,8,4,8
2023-06-01,38478,96,0,96,11,0,11
2023-06-01,132198,8,1,9,3,2,3
2023-06-01,132893,8,1,9,3,1,3
2023-06-01,45269,8,1,9,2,1,2
2023-06-01,133001,55,4,59,22,8,24
2023-06-01,45536,26,0,26,3,0,3
2023-06-01,45184,81,7,88,7,2,7
2023-06-01,134884,15,1,16,6,1,6
2023-06-01,131324,5,0,5,1,0,1
2023-06-01,58921,6,0,6,1,0,1
2023-06-01,59037,15,0,15,1,0,1
2023-06-01,9422,42,33,75,3,1,3
2023-06-01,9744,32,2,34,9,6,9
2023-06-01,45753,450,1,451,10,1,10
2023-06-01,133878,7,0,7,2,0,2
2023-06-01,131506,12,0,12,1,0,1
2023-06-01,134555,10,1,11,15,7,15
2023-06-01,133881,6,0,6,4,0,4
2023-06-01,7604,69,2,71,18,6,18
2023-06-01,135244,21,1,22,3,1,3
2023-06-01,45267,18,2,20,11,6,11
2023-06-01,132917,3,0,3,2,0,2
2023-06-01,137236,21,2,23,8,3,8
2023-06-01,141781,4,0,4,1,0,1
2023-06-01,140717,35,3,38,1,1,1
2023-06-01,9245,12,1,13,7,3,8
2023-06-01,133887,2,0,2,1,0,1
2023-06-01,146993,41,0,41,1,0,1
2023-06-01,38851,56,0,56,6,0,6
2023-06-01,136480,20,0,20,7,0,7
2023-06-01,149556,1,0,1,1,0,1
2023-06-01,132770,107,2,109,36,10,37
2023-06-01,64098,17,6,23,32,9,33
2023-06-01,38673,27,0,27,2,0,2
2023-06-01,45838,17,1,18,3,1,3
2023-06-01,133298,2,0,2,1,0,1
2023-06-01,136716,15,1,16,2,1,2
2023-06-01,133711,14,1,15,2,1,2
2023-06-01,132142,5,1,6,2,1,2
2023-06-01,132526,21,0,21,1,0,1
2023-06-01,38532,17,3,20,2,1,2
2023-06-01,63928,13,0,13,10,0,10
2023-06-01,45235,10,1,11,3,1,3
2023-06-01,134765,74,0,74,1,0,1
2023-06-01,38794,124,3,127,46,10,46
2023-06-01,133909,4,0,4,1,0,1
2023-06-01,56309,23,1,24,4,3,4
2023-06-01,132045,64,2,66,3,1,3
2023-06-01,133322,3,0,3,4,0,4
2023-06-01,24549,4,0,4,1,0,1
2023-06-01,45204,17,1,18,28,11,28
2023-06-01,17882,195,1,196,7,3,7
2023-06-01,133708,2,0,2,2,0,2
2023-06-01,64096,18,5,23,15,8,16
2023-06-01,134809,12,2,14,8,3,9
2023-06-01,132882,7,1,8,1,1,1
2023-06-01,55991,7,0,7,1,0,1
2023-06-01,133706,12,0,12,1,0,1
2023-06-01,133744,10,0,10,4,0,4
2023-06-01,132923,13,1,14,4,1,4
2023-06-01,59371,205,0,205,10,0,10
2023-06-01,63932,7,1,8,5,1,5
2023-06-01,17806,107,11,118,26,7,26
2023-06-01,45296,4,2,6,76,24,79
2023-06-01,23949,39,1,40,12,1,12
2023-06-01,132004,10,1,11,3,3,3
2023-06-01,63888,221,0,221,11,0,11
2023-06-01,56134,36,0,36,1,0,1
2023-06-01,55996,14,4,18,6,1,6
2023-06-01,131274,14,0,14,12,0,12
2023-06-01,133159,27,12,39,4,2,4
2023-06-01,6507,34,0,34,36,0,36
2023-06-01,45433,70,0,70,5,0,5
2023-06-01,138754,142,14,156,6,5,6
2023-06-01,132557,6,3,9,3,1,3
2023-06-01,64021,39,0,39,2,0,2
2023-06-01,137451,58,0,58,1,0,1
2023-06-01,400619,10,0,10,1,0,1
2023-06-01,147002,4,0,4,1,0,1
2023-06-01,23856,9,1,10,10,5,11
2023-06-01,139883,5,0,5,17,0,17
2023-06-01,21660,10,0,10,5,0,5
2023-06-01,134078,149,2,151,11,4,11
2023-06-01,29207,4,0,4,5,0,5
2023-06-01,134341,15,16,31,3,1,3
2023-06-01,141252,5,0,5,2,0,2
2023-06-01,133973,23,0,23,2,0,2
2023-06-01,149620,21,0,21,1,0,1
2023-06-01,58736,14,0,14,1,0,1
2023-06-01,45101,4,0,4,3,0,3
2023-06-01,131558,1,0,1,2,0,2
2023-06-01,59165,21,2,23,7,3,7
2023-06-01,45731,11,1,12,4,2,4
2023-06-01,17996,16,1,17,12,6,12
2023-06-01,138841,25,0,25,2,0,2
2023-06-01,58463,2,1,3,32,6,32
2023-06-01,38788,9,0,9,3,0,3
2023-06-01,137366,3,2,5,44,10,44
2023-06-01,17995,626,1,627,64,4,64
2023-06-01,58558,6,0,6,3,0,3
2023-06-01,58823,0,0,0,2,0,2
2023-06-01,140504,5,1,6,4,1,4
2023-06-01,132528,1,1,2,8,6,9
2023-06-01,58436,16,3,19,7,3,7
2023-06-01,136838,4,0,4,12,0,12
2023-06-01,38769,21,0,21,1,0,1
2023-06-01,132974,10,1,11,2,2,2
2023-06-01,134307,8,0,8,3,0,3
2023-06-01,134937,25,1,26,9,2,9
2023-06-01,137502,18,17,35,1,1,1
2023-06-01,43519,21,28,49,8,7,8
2023-06-01,398107,1,2,3,4,3,4
2023-06-01,203098,17,0,17,2,0,2
2023-06-01,135664,7,0,7,1,0,1
2023-06-01,134375,30,1,31,6,1,6
2023-06-01,1040,18,0,18,2,0,2
2023-06-01,906,80,8,88,14,7,15
2023-06-01,132754,14,1,15,4,1,4
2023-06-01,132932,11,0,11,2,0,2
2023-06-01,58907,7,0,7,17,0,17
2023-06-01,133954,17,43,60,2,3,3
2023-06-01,17747,142,12,154,9,2,9
2023-06-01,133952,13,1,14,3,1,3
2023-06-01,45725,40,2,42,6,4,6
2023-06-01,132072,0,0,0,11,8,11
2023-06-01,137549,31,3,34,3,3,3
2023-06-01,1449,9,0,9,2,0,2
2023-06-01,59065,7,0,7,1,0,1
2023-06-01,138296,100,2,102,16,5,17
2023-06-01,133724,16,0,16,1,0,1
2023-06-01,58779,75,3,78,18,9,19
2023-06-01,56082,61,0,61,2,0,2
2023-06-01,23673,126,6,132,10,5,10
2023-06-01,135386,23,2,25,3,2,3
2023-06-01,17660,5,2,7,17,10,19
2023-06-01,135666,5,1,6,2,1,2
2023-06-01,55330,69,0,69,27,0,27
2023-06-01,133894,7,0,7,3,0,3
2023-06-01,131284,49,0,49,30,0,30
2023-06-01,135881,8,5,13,3,2,3
2023-06-01,134774,9,77,86,4,1,4
2023-06-01,23848,68,17,85,10,3,10
2023-06-01,133380,72,0,72,12,0,12
2023-06-01,38067,46,0,46,2,0,2
2023-06-01,55944,48,17,65,11,5,11
2023-06-01,58765,39,4,43,7,3,7
2023-06-01,147210,1,0,1,1,0,1
2023-06-01,133648,9,1,10,5,1,5
2023-06-01,131270,14,3,17,6,1,7
2023-06-01,38835,159,0,159,1,0,1
2023-06-01,56229,12,0,12,3,0,3
2023-06-01,63963,10,0,10,4,0,4
2023-06-01,24496,12,12,24,5,1,5
2023-06-01,63962,4,0,4,2,0,2
2023-06-01,139035,4,1,5,5,4,5
2023-06-01,56110,9,1,10,1,1,1
2023-06-01,132255,15,0,15,9,0,9
2023-06-01,9901,1,3,4,12,4,12
2023-06-01,132245,11,0,11,2,0,2
2023-06-01,136776,0,0,0,5,5,6
2023-06-01,55915,33,16,49,5,4,5
2023-06-01,131987,2,1,3,2,2,2
2023-06-01,10204,26,1,27,15,3,15
2023-06-01,134069,4,1,5,3,1,3
2023-06-01,131303,12,0,12,4,0,4
2023-06-01,133585,3,0,3,2,0,2
2023-06-01,396948,13,1,14,2,2,2
2023-06-01,36007,65,0,65,3,0,3
2023-06-01,396949,17,1,18,2,2,2
2023-06-01,4686,54,1,55,1,1,1
2023-06-01,134279,6,0,6,3,0,3
2023-06-01,17506,40,1,41,2,1,2
2023-06-01,133590,8,0,8,1,0,1
2023-06-01,141501,6,0,6,4,0,4
2023-06-01,58640,32,1,33,8,2,8
2023-06-01,139901,17,3,20,78,21,80
2023-06-01,133443,9,0,9,3,0,3
2023-06-01,58945,15,20,35,73,16,74
2023-06-01,45179,17,5,22,5,2,5
2023-06-01,132829,24,72,96,15,8,15
2023-06-01,10143,119,27,146,39,4,39
2023-06-01,9311,97,1,98,1,1,1
2023-06-01,136334,56,1,57,35,9,35
2023-06-01,45194,295,3,298,30,7,30
2023-06-01,136374,19,5,24,8,2,8
2023-06-01,133980,5,0,5,4,0,4
2023-06-01,134512,19,0,19,3,0,3
2023-06-01,135706,9,0,9,3,0,3
2023-06-01,134940,3,0,3,2,0,2
2023-06-01,132941,7,0,7,3,0,3
2023-06-01,132742,77,0,77,2,0,2
2023-06-01,45215,13,0,13,2,0,2
2023-06-01,17492,20,0,20,13,2,13
2023-06-01,38726,21,3,24,3,2,3
2023-06-01,132937,9,1,10,3,1,3
2023-06-01,134866,12,0,12,1,0,1
2023-06-01,138663,5,0,5,3,0,3
2023-06-01,136780,8,0,8,4,0,4
2023-06-01,136168,4,1,5,36,12,37
2023-06-01,7643,81,0,81,2,0,2
2023-06-01,135942,12,1,13,3,1,3
2023-06-01,45538,63,2,65,7,1,7
2023-06-01,133948,23,0,23,2,0,2
2023-06-01,56109,6,0,6,2,0,2
2023-06-01,23959,74,16,90,5,3,5
2023-06-01,58906,14,0,14,11,0,11
2023-06-01,133246,12,0,12,3,0,3
2023-06-01,42745,3,0,3,6,0,6
2023-06-01,133389,6,0,6,2,0,2
2023-06-01,134771,89,6,95,1,1,1
2023-06-01,38757,0,0,0,47,10,49
2023-06-01,9341,435,1,436,14,1,14
2023-06-01,38026,46,7,53,21,4,21
2023-06-01,45959,2,0,2,3,0,3
2023-06-01,58713,15,0,15,5,0,5
2023-06-01,135357,98,0,98,2,0,2
2023-06-01,202592,15,9,24,3,3,3
2023-06-01,24235,0,0,0,3,0,3
2023-06-01,45306,1,1,2,12,3,12
2023-06-01,63493,2,0,2,1,0,1
2023-06-01,150210,4,0,4,2,0,2
2023-06-01,9657,32,16,48,7,1,7
2023-06-01,142360,6,0,6,2,0,2
2023-06-01,56246,26,4,30,4,1,4
2023-06-01,133747,32,0,32,1,0,1
2023-06-01,45638,41,14,55,5,3,5
2023-06-01,134033,30,32,62,8,3,9
2023-06-01,140174,10,0,10,9,0,9
2023-06-01,132056,8,0,8,1,0,1
2023-06-01,58910,15,2,17,3,1,3
2023-06-01,18033,31,0,31,3,0,3
2023-06-01,18168,18,0,18,2,0,2
2023-06-01,23955,16,39,55,1,1,1
2023-06-01,1851,8,1,9,1,1,1
2023-06-01,132817,21,0,21,2,0,2
2023-06-01,58940,27,19,46,3,4,5
2023-06-01,134366,19,2,21,6,1,6
2023-06-01,139118,3,0,3,1,0,1
2023-06-01,18302,43,0,43,14,0,14
2023-06-01,9712,41,0,41,3,0,3
2023-06-01,58476,6,0,6,2,0,2
2023-06-01,136975,5,1,6,8,7,10
2023-06-01,133524,25,1,26,20,3,20
2023-06-01,55649,27,0,27,4,2,4
2023-06-01,17990,21,2,23,6,3,7
2023-06-01,58893,13,1,14,2,1,2
2023-06-01,131236,2,0,2,1,0,1
2023-06-01,137697,203,3,206,3,2,3
2023-06-01,399955,32,0,32,1,0,1
2023-06-01,58627,8,1,9,8,3,8
2023-06-01,132787,12,0,12,5,0,5
2023-06-01,134141,9,1,10,2,1,2
2023-06-01,56294,21,1,22,13,1,13
2023-06-01,55707,35,0,35,14,0,14
2023-06-01,133324,6,0,6,3,0,3
2023-06-01,132857,8,0,8,5,0,5
2023-06-01,132268,5,1,6,3,3,3
2023-06-01,133232,34,2,36,4,1,4
2023-06-01,133606,46,0,46,8,0,8
2023-06-01,140223,2,1,3,2,1,2
2023-06-01,58731,19,0,19,5,2,5
2023-06-01,59257,225,182,407,4,2,4
2023-06-01,58514,17,0,17,2,0,2
2023-06-01,133054,8,0,8,2,0,2
2023-06-01,138311,32,16,48,9,2,9
2023-06-01,134254,15,0,15,2,0,2
2023-06-01,140449,2,0,2,2,2,2
2023-06-01,149004,2,1,3,2,1,2
2023-06-01,63827,6,0,6,1,0,1
2023-06-01,134972,2,0,2,4,0,4
2023-06-01,201351,1,0,1,1,0,1
2023-06-01,204381,1,0,1,1,0,1
2023-06-01,55884,23,0,23,2,0,2
2023-06-01,24122,35,4,39,12,1,12
2023-06-01,132996,24,2,26,2,1,3
2023-06-01,55766,25,3,28,13,3,13
2023-06-01,133739,19,0,19,3,0,3
2023-06-01,55734,3,0,3,1,0,1
2023-06-01,58597,12,0,12,1,0,1
2023-06-01,45625,23,1,24,6,1,6
2023-06-01,55555,15,1,16,4,3,4
2023-06-01,55532,11,1,12,1,3,4
2023-06-01,139898,10,2,12,4,1,4
2023-06-01,132405,32,0,32,7,0,7
2023-06-01,58666,6,1,7,3,3,3
2023-06-01,45650,45,13,58,20,3,20
2023-06-01,4007,78,14,92,35,10,36
2023-06-01,55427,15,13,28,9,2,9
2023-06-01,55879,34,0,34,4,0,4
2023-06-01,133130,2,0,2,4,0,4
2023-06-01,133944,28,1,29,1,1,1
2023-06-01,56264,14,12,26,7,2,7
2023-06-01,134135,1,0,1,1,0,1
2023-06-01,45245,39,19,58,5,4,5
2023-06-01,45945,9,0,9,2,0,2
2023-06-01,133736,24,1,25,1,2,2
2023-06-01,131476,12,0,12,4,0,4
2023-06-01,55785,4,1,5,10,5,10
2023-06-01,133043,3,1,4,3,2,3
2023-06-01,58505,7,1,8,4,1,4
2023-06-01,132849,4,0,4,7,0,7
2023-06-01,131755,8,1,9,3,2,3
2023-06-01,58376,16,2,18,6,2,7
2023-06-01,59318,6,7,13,20,13,23
2023-06-01,131207,94,7,101,10,2,10
2023-06-01,45345,5,2,7,1,1,1
2023-06-01,132627,4,0,4,4,0,4
2023-06-01,14127,166,0,166,17,0,17
2023-06-01,58752,6,2,8,5,4,5
2023-06-01,45845,13,8,21,16,8,16
2023-06-01,56186,5,0,5,3,0,3
2023-06-01,137491,13,7,20,89,27,91
2023-06-01,135076,24,1,25,4,1,4
2023-06-01,131740,2,0,2,2,0,2
2023-06-01,134518,4,1,5,2,1,2
2023-06-01,59191,7,17,24,15,9,15
2023-06-01,134326,14,16,30,11,3,11
2023-06-01,134294,16,1,17,2,1,2
2023-06-01,136639,11,1,12,3,1,3
2023-06-01,17666,57,2,59,8,1,8
2023-06-01,134524,2,0,2,1,0,1
2023-06-01,137449,14,1,15,14,7,14
2023-06-01,132883,35,0,35,2,0,2
2023-06-01,141742,5,0,5,4,0,4
2023-06-01,141711,21,0,21,4,0,4
2023-06-01,56132,10,7,17,2,1,2
2023-06-01,135817,17,4,21,17,4,17
2023-06-01,132751,2,0,2,1,0,1
2023-06-01,38320,143,3,146,18,4,18
2023-06-01,59322,9,0,9,4,0,4
2023-06-01,24523,78,12,90,6,3,6
2023-06-01,133613,57,2,59,9,6,9
2023-06-01,17451,402,97,499,82,20,85
2023-06-01,45312,15,2,17,6,1,6
2023-06-01,17887,30,4,34,4,2,5
2023-06-01,24413,26,0,26,12,2,12
2023-06-01,9454,2,0,2,2,0,2
2023-06-01,55947,40,1,41,7,3,7
2023-06-01,134331,10,3,13,4,1,4
2023-06-01,132761,2,0,2,2,0,2
2023-06-01,18103,65,3,68,6,1,6
2023-06-01,135784,6,0,6,2,0,2
2023-06-01,9297,4,1,5,10,6,10
2023-06-01,133120,15,1,16,8,3,8
2023-06-01,132529,2,0,2,3,0,3
2023-06-01,132296,69,2,71,13,3,13
2023-06-01,55341,28,1,29,4,1,4
2023-06-01,55468,8,0,8,3,0,3
2023-06-01,10130,0,0,0,3,2,3
2023-06-01,38875,5,0,5,2,0,2
2023-06-01,58524,4,0,4,2,0,2
2023-06-01,140733,2,0,2,1,0,1
2023-06-01,58474,8,1,9,4,2,4
2023-06-01,59217,21,2,23,3,2,4
2023-06-01,142032,46,0,46,4,0,4
2023-06-01,150300,5,0,5,1,0,1
2023-06-01,137885,2,0,2,1,0,1
2023-06-01,393889,16,0,16,1,0,1
2023-06-01,132838,2,0,2,1,0,1
2023-06-01,58927,3,0,3,1,0,1
2023-06-01,55943,8,3,11,8,5,8
2023-06-01,56017,21,0,21,3,0,3
2023-06-01,58405,20,1,21,4,1,4
2023-06-01,132449,7,0,7,3,0,3
2023-06-01,133096,3,0,3,4,0,4
2023-06-01,45298,37,0,37,9,0,9
2023-06-01,55902,8,0,8,3,0,3
2023-06-01,133748,19,2,21,7,2,7
2023-06-01,9266,68,0,68,4,0,4
2023-06-01,131459,15,0,15,4,0,4
2023-06-01,141177,4,3,7,2,2,2
2023-06-01,133352,9,0,9,2,0,2
2023-06-01,58689,39,4,43,25,5,25
2023-06-01,23888,77,25,102,3,3,3
2023-06-01,54197,9,3,12,1,2,2
2023-06-01,58594,16,5,21,3,1,3
2023-06-01,133315,10,0,10,1,0,1
2023-06-01,132615,4,0,4,4,0,4
2023-06-01,10084,9,7,16,7,7,9
2023-06-01,59029,4,1,5,2,1,2
2023-06-01,45356,31,2,33,10,5,10
2023-06-01,133283,6,0,6,1,0,1
2023-06-01,135208,14,2,16,2,1,2
2023-06-01,141201,14,3,17,2,2,2
2023-06-01,132818,6,0,6,1,0,1
2023-06-01,11054,52,69,121,9,6,9
2023-06-01,131593,3,0,3,4,0,4
2023-06-01,136462,7,13,20,8,2,8
2023-06-01,131210,20,1,21,4,2,4
2023-06-01,133297,5,0,5,1,0,1
2023-06-01,45766,40,6,46,6,2,6
2023-06-01,136160,6,0,6,1,0,1
2023-06-01,17766,79,7,86,15,2,15
2023-06-01,17598,209,0,209,1,0,1
2023-06-01,24028,111,15,126,14,2,14
2023-06-01,45780,101,7,108,10,7,10
2023-06-01,133794,2,0,2,3,0,3
2023-06-01,46023,49,1,50,4,1,4
2023-06-01,17470,17,1,18,3,1,3
2023-06-01,131178,140,2,142,2,1,2
2023-06-01,45144,17,0,17,3,0,3
2023-06-01,38277,24,0,24,5,0,5
2023-06-01,137872,111,0,111,6,0,6
2023-06-01,9231,50,0,50,12,0,12
2023-06-01,132815,7,0,7,1,0,1
2023-06-01,38758,91,20,111,52,9,53
2023-06-01,132420,46,1,47,13,1,13
2023-06-01,17465,320,41,361,13,5,13
2023-06-01,45305,57,2,59,48,8,48
2023-06-01,38154,3,3,6,11,1,11
2023-06-01,135126,20,0,20,7,0,7
2023-06-01,45652,25,1,26,4,1,4
2023-06-01,35908,516,5,521,21,9,21
2023-06-01,135513,3,0,3,1,0,1
2023-06-01,56074,4,0,4,1,0,1
2023-06-01,10032,43,2,45,7,2,7
2023-06-01,142366,4,4,8,4,3,4
2023-06-01,58404,18,2,20,1,1,1
2023-06-01,56233,25,0,25,4,0,4
2023-06-01,64313,3,0,3,10,0,10
2023-06-01,58411,23,2,25,8,5,8
2023-06-01,55666,82,27,109,42,14,43
2023-06-01,17727,26,6,32,10,3,10
2023-06-01,137831,5,2,7,30,13,30
2023-06-01,58816,9,0,9,2,0,2
2023-06-01,56258,3,0,3,57,18,58
2023-06-01,45884,3,1,4,1,2,2
2023-06-01,58481,5,0,5,4,0,4
2023-06-01,38044,8,2,10,1,3,3
2023-06-01,55701,24,59,83,16,10,17
2023-06-01,45316,2,1,3,3,1,3
2023-06-01,10226,45,16,61,13,5,15
2023-06-01,23860,220,40,260,5,1,5
2023-06-01,17686,20,1,21,13,4,13
2023-06-01,59095,1,0,1,1,0,1
2023-06-01,9387,64,2,66,5,1,5
2023-06-01,131149,7,1,8,7,5,9
2023-06-01,58423,5,0,5,1,0,1
2023-06-01,59243,22,0,22,5,0,5
2023-06-01,45504,8,0,8,3,0,3
2023-06-01,139189,6,0,6,1,0,1
2023-06-01,24534,7,1,8,19,4,19
2023-06-01,132196,22,1,23,6,1,6
2023-06-01,134542,20,2,22,2,1,2
2023-06-01,56272,20,16,36,7,2,7
2023-06-01,58482,10,9,19,4,1,4
2023-06-01,996,68,0,68,2,0,2
2023-06-01,131447,9,1,10,5,6,7
2023-06-01,135063,4,1,5,5,4,5
2023-06-01,59238,6,13,19,9,9,11
2023-06-01,136523,12,1,13,5,1,6
2023-06-01,59083,12,1,13,2,1,2
2023-06-01,58659,52,6,58,2,2,2
2023-06-01,131314,23,1,24,25,8,26
2023-06-01,45110,44,1,45,6,1,7
2023-06-01,137686,0,0,0,2,0,2
2023-06-01,24137,6,0,6,1,0,1
2023-06-01,131584,49,8,57,8,2,8
2023-06-01,18119,11,1,12,11,3,12
2023-06-01,23686,24,1,25,46,10,46
2023-06-01,59346,22,0,22,3,0,3
2023-06-01,23620,6,1,7,5,3,5
2023-06-01,59214,14,0,14,7,0,7
2023-06-01,23884,145,6,151,14,2,14
2023-06-01,63581,22,1,23,1,1,1
2023-06-01,150150,11,0,11,8,0,8
2023-06-01,984,31,6,37,10,4,10
2023-06-01,58424,48,0,48,4,0,4
2023-06-01,18361,11,0,11,4,0,4
2023-06-01,132007,3,0,3,1,0,1
2023-06-01,132579,2,1,3,6,4,6
2023-06-01,38201,8,1,9,5,1,5
2023-06-01,149013,2,0,2,1,0,1
2023-06-01,23838,23,8,31,30,14,30
2023-06-01,134764,14,6,20,1,1,1
2023-06-01,17970,29,0,29,3,0,3
2023-06-01,63548,8,0,8,4,0,4
2023-06-01,59043,3,0,3,2,0,2
2023-06-01,17480,8,1,9,1,1,1
2023-06-01,7377,20,2,22,3,3,3
2023-06-01,64435,2,2,4,1,2,2
2023-06-01,6140,7,1,8,4,1,4
2023-06-01,14570,1,2,3,5,4,7
2023-06-01,30640,14,0,14,7,0,7
2023-06-01,29962,2,1,3,1,1,1
2023-06-01,195,43,6,49,9,5,10
2023-06-01,198785,12,1,13,7,3,7
2023-06-01,60391,0,5,5,3,4,5
2023-06-01,15780,1,0,1,1,0,1
2023-06-01,209864,1,9,10,1,4,4
2023-06-01,8283,5,2,7,34,32,42
2023-06-01,49268,3,1,4,4,1,4
2023-06-01,63479,14,0,14,5,0,5
2023-06-01,395837,1,0,1,2,0,2
2023-06-01,7752,4,1,5,10,5,11
2023-06-01,201106,77,20,97,7,8,11
2023-06-01,226,14,1,15,26,11,26
2023-06-01,567,0,0,0,9,5,9
2023-06-01,202540,1,6,7,1,3,3
2023-06-01,396414,3,1,4,1,1,2
2023-06-01,396388,4,2,6,1,1,1
2023-06-01,26566,1,0,1,2,0,2
2023-06-01,25905,4,2,6,5,5,6
2023-06-01,48777,2,1,3,5,4,7
2023-06-01,211638,1,1,2,3,3,3
2023-06-01,212123,3,3,6,7,17,18
2023-06-01,399417,2,0,2,1,0,1
2023-06-01,206477,1,5,6,2,3,4
2023-06-01,42394,6,4,10,7,7,9
2023-06-01,35661,11,3,14,36,78,97
2023-06-01,57483,1,1,2,1,1,1
2023-06-01,135671,1,0,1,1,0,1
2023-06-01,43483,2,0,2,1,0,1
2023-06-01,135421,2,2,4,2,3,3
2023-06-01,199295,1,1,2,2,2,3
2023-06-01,211244,1,1,2,3,2,4
2023-06-01,207960,1,6,7,10,7,11
2023-06-01,212948,1,1,2,3,2,4
2023-06-01,209428,3,1,4,2,1,2
2023-06-01,262985,4,0,4,3,0,3
2023-06-01,7721,1,9,10,1,7,7
2023-06-01,60707,14,1,15,5,1,5
2023-06-01,200334,1,6,7,4,5,7
2023-06-01,48292,5,17,22,5,5,8
2023-06-01,208431,2,2,4,10,11,13
2023-06-01,208907,1,1,2,3,2,4
2023-06-01,205892,7,1,8,10,5,10
2023-06-01,209215,1,1,2,1,1,1
2023-06-01,210623,1,1,2,2,1,2
2023-06-01,16942,7,1,8,6,2,6
2023-06-01,212952,1,0,1,1,0,1
2023-06-01,47689,3,4,7,7,8,12
2023-06-01,210821,2,1,3,3,3,4
2023-06-01,38254,2,1,3,8,5,8
2023-06-01,7480,2,3,5,3,2,4
2023-06-01,202076,1,1,2,1,1,1
2023-06-01,224,15,2,17,6,4,6
2023-06-01,58302,3,1,4,1,1,1
2023-06-01,210667,2,15,17,4,11,11
2023-06-01,210041,1,5,6,1,6,6
2023-06-01,208529,1,4,5,2,4,5
2023-06-01,207748,1,2,3,1,1,1
2023-06-01,208021,1,0,1,1,0,1
2023-06-01,39401,39,1,40,7,1,8
2023-06-01,199840,1,2,3,2,3,3
2023-06-01,203691,1,0,1,1,0,1
2023-06-01,200280,1,1,2,2,1,3
2023-06-01,56457,2,4,6,8,5,8
2023-06-01,51574,2,1,3,1,1,1
2023-06-01,211495,1,3,4,2,1,2
2023-06-01,210561,1,1,2,1,1,1
2023-06-01,41495,4,3,7,20,12,22
2023-06-01,202359,1,2,3,6,4,7
2023-06-01,205102,1,4,5,1,5,5
2023-06-01,34979,7,1,8,2,1,2
2023-06-01,206671,1,1,2,1,1,1
2023-06-01,139742,2,4,6,6,9,11
2023-06-01,396503,5,5,10,2,2,3
2023-06-01,203478,1,1,2,5,4,7
2023-06-01,11994,32,0,32,6,0,6
2023-06-01,205827,7,0,7,1,0,1
2023-06-01,207622,1,2,3,1,1,1
2023-06-01,199518,2,12,14,3,8,8
2023-06-01,13132,3,1,4,3,3,4
2023-06-01,150788,3,2,5,2,2,2
2023-06-01,61337,12,2,14,10,4,10
2023-06-01,24705,1,0,1,1,0,1
2023-06-01,398419,2,1,3,2,1,2
2023-06-01,202113,2,2,4,3,3,4
2023-06-01,62374,1,0,1,2,0,2
2023-06-01,207755,1,1,2,2,2,2
2023-06-01,206155,2,1,3,2,1,2
2023-06-01,202224,1,3,4,2,2,3
2023-06-01,200557,1,1,2,1,1,1
2023-06-01,211776,2,1,3,3,2,3
2023-06-01,57853,1,2,3,1,1,1
2023-06-01,40138,11,25,36,4,2,4
2023-06-01,205531,1,3,4,1,3,3
2023-06-01,1050,1,6,7,2,4,4
2023-06-01,137509,7,8,15,6,8,9
2023-06-01,206628,3,4,7,3,10,10
2023-06-01,213384,1,2,3,1,1,1
2023-06-01,213185,1,1,2,2,2,2
2023-06-01,208340,1,1,2,1,2,2
2023-06-01,40761,2,1,3,2,2,2
2023-06-01,33083,10,2,12,5,3,5
2023-06-01,156,16,0,16,5,0,5
2023-06-01,62948,8,0,8,2,0,2
2023-06-01,7332,18,1,19,9,2,9
2023-06-01,395990,2,0,2,3,0,3
2023-06-01,35935,2,1,3,1,1,1
2023-06-01,400232,2,2,4,1,1,1
2023-06-01,26857,13,0,13,2,0,2
2023-06-01,397677,3,0,3,1,0,1
2023-06-01,207722,2,3,5,1,3,3
2023-06-01,398883,2,1,3,1,1,1
2023-06-01,53301,8,0,8,2,0,2
2023-06-01,7753,7,3,10,4,2,4
2023-06-01,10377,2,0,2,2,0,2
2023-06-01,22829,4,0,4,2,0,2
2023-06-01,54869,4,1,5,1,1,1
2023-06-01,18675,6,0,6,3,0,3
2023-06-01,5009,13,1,14,12,9,12
2023-06-01,27294,5,0,5,1,0,1
2023-06-01,54489,9,1,10,4,1,4
2023-06-01,399135,3,3,6,3,2,3
2023-06-01,206885,2,6,8,2,3,3
2023-06-01,20018,8,1,9,2,2,2
2023-06-01,208563,1,1,2,5,3,6
2023-06-01,41051,0,1,1,8,93,95
2023-06-01,60036,8,0,8,2,0,2
2023-06-01,49396,1,0,1,2,0,2
2023-06-01,30746,4,0,4,1,0,1
2023-06-01,197835,2,2,4,3,3,3
2023-06-01,18451,5,1,6,16,7,17
2023-06-01,15102,87,1,88,4,1,4
2023-06-01,25999,21,1,22,3,1,4
2023-06-01,23181,15,0,15,5,0,5
2023-06-01,133072,1,0,1,1,0,1
2023-06-01,26288,13,0,13,5,0,5
2023-06-01,271,61,19,80,24,11,25
2023-06-01,393249,40,2,42,2,1,2
2023-06-01,40598,2,0,2,1,0,1
2023-06-01,137219,1,1,2,1,1,1
2023-06-01,24479,11,1,12,15,6,15
2023-06-01,7546,6,1,7,4,1,4
2023-06-01,9449,31,2,33,7,2,7
2023-06-01,38220,50,5,55,11,4,11
2023-06-01,38221,9,1,10,2,1,2
2023-06-01,38887,3,0,3,7,0,7
2023-06-01,7490,2,0,2,3,0,3
2023-06-01,134245,1,1,2,2,1,2
2023-06-01,56199,4,0,4,4,0,4
2023-06-01,1101,14,2,16,10,4,11
2023-06-01,1103,95,2,97,37,23,40
2023-06-01,199508,11,2,13,4,3,4
2023-06-01,49866,1,1,2,2,2,2
2023-06-01,34387,2,1,3,2,2,2
2023-06-01,16175,2,1,3,1,1,1
2023-06-01,62383,3,0,3,3,0,3
2023-06-01,35701,4,1,5,6,1,6
2023-06-01,208627,1,2,3,5,5,5
2023-06-01,207910,1,1,2,7,6,8
2023-06-01,212760,1,0,1,1,0,1
2023-06-01,204092,2,1,3,11,8,11
2023-06-01,30962,19,5,24,7,6,7
2023-06-01,41108,13,7,20,6,15,18
2023-06-01,212972,1,1,2,2,2,2
2023-06-01,210312,4,1,5,7,6,9
2023-06-01,8298,3,3,6,16,18,20
2023-06-01,1213,17,1,18,10,10,11
2023-06-01,56067,4,1,5,4,2,4
2023-06-01,135646,4,1,5,1,1,1
2023-06-01,208993,1,2,3,1,2,2
2023-06-01,4842,1,4,5,2,5,5
2023-06-01,209306,1,5,6,3,2,4
2023-06-01,209114,3,1,4,2,4,5
2023-06-01,8893,33,5,38,16,7,17
2023-06-01,58247,7,1,8,3,1,3
2023-06-01,62445,9,3,12,3,4,4
2023-06-01,57883,7,16,23,3,7,7
2023-06-01,5404,36,1,37,20,11,21
2023-06-01,202928,2,17,19,1,1,1
2023-06-01,10080,8,2,10,7,6,7
2023-06-01,133217,2,1,3,1,1,1
2023-06-01,206161,1,2,3,1,2,2
2023-06-01,6556,4,18,22,1,1,2
2023-06-01,290,3,1,4,1,1,1
2023-06-01,1312,4,5,9,2,2,2
2023-06-01,265662,5,1,6,3,2,4
2023-06-01,262643,28,7,35,11,5,11
2023-06-01,266042,1,1,2,3,2,4
2023-06-01,52988,3,1,4,11,2,11
2023-06-01,266052,4,0,4,2,0,2
2023-06-01,263482,13,4,17,24,15,24
2023-06-01,270539,5,0,5,6,0,6
2023-06-01,53065,18,1,19,40,35,43
2023-06-01,266035,5,1,6,2,1,2
2023-06-01,262756,22,6,28,9,6,10
2023-06-01,266053,1,1,2,1,1,1
2023-06-01,266050,7,2,9,2,2,2
2023-06-01,262459,76,36,112,8,6,9
2023-06-01,266043,4,7,11,3,2,3
2023-06-01,264969,3,5,8,13,10,13
2023-06-01,266036,3,1,4,2,2,2
2023-06-01,265038,3,3,6,17,13,19
2023-06-01,52872,27,3,30,52,30,53
2023-06-01,266045,5,0,5,1,0,1
2023-06-01,267388,11,0,11,2,0,2
2023-06-01,273683,1,4,5,40,28,41
2023-06-01,266054,6,1,7,4,2,5
2023-06-01,52699,24,11,35,9,5,9
2023-06-01,266055,7,0,7,1,0,1
2023-06-01,266037,7,3,10,5,4,5
2023-06-01,267469,5,7,12,52,34,52
2023-06-01,28642,41,9,50,18,14,18
2023-06-01,266040,5,7,12,5,2,5
2023-06-01,53237,37,17,54,31,21,31
2023-06-01,265377,2,1,3,30,21,32
2023-06-01,266039,3,9,12,9,5,10
2023-06-01,267524,3,1,4,8,3,8
2023-06-01,28220,24,3,27,21,15,22
2023-06-01,53059,44,5,49,6,1,6
2023-06-01,266069,7,0,7,5,0,5
2023-06-01,262594,7,1,8,11,8,12
2023-06-01,266046,1,0,1,1,0,1
2023-06-01,52866,15,1,16,21,14,21
2023-06-01,266041,3,0,3,4,0,4
2023-06-01,17222,137,2,139,60,23,64
2023-06-01,266925,5,5,10,43,34,49
2023-06-01,262234,25,2,27,7,1,7
2023-06-01,27696,92,33,125,19,5,19
2023-06-01,265674,1,0,1,1,0,1
2023-06-01,266077,1,0,1,1,0,1
2023-06-01,265658,1,0,1,1,0,1
2023-06-01,6568,119,2,121,21,5,21
2023-06-01,265756,2,0,2,1,0,1
2023-06-01,265673,4,0,4,2,0,2
2023-06-01,266063,7,3,10,3,2,3
2023-06-01,11835,100,3,103,16,9,17
2023-06-01,271253,14,8,22,124,89,134
2023-06-01,264556,13,6,19,41,27,46
2023-06-01,266047,6,1,7,1,1,1
2023-06-01,266070,7,0,7,2,0,2
2023-06-01,266048,1,1,2,1,1,1
2023-06-01,266071,3,3,6,5,2,5
2023-06-01,263432,21,12,33,49,35,55
2023-06-01,266066,3,3,6,3,1,3
2023-06-01,263650,13,6,19,20,14,22
2023-06-01,266337,3,1,4,7,2,7
2023-06-01,22869,27,1,28,9,5,9
2023-06-01,266062,5,3,8,7,2,8
2023-06-01,398947,1,0,1,5,2,5
2023-06-01,27884,162,5,167,12,4,12
2023-06-01,266072,2,1,3,2,2,2
2023-06-01,263629,16,27,43,35,22,35
2023-06-01,264288,5,3,8,21,18,24
2023-06-01,266049,5,7,12,3,3,4
2023-06-01,61888,14,13,27,9,5,9
2023-06-01,265890,7,2,9,15,13,16
2023-06-01,266073,6,0,6,1,0,1
2023-06-01,264170,7,2,9,28,18,31
2023-06-01,266074,5,4,9,3,1,3
2023-06-01,268678,5,0,5,5,0,5
2023-06-01,262999,3,1,4,32,18,33
2023-06-01,52444,95,13,108,37,13,38
2023-06-01,265683,5,0,5,1,0,1
2023-06-01,266749,7,0,7,3,0,3
2023-06-01,265678,3,0,3,1,0,1
2023-06-01,55293,114,0,114,9,0,9
2023-06-01,266009,3,7,10,10,8,10
2023-06-01,266097,7,2,9,5,1,5
2023-06-01,269646,6,8,14,18,8,18
2023-06-01,265904,4,3,7,11,3,11
2023-06-01,61893,14,1,15,8,6,9
2023-06-01,266057,3,0,3,1,0,1
2023-06-01,266089,1,0,1,3,0,3
2023-06-01,266087,5,0,5,4,0,4
2023-06-01,204300,8,0,8,1,0,1
2023-06-01,265680,4,1,5,14,17,18
2023-06-01,265671,1,5,6,1,1,1
2023-06-01,264595,5,4,9,12,10,12
2023-06-01,266086,3,1,4,1,1,1
2023-06-01,262502,7,3,10,7,4,8
2023-06-01,266061,2,0,2,1,0,1
2023-06-01,266059,6,1,7,10,4,10
2023-06-01,265679,4,0,4,2,0,2
2023-06-01,266067,5,1,6,2,2,2
2023-06-01,28359,118,3,121,42,24,42
2023-06-01,266060,7,1,8,6,1,6
2023-06-01,28666,15,1,16,30,11,33
2023-06-01,266075,3,0,3,3,0,3
2023-06-01,266058,6,5,11,2,1,2
2023-06-01,266076,7,11,18,6,5,6
2023-06-01,267313,6,4,10,13,12,14
2023-06-01,28186,88,4,92,89,56,95
2023-06-01,266065,3,5,8,3,1,3
2023-06-01,263919,6,3,9,4,3,5
2023-06-01,264564,3,1,4,21,17,21
2023-06-01,266064,3,1,4,1,1,1
2023-06-01,28145,11,2,13,12,9,12
2023-06-01,263944,1,1,2,2,1,2
2023-06-01,265661,4,0,4,3,0,3
2023-06-01,61599,4,1,5,23,18,25
2023-06-01,263774,12,1,13,35,11,35
2023-06-01,265687,3,0,3,2,0,2
2023-06-01,266132,5,0,5,2,0,2
2023-06-01,16906,8,2,10,6,2,6
2023-06-01,265670,1,0,1,4,0,4
2023-06-01,27882,292,30,322,20,3,20
2023-06-01,26210,178,11,189,11,3,12
2023-06-01,262206,8,0,8,27,14,27
2023-06-01,266068,1,0,1,3,0,3
2023-06-01,263396,4,3,7,10,5,10
2023-06-01,52873,14,1,15,79,56,82
2023-06-01,263321,4,1,5,8,8,10
2023-06-01,10481,7,0,7,34,5,34
2023-06-01,265690,1,0,1,2,0,2
2023-06-01,262476,37,7,44,49,29,50
2023-06-01,266083,2,1,3,1,1,1
2023-06-01,265685,5,0,5,2,0,2
2023-06-01,271061,3,1,4,2,1,2
2023-06-01,265160,1,3,4,4,4,5
2023-06-01,262262,21,1,22,2,1,2
2023-06-01,265706,4,0,4,1,0,1
2023-06-01,266080,6,1,7,9,5,9
2023-06-01,266610,2,2,4,6,4,6
2023-06-01,270452,4,1,5,5,5,6
2023-06-01,266093,3,1,4,5,1,5
2023-06-01,262456,10,0,10,5,3,6
2023-06-01,265462,3,1,4,9,5,9
2023-06-01,264216,2,1,3,10,6,10
2023-06-01,266107,1,1,2,2,1,2
2023-06-01,266081,5,7,12,4,2,4
2023-06-01,265530,4,0,4,1,0,1
2023-06-01,266757,10,2,12,6,2,6
2023-06-01,12252,422,262,684,18,12,19
2023-06-01,394474,12,0,12,1,0,1
2023-06-01,267113,3,3,6,8,5,8
2023-06-01,266082,2,1,3,4,2,4
2023-06-01,53234,8,4,12,6,5,6
2023-06-01,266207,7,3,10,8,6,9
2023-06-01,266088,3,1,4,1,2,2
2023-06-01,61874,5,1,6,3,2,3
2023-06-01,269418,7,1,8,2,1,2
2023-06-01,266090,3,3,6,2,1,2
2023-06-01,268689,2,1,3,37,27,37
2023-06-01,266516,7,1,8,14,5,14
2023-06-01,266084,1,0,1,1,0,1
2023-06-01,28419,6,0,6,3,0,3
2023-06-01,28191,60,1,61,29,23,30
2023-06-01,266095,7,1,8,2,3,3
2023-06-01,28126,47,17,64,93,62,96
2023-06-01,268687,3,3,6,4,4,4
2023-06-01,263920,122,7,129,12,13,14
2023-06-01,266096,5,1,6,1,1,1
2023-06-01,262818,5,5,10,12,4,13
2023-06-01,266092,4,0,4,7,0,7
2023-06-01,266650,4,1,5,5,2,5
2023-06-01,271042,5,18,23,12,8,12
2023-06-01,264948,6,1,7,3,4,6
2023-06-01,266015,4,2,6,4,2,4
2023-06-01,266094,5,3,8,18,17,18
2023-06-01,14259,171,178,349,70,22,71
2023-06-01,265644,3,0,3,1,0,1
2023-06-01,266111,7,0,7,2,0,2
2023-06-01,53102,18,4,22,20,13,20
2023-06-01,268238,9,4,13,2,1,2
2023-06-01,52551,1,2,3,48,32,50
2023-06-01,53012,1,1,2,3,3,6
2023-06-01,264562,24,7,31,24,13,26
2023-06-01,266098,7,0,7,6,0,6
2023-06-01,269633,2,1,3,5,5,6
2023-06-01,264444,2,1,3,6,4,6
2023-06-01,266103,1,1,2,2,2,3
2023-06-01,265702,1,0,1,2,0,2
2023-06-01,265676,4,1,5,2,1,2
2023-06-01,266114,5,3,8,3,3,3
2023-06-01,265144,8,2,10,27,17,29
2023-06-01,10299,70,1,71,7,3,7
2023-06-01,265696,17,1,18,2,1,2
2023-06-01,262766,3,1,4,5,1,5
2023-06-01,266179,1,0,1,1,0,1
2023-06-01,52747,21,5,26,14,9,14
2023-06-01,264344,4,31,35,18,13,19
2023-06-01,266194,4,0,4,1,0,1
2023-06-01,263258,9,2,11,9,7,9
2023-06-01,266104,5,4,9,3,2,3
2023-06-01,265217,3,2,5,5,1,5
2023-06-01,263042,5,2,7,8,8,10
2023-06-01,267335,5,2,7,4,3,4
2023-06-01,266106,5,1,6,4,1,4
2023-06-01,52850,31,7,38,7,7,8
2023-06-01,267427,5,10,15,16,10,17
2023-06-01,269213,3,2,5,5,2,5
2023-06-01,266722,0,0,0,11,0,11
2023-06-01,266122,1,1,2,1,1,1
2023-06-01,266100,3,2,5,2,2,2
2023-06-01,266101,3,1,4,5,1,5
2023-06-01,271938,7,1,8,1,1,1
2023-06-01,263569,30,7,37,11,7,11
2023-06-01,264270,10,4,14,10,6,10
2023-06-01,266113,5,1,6,1,1,1
2023-06-01,263903,18,8,26,102,71,112
2023-06-01,266102,5,3,8,2,1,2
2023-06-01,263151,27,1,28,12,11,13
2023-06-01,262462,4,1,5,65,56,69
2023-06-01,271271,1,1,2,1,1,1
2023-06-01,266109,3,0,3,3,0,3
2023-06-01,263880,47,24,71,24,13,25
2023-06-01,266124,7,3,10,5,1,5
2023-06-01,267973,2,1,3,6,1,6
2023-06-01,262286,10,4,14,18,11,18
2023-06-01,266110,7,1,8,2,1,2
2023-06-01,271034,3,4,7,5,1,5
2023-06-01,267357,8,3,11,4,3,5
2023-06-01,263641,19,6,25,7,5,7
2023-06-01,263415,41,2,43,14,10,16
2023-06-01,266115,5,0,5,3,0,3
2023-06-01,264127,3,1,4,23,17,23
2023-06-01,61844,15,5,20,47,29,50
2023-06-01,262875,4,0,4,5,0,5
2023-06-01,266233,4,3,7,42,24,42
2023-06-01,52579,21,9,30,39,26,43
2023-06-01,265686,12,0,12,1,0,1
2023-06-01,265819,3,1,4,1,1,1
2023-06-01,266117,4,1,5,4,2,4
2023-06-01,266269,4,3,7,17,14,19
2023-06-01,266119,3,1,4,3,1,3
2023-06-01,266120,3,0,3,1,0,1
2023-06-01,266118,1,1,2,6,6,6
2023-06-01,52840,8,1,9,47,31,47
2023-06-01,266121,4,5,9,12,4,12
2023-06-01,270814,99,12,111,22,17,27
2023-06-01,267955,4,4,8,5,5,6
2023-06-01,278014,5,0,5,5,0,5
2023-06-01,266152,5,3,8,14,11,14
2023-06-01,264605,4,2,6,1,1,1
2023-06-01,16371,105,1,106,2,1,3
2023-06-01,267420,17,23,40,35,28,35
2023-06-01,266128,7,0,7,2,0,2
2023-06-01,52742,7,10,17,9,5,9
2023-06-01,265505,1,0,1,3,0,3
2023-06-01,266133,7,1,8,1,2,2
2023-06-01,271321,3,1,4,3,4,4
2023-06-01,270985,2,1,3,2,1,2
2023-06-01,52688,7,1,8,13,7,14
2023-06-01,268757,10,0,10,2,2,2
2023-06-01,266180,3,0,3,3,0,3
2023-06-01,266182,1,1,2,1,1,1
2023-06-01,52630,68,3,71,19,11,19
2023-06-01,266186,1,0,1,1,0,1
2023-06-01,53180,48,115,163,38,34,42
2023-06-01,268337,7,31,38,7,6,7
2023-06-01,266127,5,2,7,2,2,2
2023-06-01,266129,7,7,14,19,10,20
2023-06-01,265274,4,1,5,4,2,4
2023-06-01,266185,8,8,16,6,4,6
2023-06-01,265761,5,1,6,2,1,2
2023-06-01,266181,32,14,46,31,21,35
2023-06-01,265701,4,0,4,2,0,2
2023-06-01,266130,6,1,7,8,3,8
2023-06-01,262526,9,2,11,21,15,22
2023-06-01,266131,3,2,5,14,10,14
2023-06-01,53163,4,1,5,14,14,15
2023-06-01,266157,4,1,5,2,1,2
2023-06-01,52863,8,4,12,72,29,74
2023-06-01,266158,1,1,2,2,2,3
2023-06-01,266389,6,2,8,8,6,9
2023-06-01,266134,1,0,1,3,0,3
2023-06-01,265147,4,6,10,33,21,35
2023-06-01,266135,4,22,26,10,9,15
2023-06-01,268788,3,1,4,4,2,5
2023-06-01,265697,5,0,5,1,0,1
2023-06-01,266136,5,3,8,18,12,20
2023-06-01,265531,5,0,5,2,0,2
2023-06-01,266227,4,0,4,1,0,1
2023-06-01,28649,45,1,46,26,19,26
2023-06-01,28284,21,12,33,7,3,7
2023-06-01,263969,3,5,8,1,1,2
2023-06-01,270631,24,1,25,2,2,2
2023-06-01,266231,7,0,7,2,0,2
2023-06-01,264880,8,12,20,5,3,6
2023-06-01,266196,4,1,5,5,3,6
2023-06-01,266140,6,7,13,7,3,7
2023-06-01,28580,220,13,233,19,13,19
2023-06-01,262696,5,0,5,8,0,8
2023-06-01,266138,1,1,2,3,2,5
2023-06-01,266139,5,3,8,6,3,6
2023-06-01,268018,28,2,30,10,4,11
2023-06-01,264378,5,3,8,2,1,2
2023-06-01,264133,1,1,2,3,4,4
2023-06-01,266170,2,1,3,1,1,1
2023-06-01,263250,35,3,38,19,11,19
2023-06-01,53158,32,7,39,45,19,48
2023-06-01,266232,5,4,9,6,2,6
2023-06-01,52686,9,3,12,8,5,8
2023-06-01,262493,29,16,45,39,32,42
2023-06-01,266164,4,1,5,1,1,1
2023-06-01,266169,6,1,7,5,3,5
2023-06-01,266545,5,3,8,8,7,9
2023-06-01,268283,5,1,6,10,9,10
2023-06-01,266563,4,2,6,4,3,4
2023-06-01,265336,1,4,5,15,13,15
2023-06-01,52720,7,2,9,35,23,38
2023-06-01,266520,8,1,9,21,13,24
2023-06-01,266245,1,1,2,1,1,1
2023-06-01,52862,114,28,142,26,14,26
2023-06-01,266246,7,1,8,1,1,1
2023-06-01,266250,1,1,2,1,1,1
2023-06-01,265709,2,0,2,1,0,1
2023-06-01,270101,4,0,4,1,0,1
2023-06-01,266247,4,3,7,20,15,21
2023-06-01,266248,3,2,5,4,2,4
2023-06-01,265724,1,0,1,1,0,1
2023-06-01,61649,24,1,25,3,1,3
2023-06-01,264386,5,1,6,11,5,12
2023-06-01,266167,1,1,2,33,20,35
2023-06-01,61657,7,3,10,4,2,4
2023-06-01,271078,4,2,6,3,2,3
2023-06-01,61689,18,16,34,32,30,39
2023-06-01,52609,18,2,20,5,2,5
2023-06-01,264112,2,1,3,13,12,14
2023-06-01,266613,4,1,5,2,1,2
2023-06-01,265015,7,1,8,2,2,2
2023-06-01,266579,4,1,5,1,1,1
2023-06-01,61678,22,17,39,44,30,45
2023-06-01,266606,8,7,15,2,2,2
2023-06-01,266560,5,1,6,5,2,5
2023-06-01,265187,1,1,2,7,4,7
2023-06-01,265113,3,5,8,7,4,9
2023-06-01,266596,5,1,6,2,2,2
2023-06-01,266568,4,2,6,2,2,2
2023-06-01,28420,1,0,1,1,0,1
2023-06-01,61939,9,1,10,11,2,11
2023-06-01,266597,3,0,3,3,0,3
2023-06-01,262617,40,24,64,6,5,7
2023-06-01,266532,1,3,4,2,1,3
2023-06-01,266565,1,1,2,2,1,2
2023-06-01,264500,5,8,13,12,6,12
2023-06-01,265534,13,0,13,2,0,2
2023-06-01,28146,128,18,146,105,64,110
2023-06-01,266581,1,0,1,1,0,1
2023-06-01,266567,5,0,5,1,0,1
2023-06-01,266561,4,0,4,4,0,4
2023-06-01,265587,16,2,18,4,2,4
2023-06-01,270143,4,2,6,3,2,3
2023-06-01,263004,6,7,13,4,1,4
2023-06-01,266570,3,0,3,2,0,2
2023-06-01,268503,7,4,11,24,17,25
2023-06-01,263935,6,3,9,17,8,18
2023-06-01,266578,4,3,7,1,1,1
2023-06-01,262737,9,1,10,4,2,4
2023-06-01,266575,5,0,5,2,0,2
2023-06-01,263099,21,3,24,15,9,16
2023-06-01,265722,4,0,4,1,0,1
2023-06-01,263764,10,0,10,3,0,3
2023-06-01,265723,2,0,2,1,0,1
2023-06-01,263793,10,3,13,15,4,15
2023-06-01,27827,39,0,39,6,0,6
2023-06-01,271386,1,1,2,1,1,1
2023-06-01,266571,1,1,2,3,1,3
2023-06-01,268267,1,2,3,15,11,15
2023-06-01,266573,7,1,8,4,1,4
2023-06-01,266638,7,1,8,1,1,1
2023-06-01,265692,5,0,5,2,0,2
2023-06-01,262186,324,72,396,23,15,26
2023-06-01,265554,15,7,22,3,1,3
2023-06-01,265535,5,1,6,4,1,4
2023-06-01,271816,2,1,3,1,1,1
2023-06-01,266605,5,3,8,1,1,1
2023-06-01,266586,3,1,4,4,3,4
2023-06-01,53097,15,1,16,11,6,11
2023-06-01,266593,7,1,8,3,3,3
2023-06-01,10733,21,1,22,26,15,26
2023-06-01,262729,37,24,61,7,6,7
2023-06-01,266587,2,6,8,1,1,1
2023-06-01,262532,12,7,19,24,11,25
2023-06-01,266588,3,1,4,2,1,2
2023-06-01,266592,5,5,10,7,4,8
2023-06-01,266594,1,0,1,3,0,3
2023-06-01,61834,2,1,3,4,1,4
2023-06-01,266591,1,0,1,1,0,1
2023-06-01,266240,3,8,11,19,15,19
2023-06-01,266626,5,1,6,4,2,4
2023-06-01,61592,9,89,98,20,10,21
2023-06-01,269663,1,1,2,5,2,6
2023-06-01,266599,1,0,1,1,0,1
2023-06-01,266601,1,0,1,1,0,1
2023-06-01,61666,21,8,29,10,8,12
2023-06-01,266595,7,0,7,1,0,1
2023-06-01,266607,7,3,10,4,3,5
2023-06-01,266608,3,7,10,7,5,8
2023-06-01,267201,3,7,10,12,5,12
2023-06-01,265022,7,1,8,21,10,24
2023-06-01,265924,4,1,5,3,1,3
2023-06-01,263124,14,2,16,39,30,42
2023-06-01,266614,3,1,4,4,1,4
2023-06-01,61917,9,1,10,8,7,10
2023-06-01,268246,7,5,12,3,2,3
2023-06-01,265729,5,0,5,4,0,4
2023-06-01,262150,21,1,22,14,2,15
2023-06-01,266622,7,4,11,6,4,6
2023-06-01,28306,50,21,71,31,17,31
2023-06-01,268925,7,3,10,21,16,23
2023-06-01,266619,2,0,2,5,0,5
2023-06-01,265061,7,1,8,33,22,36
2023-06-01,266598,2,3,5,4,3,4
2023-06-01,262427,7,1,8,19,16,22
2023-06-01,268479,5,1,6,2,2,2
2023-06-01,266615,1,1,2,1,1,1
2023-06-01,262761,87,52,139,70,54,75
2023-06-01,52368,14,6,20,5,1,5
2023-06-01,52512,1,0,1,2,0,2
2023-06-01,266602,7,2,9,16,9,16
2023-06-01,265736,1,0,1,1,0,1
2023-06-01,265738,10,0,10,3,0,3
2023-06-01,265739,3,0,3,1,0,1
2023-06-01,204303,9,0,9,3,0,3
2023-06-01,206276,7,0,7,14,0,14
2023-06-01,400040,30,0,30,1,0,1
2023-06-01,16628,77,0,77,2,0,2
2023-06-01,141968,12,9,21,1,1,2
2023-06-01,200046,2,0,2,1,0,1
2023-06-01,209064,5,0,5,1,0,1
2023-06-01,209055,1,0,1,1,0,1
2023-06-01,199738,10,0,10,2,0,2
2023-06-01,50585,4,0,4,2,0,2
2023-06-01,56596,15,0,15,3,0,3
2023-06-01,43414,5,3,8,12,12,15
2023-06-01,206894,13,6,19,1,1,1
2023-06-01,5429,7,0,7,12,0,12
2023-06-01,49450,1,0,1,2,0,2
2023-06-01,49478,4,0,4,6,0,6
2023-06-01,12348,5,2,7,7,4,7
2023-06-01,147287,12,0,12,2,0,2
2023-06-01,48716,99,1,100,4,4,4
2023-06-01,57681,2,2,4,35,2,35
2023-06-01,62010,8,0,8,4,0,4
2023-06-01,44205,3,3,6,3,2,3
2023-06-01,206516,4,4,8,6,4,6
2023-06-01,200370,22,0,22,5,0,5
2023-06-01,208987,1,0,1,1,0,1
2023-06-01,200415,1,0,1,1,0,1
2023-06-01,198740,2,0,2,1,0,1
2023-06-01,210531,18,0,18,1,0,1
2023-06-01,30740,4,1,5,11,4,11
2023-06-01,208330,1,0,1,1,0,1
2023-06-01,211804,5,0,5,1,0,1
2023-06-01,400529,8,0,8,3,0,3
2023-06-01,203470,1,0,1,1,0,1
2023-06-01,57025,1,1,2,1,1,1
2023-06-01,60800,8,1,9,13,6,13
2023-06-01,204174,4,0,4,6,0,6
2023-06-01,271993,1,4,5,1,1,1
2023-06-01,210720,1,0,1,3,0,3
2023-06-01,201752,1,0,1,1,0,1
2023-06-01,48254,12,7,19,7,6,7
2023-06-01,29470,44,1,45,4,1,4
2023-06-01,58236,1,0,1,1,0,1
2023-06-01,209053,1,0,1,3,0,3
2023-06-01,49033,23,0,23,12,0,12
2023-06-01,209048,1,0,1,1,0,1
2023-06-01,211198,1,0,1,1,0,1
2023-06-01,211393,3,10,13,6,5,7
2023-06-01,62206,11,5,16,30,7,30
2023-06-01,202890,1,0,1,1,0,1
2023-06-01,2601,2,0,2,1,0,1
2023-06-01,209047,5,0,5,1,0,1
2023-06-01,209023,4,0,4,1,0,1
2023-06-01,209046,5,0,5,2,0,2
2023-06-01,4862,1,0,1,20,10,21
2023-06-01,51964,351,60,411,24,11,25
2023-06-01,6505,4,0,4,5,2,5
2023-06-01,5583,0,0,0,11,8,14
2023-06-01,35421,3,0,3,7,0,7
2023-06-01,202942,8,0,8,2,0,2
2023-06-01,208606,7,0,7,1,0,1
2023-06-01,200740,20,6,26,3,3,3
2023-06-01,205090,35,2,37,1,1,1
2023-06-01,212009,2,0,2,2,0,2
2023-06-01,43467,4,0,4,1,0,1
2023-06-01,35061,1,0,1,1,0,1
2023-06-01,33986,7,1,8,10,5,11
2023-06-01,1301,41,3,44,7,6,7
2023-06-01,211310,1,1,2,1,1,1
2023-06-01,205981,5,0,5,1,0,1
2023-06-01,212327,1,0,1,3,0,3
2023-06-01,204161,12,0,12,2,0,2
2023-06-01,209038,2,0,2,1,0,1
2023-06-01,49447,3,2,5,2,1,2
2023-06-01,47969,6,0,6,3,0,3
2023-06-01,42490,2,0,2,2,0,2
2023-06-01,62142,1,2,3,3,1,3
2023-06-01,211366,1,0,1,2,0,2
2023-06-01,51255,1,2,3,1,1,2
2023-06-01,208975,1,0,1,2,0,2
2023-06-01,207239,2,1,3,2,1,3
2023-06-01,51920,8,11,19,3,2,3
2023-06-01,208977,0,0,0,3,0,3
2023-06-01,59909,11,4,15,4,4,4
2023-06-01,51616,9,0,9,3,0,3
2023-06-01,209033,1,0,1,1,0,1
2023-06-01,60589,9,0,9,3,0,3
2023-06-01,49895,4,1,5,15,4,15
2023-06-01,42331,13,3,16,9,4,9
2023-06-01,42159,26,16,42,3,2,3
2023-06-01,209031,5,0,5,1,0,1
2023-06-01,207409,1,0,1,1,0,1
2023-06-01,209859,4,9,13,3,5,5
2023-06-01,23422,13,0,13,3,0,3
2023-06-01,208978,3,0,3,1,0,1
2023-06-01,198034,4,1,5,4,3,4
2023-06-01,25431,6,0,6,4,0,4
2023-06-01,59514,1,0,1,1,0,1
2023-06-01,203303,2,0,2,1,0,1
2023-06-01,60985,1,0,1,1,0,1
2023-06-01,41528,4,1,5,3,3,3
2023-06-01,210874,2,1,3,6,4,6
2023-06-01,203004,7,3,10,5,2,5
2023-06-01,49030,1,2,3,1,1,1
2023-06-01,198192,8,0,8,2,0,2
2023-06-01,393262,30,0,30,3,0,3
2023-06-01,197395,5,1,6,2,2,2
2023-06-01,61154,15,0,15,6,0,6
2023-06-01,207912,1,0,1,5,0,5
2023-06-01,2821,2,0,2,2,0,2
2023-06-01,47954,30,0,30,6,0,6
2023-06-01,208198,1,0,1,1,0,1
2023-06-01,212953,5,0,5,1,0,1
2023-06-01,207482,1,0,1,1,0,1
2023-06-01,206662,2,0,2,3,0,3
2023-06-01,208837,1,0,1,3,0,3
2023-06-01,209015,4,0,4,2,0,2
2023-06-01,209016,4,0,4,1,0,1
2023-06-01,35751,20,0,20,1,0,1
2023-06-01,208999,4,0,4,1,0,1
2023-06-01,199927,4,2,6,1,1,1
2023-06-01,205893,5,2,7,2,1,2
2023-06-01,211335,1,0,1,1,0,1
2023-06-01,209007,5,0,5,2,0,2
2023-06-01,43180,9,1,10,1,1,2
2023-06-01,202004,2,0,2,4,0,4
2023-06-01,39273,85,1,86,11,1,11
2023-06-01,209004,3,0,3,3,0,3
2023-06-01,8829,8,2,10,5,3,5
2023-06-01,56971,42,2,44,8,2,8
2023-06-01,57578,7,6,13,11,6,13
2023-06-01,35487,7,20,27,14,12,17
2023-06-01,201333,9,3,12,8,4,9
2023-06-01,35793,6,1,7,8,5,10
2023-06-01,39761,6,2,8,2,2,2
2023-06-01,208997,4,0,4,2,0,2
2023-06-01,13216,7,0,7,2,0,2
2023-06-01,211415,44,0,44,2,0,2
2023-06-01,200851,6,2,8,4,2,4
2023-06-01,62455,7,2,9,1,1,1
2023-06-01,207408,3,1,4,1,1,1
2023-06-01,208996,4,0,4,1,0,1
2023-06-01,44086,6,0,6,4,0,4
2023-06-01,207782,8,0,8,1,0,1
2023-06-01,58293,4,1,5,2,1,2
2023-06-01,39090,4,1,5,9,7,11
2023-06-01,50556,13,0,13,3,0,3
2023-06-01,35645,28,0,28,7,0,7
2023-06-01,29670,8,5,13,19,16,25
2023-06-01,212872,7,6,13,2,2,2
2023-06-01,208989,1,0,1,2,0,2
2023-06-01,49824,14,2,16,17,3,17
2023-06-01,207475,2,0,2,1,0,1
2023-06-01,212419,1,0,1,1,0,1
2023-06-01,200313,31,3,34,4,2,4
2023-06-01,57030,11,0,11,4,0,4
2023-06-01,197886,8,1,9,1,1,1
2023-06-01,29423,12,5,17,2,2,2
2023-06-01,28961,2,0,2,2,0,2
2023-06-01,208961,4,0,4,3,0,3
2023-06-01,8245,9,1,10,18,9,19
2023-06-01,47576,4,1,5,3,2,4
2023-06-01,24953,19,4,23,13,6,14
2023-06-01,59780,6,1,7,3,3,3
2023-06-01,39864,5,0,5,8,3,8
2023-06-01,208981,4,1,5,1,1,1
2023-06-01,30892,6,2,8,5,3,5
2023-06-01,50715,6,1,7,1,1,1
2023-06-01,61397,3,0,3,4,0,4
2023-06-01,208767,4,0,4,1,0,1
2023-06-01,43747,2,0,2,1,0,1
2023-06-01,204680,1,1,2,5,5,5
2023-06-01,208974,2,1,3,1,1,1
2023-06-01,202914,29,1,30,15,5,15
2023-06-01,35085,1,3,4,1,1,1
2023-06-01,680,287,12,299,40,26,41
2023-06-01,6643,10,0,10,6,0,6
2023-06-01,202539,1,3,4,2,2,2
2023-06-01,47536,2,1,3,1,1,1
2023-06-01,209347,1,1,2,5,3,5
2023-06-01,202596,52,0,52,8,0,8
2023-06-01,204841,1,2,3,2,2,2
2023-06-01,60377,2,1,3,7,6,8
2023-06-01,23031,20,9,29,13,4,13
2023-06-01,202125,10,0,10,3,0,3
2023-06-01,207790,5,1,6,10,6,12
2023-06-01,208342,2,0,2,1,0,1
2023-06-01,60757,11,0,11,9,0,9
2023-06-01,208946,3,0,3,2,0,2
2023-06-01,12693,21,2,23,23,8,24
2023-06-01,208968,6,0,6,3,0,3
2023-06-01,203536,6,3,9,9,6,11
2023-06-01,50628,11,4,15,16,10,17
2023-06-01,35077,2,0,2,1,0,1
2023-06-01,35478,39,0,39,1,0,1
2023-06-01,39452,4,0,4,2,0,2
2023-06-01,208963,1,0,1,1,0,1
2023-06-01,201172,7,0,7,1,0,1
2023-06-01,208956,2,0,2,3,0,3
2023-06-01,210869,3,0,3,2,0,2
2023-06-01,208784,3,0,3,2,0,2
2023-06-01,51548,1,0,1,6,0,6
2023-06-01,212530,1,0,1,2,0,2
2023-06-01,47484,1,2,3,1,3,3
2023-06-01,201877,17,0,17,9,0,9
2023-06-01,200781,5,2,7,16,12,20
2023-06-01,44092,100,3,103,11,4,11
2023-06-01,60995,1,0,1,2,0,2
2023-06-01,208839,1,1,2,1,1,1
2023-06-01,212700,1,0,1,4,0,4
2023-06-01,62579,30,0,30,1,0,1
2023-06-01,208804,4,0,4,2,0,2
2023-06-01,42130,18,0,18,1,0,1
2023-06-01,201446,39,0,39,5,0,5
2023-06-01,32613,28,3,31,12,3,12
2023-06-01,197077,26,0,26,3,0,3
2023-06-01,208616,3,0,3,1,0,1
2023-06-01,205999,3,0,3,2,0,2
2023-06-01,21221,8,3,11,7,6,7
2023-06-01,208476,6,1,7,6,1,6
2023-06-01,208955,2,0,2,4,0,4
2023-06-01,49223,60,1,61,6,2,6
2023-06-01,42504,2,1,3,11,1,11
2023-06-01,48437,6,0,6,1,0,1
2023-06-01,208952,4,0,4,1,0,1
2023-06-01,208881,3,0,3,1,0,1
2023-06-01,208776,1,0,1,2,0,2
2023-06-01,42032,1,0,1,1,0,1
2023-06-01,206499,2,28,30,5,22,23
2023-06-01,208913,106,0,106,1,0,1
2023-06-01,208939,2,0,2,1,0,1
2023-06-01,57389,30,1,31,2,1,2
2023-06-01,208721,1,0,1,2,0,2
2023-06-01,29468,23,3,26,9,3,9
2023-06-01,44938,4,0,4,2,0,2
2023-06-01,200069,14,0,14,4,0,4
2023-06-01,209987,2,0,2,1,0,1
2023-06-01,208924,1,0,1,2,0,2
2023-06-01,204451,1,0,1,1,0,1
2023-06-01,8342,27,1,28,14,4,15
2023-06-01,49042,3,0,3,1,0,1
2023-06-01,208934,2,0,2,1,0,1
2023-06-01,208942,1,2,3,4,4,4
2023-06-01,35711,4,0,4,1,0,1
2023-06-01,34679,1,0,1,2,0,2
2023-06-01,35055,3,0,3,1,0,1
2023-06-01,61390,11,0,11,3,0,3
2023-06-01,206818,1,0,1,3,0,3
2023-06-01,208925,4,0,4,1,0,1
2023-06-01,208928,8,0,8,3,0,3
2023-06-01,140715,2,0,2,2,0,2
2023-06-01,34756,13,2,15,9,7,11
2023-06-01,42675,14,13,27,1,1,1
2023-06-01,208933,3,0,3,2,0,2
2023-06-01,206496,8,0,8,2,0,2
2023-06-01,50959,3,2,5,3,1,3
2023-06-01,198521,5,0,5,2,0,2
2023-06-01,42189,4,1,5,1,1,1
2023-06-01,2118,27,0,27,2,0,2
2023-06-01,44307,25,0,25,2,0,2
2023-06-01,28875,3,6,9,2,1,2
2023-06-01,208929,1,1,2,2,1,2
2023-06-01,207054,3,1,4,6,4,6
2023-06-01,34568,9,3,12,2,2,2
2023-06-01,33984,14,2,16,1,2,2
2023-06-01,15765,3,1,4,2,1,2
2023-06-01,206195,9,0,9,2,0,2
2023-06-01,208897,5,0,5,2,0,2
2023-06-01,208909,16,2,18,1,1,1
2023-06-01,48675,2,0,2,1,0,1
2023-06-01,211409,4,0,4,2,0,2
2023-06-01,208922,2,0,2,1,0,1
2023-06-01,208921,1,1,2,1,1,1
2023-06-01,204902,4,0,4,2,0,2
2023-06-01,393894,9,0,9,1,0,1
2023-06-01,57986,4,0,4,1,0,1
2023-06-01,33930,6,0,6,5,0,5
2023-06-01,197915,3,3,6,8,8,11
2023-06-01,57468,11,4,15,4,2,4
2023-06-01,207164,2,0,2,1,0,1
2023-06-01,3225,127,1,128,17,2,18
2023-06-01,208899,4,0,4,1,0,1
2023-06-01,206158,1,0,1,2,0,2
2023-06-01,49103,16,0,16,2,0,2
2023-06-01,399376,1,0,1,1,0,1
2023-06-01,395555,10,1,11,8,1,8
2023-06-01,397406,1,0,1,1,0,1
2023-06-01,6653,34,1,35,12,1,12
2023-06-01,63195,1,0,1,1,0,1
2023-06-01,53914,6,0,6,1,0,1
2023-06-01,395200,2,0,2,3,0,3
2023-06-01,19787,3,0,3,3,0,3
2023-06-01,393619,5,0,5,2,0,2
2023-06-01,64278,1,0,1,2,0,2
2023-06-01,399215,7,1,8,3,1,3
2023-06-01,198652,12,0,12,1,0,1
2023-06-01,397563,31,0,31,2,0,2
2023-06-01,393809,16,0,16,3,0,3
2023-06-01,63411,1,0,1,1,0,1
2023-06-01,205676,4,0,4,2,0,2
2023-06-01,395032,10,0,10,3,0,3
2023-06-01,399690,2,0,2,2,0,2
2023-06-01,63457,22,0,22,5,0,5
2023-06-01,399924,2,2,4,3,2,3
2023-06-01,399502,3,0,3,1,0,1
2023-06-01,399661,1,0,1,1,0,1
2023-06-01,19112,10,1,11,5,2,5
2023-06-01,395209,15,0,15,1,0,1
2023-06-01,11367,10,0,10,6,0,6
2023-06-01,46516,5,1,6,1,1,2
2023-06-01,33307,10,0,10,2,0,2
2023-06-01,399637,1,0,1,1,0,1
2023-06-01,399350,2,0,2,2,0,2
2023-06-01,4172,1,0,1,1,0,1
2023-06-01,393598,4,0,4,3,0,3
2023-06-01,399388,1,0,1,1,0,1
2023-06-01,399851,2,1,3,2,1,2
2023-06-01,33297,2,2,4,2,2,2
2023-06-01,30522,2,0,2,3,0,3
2023-06-01,60354,3,3,6,2,1,2
2023-06-01,399250,6,0,6,3,0,3
2023-06-01,212513,2,0,2,1,0,1
2023-06-01,399656,1,0,1,1,0,1
2023-06-01,54613,6,4,10,1,1,1
2023-06-01,6649,6,3,9,1,1,1
2023-06-01,393275,8,0,8,2,0,2
2023-06-01,16929,1,0,1,1,0,1
2023-06-01,398844,7,0,7,1,0,1
2023-06-01,395570,19,0,19,1,0,1
2023-06-01,40028,28,2,30,8,5,8
2023-06-01,11670,0,0,0,9,0,9
2023-06-01,398312,1,2,3,2,1,2
2023-06-01,13657,9,2,11,10,4,10
2023-06-01,30414,2,0,2,1,0,1
2023-06-01,33339,50,1,51,2,2,2
2023-06-01,10747,14,0,14,6,0,6
2023-06-01,394129,2,0,2,2,0,2
2023-06-01,18478,5,0,5,5,0,5
2023-06-01,13443,19,58,77,17,13,18
2023-06-01,55248,8,0,8,3,0,3
2023-06-01,54155,43,0,43,9,0,9
2023-06-01,21743,17,1,18,7,5,8
2023-06-01,399084,7,2,9,2,1,2
2023-06-01,399458,4,0,4,4,0,4
2023-06-01,398335,4,0,4,2,0,2
2023-06-01,399108,1,0,1,3,0,3
2023-06-01,17313,3,0,3,4,0,4
2023-06-01,399141,4,2,6,2,1,2
2023-06-01,399287,1,0,1,1,0,1
2023-06-01,399295,3,0,3,2,0,2
2023-06-01,46091,21,10,31,4,4,4
2023-06-01,399577,1,0,1,1,0,1
2023-06-01,399102,2,0,2,1,0,1
2023-06-01,399235,1,0,1,1,0,1
2023-06-01,21757,6,1,7,1,1,1
2023-06-01,399116,1,0,1,5,0,5
2023-06-01,399273,1,1,2,3,1,3
2023-06-01,395561,5,5,10,4,1,4
2023-06-01,14361,83,17,100,13,5,13
2023-06-01,398345,1,0,1,1,0,1
2023-06-01,395723,4,1,5,2,1,2
2023-06-01,54648,4,0,4,2,0,2
2023-06-01,396202,2,0,2,2,0,2
2023-06-01,980,19,0,19,1,0,1
2023-06-01,395003,8,1,9,4,1,4
2023-06-01,64080,12,2,14,1,1,1
2023-06-01,58305,36,8,44,2,2,2
2023-06-01,26794,8,1,9,25,10,25
2023-06-01,63414,38,1,39,2,1,2
2023-06-01,54198,100,9,109,6,2,7
2023-06-01,17381,12,0,12,7,0,7
2023-06-01,394142,6,3,9,1,1,1
2023-06-01,397936,4,0,4,2,0,2
2023-06-01,399900,1,0,1,1,0,1
2023-06-01,30221,15,0,15,4,0,4
2023-06-01,399774,1,0,1,2,0,2
2023-06-01,400315,1,0,1,1,0,1
2023-06-01,399760,1,7,8,3,3,4
2023-06-01,399769,1,0,1,2,0,2
2023-06-01,4261,7,9,16,7,2,7
2023-06-01,32030,3,3,6,3,3,4
2023-06-01,22534,7,1,8,3,1,3
2023-06-01,399871,1,1,2,2,2,2
2023-06-01,23372,1,0,1,1,0,1
2023-06-01,399866,4,8,12,1,1,1
2023-06-01,393238,18,1,19,16,5,16
2023-06-01,399860,1,0,1,1,0,1
2023-06-01,399723,1,0,1,1,0,1
2023-06-01,399888,3,4,7,3,8,8
2023-06-01,13830,6,6,12,10,6,11
2023-06-01,399856,3,0,3,2,0,2
2023-06-01,7011,445,0,445,1,0,1
2023-06-01,63911,114,85,199,3,2,3
2023-06-01,64089,8,4,12,5,1,5
2023-06-01,42210,1,0,1,1,0,1
2023-06-01,260,5,2,7,11,6,11
2023-06-01,29997,8,8,16,5,4,5
2023-06-01,10405,7,0,7,3,0,3
2023-06-01,397615,1,0,1,2,0,2
2023-06-01,11042,112,6,118,4,4,4
2023-06-01,32780,42,4,46,4,2,4
2023-06-01,11979,36,13,49,9,7,10
2023-06-01,203101,10,0,10,12,0,12
2023-06-01,40027,12,12,24,1,1,1
2023-06-01,18747,394,29,423,37,11,41
2023-06-01,64112,4,5,9,6,3,7
2023-06-01,22850,0,0,0,6,4,6
2023-06-01,395167,3,0,3,1,0,1
2023-06-01,6364,47,10,57,6,3,6
2023-06-01,20021,37,4,41,13,4,13
2023-06-01,15216,10,0,10,1,0,1
2023-06-01,19679,44,34,78,25,19,30
2023-06-01,16612,5,0,5,2,0,2
2023-06-01,399559,31,0,31,4,2,4
2023-06-01,3800,27,2,29,6,1,6
2023-06-01,20150,8,3,11,2,1,2
2023-06-01,399804,10,2,12,1,1,1
2023-06-01,399852,2,1,3,2,1,2
2023-06-01,33623,11,0,11,4,0,4
2023-06-01,54380,3,6,9,4,2,4
2023-06-01,23026,3,2,5,1,1,1
2023-06-01,63379,1,0,1,1,0,1
2023-06-01,399231,2,0,2,2,0,2
2023-06-01,12250,5,0,5,2,0,2
2023-06-01,400129,1,1,2,1,1,1
2023-06-01,399546,1,0,1,1,0,1
2023-06-01,400298,4,3,7,1,1,1
2023-06-01,30176,7,3,10,10,7,11
2023-06-01,53999,7,2,9,5,3,5
2023-06-01,14956,9,0,9,3,0,3
2023-06-01,399629,25,0,25,1,0,1
2023-06-01,213349,2,2,4,2,2,3
2023-06-01,931,0,0,0,3,0,3
2023-06-01,29848,8,2,10,5,3,6
2023-06-01,40440,1,0,1,3,0,3
2023-06-01,31882,18,0,18,4,0,4
2023-06-01,15265,6,0,6,3,0,3
2023-06-01,138156,20,0,20,4,0,4
2023-06-01,394081,7,0,7,4,0,4
2023-06-01,53996,1,0,1,1,0,1
2023-06-01,399122,19,18,37,4,3,4
2023-06-01,13150,126,0,126,58,0,58
2023-06-01,394146,15,1,16,2,1,2
2023-06-01,4549,15,0,15,6,0,6
2023-06-01,136170,17,0,17,2,0,2
2023-06-01,38778,16,0,16,8,0,8
2023-06-01,45773,48,67,115,4,3,4
2023-06-01,38841,212,38,250,1,1,1
2023-06-01,24164,87,11,98,1,1,1
2023-06-01,24163,54,3,57,1,1,1
2023-06-01,58408,3,0,3,1,0,1
2023-06-01,9650,60,1,61,8,3,8
2023-06-01,59325,11,0,11,9,0,9
2023-06-01,23872,12,0,12,2,0,2
2023-06-01,141985,2,0,2,7,0,7
2023-06-01,58477,16,0,16,2,0,2
2023-06-01,135360,3,0,3,3,0,3
2023-06-01,45786,74,1,75,6,1,6
2023-06-01,133399,3,1,4,2,2,2
2023-06-01,9927,69,1,70,21,3,21
2023-06-01,45634,22,1,23,6,1,6
2023-06-01,137991,10,1,11,13,7,15
2023-06-01,58889,1,0,1,2,0,2
2023-06-01,134236,11,4,15,2,2,2
2023-06-01,38684,74,0,74,2,0,2
2023-06-01,134844,9,1,10,5,1,5
2023-06-01,55592,164,0,164,1,0,1
2023-06-01,38200,22,0,22,9,0,9
2023-06-01,17539,43,0,43,2,0,2
2023-06-01,132933,24,11,35,4,2,4
2023-06-01,18407,3,0,3,4,0,4
2023-06-01,131627,60,0,60,4,0,4
2023-06-01,17924,108,3,111,12,5,13
2023-06-01,18025,2,0,2,1,0,1
2023-06-01,18024,7,2,9,4,3,4
2023-06-01,45294,24,7,31,5,2,5
2023-06-01,139690,3,0,3,2,0,2
2023-06-01,55936,5,0,5,1,0,1
2023-06-01,132931,16,9,25,1,1,1
2023-06-01,135031,79,1,80,4,1,4
2023-06-01,134019,9,0,9,3,0,3
2023-06-01,55353,28,11,39,6,3,6
2023-06-01,132945,8,0,8,1,0,1
2023-06-01,134134,10,0,10,3,0,3
2023-06-01,135543,6,0,6,1,0,1
2023-06-01,209905,4,0,4,1,0,1
2023-06-01,209900,3,0,3,2,0,2
2023-06-01,209899,1,0,1,1,0,1
2023-06-01,206296,4,0,4,1,0,1
2023-06-01,209895,4,0,4,2,0,2
2023-06-01,266528,3,1,4,1,1,1
2023-06-01,271613,1,3,4,4,2,4
2023-06-01,266529,7,3,10,3,1,3
2023-06-01,271170,7,3,10,5,4,5
2023-06-01,266530,5,1,6,1,1,1
2023-06-01,266566,7,5,12,2,3,3
2023-06-01,266793,1,0,1,4,0,4
2023-06-01,265715,3,1,4,5,2,5
2023-06-01,30270,1,0,1,1,0,1
2023-06-01,262664,50,11,61,6,5,6
2023-06-01,7063,27,12,39,3,5,5
2023-06-01,271501,6,1,7,1,1,1
2023-06-01,262903,51,7,58,23,22,25
2023-06-01,271045,12,6,18,3,3,3
2023-06-01,266543,4,0,4,2,0,2
2023-06-01,61614,0,0,0,6,5,6
2023-06-01,267276,5,6,11,18,11,19
2023-06-01,266574,7,1,8,8,7,9
2023-06-01,266265,5,1,6,2,1,2
2023-06-01,269478,7,7,14,7,6,7
2023-06-01,266258,7,0,7,1,0,1
2023-06-01,266266,3,1,4,1,1,1
2023-06-01,267544,6,3,9,10,9,10
2023-06-01,266536,1,16,17,1,1,1
2023-06-01,268696,5,19,24,59,44,63
2023-06-01,262725,15,8,23,12,9,13
2023-06-01,266853,10,1,11,10,1,10
2023-06-01,268320,3,1,4,6,2,6
2023-06-01,266267,3,0,3,1,0,1
2023-06-01,269429,5,3,8,4,2,4
2023-06-01,266537,5,3,8,1,1,1
2023-06-01,267893,1,0,1,2,0,2
2023-06-01,266589,1,0,1,3,0,3
2023-06-01,19582,15,0,15,4,0,4
2023-06-01,265734,1,0,1,1,0,1
2023-06-01,52772,3,1,4,16,13,19
2023-06-01,266544,3,4,7,2,1,2
2023-06-01,263145,3,3,6,13,14,18
2023-06-01,266402,5,4,9,4,3,4
2023-06-01,266268,5,2,7,2,1,2
2023-06-01,266525,4,7,11,26,17,26
2023-06-01,28294,120,14,134,11,6,11
2023-06-01,265980,3,3,6,4,1,4
2023-06-01,266531,1,1,2,1,1,1
2023-06-01,266725,22,0,22,13,0,13
2023-06-01,269822,20,8,28,6,5,8
2023-06-01,266526,3,5,8,1,1,1
2023-06-01,14117,627,9,636,9,1,9
2023-06-01,264780,55,1,56,6,1,6
2023-06-01,16629,26,2,28,26,2,27
2023-06-01,27855,66,6,72,4,1,4
2023-06-01,265941,1,0,1,2,0,2
2023-06-01,208710,1,0,1,1,0,1
2023-06-01,35360,2,1,3,6,5,7
2023-06-01,207937,2,0,2,2,0,2
2023-06-01,207668,3,1,4,4,3,4
2023-06-01,47482,4,0,4,2,0,2
2023-06-01,42250,1,0,1,1,0,1
2023-06-01,208180,4,0,4,2,0,2
2023-06-01,25780,12,9,21,2,2,2
2023-06-01,199542,21,0,21,1,0,1
2023-06-01,49115,2,1,3,10,4,10
2023-06-01,209429,1,0,1,1,0,1
2023-06-01,35224,33,0,33,7,0,7
2023-06-01,49735,1,1,2,1,1,2
2023-06-01,13135,8,3,11,5,7,7
2023-06-01,202372,2,0,2,2,0,2
2023-06-01,31617,15,2,17,8,5,8
2023-06-01,43619,5,8,13,3,3,3
2023-06-01,61060,5,0,5,3,0,3
2023-06-01,35499,3,0,3,1,0,1
2023-06-01,24929,8,2,10,8,1,9
2023-06-01,212751,4,1,5,5,4,5
2023-06-01,50877,4,1,5,14,11,16
2023-06-01,41720,7,2,9,6,5,6
2023-06-01,43043,17,0,17,2,0,2
2023-06-01,44533,17,0,17,1,0,1
2023-06-01,35482,2,0,2,2,0,2
2023-06-01,208858,1,0,1,1,0,1
2023-06-01,209325,1,0,1,1,0,1
2023-06-01,35441,7,0,7,1,0,1
2023-06-01,209410,1,0,1,2,0,2
2023-06-01,21217,12,2,14,7,5,7
2023-06-01,20932,4,1,5,19,7,20
2023-06-01,209408,1,1,2,6,2,6
2023-06-01,64445,2,3,5,11,6,14
2023-06-01,203434,8,5,13,3,3,3
2023-06-01,209688,4,0,4,1,0,1
2023-06-01,61344,2,0,2,3,0,3
2023-06-01,44539,5,0,5,20,0,20
2023-06-01,204996,12,0,12,3,0,3
2023-06-01,209403,1,0,1,1,0,1
2023-06-01,207616,5,1,6,7,4,10
2023-06-01,41635,1,0,1,2,0,2
2023-06-01,209537,1,1,2,1,1,2
2023-06-01,35455,2,0,2,4,0,4
2023-06-01,39257,9,2,11,1,1,1
2023-06-01,48757,8,0,8,5,0,5
2023-06-01,209805,8,0,8,1,0,1
2023-06-01,202838,2,0,2,5,0,5
2023-06-01,35203,3,0,3,1,0,1
2023-06-01,48817,1,1,2,7,4,7
2023-06-01,35453,1,0,1,1,0,1
2023-06-01,40169,2,0,2,3,0,3
2023-06-01,64728,0,0,0,1,0,1
2023-06-01,209322,4,4,8,3,3,3
2023-06-01,198985,3,2,5,2,3,4
2023-06-01,211858,1,1,2,1,1,1
2023-06-01,203363,8,4,12,3,2,3
2023-06-01,212728,7,0,7,4,0,4
2023-06-01,211043,4,0,4,1,0,1
2023-06-01,208973,1,0,1,3,0,3
2023-06-01,60893,23,3,26,9,5,10
2023-06-01,209970,2,0,2,5,0,5
2023-06-01,43818,1,0,1,2,0,2
2023-06-01,62013,10,0,10,6,0,6
2023-06-01,200303,22,16,38,9,8,11
2023-06-01,209380,5,0,5,3,0,3
2023-06-01,39679,11,1,12,3,2,4
2023-06-01,41633,1,0,1,1,0,1
2023-06-01,35424,1,0,1,1,0,1
2023-06-01,39878,7,1,8,11,7,12
2023-06-01,39328,9,0,9,6,0,6
2023-06-01,34245,21,2,23,11,6,12
2023-06-01,209285,3,0,3,2,0,2
2023-06-01,208803,1,0,1,3,0,3
2023-06-01,207364,4,0,4,2,0,2
2023-06-01,12312,25,5,30,18,8,19
2023-06-01,201839,1,0,1,1,0,1
2023-06-01,44094,6,1,7,3,3,4
2023-06-01,212301,2,0,2,1,0,1
2023-06-01,209382,2,2,4,3,2,3
2023-06-01,35437,4,1,5,7,2,7
2023-06-01,271885,2,1,3,3,1,3
2023-06-01,27750,2,1,3,13,6,13
2023-06-01,27929,4,0,4,6,0,6
2023-06-01,272136,2,3,5,1,1,1
2023-06-01,272806,5,0,5,2,0,2
2023-06-01,269940,4,1,5,3,1,3
2023-06-01,64150,2,1,3,2,1,2
2023-06-01,28370,18,2,20,20,10,21
2023-06-01,267556,1,2,3,4,2,4
2023-06-01,264478,104,3,107,5,2,5
2023-06-01,267557,7,3,10,2,1,2
2023-06-01,265772,1,1,2,2,1,2
2023-06-01,265817,5,0,5,6,0,6
2023-06-01,263791,4,0,4,5,0,5
2023-06-01,271933,1,1,2,2,1,2
2023-06-01,28352,25,3,28,9,6,9
2023-06-01,267543,5,1,6,2,2,2
2023-06-01,267573,4,1,5,5,3,5
2023-06-01,52721,9,1,10,11,5,11
2023-06-01,267569,1,1,2,2,3,3
2023-06-01,262505,16,11,27,17,12,17
2023-06-01,263028,31,1,32,2,2,2
2023-06-01,267574,7,7,14,2,2,2
2023-06-01,267545,5,1,6,2,1,2
2023-06-01,52999,51,15,66,12,10,13
2023-06-01,267546,9,3,12,2,2,2
2023-06-01,267565,7,1,8,1,1,1
2023-06-01,267551,3,1,4,1,1,1
2023-06-01,267579,3,1,4,5,1,5
2023-06-01,28189,24,2,26,46,27,47
2023-06-01,53122,39,5,44,5,3,5
2023-06-01,61863,3,3,6,3,2,3
2023-06-01,264162,3,7,10,16,10,19
2023-06-01,269416,9,1,10,8,6,9
2023-06-01,271911,5,0,5,2,0,2
2023-06-01,267552,3,1,4,3,1,3
2023-06-01,267566,3,0,3,4,0,4
2023-06-01,267580,5,13,18,2,1,2
2023-06-01,263144,4,7,11,15,13,18
2023-06-01,262688,59,3,62,14,6,15
2023-06-01,267581,1,1,2,3,1,3
2023-06-01,52680,6,1,7,19,13,19
2023-06-01,267570,3,1,4,3,1,3
2023-06-01,267593,5,3,8,8,5,8
2023-06-01,267038,3,1,4,4,1,4
2023-06-01,52477,18,0,18,6,0,6
2023-06-01,267616,7,2,9,5,3,5
2023-06-01,266354,5,1,6,3,1,3
2023-06-01,267635,5,0,5,1,0,1
2023-06-01,28130,95,4,99,11,8,12
2023-06-01,262841,3,1,4,7,4,7
2023-06-01,267567,5,1,6,4,4,4
2023-06-01,61937,13,4,17,2,1,2
2023-06-01,267559,3,1,4,2,1,2
2023-06-01,267561,5,1,6,5,2,5
2023-06-01,265824,5,0,5,3,0,3
2023-06-01,267577,1,1,2,2,1,2
2023-06-01,262769,24,5,29,11,7,11
2023-06-01,267562,7,1,8,9,5,10
2023-06-01,267563,5,3,8,7,4,8
2023-06-01,264069,2,1,3,8,2,8
2023-06-01,267572,3,0,3,1,0,1
2023-06-01,267582,1,1,2,1,1,1
2023-06-01,267583,5,0,5,1,0,1
2023-06-01,267568,5,6,11,6,4,7
2023-06-01,267589,1,3,4,2,2,2
2023-06-01,265809,6,0,6,1,0,1
2023-06-01,267654,7,7,14,3,4,4
2023-06-01,61797,16,1,17,10,6,11
2023-06-01,267575,21,7,28,7,8,8
2023-06-01,267578,1,1,2,2,3,3
2023-06-01,265833,1,0,1,2,0,2
2023-06-01,265066,20,10,30,23,18,25
2023-06-01,267584,4,1,5,1,1,1
2023-06-01,267576,7,3,10,7,6,7
2023-06-01,265814,1,0,1,1,0,1
2023-06-01,263693,12,0,12,3,0,3
2023-06-01,267594,4,4,8,11,9,13
2023-06-01,267585,7,7,14,6,5,6
2023-06-01,264953,3,1,4,6,6,7
2023-06-01,264293,3,3,6,41,34,43
2023-06-01,267586,5,1,6,5,2,5
2023-06-01,52871,64,5,69,46,30,51
2023-06-01,271618,1,1,2,1,1,1
2023-06-01,61786,14,2,16,9,3,9
2023-06-01,267587,11,1,12,4,3,5
2023-06-01,268960,4,7,11,15,6,16
2023-06-01,267588,4,4,8,3,1,3
2023-06-01,265816,31,0,31,5,0,5
2023-06-01,267590,7,4,11,4,6,7
2023-06-01,263824,20,12,32,6,4,6
2023-06-01,265826,3,5,8,2,2,3
2023-06-01,28263,53,25,78,14,6,14
2023-06-01,262272,85,5,90,1,1,1
2023-06-01,10269,32,1,33,6,3,6
2023-06-01,265818,5,0,5,1,0,1
2023-06-01,53137,5,3,8,9,5,9
2023-06-01,267598,3,1,4,1,1,1
2023-06-01,267610,3,1,4,4,3,4
2023-06-01,267611,4,1,5,3,3,3
2023-06-01,266672,2,1,3,2,1,2
2023-06-01,267592,1,1,2,1,1,1
2023-06-01,265884,1,1,2,2,1,2
2023-06-01,3597,28,1,29,14,8,14
2023-06-01,1916,265,33,298,48,34,49
2023-06-01,267630,1,1,2,2,1,2
2023-06-01,262503,29,3,32,74,51,81
2023-06-01,3816,1297,19,1316,18,14,26
2023-06-01,27817,16,7,23,9,2,9
2023-06-01,23864,1,1,2,2,2,2
2023-06-01,22908,74,6,80,13,7,14
2023-06-01,267595,3,3,6,3,3,3
2023-06-01,265827,2,1,3,1,1,1
2023-06-01,267596,5,3,8,1,1,1
2023-06-01,267631,3,1,4,1,1,1
2023-06-01,268738,10,6,16,6,3,6
2023-06-01,268428,3,2,5,14,8,15
2023-06-01,271860,7,0,7,1,0,1
2023-06-01,267634,1,2,3,1,1,1
2023-06-01,265830,1,0,1,3,0,3
2023-06-01,61586,1,2,3,8,7,9
2023-06-01,265820,1,0,1,2,0,2
2023-06-01,27932,50,1,51,15,4,15
2023-06-01,27983,295,0,295,16,0,16
2023-06-01,267600,5,31,36,2,1,2
2023-06-01,52696,5,3,8,14,10,16
2023-06-01,267612,1,0,1,1,0,1
2023-06-01,267601,7,6,13,2,2,2
2023-06-01,265457,1,1,2,5,4,6
2023-06-01,267597,4,0,4,2,0,2
2023-06-01,272193,0,3,3,11,4,11
2023-06-01,269446,7,7,14,3,2,3
2023-06-01,267615,7,7,14,1,1,1
2023-06-01,264525,14,20,34,15,9,15
2023-06-01,267602,2,1,3,4,1,4
2023-06-01,267618,5,0,5,1,0,1
2023-06-01,267606,3,1,4,1,1,1
2023-06-01,267603,3,3,6,4,3,5
2023-06-01,264210,7,7,14,5,3,6
2023-06-01,264943,4,1,5,12,6,13
2023-06-01,267607,1,1,2,2,1,2
2023-06-01,262434,23,1,24,12,9,16
2023-06-01,263329,5,3,8,14,8,14
2023-06-01,267604,3,1,4,1,1,1
2023-06-01,265860,1,0,1,1,0,1
2023-06-01,267655,1,0,1,2,0,2
2023-06-01,267614,3,3,6,8,7,8
2023-06-01,262496,9,2,11,6,6,6
2023-06-01,267605,1,1,2,1,1,1
2023-06-01,267619,7,3,10,6,3,6
2023-06-01,267620,12,1,13,5,2,5
2023-06-01,267608,7,4,11,2,1,2
2023-06-01,262300,12,3,15,15,9,15
2023-06-01,267664,6,1,7,3,1,3
2023-06-01,269486,3,1,4,3,1,3
2023-06-01,262494,40,4,44,36,25,38
2023-06-01,267658,5,1,6,3,1,3
2023-06-01,269595,3,5,8,24,15,25
2023-06-01,266917,7,3,10,3,1,3
2023-06-01,262433,8,7,15,9,6,9
2023-06-01,61696,14,12,26,15,9,15
2023-06-01,61717,19,3,22,9,2,9
2023-06-01,53085,39,6,45,13,6,13
2023-06-01,262663,85,2,87,69,4,70
2023-06-01,262492,21,1,22,3,1,3
2023-06-01,267656,1,1,2,1,1,1
2023-06-01,265836,4,0,4,3,0,3
2023-06-01,26505,43,1,44,5,1,5
2023-06-01,265825,4,1,5,2,1,2
2023-06-01,267638,6,1,7,8,4,8
2023-06-01,61659,3,1,4,10,5,10
2023-06-01,267621,10,7,17,9,5,9
2023-06-01,273580,0,0,0,2,0,2
2023-06-01,267622,2,0,2,2,0,2
2023-06-01,266302,6,1,7,17,11,17
2023-06-01,267633,4,1,5,1,1,1
2023-06-01,264598,3,19,22,26,22,27
2023-06-01,267627,4,1,5,1,1,1
2023-06-01,14080,252,123,375,28,14,30
2023-06-01,266465,4,1,5,8,4,9
2023-06-01,267628,4,0,4,3,0,3
2023-06-01,264459,6,11,17,8,6,10
2023-06-01,267642,5,1,6,10,6,10
2023-06-01,265828,3,1,4,5,2,5
2023-06-01,28100,7,0,7,2,0,2
2023-06-01,266989,3,33,36,13,4,14
2023-06-01,269597,6,2,8,6,1,6
2023-06-01,267639,4,0,4,1,0,1
2023-06-01,267623,1,1,2,3,3,3
2023-06-01,267626,3,3,6,2,2,2
2023-06-01,267629,3,7,10,1,2,2
2023-06-01,267643,1,0,1,2,0,2
2023-06-01,267624,3,0,3,5,3,6
2023-06-01,53209,16,3,19,7,5,7
2023-06-01,271387,4,1,5,11,10,12
2023-06-01,267632,3,1,4,2,1,2
2023-06-01,270596,6,5,11,8,6,9
2023-06-01,267625,5,1,6,4,2,4
2023-06-01,263922,5,2,7,6,3,6
2023-06-01,267645,5,1,6,1,1,1
2023-06-01,262352,17,1,18,18,10,22
2023-06-01,267651,4,1,5,1,1,1
2023-06-01,262865,27,26,53,12,8,12
2023-06-01,263599,16,15,31,5,4,5
2023-06-01,267640,4,0,4,1,0,1
2023-06-01,272121,1,1,2,1,1,1
2023-06-01,272075,2,1,3,2,1,2
2023-06-01,26292,9,1,10,5,4,5
2023-06-01,393959,3,0,3,1,0,1
2023-06-01,45014,28,8,36,12,6,12
2023-06-01,209378,3,1,4,1,1,1
2023-06-01,38628,12,1,13,4,1,4
2023-06-01,11698,4,0,4,1,0,1
2023-06-01,62833,27,3,30,25,8,25
2023-06-01,41652,3,2,5,4,4,4
2023-06-01,199636,14,1,15,1,1,1
2023-06-01,58222,7,2,9,1,1,1
2023-06-01,62105,2,1,3,6,3,7
2023-06-01,59521,8,0,8,1,0,1
2023-06-01,47454,1,1,2,2,3,3
2023-06-01,47149,0,0,0,3,0,3
2023-06-01,208954,1,0,1,4,0,4
2023-06-01,29329,7,1,8,5,3,5
2023-06-01,207377,1,0,1,1,0,1
2023-06-01,212132,2,0,2,1,0,1
2023-06-01,209235,2,0,2,1,0,1
2023-06-01,203244,14,0,14,3,0,3
2023-06-01,59717,2,1,3,3,2,3
2023-06-01,208898,2,0,2,1,0,1
2023-06-01,208028,1,0,1,2,0,2
2023-06-01,204641,7,0,7,3,0,3
2023-06-01,201241,6,0,6,1,0,1
2023-06-01,206995,6,0,6,2,0,2
2023-06-01,204287,20,0,20,1,0,1
2023-06-01,140627,13,2,15,18,7,20
2023-06-01,60808,1,1,2,7,1,7
2023-06-01,213296,17,0,17,1,0,1
2023-06-01,208891,1,0,1,1,0,1
2023-06-01,210015,3,1,4,2,2,2
2023-06-01,211056,0,0,0,2,0,2
2023-06-01,204104,1,0,1,1,0,1
2023-06-01,213318,1,1,2,1,1,1
2023-06-01,208883,5,0,5,1,0,1
2023-06-01,328543,20,7,27,7,5,8
2023-06-01,205175,3,1,4,2,1,2
2023-06-01,208882,1,2,3,5,4,5
2023-06-01,208418,2,0,2,2,0,2
2023-06-01,49289,23,1,24,14,2,14
2023-06-01,201838,56,2,58,8,7,9
2023-06-01,197922,30,1,31,5,4,5
2023-06-01,208659,1,0,1,1,0,1
2023-06-01,208859,4,0,4,2,0,2
2023-06-01,64236,23,0,23,1,0,1
2023-06-01,8816,7,1,8,8,3,8
2023-06-01,208873,4,0,4,5,0,5
2023-06-01,5572,10,0,10,3,0,3
2023-06-01,209288,8,2,10,9,5,10
2023-06-01,207903,10,0,10,2,0,2
2023-06-01,42487,11,7,18,7,8,8
2023-06-01,49397,2,0,2,1,0,1
2023-06-01,44176,9,4,13,2,2,2
2023-06-01,52075,16,8,24,11,8,13
2023-06-01,60456,2,0,2,4,0,4
2023-06-01,20565,5,2,7,6,5,6
2023-06-01,212745,2,1,3,1,1,1
2023-06-01,202002,1,2,3,1,1,1
2023-06-01,210793,4,0,4,1,0,1
2023-06-01,212853,2,0,2,1,0,1
2023-06-01,45929,8,0,8,1,0,1
2023-06-01,205220,23,0,23,1,0,1
2023-06-01,42237,10,10,20,4,3,4
2023-06-01,39699,5,1,6,8,5,8
2023-06-01,52056,2,0,2,1,0,1
2023-06-01,42549,1,0,1,3,2,4
2023-06-01,202120,26,5,31,10,7,15
2023-06-01,208530,1,0,1,1,0,1
2023-06-01,212250,0,0,0,10,2,10
2023-06-01,202699,6,0,6,4,0,4
2023-06-01,209733,1,0,1,4,0,4
2023-06-01,16,3,1,4,4,2,4
2023-06-01,61149,8,3,11,7,3,7
2023-06-01,13170,14,0,14,9,0,9
2023-06-01,57359,5,0,5,1,0,1
2023-06-01,208304,3,0,3,2,0,2
2023-06-01,42184,14,3,17,17,9,18
2023-06-01,208844,1,0,1,6,0,6
2023-06-01,51809,4,1,5,7,5,8
2023-06-01,208599,2,1,3,1,1,1
2023-06-01,206341,1,0,1,3,0,3
2023-06-01,35009,3,0,3,1,0,1
2023-06-01,200023,20,2,22,12,8,14
2023-06-01,50316,138,1,139,12,7,14
2023-06-01,59842,5,1,6,5,3,5
2023-06-01,208849,1,0,1,2,0,2
2023-06-01,39294,7,0,7,3,0,3
2023-06-01,206515,1,0,1,2,0,2
2023-06-01,264617,18,2,20,1,1,1
2023-06-01,208827,1,0,1,1,0,1
2023-06-01,208847,1,0,1,1,0,1
2023-06-01,208830,1,1,2,1,1,1
2023-06-01,139057,62,26,88,36,23,39
2023-06-01,212372,4,1,5,2,1,2
2023-06-01,64469,1,0,1,1,0,1
2023-06-01,208821,5,0,5,3,0,3
2023-06-01,208829,2,0,2,2,0,2
2023-06-01,29014,33,16,49,17,10,19
2023-06-01,208843,2,0,2,1,0,1
2023-06-01,208834,1,0,1,2,0,2
2023-06-01,208838,2,0,2,2,0,2
2023-06-01,25465,5,0,5,2,0,2
2023-06-01,204189,6,1,7,4,2,4
2023-06-01,21476,22,1,23,7,6,8
2023-06-01,203759,1,2,3,6,6,6
2023-06-01,211768,7,3,10,1,1,1
2023-06-01,208833,1,0,1,1,0,1
2023-06-01,57793,4,2,6,6,5,7
2023-06-01,16066,4,1,5,11,2,11
2023-06-01,48644,1,0,1,1,0,1
2023-06-01,56380,6,1,7,1,1,1
2023-06-01,12436,2,0,2,3,0,3
2023-06-01,203391,8,4,12,13,5,13
2023-06-01,49282,7,1,8,11,3,11
2023-06-01,199020,3,0,3,16,0,16
2023-06-01,208762,1,0,1,1,0,1
2023-06-01,208799,1,0,1,1,0,1
2023-06-01,32338,13,13,26,5,4,6
2023-06-01,35710,15,10,25,9,4,10
2023-06-01,208815,2,0,2,2,0,2
2023-06-01,207137,6,4,10,8,6,8
2023-06-01,202754,10,0,10,3,0,3
2023-06-01,212396,6,0,6,2,0,2
2023-06-01,211826,36,0,36,12,0,12
2023-06-01,204704,8,1,9,5,2,5
2023-06-01,43598,1,0,1,4,0,4
2023-06-01,57019,1,0,1,1,0,1
2023-06-01,208777,1,0,1,2,0,2
2023-06-01,209371,23,0,23,2,0,2
2023-06-01,213257,2,0,2,1,0,1
2023-06-01,56834,3,1,4,6,4,7
2023-06-01,208482,1,0,1,1,0,1
2023-06-01,140902,20,0,20,1,0,1
2023-06-01,64286,146,1,147,3,1,3
2023-06-01,208734,4,0,4,2,0,2
2023-06-01,29170,23,1,24,16,3,16
2023-06-01,207233,2,0,2,2,0,2
2023-06-01,21056,32,1,33,13,4,13
2023-06-01,61438,4,2,6,2,2,2
2023-06-01,49810,1,1,2,5,5,7
2023-06-01,206805,17,2,19,7,5,7
2023-06-01,42000,7,1,8,19,17,24
2023-06-01,209810,5,1,6,7,4,9
2023-06-01,208805,1,0,1,1,0,1
2023-06-01,203726,9,0,9,5,0,5
2023-06-01,59466,6,0,6,3,0,3
2023-06-01,51317,1,0,1,1,0,1
2023-06-01,41019,3,0,3,4,0,4
2023-06-01,199364,3,8,11,2,1,2
2023-06-01,208802,3,0,3,8,0,8
2023-06-01,212411,6,0,6,4,0,4
2023-06-01,209275,4,0,4,6,0,6
2023-06-01,201178,12,9,21,6,5,9
2023-06-01,208630,1,0,1,1,0,1
2023-06-01,135392,1,0,1,1,0,1
2023-06-01,271320,4,3,7,5,3,5
2023-06-01,208742,1,0,1,1,0,1
2023-06-01,28032,36,6,42,7,1,7
2023-06-01,205498,2,0,2,2,0,2
2023-06-01,20912,9,1,10,15,7,15
2023-06-01,208620,3,0,3,1,0,1
2023-06-01,39923,28,8,36,11,11,15
2023-06-01,208792,2,0,2,1,0,1
2023-06-01,208791,1,0,1,1,0,1
2023-06-01,57667,16,0,16,2,0,2
2023-06-01,198575,3,0,3,2,0,2
2023-06-01,208016,1,1,2,8,5,9
2023-06-01,208789,1,1,2,1,1,1
2023-06-01,208644,1,1,2,2,2,2
2023-06-01,49375,4,2,6,10,7,11
2023-06-01,48995,1,0,1,4,0,4
2023-06-01,206435,1,0,1,2,0,2
2023-06-01,58317,4,4,8,2,2,2
2023-06-01,198545,29,0,29,6,0,6
2023-06-01,52423,36,33,69,5,2,5
2023-06-01,264763,1,3,4,5,1,5
2023-06-01,9100,22,5,27,4,2,5
2023-06-01,201714,2,1,3,2,1,2
2023-06-01,399498,5,0,5,1,0,1
2023-06-01,208665,1,0,1,1,0,1
2023-06-01,35394,38,3,41,6,3,7
2023-06-01,208654,1,1,2,2,2,2
2023-06-01,213123,3,0,3,3,0,3
2023-06-01,47834,6,1,7,2,2,2
2023-06-01,25248,5,1,6,33,13,33
2023-06-01,199341,5,0,5,3,0,3
2023-06-01,206455,2,0,2,5,0,5
2023-06-01,212344,2,0,2,1,0,1
2023-06-01,208770,43,0,43,6,0,6
2023-06-01,208228,1,0,1,1,0,1
2023-06-01,199980,8,0,8,2,0,2
2023-06-01,208152,1,0,1,3,0,3
2023-06-01,208766,1,1,2,1,3,3
2023-06-01,208759,3,3,6,2,2,2
2023-06-01,206703,2,0,2,4,0,4
2023-06-01,203392,4,0,4,1,0,1
2023-06-01,207177,3,0,3,1,0,1
2023-06-01,49443,1,0,1,1,0,1
2023-06-01,209516,1,0,1,2,0,2
2023-06-01,206786,1,0,1,1,0,1
2023-06-01,204397,1,0,1,2,0,2
2023-06-01,56798,3,0,3,1,0,1
2023-06-01,49444,12,0,12,4,0,4
2023-06-01,207804,1,0,1,6,0,6
2023-06-01,208757,3,0,3,2,0,2
2023-06-01,62048,4,0,4,3,0,3
2023-06-01,208746,11,0,11,3,0,3
2023-06-01,208662,1,0,1,1,0,1
2023-06-01,49088,10,1,11,3,3,3
2023-06-01,199236,13,1,14,5,1,5
2023-06-01,203501,23,1,24,3,1,3
2023-06-01,208576,1,0,1,1,0,1
2023-06-01,213392,1,2,3,4,2,4
2023-06-01,34924,1,3,4,1,3,3
2023-06-01,9044,16,5,21,21,13,25
2023-06-01,33823,8,3,11,6,1,7
2023-06-01,209433,2,0,2,2,0,2
2023-06-01,21368,6,0,6,3,0,3
2023-06-01,199348,5,1,6,3,2,3
2023-06-01,36268,2,1,3,2,1,2
2023-06-01,208740,3,1,4,2,2,2
2023-06-01,41957,14,0,14,2,0,2
2023-06-01,29172,1,0,1,4,0,4
2023-06-01,56398,1,0,1,1,0,1
2023-06-01,201975,5,1,6,2,2,2
2023-06-01,60695,6,12,18,15,7,16
2023-06-01,15969,11,1,12,2,2,2
2023-06-01,211611,7,0,7,2,0,2
2023-06-01,208959,2,1,3,2,4,4
2023-06-01,52202,1,0,1,1,0,1
2023-06-01,51102,3,0,3,1,0,1
2023-06-01,21159,3,1,4,3,1,3
2023-06-01,202006,0,0,0,2,0,2
2023-06-01,208732,3,0,3,4,0,4
2023-06-01,41974,2,1,3,4,3,4
2023-06-01,208613,5,1,6,2,1,2
2023-06-01,48408,3,1,4,13,8,13
2023-06-01,208725,1,1,2,3,2,3
2023-06-01,208724,1,0,1,1,0,1
2023-06-01,13332,4,0,4,1,0,1
2023-06-01,211895,6,3,9,1,1,1
2023-06-01,208708,5,0,5,1,0,1
2023-06-01,208422,1,1,2,1,1,1
2023-06-01,39668,6,0,6,7,0,7
2023-06-01,42280,2,0,2,3,0,3
2023-06-01,201162,3,0,3,1,0,1
2023-06-01,208879,1,0,1,4,0,4
2023-06-01,48596,2,2,4,4,2,5
2023-06-01,34997,1,0,1,1,0,1
2023-06-01,25198,26,1,27,18,1,18
2023-06-01,212249,9,0,9,1,0,1
2023-06-01,208704,2,1,3,2,1,2
2023-06-01,208718,2,0,2,2,0,2
2023-06-01,207065,8,0,8,1,0,1
2023-06-01,209196,9,0,9,1,0,1
2023-06-01,213078,1,1,2,1,1,1
2023-06-01,203850,5,0,5,1,0,1
2023-06-01,208712,1,1,2,1,1,1
2023-06-01,208587,1,0,1,2,0,2
2023-06-01,203252,7,0,7,1,0,1
2023-06-01,57758,5,7,12,6,5,7
2023-06-01,211593,1,1,2,1,1,1
2023-06-01,201949,2,0,2,2,0,2
2023-06-01,40564,6,2,8,5,1,5
2023-06-01,202365,3,5,8,10,272,273
2023-06-01,205381,4,1,5,2,2,4
2023-06-01,208701,1,0,1,3,0,3
2023-06-01,213256,4,0,4,1,0,1
2023-06-01,48025,1,1,2,5,4,5
2023-06-01,208692,1,1,2,2,1,2
2023-06-01,59456,7,1,8,2,2,2
2023-06-01,198682,15,5,20,7,4,7
2023-06-01,39458,4,1,5,4,3,5
2023-06-01,205226,1,0,1,5,0,5
2023-06-01,208380,1,0,1,1,0,1
2023-06-01,207889,4,0,4,4,0,4
2023-06-01,206382,5,0,5,1,0,1
2023-06-01,54574,35,0,35,5,0,5
2023-06-01,48357,10,1,11,2,1,2
2023-06-01,42651,1,0,1,1,0,1
2023-06-01,20568,4,1,5,3,1,3
2023-06-01,50254,2,0,2,11,0,11
2023-06-01,42577,1,0,1,2,0,2
2023-06-01,208694,4,0,4,1,0,1
2023-06-01,49415,5,0,5,7,0,7
2023-06-01,208687,9,2,11,1,1,1
2023-06-01,62321,1,1,2,2,2,2
2023-06-01,203459,5,1,6,8,2,8
2023-06-01,211235,1,0,1,1,0,1
2023-06-01,8985,17,5,22,32,15,32
2023-06-01,204582,15,6,21,2,2,2
2023-06-01,211239,1,0,1,1,0,1
2023-06-01,63339,6,1,7,2,2,2
2023-06-01,6700,44,2,46,17,4,18
2023-06-01,205007,3,2,5,1,1,1
2023-06-01,29611,24,2,26,14,6,15
2023-06-01,212088,0,0,0,4,0,4
2023-06-01,203735,19,0,19,5,0,5
2023-06-01,209641,50,4,54,1,1,1
2023-06-01,208684,5,1,6,1,1,1
2023-06-01,2597,5,11,16,3,3,3
2023-06-01,15598,104,5,109,28,19,30
2023-06-01,208681,3,1,4,2,2,2
2023-06-01,208683,1,1,2,1,1,1
2023-06-01,208675,4,0,4,2,0,2
2023-06-01,205614,5,7,12,8,7,10
2023-06-01,8445,34,2,36,13,10,16
2023-06-01,48112,5,2,7,4,1,4
2023-06-01,204989,2,1,3,3,3,4
2023-06-01,206851,2,0,2,3,0,3
2023-06-01,34947,2,0,2,2,0,2
2023-06-01,51659,52,16,68,5,31,31
2023-06-01,31469,1,0,1,1,0,1
2023-06-01,203140,1,0,1,4,0,4
2023-06-01,56598,1,2,3,2,1,2
2023-06-01,8896,27,9,36,21,9,22
2023-06-01,201933,2,1,3,10,5,10
2023-06-01,206551,1,0,1,1,0,1
2023-06-01,64458,3,0,3,2,0,2
2023-06-01,44436,2,0,2,2,0,2
2023-06-01,212752,4,0,4,1,0,1
2023-06-01,49095,2,2,4,2,3,3
2023-06-01,34819,1,0,1,3,3,3
2023-06-01,61226,1,0,1,1,0,1
2023-06-01,47755,3,2,5,3,1,3
2023-06-01,208449,1,3,4,1,3,3
2023-06-01,61314,2,0,2,2,0,2
2023-06-01,203934,3,0,3,1,0,1
2023-06-01,209993,1,1,2,2,1,2
2023-06-01,199926,3,2,5,1,2,3
2023-06-01,212017,5,0,5,2,0,2
2023-06-01,207669,2,0,2,1,0,1
2023-06-01,208603,3,0,3,3,0,3
2023-06-01,34080,4,1,5,9,4,9
2023-06-01,208663,1,1,2,1,1,1
2023-06-01,49909,3,1,4,11,2,12
2023-06-01,56729,3,0,3,1,0,1
2023-06-01,35278,14,9,23,3,2,3
2023-06-01,59645,5,8,13,5,10,11
2023-06-01,250,4,1,5,11,6,13
2023-06-01,208638,4,3,7,8,3,8
2023-06-01,328317,21,0,21,13,0,13
2023-06-01,149782,1,0,1,1,0,1
2023-06-01,48430,16,2,18,1,1,1
2023-06-01,196610,1,1,2,11,9,13
2023-06-01,41731,1,2,3,2,2,3
2023-06-01,209696,2,0,2,1,0,1
2023-06-01,48886,16,0,16,5,0,5
2023-06-01,57916,1,0,1,6,0,6
2023-06-01,42881,4,0,4,5,0,5
2023-06-01,203624,1,0,1,1,0,1
2023-06-01,44016,6,8,14,1,1,1
2023-06-01,34347,6,1,7,19,14,20
2023-06-01,203059,2,1,3,2,2,2
2023-06-01,208585,1,1,2,1,1,1
2023-06-01,208567,1,1,2,2,2,2
2023-06-01,208656,1,0,1,2,0,2
2023-06-01,205722,1,0,1,1,0,1
2023-06-01,9335,105,6,111,2,2,2
2023-06-01,270353,29,1,30,8,5,8
2023-06-01,213305,10,0,10,1,0,1
2023-06-01,208655,5,4,9,2,2,2
2023-06-01,41155,19,0,19,2,0,2
2023-06-01,208651,4,0,4,1,0,1
2023-06-01,47709,1,0,1,4,0,4
2023-06-01,41453,2,2,4,4,2,4
2023-06-01,208648,2,0,2,1,0,1
2023-06-01,202074,9,0,9,3,0,3
2023-06-01,208608,3,1,4,6,3,6
2023-06-01,31276,3,0,3,2,0,2
2023-06-01,41133,4,0,4,1,0,1
2023-06-01,208572,1,0,1,2,0,2
2023-06-01,208640,4,0,4,2,0,2
2023-06-01,202664,7,0,7,7,0,7
2023-06-01,208645,2,0,2,3,0,3
2023-06-01,209143,5,0,5,2,0,2
2023-06-01,64473,2,1,3,1,1,1
2023-06-01,205909,1,0,1,1,0,1
2023-06-01,200325,9,15,24,6,7,8
2023-06-01,208612,1,0,1,1,0,1
2023-06-01,212655,10,1,11,8,6,8
2023-06-01,213027,6,3,9,3,3,3
2023-06-01,205845,7,1,8,5,1,5
2023-06-01,205122,3,0,3,2,0,2
2023-06-01,200424,12,0,12,4,0,4
2023-06-01,208625,2,0,2,1,0,1
2023-06-01,208609,2,0,2,1,0,1
2023-06-01,212721,4,0,4,1,0,1
2023-06-01,204818,8,1,9,5,5,5
2023-06-01,208015,1,1,2,3,2,3
2023-06-01,13002,6,4,10,19,9,21
2023-06-01,58049,4,2,6,1,1,1
2023-06-01,208619,1,0,1,1,0,1
2023-06-01,208134,1,0,1,1,0,1
2023-06-01,210282,2,0,2,1,0,1
2023-06-01,47636,1,0,1,2,0,2
2023-06-01,205836,12,0,12,2,0,2
2023-06-01,206841,11,2,13,4,3,4
2023-06-01,208479,1,2,3,1,1,2
2023-06-01,209543,10,0,10,1,0,1
2023-06-01,207907,9,0,9,1,0,1
2023-06-01,44489,21,4,25,6,4,8
2023-06-01,208660,4,0,4,2,0,2
2023-06-01,39249,6,3,9,6,4,6
2023-06-01,29390,2,2,4,5,5,6
2023-06-01,212147,4,0,4,5,0,5
2023-06-01,142019,1,0,1,1,0,1
2023-06-01,142578,58,0,58,3,0,3
2023-06-01,57523,11,0,11,1,0,1
2023-06-01,202940,64,3,67,11,2,11
2023-06-01,206446,28,4,32,14,10,16
2023-06-01,207176,8,1,9,8,7,10
2023-06-01,50214,27,0,27,3,0,3
2023-06-01,208600,2,0,2,1,0,1
2023-06-01,61970,4,0,4,2,0,2
2023-06-01,34790,7,2,9,2,1,3
2023-06-01,200810,25,1,26,2,1,2
2023-06-01,202352,2,1,3,1,1,1
2023-06-01,62241,3,1,4,3,3,4
2023-06-01,57829,5,3,8,5,3,5
2023-06-01,208607,1,0,1,1,0,1
2023-06-01,42093,9,3,12,14,9,16
2023-06-01,211827,1,0,1,1,0,1
2023-06-01,2852,22,2,24,27,21,30
2023-06-01,208093,1,1,2,1,1,1
2023-06-01,39817,4,1,5,5,3,5
2023-06-01,211922,4,0,4,1,0,1
2023-06-01,204717,5,0,5,2,0,2
2023-06-01,206583,2,3,5,2,2,2
2023-06-01,208586,1,0,1,3,0,3
2023-06-01,44682,21,1,22,11,1,11
2023-06-01,35267,7,0,7,1,0,1
2023-06-01,56934,2,0,2,2,0,2
2023-06-01,62040,6,1,7,7,1,7
2023-06-01,60365,2,0,2,2,0,2
2023-06-01,21479,15,0,15,2,0,2
2023-06-01,200799,12,0,12,8,0,8
2023-06-01,51872,1,0,1,1,0,1
2023-06-01,208597,3,1,4,2,1,2
2023-06-01,35444,42,1,43,7,1,7
2023-06-01,207787,4,1,5,2,1,2
2023-06-01,47288,25,1,26,7,3,7
2023-06-01,204457,7,0,7,2,0,2
2023-06-01,202087,18,2,20,6,3,7
2023-06-01,8895,177,6,183,16,7,18
2023-06-01,208520,2,1,3,1,1,1
2023-06-01,202834,1,0,1,2,0,2
2023-06-01,20766,5,4,9,14,11,16
2023-06-01,57179,1,0,1,6,2,6
2023-06-01,201211,16,2,18,5,3,6
2023-06-01,47358,1,0,1,2,0,2
2023-06-01,199775,5,0,5,4,0,4
2023-06-01,201508,9,0,9,3,0,3
2023-06-01,62313,20,0,20,8,0,8
2023-06-01,33988,6,3,9,1,2,3
2023-06-01,212416,5,0,5,3,0,3
2023-06-01,206723,5,0,5,3,0,3
2023-06-01,49696,1,1,2,2,2,2
2023-06-01,203531,1,0,1,1,0,1
2023-06-01,62386,12,0,12,3,0,3
2023-06-01,42148,14,1,15,4,1,4
2023-06-01,52193,17,2,19,2,1,2
2023-06-01,208594,4,0,4,4,0,4
2023-06-01,48814,1,0,1,2,0,2
2023-06-01,39364,2,0,2,2,0,2
2023-06-01,48549,5,0,5,4,0,4
2023-06-01,50518,3,1,4,2,1,2
2023-06-01,211903,1,0,1,1,0,1
2023-06-01,211215,2,1,3,1,1,1
2023-06-01,211222,1,0,1,2,0,2
2023-06-01,212822,2,0,2,2,0,2
2023-06-01,206892,8,1,9,9,8,11
2023-06-01,42335,1,0,1,1,0,1
2023-06-01,208456,2,0,2,1,0,1
2023-06-01,207957,4,1,5,1,1,1
2023-06-01,59732,4,0,4,1,0,1
2023-06-01,12884,4,0,4,2,0,2
2023-06-01,47897,4,1,5,2,1,2
2023-06-01,207320,1,3,4,4,2,4
2023-06-01,210732,2,8,10,2,3,4
2023-06-01,210972,1,0,1,1,0,1
2023-06-01,208534,2,0,2,2,0,2
2023-06-01,35319,18,0,18,4,0,4
2023-06-01,207747,4,3,7,2,2,2
2023-06-01,199726,1,0,1,3,0,3
2023-06-01,205125,1,2,3,1,1,2
2023-06-01,60767,1,2,3,5,5,6
2023-06-01,47823,4,0,4,3,0,3
2023-06-01,47527,10,4,14,3,2,3
2023-06-01,203511,8,0,8,3,0,3
2023-06-01,200385,8,0,8,2,0,2
2023-06-01,134000,8,1,9,1,1,1
2023-06-01,134138,3,1,4,4,1,4
2023-06-01,132108,5,0,5,4,0,4
2023-06-01,55806,8,0,8,5,0,5
2023-06-01,133466,16,1,17,2,1,2
2023-06-01,24324,28,2,30,32,4,32
2023-06-01,45230,24,1,25,5,2,5
2023-06-01,56018,2,0,2,3,0,3
2023-06-01,58688,12,0,12,8,0,8
2023-06-01,9451,3,0,3,1,0,1
2023-06-01,131235,17,0,17,8,0,8
2023-06-01,41179,2,1,3,1,1,1
2023-06-01,17597,23,0,23,1,0,1
2023-06-01,17849,189,0,189,1,0,1
2023-06-01,38095,12,0,12,1,0,1
2023-06-01,134789,5,0,5,1,0,1
2023-06-01,715,29,9,38,5,2,5
2023-06-01,134088,2,0,2,3,0,3
2023-06-01,140121,2,0,2,5,0,5
2023-06-01,133660,9,0,9,4,0,4
2023-06-01,45349,5,0,5,10,0,10
2023-06-01,4638,94,0,94,5,0,5
2023-06-01,18209,129,30,159,6,3,6
2023-06-01,55577,91,20,111,1,1,1
2023-06-01,149002,3,0,3,1,0,1
2023-06-01,131325,40,9,49,1,1,1
2023-06-01,63959,8,1,9,5,1,5
2023-06-01,38084,10,2,12,6,2,6
2023-06-01,9972,10,0,10,2,0,2
2023-06-01,45530,7,0,7,6,0,6
2023-06-01,134177,9,8,17,2,1,2
2023-06-01,131597,48,0,48,4,0,4
2023-06-01,133012,16,8,24,7,6,7
2023-06-01,55967,56,1,57,13,4,13
2023-06-01,38768,6,1,7,13,4,13
2023-06-01,139396,4,0,4,2,0,2
2023-06-01,10148,19,0,19,1,0,1
2023-06-01,134055,7,0,7,4,0,4
2023-06-01,135600,16,0,16,2,0,2
2023-06-01,38278,16,1,17,13,3,13
2023-06-01,132837,1,1,2,12,6,13
2023-06-01,59196,8,0,8,2,0,2
2023-06-01,131477,22,3,25,15,8,17
2023-06-01,133695,14,1,15,4,3,4
2023-06-01,146904,10,0,10,10,0,10
2023-06-01,135821,12,0,12,1,0,1
2023-06-01,63969,61,19,80,15,6,15
2023-06-01,134116,9,5,14,4,2,4
2023-06-01,24155,28,1,29,6,1,6
2023-06-01,134117,4,0,4,1,0,1
2023-06-01,134451,7,4,11,3,1,3
2023-06-01,136146,8,0,8,1,0,1
2023-06-01,55507,13,1,14,4,1,4
2023-06-01,132785,12,0,12,4,0,4
2023-06-01,149634,13,0,13,1,0,1
2023-06-01,133589,6,1,7,1,1,1
2023-06-01,136402,3,1,4,1,1,1
2023-06-01,14773,6,8,14,7,5,7
2023-06-01,398574,2,0,2,4,0,4
2023-06-01,132168,24,3,27,10,4,11
2023-06-01,58725,7,0,7,4,0,4
2023-06-01,150748,3,0,3,12,4,12
2023-06-01,59239,12,7,19,60,5,60
2023-06-01,132952,4,0,4,3,0,3
2023-06-01,45226,7,0,7,3,0,3
2023-06-01,4618,282,11,293,28,7,29
2023-06-01,133760,3,0,3,1,0,1
2023-06-01,137166,41,3,44,4,1,4
2023-06-01,149196,5,0,5,1,0,1
2023-06-01,149242,19,0,19,1,0,1
2023-06-01,134139,18,0,18,4,0,4
2023-06-01,58815,3,0,3,3,0,3
2023-06-01,133593,33,1,34,6,2,6
2023-06-01,23674,491,526,1017,12,5,12
2023-06-01,38571,36,0,36,3,0,3
2023-06-01,134026,43,2,45,6,3,6
2023-06-01,55828,15,0,15,3,0,3
2023-06-01,24436,23,1,24,2,1,2
2023-06-01,9517,4,0,4,1,0,1
2023-06-01,63873,8,1,9,4,1,4
2023-06-01,132960,13,1,14,2,1,2
2023-06-01,134022,19,1,20,2,1,2
2023-06-01,147185,2,0,2,5,0,5
2023-06-01,132323,13,0,13,4,0,4
2023-06-01,9253,10,1,11,6,6,7
2023-06-01,136762,0,0,0,5,2,5
2023-06-01,23647,5,0,5,4,0,4
2023-06-01,18222,7,0,7,4,0,4
2023-06-01,31972,62,6,68,6,2,6
2023-06-01,7481,0,0,0,9,0,9
2023-06-01,134160,10,2,12,5,2,5
2023-06-01,59022,2,2,4,1,1,2
2023-06-01,23752,108,6,114,11,4,11
2023-06-01,45061,11,1,12,2,1,2
2023-06-01,10098,36,3,39,18,6,18
2023-06-01,149628,17,0,17,3,0,3
2023-06-01,58898,60,36,96,8,3,8
2023-06-01,58697,4,0,4,2,0,2
2023-06-01,132899,2,0,2,3,0,3
2023-06-01,17675,12,2,14,16,5,16
2023-06-01,139468,8,1,9,6,2,6
2023-06-01,58885,10,1,11,1,1,1
2023-06-01,38516,1,0,1,4,0,4
2023-06-01,133823,30,0,30,3,0,3
2023-06-01,63701,5,0,5,3,0,3
2023-06-01,134369,6,0,6,1,0,1
2023-06-01,133301,19,4,23,5,3,5
2023-06-01,24068,24,0,24,3,0,3
2023-06-01,9986,2,0,2,1,0,1
2023-06-01,133674,10,1,11,7,1,7
2023-06-01,135724,19,2,21,4,3,5
2023-06-01,9484,5,1,6,4,1,4
2023-06-01,133003,5,0,5,2,0,2
2023-06-01,13951,37,12,49,3,1,3
2023-06-01,134186,10,0,10,3,0,3
2023-06-01,131428,18,0,18,1,0,1
2023-06-01,131353,25,1,26,4,1,4
2023-06-01,63981,21,2,23,12,4,12
2023-06-01,18196,64,3,67,6,1,6
2023-06-01,63991,12,11,23,2,3,3
2023-06-01,58762,33,4,37,7,3,7
2023-06-01,4628,409,1,410,24,13,26
2023-06-01,134202,10,0,10,6,0,6
2023-06-01,133421,27,1,28,11,2,11
2023-06-01,45355,11,3,14,8,3,8
2023-06-01,9241,2,0,2,6,0,6
2023-06-01,134041,12,1,13,7,3,8
2023-06-01,133320,3,0,3,1,0,1
2023-06-01,134032,23,1,24,4,2,4
2023-06-01,7629,101,0,101,6,0,6
2023-06-01,134201,8,1,9,2,1,2
2023-06-01,133957,6,3,9,5,2,5
2023-06-01,38783,4,0,4,3,0,3
2023-06-01,131717,24,0,24,9,0,9
2023-06-01,45557,28,20,48,6,3,6
2023-06-01,131349,6,1,7,3,1,3
2023-06-01,131414,5,0,5,2,0,2
2023-06-01,131367,8,0,8,2,0,2
2023-06-01,134220,14,1,15,6,2,6
2023-06-01,45905,27,2,29,11,2,11
2023-06-01,134674,41,329,370,4,3,4
2023-06-01,135241,4,0,4,1,0,1
2023-06-01,131386,8,2,10,3,2,3
2023-06-01,9732,3,1,4,4,3,4
2023-06-01,59185,12,1,13,3,1,3
2023-06-01,132132,4,0,4,15,4,15
2023-06-01,56300,165,11,176,8,2,8
2023-06-01,133136,7,0,7,2,0,2
2023-06-01,58983,10,2,12,2,1,2
2023-06-01,63930,21,1,22,3,2,3
2023-06-01,131423,3,0,3,3,0,3
2023-06-01,131435,10,0,10,4,0,4
2023-06-01,55871,4,0,4,3,0,3
2023-06-01,131418,8,3,11,11,3,12
2023-06-01,132568,8,1,9,2,1,2
2023-06-01,138354,5,0,5,2,0,2
2023-06-01,58890,12,20,32,4,3,4
2023-06-01,134040,8,1,9,3,1,3
2023-06-01,133041,10,0,10,4,0,4
2023-06-01,18328,3,0,3,1,0,1
2023-06-01,46160,18,0,18,6,0,6
2023-06-01,63996,34,2,36,3,2,3
2023-06-01,9303,38,4,42,6,2,6
2023-06-01,132744,8,0,8,1,0,1
2023-06-01,132934,8,2,10,3,2,3
2023-06-01,24218,8,2,10,3,4,4
2023-06-01,133444,2,1,3,2,1,2
2023-06-01,24109,18,0,18,6,0,6
2023-06-01,38814,9,0,9,4,0,4
2023-06-01,134352,6,0,6,2,0,2
2023-06-01,136714,5,1,6,2,1,2
2023-06-01,56147,10,0,10,7,2,7
2023-06-01,63583,6,4,10,1,1,1
2023-06-01,63582,5,8,13,2,1,2
2023-06-01,135457,4,1,5,2,2,2
2023-06-01,136908,9,1,10,3,1,3
2023-06-01,56245,8,0,8,1,0,1
2023-06-01,45644,6,4,10,2,2,2
2023-06-01,45328,27,2,29,5,3,6
2023-06-01,132447,10,1,11,3,1,3
2023-06-01,135214,12,1,13,3,2,3
2023-06-01,56149,10,0,10,4,0,4
2023-06-01,9532,14,0,14,2,0,2
2023-06-01,17581,4,0,4,2,0,2
2023-06-01,2635,160,46,206,27,24,34
2023-06-01,132590,4,0,4,1,0,1
2023-06-01,135333,11,0,11,1,0,1
2023-06-01,135448,7,0,7,3,0,3
2023-06-01,133797,10,0,10,2,0,2
2023-06-01,137367,0,1,1,33,6,35
2023-06-01,56150,29,5,34,4,4,4
2023-06-01,133403,7,0,7,12,0,12
2023-06-01,133287,47,0,47,3,0,3
2023-06-01,17483,106,13,119,14,9,15
2023-06-01,133398,22,3,25,7,1,7
2023-06-01,132137,51,0,51,3,0,3
2023-06-01,135920,5,0,5,1,0,1
2023-06-01,134094,16,5,21,4,4,4
2023-06-01,132850,3,1,4,2,1,2
2023-06-01,209605,7,0,7,3,0,3
2023-06-01,136758,7,1,8,3,1,4
2023-06-01,134550,10,0,10,1,0,1
2023-06-01,146902,8,1,9,5,1,5
2023-06-01,141490,3,1,4,3,1,3
2023-06-01,58912,10,0,10,4,0,4
2023-06-01,21650,16,0,16,2,0,2
2023-06-01,42382,1,1,2,2,1,2
2023-06-01,131410,3,0,3,3,0,3
2023-06-01,55705,35,2,37,5,2,5
2023-06-01,135846,8,1,9,2,1,2
2023-06-01,133255,25,5,30,8,2,9
2023-06-01,56106,7,0,7,2,0,2
2023-06-01,38371,0,0,0,1,0,1
2023-06-01,133384,16,2,18,1,1,1
2023-06-01,132325,104,0,104,1,0,1
2023-06-01,136950,79,1,80,1,1,1
2023-06-01,64047,5,2,7,1,3,3
2023-06-01,10105,17,1,18,7,3,7
2023-06-01,134441,1,0,1,1,0,1
2023-06-01,9287,83,8,91,5,3,5
2023-06-01,45469,14,0,14,3,0,3
2023-06-01,24183,10,4,14,10,4,11
2023-06-01,63526,46,1,47,13,1,13
2023-06-01,4621,293,2,295,75,17,75
2023-06-01,133880,9,0,9,4,0,4
2023-06-01,24475,1,1,2,4,1,4
2023-06-01,140832,12,0,12,1,0,1
2023-06-01,204765,2,0,2,5,0,5
2023-06-01,139482,11,1,12,21,1,21
2023-06-01,150101,4,0,4,1,0,1
2023-06-01,134544,7,0,7,3,0,3
2023-06-01,4646,16,0,16,6,0,6
2023-06-01,132540,12,0,12,3,0,3
2023-06-01,132647,8,7,15,10,7,11
2023-06-01,38525,12,2,14,10,4,10
2023-06-01,17617,5,1,6,4,1,4
2023-06-01,135478,103,15,118,1,1,1
2023-06-01,134553,8,0,8,2,0,2
2023-06-01,38247,52,3,55,2,2,2
2023-06-01,64022,16,1,17,2,2,2
2023-06-01,132644,9,1,10,1,1,1
2023-06-01,46031,3,0,3,7,0,7
2023-06-01,56241,17,0,17,6,0,6
2023-06-01,10137,53,0,53,4,0,4
2023-06-01,41690,10,5,15,19,11,22
2023-06-01,134014,23,16,39,7,3,9
2023-06-01,137968,6,0,6,2,0,2
2023-06-01,11179,114,3,117,27,2,27
2023-06-01,133000,5,0,5,2,0,2
2023-06-01,134677,6,0,6,3,0,3
2023-06-01,137522,5,1,6,1,1,1
2023-06-01,45284,20,1,21,10,2,10
2023-06-01,139567,8,1,9,2,1,2
2023-06-01,17726,39,1,40,11,6,12
2023-06-01,56094,9,5,14,2,1,2
2023-06-01,55478,18,0,18,3,0,3
2023-06-01,134687,26,1,27,5,1,6
2023-06-01,17754,187,9,196,17,6,17
2023-06-01,17771,57,98,155,3,3,3
2023-06-01,133272,2,0,2,2,0,2
2023-06-01,55699,35,4,39,4,1,4
2023-06-01,132369,24,2,26,6,3,6
2023-06-01,59163,8,0,8,5,0,5
2023-06-01,5963,2,0,2,1,0,1
2023-06-01,38244,71,2,73,6,1,6
2023-06-01,201290,20,2,22,13,4,15
2023-06-01,43202,2,8,10,3,2,3
2023-06-01,48971,7,2,9,4,3,4
2023-06-01,208575,0,0,0,2,0,2
2023-06-01,208126,5,1,6,3,2,4
2023-06-01,39201,7,1,8,4,2,4
2023-06-01,14052,4,0,4,3,0,3
2023-06-01,208319,1,0,1,1,0,1
2023-06-01,202741,2,1,3,2,2,2
2023-06-01,12571,2,1,3,2,3,3
2023-06-01,204330,2,0,2,1,0,1
2023-06-01,203620,0,0,0,10,0,10
2023-06-01,43073,3,0,3,4,0,4
2023-06-01,208363,4,0,4,3,0,3
2023-06-01,51177,7,0,7,1,0,1
2023-06-01,50979,5,3,8,2,1,2
2023-06-01,30644,15,0,15,1,0,1
2023-06-01,208258,18,14,32,6,4,8
2023-06-01,212826,12,0,12,1,0,1
2023-06-01,58197,1,0,1,1,0,1
2023-06-01,206481,7,0,7,1,0,1
2023-06-01,5564,4,1,5,8,4,9
2023-06-01,208564,2,0,2,2,0,2
2023-06-01,43545,13,2,15,15,1,15
2023-06-01,208566,5,1,6,7,3,7
2023-06-01,204814,9,3,12,1,1,1
2023-06-01,208417,4,0,4,6,0,6
2023-06-01,47864,1,1,2,11,6,11
2023-06-01,43994,60,1,61,18,2,18
2023-06-01,200738,21,11,32,11,5,12
2023-06-01,44076,25,3,28,2,1,2
2023-06-01,204068,2,2,4,1,1,1
2023-06-01,39371,2,2,4,1,2,2
2023-06-01,31244,6,0,6,2,0,2
2023-06-01,25386,6,1,7,14,2,14
2023-06-01,208557,2,0,2,3,0,3
2023-06-01,51531,8,2,10,8,7,9
2023-06-01,204856,1,0,1,1,0,1
2023-06-01,208440,1,2,3,1,3,3
2023-06-01,201094,6,22,28,3,2,3
2023-06-01,208522,3,0,3,1,0,1
2023-06-01,200222,2,1,3,1,1,1
2023-06-01,212362,1,1,2,2,1,2
2023-06-01,48518,3,2,5,3,2,3
2023-06-01,208493,2,0,2,1,0,1
2023-06-01,208012,3,0,3,1,0,1
2023-06-01,210681,1,0,1,1,0,1
2023-06-01,56419,1,0,1,1,0,1
2023-06-01,206485,1,0,1,1,0,1
2023-06-01,50473,18,0,18,11,0,11
2023-06-01,49127,10,3,13,20,12,22
2023-06-01,203172,2,1,3,3,4,4
2023-06-01,210239,1,0,1,2,0,2
2023-06-01,212747,1,0,1,1,0,1
2023-06-01,208533,4,0,4,2,0,2
2023-06-01,212174,9,0,9,3,0,3
2023-06-01,34897,1,0,1,1,0,1
2023-06-01,206766,34,1,35,1,1,1
2023-06-01,61121,54,1,55,5,2,5
2023-06-01,211529,2,0,2,1,0,1
2023-06-01,47895,8,0,8,12,0,12
2023-06-01,208544,5,0,5,3,0,3
2023-06-01,54247,2,0,2,2,0,2
2023-06-01,208551,3,0,3,1,0,1
2023-06-01,58280,1,1,2,3,2,3
2023-06-01,49569,4,0,4,4,0,4
2023-06-01,57558,6,0,6,2,0,2
2023-06-01,208540,2,0,2,2,0,2
2023-06-01,198857,3,0,3,6,0,6
2023-06-01,47952,39,2,41,7,3,7
2023-06-01,43357,12,12,24,3,5,5
2023-06-01,49619,5,0,5,1,0,1
2023-06-01,202270,1,0,1,2,0,2
2023-06-01,202548,1,0,1,2,0,2
2023-06-01,212091,2,2,4,1,1,1
2023-06-01,208199,1,0,1,2,0,2
2023-06-01,398986,4,0,4,1,0,1
2023-06-01,42201,12,6,18,5,3,6
2023-06-01,208532,1,0,1,2,0,2
2023-06-01,15589,28,3,31,23,6,26
2023-06-01,56876,32,1,33,4,2,5
2023-06-01,208920,3,1,4,5,3,5
2023-06-01,41704,45,2,47,6,2,6
2023-06-01,50284,2,0,2,2,0,2
2023-06-01,58314,10,1,11,12,3,12
2023-06-01,12731,11,5,16,19,13,22
2023-06-01,34903,6,1,7,2,1,2
2023-06-01,204145,11,0,11,1,0,1
2023-06-01,207187,6,3,9,10,11,11
2023-06-01,200254,1,0,1,4,0,4
2023-06-01,208403,3,0,3,2,0,2
2023-06-01,50564,51,0,51,3,0,3
2023-06-01,201746,21,1,22,13,3,13
2023-06-01,206184,1,0,1,6,0,6
2023-06-01,50247,13,1,14,3,1,4
2023-06-01,198518,5,0,5,2,0,2
2023-06-01,47533,1,0,1,2,0,2
2023-06-01,205491,1,0,1,1,0,1
2023-06-01,197759,2,0,2,2,0,2
2023-06-01,41529,5,5,10,9,6,9
2023-06-01,39389,1,0,1,1,0,1
2023-06-01,35432,31,1,32,32,6,34
2023-06-01,47943,0,1,1,2,2,2
2023-06-01,8365,5,3,8,18,15,22
2023-06-01,35548,10,2,12,11,6,11
2023-06-01,207686,2,2,4,3,3,3
2023-06-01,208526,1,0,1,2,0,2
2023-06-01,197518,3,1,4,4,3,5
2023-06-01,204745,1,0,1,2,0,2
2023-06-01,57848,1,3,4,1,3,3
2023-06-01,42066,3,0,3,3,0,3
2023-06-01,206123,16,2,18,3,3,3
2023-06-01,203537,2,0,2,3,0,3
2023-06-01,203534,3,0,3,3,0,3
2023-06-01,211381,1,2,3,1,1,1
2023-06-01,50019,6,0,6,2,0,2
2023-06-01,203222,3,0,3,3,0,3
2023-06-01,212286,4,1,5,1,1,1
2023-06-01,208516,5,1,6,4,3,4
2023-06-01,208501,3,3,6,6,6,8
2023-06-01,51154,1,0,1,2,0,2
2023-06-01,207143,29,3,32,3,2,3
2023-06-01,207719,1,0,1,1,0,1
2023-06-01,199785,18,1,19,5,1,6
2023-06-01,51198,4,2,6,4,3,6
2023-06-01,60952,3,0,3,1,0,1
2023-06-01,208500,2,0,2,1,0,1
2023-06-01,62033,2,0,2,1,0,1
2023-06-01,209984,22,1,23,4,1,4
2023-06-01,35586,5,0,5,2,0,2
2023-06-01,12293,1,0,1,2,0,2
2023-06-01,206775,2,1,3,8,6,9
2023-06-01,24989,21,2,23,23,4,23
2023-06-01,207507,1,0,1,1,0,1
2023-06-01,208448,3,0,3,3,0,3
2023-06-01,39862,7,1,8,5,1,5
2023-06-01,207992,10,1,11,3,3,3
2023-06-01,147176,14,1,15,3,2,3
2023-06-01,213167,1,1,2,1,1,1
2023-06-01,208451,2,0,2,2,0,2
2023-06-01,208495,1,0,1,1,0,1
2023-06-01,33951,5,1,6,15,1,15
2023-06-01,212570,1,0,1,1,0,1
2023-06-01,3927,1,1,2,3,2,3
2023-06-01,3970,5,0,5,1,0,1
2023-06-01,57530,3,0,3,5,0,5
2023-06-01,62314,11,0,11,14,0,14
2023-06-01,49729,11,0,11,3,0,3
2023-06-01,59731,1,0,1,4,0,4
2023-06-01,51569,62,0,62,6,0,6
2023-06-01,212256,1,0,1,1,0,1
2023-06-01,56913,16,0,16,1,0,1
2023-06-01,43648,10,1,11,5,2,5
2023-06-01,203320,1,0,1,1,0,1
2023-06-01,43602,3,0,3,2,0,2
2023-06-01,208402,1,1,2,1,1,1
2023-06-01,31198,11,0,11,1,0,1
2023-06-01,207919,1,0,1,1,0,1
2023-06-01,48732,0,4,4,4,6,7
2023-06-01,200056,1,2,3,1,1,1
2023-06-01,47891,11,2,13,7,6,7
2023-06-01,50302,1,0,1,1,0,1
2023-06-01,39505,13,1,14,8,4,8
2023-06-01,35489,9,0,9,3,0,3
2023-06-01,9070,239,0,239,19,4,20
2023-06-01,210429,9,4,13,1,2,2
2023-06-01,206587,3,0,3,2,0,2
2023-06-01,41270,1,0,1,2,0,2
2023-06-01,33916,3,0,3,2,0,2
2023-06-01,135375,15,2,17,7,1,7
2023-06-01,210846,1,0,1,1,0,1
2023-06-01,208490,3,3,6,1,1,1
2023-06-01,213281,12,9,21,2,5,5
2023-06-01,205063,4,0,4,6,0,6
2023-06-01,41007,12,0,12,8,0,8
2023-06-01,43606,8,0,8,3,0,3
2023-06-01,59829,3,2,5,7,4,7
2023-06-01,201069,5,0,5,5,2,5
2023-06-01,48891,1,0,1,2,0,2
2023-06-01,200785,2,0,2,1,0,1
2023-06-01,140947,5,0,5,4,0,4
2023-06-01,198953,5,0,5,3,0,3
2023-06-01,51220,1,0,1,1,0,1
2023-06-01,28854,20,2,22,1,1,1
2023-06-01,48514,2,1,3,1,1,1
2023-06-01,203714,6,0,6,5,0,5
2023-06-01,48399,8,2,10,24,5,24
2023-06-01,210876,15,0,15,1,0,1
2023-06-01,213064,1,2,3,1,1,1
2023-06-01,208452,2,0,2,3,0,3
2023-06-01,199854,2,0,2,3,0,3
2023-06-01,205199,27,0,27,2,0,2
2023-06-01,213081,3,11,14,2,2,2
2023-06-01,207996,1,20,21,2,3,3
2023-06-01,208948,3,2,5,2,2,2
2023-06-01,34781,3,1,4,3,2,3
2023-06-01,141759,1,0,1,1,0,1
2023-06-01,212221,11,2,13,7,4,7
2023-06-01,50939,9,1,10,1,1,1
2023-06-01,43059,4,1,5,1,1,1
2023-06-01,208473,2,0,2,1,0,1
2023-06-01,204672,3,0,3,3,0,3
2023-06-01,204252,2,0,2,1,0,1
2023-06-01,200697,12,3,15,5,1,5
2023-06-01,47373,1,1,2,3,1,3
2023-06-01,208467,1,0,1,1,0,1
2023-06-01,25596,12,1,13,11,8,13
2023-06-01,34985,13,0,13,2,0,2
2023-06-01,206176,4,0,4,3,0,3
2023-06-01,62365,10,3,13,15,11,17
2023-06-01,208470,1,0,1,1,0,1
2023-06-01,209528,3,2,5,3,3,4
2023-06-01,211978,2,0,2,3,0,3
2023-06-01,208466,1,0,1,1,0,1
2023-06-01,207865,1,0,1,1,0,1
2023-06-01,210489,12,0,12,1,0,1
2023-06-01,207580,1,1,2,1,1,1
2023-06-01,8495,13,3,16,14,10,14
2023-06-01,42034,3,3,6,1,3,3
2023-06-01,208463,1,0,1,2,0,2
2023-06-01,41719,11,0,11,2,0,2
2023-06-01,208459,1,0,1,1,0,1
2023-06-01,61074,3,0,3,2,0,2
2023-06-01,63113,8,0,8,9,0,9
2023-06-01,48889,1,0,1,1,0,1
2023-06-01,59767,4,2,6,1,1,1
2023-06-01,16353,17,4,21,13,4,13
2023-06-01,207560,5,1,6,3,1,3
2023-06-01,208457,1,1,2,3,1,3
2023-06-01,213030,14,0,14,1,0,1
2023-06-01,202375,12,0,12,3,0,3
2023-06-01,206375,32,0,32,1,0,1
2023-06-01,208390,2,0,2,1,0,1
2023-06-01,208111,2,0,2,1,0,1
2023-06-01,51310,7,0,7,12,0,12
2023-06-01,205820,7,2,9,7,5,9
2023-06-01,60591,3,1,4,1,1,1
2023-06-01,42174,2,0,2,1,0,1
2023-06-01,212565,6,0,6,3,0,3
2023-06-01,207508,4,0,4,1,0,1
2023-06-01,199770,12,0,12,2,0,2
2023-06-01,62113,6,2,8,6,7,8
2023-06-01,212816,7,0,7,1,0,1
2023-06-01,57743,5,1,6,2,1,2
2023-06-01,208450,4,0,4,2,0,2
2023-06-01,41371,8,0,8,4,0,4
2023-06-01,398772,10,0,10,2,0,2
2023-06-01,61205,26,1,27,3,4,5
2023-06-01,60048,1,0,1,3,0,3
2023-06-01,49353,2,1,3,13,3,13
2023-06-01,211500,5,0,5,1,0,1
2023-06-01,61241,2,0,2,1,0,1
2023-06-01,51876,1,0,1,1,0,1
2023-06-01,201850,1,0,1,2,0,2
2023-06-01,13046,417,2,419,23,7,24
2023-06-01,35608,10,0,10,6,0,6
2023-06-01,49394,1,0,1,2,0,2
2023-06-01,44985,3,0,3,3,0,3
2023-06-01,39063,2,2,4,18,16,22
2023-06-01,29108,21,20,41,1,1,1
2023-06-01,208439,1,0,1,1,0,1
2023-06-01,51790,19,4,23,12,5,12
2023-06-01,208443,2,0,2,1,0,1
2023-06-01,204581,14,0,14,1,0,1
2023-06-01,206054,5,0,5,2,0,2
2023-06-01,213342,1,1,2,1,1,1
2023-06-01,210372,1,0,1,1,0,1
2023-06-01,34919,1,4,5,2,3,3
2023-06-01,57393,6,0,6,6,0,6
2023-06-01,34642,1,0,1,3,0,3
2023-06-01,213348,6,0,6,4,0,4
2023-06-01,51447,10,0,10,2,0,2
2023-06-01,200235,1,1,2,2,2,2
2023-06-01,61026,4,1,5,6,4,7
2023-06-01,202384,13,0,13,3,0,3
2023-06-01,12748,4,1,5,5,5,6
2023-06-01,25560,5,1,6,8,5,9
2023-06-01,61967,3,1,4,3,3,3
2023-06-01,16143,6,1,7,15,4,15
2023-06-01,61435,1,0,1,2,0,2
2023-06-01,62410,4,1,5,10,4,10
2023-06-01,210899,1,0,1,2,0,2
2023-06-01,59994,2,0,2,2,0,2
2023-06-01,205638,9,0,9,7,0,7
2023-06-01,35575,34,2,36,8,6,11
2023-06-01,208429,1,1,2,1,1,1
2023-06-01,60350,21,1,22,11,3,11
2023-06-01,31732,3,0,3,7,2,7
2023-06-01,210851,1,1,2,1,1,1
2023-06-01,205879,3,0,3,7,0,7
2023-06-01,202966,1,1,2,2,2,3
2023-06-01,207725,6,0,6,2,0,2
2023-06-01,208420,4,4,8,3,3,3
2023-06-01,44377,6,1,7,4,1,4
2023-06-01,208411,5,0,5,5,0,5
2023-06-01,212748,1,0,1,3,2,3
2023-06-01,208408,4,4,8,1,1,1
2023-06-01,51736,2,0,2,1,0,1
2023-06-01,208419,1,1,2,1,1,1
2023-06-01,57814,29,3,32,8,1,8
2023-06-01,35261,3,0,3,1,0,1
2023-06-01,208413,2,0,2,2,0,2
2023-06-01,208414,5,28,33,9,10,12
2023-06-01,134526,5,2,7,7,4,9
2023-06-01,209280,3,1,4,1,1,1
2023-06-01,208416,1,0,1,1,0,1
2023-06-01,50411,8,0,8,5,0,5
2023-06-01,397453,6,1,7,3,2,3
2023-06-01,25428,6,1,7,7,4,7
2023-06-01,204247,1,0,1,3,0,3
2023-06-01,42005,19,1,20,10,7,10
2023-06-01,57505,1,0,1,1,0,1
2023-06-01,149485,3,3,6,1,1,1
2023-06-01,39146,7,0,7,1,0,1
2023-06-01,39522,10,0,10,4,0,4
2023-06-01,49022,2,0,2,1,0,1
2023-06-01,60542,2,0,2,6,0,6
2023-06-01,62257,4,0,4,1,0,1
2023-06-01,60631,50,2,52,4,2,5
2023-06-01,208345,1,0,1,3,0,3
2023-06-01,62366,5,0,5,2,0,2
2023-06-01,208382,2,0,2,1,0,1
2023-06-01,20817,1,0,1,2,0,2
2023-06-01,50241,4,0,4,12,0,12
2023-06-01,208401,1,0,1,1,0,1
2023-06-01,48055,1,0,1,3,0,3
2023-06-01,197296,4,1,5,1,1,1
2023-06-01,44061,11,0,11,8,0,8
2023-06-01,39476,2,0,2,2,0,2
2023-06-01,62205,5,0,5,10,0,10
2023-06-01,208395,1,1,2,1,1,1
2023-06-01,207547,1,1,2,4,3,4
2023-06-01,50458,9,0,9,2,0,2
2023-06-01,211112,2,1,3,1,1,1
2023-06-01,59504,42,26,68,5,1,5
2023-06-01,267950,5,1,6,5,1,5
2023-06-01,263522,10,1,11,5,3,6
2023-06-01,54900,8,4,12,3,2,3
2023-06-01,29650,9,1,10,1,1,1
2023-06-01,201454,2,1,3,3,1,3
2023-06-01,206728,15,6,21,3,1,3
2023-06-01,60566,1,0,1,1,0,1
2023-06-01,39501,68,0,68,1,0,1
2023-06-01,207492,2,0,2,1,0,1
2023-06-01,199947,2,1,3,3,2,3
2023-06-01,47556,1,4,5,1,2,2
2023-06-01,48813,6,1,7,3,2,3
2023-06-01,205530,5,0,5,10,0,10
2023-06-01,200081,21,4,25,5,2,5
2023-06-01,201492,20,0,20,2,0,2
2023-06-01,205341,10,0,10,1,0,1
2023-06-01,208854,2,1,3,2,2,2
2023-06-01,201727,1,1,2,2,1,2
2023-06-01,208387,1,0,1,1,0,1
2023-06-01,47544,11,1,12,9,4,10
2023-06-01,212663,6,0,6,1,0,1
2023-06-01,49151,2,0,2,4,0,4
2023-06-01,56373,25,0,25,7,0,7
2023-06-01,396426,8,0,8,3,0,3
2023-06-01,7106,10,1,11,21,6,21
2023-06-01,400175,3,3,6,1,1,1
2023-06-01,206286,3,0,3,2,0,2
2023-06-01,142299,13,1,14,4,1,5
2023-06-01,208296,5,1,6,3,1,3
2023-06-01,208393,2,0,2,8,0,8
2023-06-01,59741,5,1,6,1,1,1
2023-06-01,208094,1,1,2,1,1,1
2023-06-01,212508,4,16,20,3,3,6
2023-06-01,209493,2,0,2,1,0,1
2023-06-01,51384,1,0,1,3,0,3
2023-06-01,51200,28,1,29,6,1,6
2023-06-01,51787,1,0,1,1,0,1
2023-06-01,200102,9,0,9,1,0,1
2023-06-01,135343,10,1,11,3,2,3
2023-06-01,211557,4,1,5,3,2,4
2023-06-01,202580,5,0,5,4,0,4
2023-06-01,206776,3,0,3,3,0,3
2023-06-01,21283,16,3,19,26,8,27
2023-06-01,207746,3,0,3,1,0,1
2023-06-01,213211,3,2,5,1,1,1
2023-06-01,8823,17,9,26,14,10,16
2023-06-01,268624,8,1,9,13,4,13
2023-06-01,208376,3,1,4,5,4,5
2023-06-01,25211,41,0,41,3,0,3
2023-06-01,202513,19,1,20,5,2,6
2023-06-01,198789,1,0,1,1,0,1
2023-06-01,207348,7,0,7,4,0,4
2023-06-01,210858,1,1,2,1,1,1
2023-06-01,205869,1,1,2,1,1,1
2023-06-01,208360,1,0,1,1,0,1
2023-06-01,58330,4,0,4,1,0,1
2023-06-01,208372,1,1,2,3,2,3
2023-06-01,20355,2,1,3,5,4,5
2023-06-01,206366,15,0,15,3,0,3
2023-06-01,206945,8,0,8,2,0,2
2023-06-01,43004,1,0,1,1,0,1
2023-06-01,212001,3,0,3,1,0,1
2023-06-01,34605,19,0,19,3,0,3
2023-06-01,207123,1,0,1,1,0,1
2023-06-01,208367,2,1,3,4,2,4
2023-06-01,49901,2,2,4,3,5,6
2023-06-01,210542,5,6,11,3,2,3
2023-06-01,57443,7,0,7,4,0,4
2023-06-01,43077,1,0,1,1,0,1
2023-06-01,207577,2,0,2,1,0,1
2023-06-01,203540,6,0,6,1,0,1
2023-06-01,39287,9,8,17,2,3,3
2023-06-01,208348,3,1,4,2,1,2
2023-06-01,205051,15,0,15,6,0,6
2023-06-01,207959,1,0,1,1,0,1
2023-06-01,48090,2,0,2,1,0,1
2023-06-01,203394,4,4,8,6,4,6
2023-06-01,31529,6,4,10,23,11,24
2023-06-01,208366,4,4,8,1,1,1
2023-06-01,25164,4,1,5,1,1,1
2023-06-01,146943,7,0,7,3,0,3
2023-06-01,208315,1,1,2,2,2,2
2023-06-01,137940,1,0,1,2,0,2
2023-06-01,397735,19,1,20,5,1,5
2023-06-01,210937,7,4,11,11,8,12
2023-06-01,203446,1,1,2,2,1,2
2023-06-01,198651,24,3,27,7,4,7
2023-06-01,399045,17,4,21,3,2,3
2023-06-01,204053,7,0,7,3,0,3
2023-06-01,207929,2,0,2,2,0,2
2023-06-01,210162,5,0,5,1,0,1
2023-06-01,35171,14,0,14,4,0,4
2023-06-01,61013,3,1,4,4,3,4
2023-06-01,39690,1,0,1,1,0,1
2023-06-01,208255,1,0,1,1,0,1
2023-06-01,201193,3,2,5,2,2,2
2023-06-01,213217,1,0,1,2,0,2
2023-06-01,213157,5,0,5,2,0,2
2023-06-01,50565,3,0,3,1,0,1
2023-06-01,208320,5,0,5,3,0,3
2023-06-01,208895,1,0,1,3,0,3
2023-06-01,21339,5,0,5,2,0,2
2023-06-01,47196,40,2,42,5,3,6
2023-06-01,22168,9,0,9,1,0,1
2023-06-01,50474,11,0,11,3,0,3
2023-06-01,212603,5,0,5,2,0,2
2023-06-01,47957,16,0,16,19,0,19
2023-06-01,56376,10,0,10,4,0,4
2023-06-01,198090,7,1,8,7,4,7
2023-06-01,208337,2,0,2,2,0,2
2023-06-01,6775,4,3,7,11,5,12
2023-06-01,212283,1,0,1,1,0,1
2023-06-01,48693,8,0,8,3,0,3
2023-06-01,210950,2,0,2,2,0,2
2023-06-01,61432,2,0,2,2,0,2
2023-06-01,208339,1,0,1,7,0,7
2023-06-01,205293,1,0,1,1,0,1
2023-06-01,206783,2,0,2,3,0,3
2023-06-01,29551,34,11,45,27,13,28
2023-06-01,201155,8,2,10,2,2,2
2023-06-01,30766,6,1,7,9,9,11
2023-06-01,12306,10,8,18,35,22,39
2023-06-01,51579,6,1,7,4,1,4
2023-06-01,20688,5,0,5,1,0,1
2023-06-01,206847,1,0,1,1,0,1
2023-06-01,3221,2,1,3,8,6,8
2023-06-01,208338,1,1,2,2,2,2
2023-06-01,208283,1,1,2,2,2,2
2023-06-01,208343,1,0,1,1,0,1
2023-06-01,208992,2,0,2,6,0,6
2023-06-01,210447,1,0,1,2,0,2
2023-06-01,204997,40,0,40,2,0,2
2023-06-01,201239,1,1,2,2,2,2
2023-06-01,197293,24,0,24,6,0,6
2023-06-01,210106,3,0,3,1,0,1
2023-06-01,205243,3,3,6,5,2,5
2023-06-01,211674,1,0,1,1,0,1
2023-06-01,200908,3,0,3,1,0,1
2023-06-01,29457,45,4,49,15,5,16
2023-06-01,207405,4,0,4,1,0,1
2023-06-01,8875,11,8,19,1,1,1
2023-06-01,35131,1,0,1,3,0,3
2023-06-01,41228,2,1,3,2,2,2
2023-06-01,205770,1,0,1,1,0,1
2023-06-01,398148,1,0,1,1,0,1
2023-06-01,208234,4,0,4,2,0,2
2023-06-01,60876,8,1,9,8,6,10
2023-06-01,208327,1,1,2,1,1,1
2023-06-01,16158,11,1,12,5,1,5
2023-06-01,15391,7,5,12,3,5,5
2023-06-01,200918,9,1,10,7,1,7
2023-06-01,13121,1,1,2,6,1,6
2023-06-01,39801,1,0,1,2,0,2
2023-06-01,49854,1,0,1,1,0,1
2023-06-01,207698,1,0,1,1,0,1
2023-06-01,56810,1,0,1,2,0,2
2023-06-01,51804,1,0,1,1,0,1
2023-06-01,50374,4,0,4,5,0,5
2023-06-01,51055,5,1,6,10,7,11
2023-06-01,208307,3,0,3,1,0,1
2023-06-01,205986,10,0,10,1,0,1
2023-06-01,272611,2,1,3,3,1,3
2023-06-01,208238,2,0,2,2,0,2
2023-06-01,204115,1,1,2,1,1,1
2023-06-01,200567,18,7,25,4,2,4
2023-06-01,35122,2,0,2,1,0,1
2023-06-01,208313,4,0,4,1,0,1
2023-06-01,208311,1,0,1,2,0,2
2023-06-01,57965,2,1,3,1,1,1
2023-06-01,41405,5,1,6,8,4,8
2023-06-01,198211,4,1,5,3,2,3
2023-06-01,57931,1,0,1,2,0,2
2023-06-01,42551,1,0,1,3,0,3
2023-06-01,50064,17,2,19,2,2,2
2023-06-01,201691,8,1,9,3,1,3
2023-06-01,209642,3,2,5,2,2,3
2023-06-01,48133,2,1,3,2,2,2
2023-06-01,58340,4,0,4,1,0,1
2023-06-01,133219,3,0,3,5,2,5
2023-06-01,201868,11,1,12,2,2,2
2023-06-01,204188,4,3,7,8,7,9
2023-06-01,41290,1,0,1,1,0,1
2023-06-01,61309,1,0,1,1,0,1
2023-06-01,207643,1,0,1,1,0,1
2023-06-01,206607,4,2,6,2,2,2
2023-06-01,51889,7,0,7,1,0,1
2023-06-01,212899,1,1,2,2,1,2
2023-06-01,8592,2,1,3,4,1,4
2023-06-01,15562,18,5,23,9,7,12
2023-06-01,48603,1,1,2,1,1,1
2023-06-01,208164,2,1,3,8,7,8
2023-06-01,203071,1,1,2,1,1,1
2023-06-01,62000,31,5,36,9,6,9
2023-06-01,43304,7,4,11,2,2,2
2023-06-01,208288,7,0,7,4,0,4
2023-06-01,47164,4,0,4,3,0,3
2023-06-01,201500,19,0,19,5,0,5
2023-06-01,43299,4,2,6,5,1,5
2023-06-01,208061,1,0,1,1,0,1
2023-06-01,210231,1,1,2,2,2,2
2023-06-01,50575,1,1,2,1,1,1
2023-06-01,202358,1,0,1,1,0,1
2023-06-01,47141,6,0,6,1,0,1
2023-06-01,48305,4,4,8,11,7,11
2023-06-01,42692,3,14,17,6,8,10
2023-06-01,52106,9,0,9,6,0,6
2023-06-01,213275,2,2,4,3,2,3
2023-06-01,204667,3,0,3,1,0,1
2023-06-01,199496,8,2,10,7,2,7
2023-06-01,201626,17,1,18,1,1,1
2023-06-01,50903,4,1,5,4,4,4
2023-06-01,262254,33,0,33,4,0,4
2023-06-01,205668,10,3,13,5,7,9
2023-06-01,51044,3,16,19,4,6,6
2023-06-01,213336,1,0,1,1,0,1
2023-06-01,202913,8,0,8,1,0,1
2023-06-01,62183,11,8,19,5,2,5
2023-06-01,50050,10,0,10,9,0,9
2023-06-01,208290,4,0,4,2,0,2
2023-06-01,60813,7,0,7,3,0,3
2023-06-01,48350,7,0,7,5,0,5
2023-06-01,12620,7,1,8,4,3,5
2023-06-01,56529,2,0,2,3,0,3
2023-06-01,49321,3,2,5,6,5,7
2023-06-01,34661,14,1,15,4,2,4
2023-06-01,211161,1,0,1,1,0,1
2023-06-01,52199,1,0,1,1,0,1
2023-06-01,211217,2,0,2,2,0,2
2023-06-01,208261,3,1,4,4,4,4
2023-06-01,208270,3,0,3,1,0,1
2023-06-01,57750,5,0,5,1,0,1
2023-06-01,208278,2,0,2,2,0,2
2023-06-01,46616,9,1,10,6,2,6
2023-06-01,51789,2,0,2,1,0,1
2023-06-01,2200,64,2,66,46,15,50
2023-06-01,1942,12,0,12,1,0,1
2023-06-01,56339,33,0,33,6,0,6
2023-06-01,208275,1,0,1,1,0,1
2023-06-01,208486,2,0,2,2,0,2
2023-06-01,200793,8,0,8,1,0,1
2023-06-01,198935,9,0,9,5,0,5
2023-06-01,3949,71,5,76,2,1,2
2023-06-01,15466,2,1,3,2,2,2
2023-06-01,45009,4,4,8,7,7,9
2023-06-01,207238,2,0,2,3,0,3
2023-06-01,209961,1,0,1,1,0,1
2023-06-01,60699,1,0,1,1,0,1
2023-06-01,63902,11,0,11,1,0,1
2023-06-01,200195,4,2,6,2,1,2
2023-06-01,33843,4,2,6,13,6,14
2023-06-01,203546,1,0,1,1,0,1
2023-06-01,208246,2,0,2,1,0,1
2023-06-01,34582,2,0,2,1,0,1
2023-06-01,60957,1,0,1,2,0,2
2023-06-01,208250,2,2,4,1,1,1
2023-06-01,60264,5,0,5,3,0,3
2023-06-01,208262,1,1,2,1,1,1
2023-06-01,31631,8,2,10,8,5,8
2023-06-01,208236,4,10,14,4,6,7
2023-06-01,206127,1,0,1,1,0,1
2023-06-01,208253,1,1,2,1,1,1
2023-06-01,59699,9,0,9,11,0,11
2023-06-01,201795,4,0,4,1,0,1
2023-06-01,62412,10,7,17,1,1,1
2023-06-01,209326,8,0,8,6,0,6
2023-06-01,23961,7,2,9,4,1,4
2023-06-01,6659,36,1,37,3,2,3
2023-06-01,52010,2,0,2,2,0,2
2023-06-01,34882,3,0,3,2,0,2
2023-06-01,212457,1,1,2,1,1,1
2023-06-01,48348,8,1,9,8,1,8
2023-06-01,208248,4,0,4,2,0,2
2023-06-01,5505,8,1,9,13,3,14
2023-06-01,197740,3,0,3,2,0,2
2023-06-01,208365,8,0,8,2,0,2
2023-06-01,208247,1,0,1,1,0,1
2023-06-01,59745,3,0,3,1,0,1
2023-06-01,209974,15,1,16,6,6,7
2023-06-01,209446,2,1,3,2,1,2
2023-06-01,208220,1,0,1,2,0,2
2023-06-01,12346,11,1,12,8,2,8
2023-06-01,204779,1,1,2,3,3,3
2023-06-01,207265,1,1,2,2,2,2
2023-06-01,212093,2,0,2,1,0,1
2023-06-01,199797,1,0,1,1,0,1
2023-06-01,48236,1,0,1,1,0,1
2023-06-01,201701,4,4,8,16,10,17
2023-06-01,207871,1,1,2,3,1,3
2023-06-01,208169,1,1,2,1,1,1
2023-06-01,200278,4,1,5,5,4,6
2023-06-01,207944,7,0,7,2,0,2
2023-06-01,201188,7,2,9,4,2,4
2023-06-01,209396,1,0,1,1,0,1
2023-06-01,204869,3,0,3,10,4,10
2023-06-01,208195,1,0,1,1,0,1
2023-06-01,34182,2,2,4,4,5,5
2023-06-01,59808,1,1,2,1,1,1
2023-06-01,213190,1,2,3,2,1,2
2023-06-01,211998,1,1,2,1,1,1
2023-06-01,207908,1,1,2,2,1,2
2023-06-01,30813,2,1,3,4,5,6
2023-06-01,201675,6,2,8,5,3,5
2023-06-01,203190,2,0,2,1,0,1
2023-06-01,51827,1,0,1,1,0,1
2023-06-01,208222,1,0,1,1,0,1
2023-06-01,209853,12,0,12,1,0,1
2023-06-01,201739,11,0,11,2,0,2
2023-06-01,204506,2,2,4,1,1,1
2023-06-01,44125,1,0,1,1,0,1
2023-06-01,8612,51,2,53,18,9,18
2023-06-01,15894,4,2,6,8,6,9
2023-06-01,208235,6,1,7,1,1,1
2023-06-01,212832,2,1,3,1,1,1
2023-06-01,45040,4,1,5,4,3,6
2023-06-01,207117,1,0,1,1,0,1
2023-06-01,42053,2,0,2,1,0,1
2023-06-01,24603,4,1,5,1,1,1
2023-06-01,207400,1,0,1,3,0,3
2023-06-01,60029,2,0,2,1,0,1
2023-06-01,43667,7,0,7,4,0,4
2023-06-01,205500,2,1,3,4,2,4
2023-06-01,49703,2,1,3,3,2,3
2023-06-01,208163,3,1,4,2,1,2
2023-06-01,56679,6,0,6,5,0,5
2023-06-01,208183,3,3,6,4,3,4
2023-06-01,207942,1,0,1,1,0,1
2023-06-01,34934,4,0,4,2,0,2
2023-06-01,31257,25,0,25,22,0,22
2023-06-01,208221,6,0,6,2,0,2
2023-06-01,204137,1,0,1,4,0,4
2023-06-01,16024,10,8,18,11,10,14
2023-06-01,202629,3,1,4,2,2,2
2023-06-01,205495,11,0,11,6,0,6
2023-06-01,210792,2,1,3,1,1,1
2023-06-01,208218,1,0,1,1,0,1
2023-06-01,5405,3,1,4,3,3,4
2023-06-01,24586,13,2,15,9,6,10
2023-06-01,203318,3,2,5,1,1,1
2023-06-01,51295,5,5,10,1,1,1
2023-06-01,201103,2,0,2,1,0,1
2023-06-01,201709,3,2,5,4,5,6
2023-06-01,59588,51,3,54,6,1,6
2023-06-01,20626,6,2,8,5,3,5
2023-06-01,208201,1,1,2,3,1,3
2023-06-01,2874,0,0,0,9,6,10
2023-06-01,10282,1,0,1,10,4,11
2023-06-01,60255,4,1,5,10,8,12
2023-06-01,24951,32,2,34,7,4,8
2023-06-01,208216,1,0,1,1,0,1
2023-06-01,207203,9,1,10,6,4,6
2023-06-01,272073,3,1,4,3,1,3
2023-06-01,201962,3,1,4,9,6,11
2023-06-01,207269,2,0,2,3,0,3
2023-06-01,208149,6,0,6,1,0,1
2023-06-01,35807,85,61,146,9,5,9
2023-06-01,212128,10,0,10,1,0,1
2023-06-01,204666,2,0,2,4,0,4
2023-06-01,5467,8,0,8,9,0,9
2023-06-01,25100,9,0,9,2,0,2
2023-06-01,201986,12,1,13,11,5,11
2023-06-01,47450,4,0,4,2,0,2
2023-06-01,208209,1,0,1,1,0,1
2023-06-01,48412,6,0,6,1,0,1
2023-06-01,208206,4,1,5,2,1,2
2023-06-01,8873,1,1,2,2,1,2
2023-06-01,56563,1,0,1,1,0,1
2023-06-01,44769,6,0,6,3,0,3
2023-06-01,207045,6,1,7,1,1,1
2023-06-01,208202,4,2,6,1,1,2
2023-06-01,213110,1,2,3,7,7,7
2023-06-01,202945,1,3,4,1,4,4
2023-06-01,210118,1,1,2,1,1,1
2023-06-01,201281,1,2,3,1,1,1
2023-06-01,208074,1,1,2,1,1,1
2023-06-01,39384,7,4,11,8,6,9
2023-06-01,30798,5,1,6,2,2,2
2023-06-01,208200,2,5,7,2,2,2
2023-06-01,42072,2,3,5,3,3,3
2023-06-01,212803,4,0,4,3,0,3
2023-06-01,208702,4,1,5,2,3,3
2023-06-01,207300,1,1,2,1,1,1
2023-06-01,206313,3,3,6,7,6,9
2023-06-01,209894,1,0,1,4,0,4
2023-06-01,44146,3,0,3,1,0,1
2023-06-01,208176,1,1,2,2,2,2
2023-06-01,139345,2,2,4,3,3,3
2023-06-01,61251,5,1,6,4,1,4
2023-06-01,200193,1,0,1,1,0,1
2023-06-01,212175,2,2,4,5,5,6
2023-06-01,211091,2,0,2,1,0,1
2023-06-01,202591,3,3,6,3,4,5
2023-06-01,208109,1,0,1,1,0,1
2023-06-01,202543,8,4,12,3,2,4
2023-06-01,136133,3,0,3,4,0,4
2023-06-01,47522,5,0,5,3,0,3
2023-06-01,212517,4,0,4,2,0,2
2023-06-01,211761,1,0,1,1,0,1
2023-06-01,395849,1,1,2,2,2,2
2023-06-01,61423,2,13,15,16,16,19
2023-06-01,213044,1,1,2,1,2,2
2023-06-01,25506,5,0,5,6,0,6
2023-06-01,202208,10,1,11,1,1,1
2023-06-01,51956,2,0,2,3,0,3
2023-06-01,199821,1,0,1,1,0,1
2023-06-01,199033,1,0,1,1,0,1
2023-06-01,41281,6,3,9,7,3,7
2023-06-01,41634,3,2,5,3,1,3
2023-06-01,61292,1,2,3,5,5,7
2023-06-01,203755,1,0,1,3,0,3
2023-06-01,28972,8,2,10,7,3,7
2023-06-01,196861,2,1,3,2,1,2
2023-06-01,147186,10,0,10,1,0,1
2023-06-01,207817,2,0,2,2,0,2
2023-06-01,205072,10,1,11,2,2,2
2023-06-01,39233,9,0,9,7,0,7
2023-06-01,201153,23,0,23,3,0,3
2023-06-01,35367,2,0,2,1,0,1
2023-06-01,44664,15,0,15,4,0,4
2023-06-01,206975,5,0,5,1,0,1
2023-06-01,60776,1,1,2,1,1,2
2023-06-01,62390,16,0,16,8,0,8
2023-06-01,213205,2,0,2,4,0,4
2023-06-01,47154,1,0,1,1,0,1
2023-06-01,208177,1,0,1,5,0,5
2023-06-01,197564,4,1,5,2,2,2
2023-06-01,208178,4,1,5,2,2,2
2023-06-01,212369,11,0,11,1,0,1
2023-06-01,42724,14,0,14,2,0,2
2023-06-01,208162,1,2,3,1,1,1
2023-06-01,212795,3,2,5,6,6,8
2023-06-01,208007,1,0,1,1,0,1
2023-06-01,201299,8,7,15,2,2,2
2023-06-01,204272,2,1,3,4,2,4
2023-06-01,198984,11,0,11,7,0,7
2023-06-01,400031,5,0,5,1,0,1
2023-06-01,200180,2,1,3,2,1,3
2023-06-01,51458,2,1,3,2,2,2
2023-06-01,43581,5,0,5,1,0,1
2023-06-01,200756,2,0,2,4,0,4
2023-06-01,201791,3,1,4,9,8,11
2023-06-01,208155,3,0,3,2,0,2
2023-06-01,42541,5,1,6,12,8,13
2023-06-01,201697,1,1,2,2,2,2
2023-06-01,200064,48,1,49,2,2,2
2023-06-01,200034,2,0,2,1,0,1
2023-06-01,210687,2,0,2,2,0,2
2023-06-01,209076,1,0,1,1,0,1
2023-06-01,34890,2,0,2,3,0,3
2023-06-01,211823,1,1,2,2,1,2
2023-06-01,51131,1,1,2,5,1,5
2023-06-01,12540,1,0,1,9,0,9
2023-06-01,202211,5,0,5,2,0,2
2023-06-01,208170,5,0,5,1,0,1
2023-06-01,28701,1,1,2,2,2,2
2023-06-01,202993,2,0,2,2,0,2
2023-06-01,201000,24,0,24,2,0,2
2023-06-01,13045,11,6,17,15,11,17
2023-06-01,211680,4,1,5,2,1,2
2023-06-01,200202,1,1,2,1,1,2
2023-06-01,57648,1,0,1,1,0,1
2023-06-01,23528,57,0,57,3,0,3
2023-06-01,208161,21,0,21,2,0,2
2023-06-01,208896,1,0,1,1,0,1
2023-06-01,16321,4,0,4,1,0,1
2023-06-01,44606,1,0,1,1,0,1
2023-06-01,200698,20,1,21,2,1,2
2023-06-01,43161,1,0,1,1,0,1
2023-06-01,212047,2,1,3,2,2,2
2023-06-01,211552,2,1,3,2,2,2
2023-06-01,210920,2,1,3,2,1,2
2023-06-01,60435,6,2,8,3,1,3
2023-06-01,28682,4,1,5,6,2,6
2023-06-01,199723,22,3,25,7,2,7
2023-06-01,209243,8,1,9,1,1,1
2023-06-01,30830,2,1,3,1,1,1
2023-06-01,210413,2,0,2,1,0,1
2023-06-01,208115,2,0,2,1,0,1
2023-06-01,51185,22,11,33,13,5,16
2023-06-01,32558,54,0,54,5,0,5
2023-06-01,139888,1,1,2,1,2,3
2023-06-01,212664,1,0,1,1,0,1
2023-06-01,209916,2,1,3,2,2,2
2023-06-01,34427,5,2,7,5,4,5
2023-06-01,208064,10,0,10,2,0,2
2023-06-01,211732,3,0,3,1,0,1
2023-06-01,208131,2,0,2,1,0,1
2023-06-01,208144,2,0,2,2,0,2
2023-06-01,209505,2,2,4,7,5,7
2023-06-01,201115,1,1,2,3,1,3
2023-06-01,5631,22,2,24,8,5,8
2023-06-01,56701,9,0,9,14,0,14
2023-06-01,201847,10,2,12,4,2,4
2023-06-01,205112,12,9,21,14,4,15
2023-06-01,62442,31,0,31,6,0,6
2023-06-01,62229,1,0,1,1,0,1
2023-06-01,35471,0,1,1,4,2,4
2023-06-01,44667,1,0,1,1,0,1
2023-06-01,60917,8,1,9,6,4,8
2023-06-01,199765,2,1,3,2,2,4
2023-06-01,211871,7,0,7,2,0,2
2023-06-01,41683,2,0,2,1,0,1
2023-06-01,41897,91,4,95,9,4,9
2023-06-01,201200,20,0,20,2,0,2
2023-06-01,208135,4,4,8,1,1,1
2023-06-01,51148,1,0,1,3,0,3
2023-06-01,34835,1,0,1,1,0,1
2023-06-01,41729,11,2,13,3,2,3
2023-06-01,207923,5,1,6,2,1,2
2023-06-01,199585,4,0,4,7,0,7
2023-06-01,197099,10,2,12,8,2,8
2023-06-01,44375,3,0,3,3,0,3
2023-06-01,58104,4,0,4,3,0,3
2023-06-01,41710,15,0,15,8,0,8
2023-06-01,39093,4,2,6,5,3,5
2023-06-01,15510,18,4,22,10,7,11
2023-06-01,40913,22,2,24,7,2,7
2023-06-01,269749,9,3,12,3,3,3
2023-06-01,50326,6,0,6,5,0,5
2023-06-01,208033,3,1,4,2,1,2
2023-06-01,44398,27,0,27,3,0,3
2023-06-01,44270,7,0,7,3,0,3
2023-06-01,51615,4,1,5,3,1,3
2023-06-01,43061,2,0,2,56,9,57
2023-06-01,213221,2,0,2,1,0,1
2023-06-01,133153,1,0,1,1,0,1
2023-06-01,328867,14,0,14,6,0,6
2023-06-01,13259,4,1,5,16,3,16
2023-06-01,209734,5,0,5,1,0,1
2023-06-01,62020,4,1,5,1,1,1
2023-06-01,200702,5,0,5,2,0,2
2023-06-01,207953,1,0,1,1,0,1
2023-06-01,207983,5,1,6,5,1,5
2023-06-01,208095,3,0,3,2,0,2
2023-06-01,205953,6,0,6,4,0,4
2023-06-01,207617,3,0,3,2,0,2
2023-06-01,48821,4,3,7,4,4,5
2023-06-01,208123,1,0,1,1,0,1
2023-06-01,43995,17,2,19,1,1,1
2023-06-01,138648,4,0,4,1,0,1
2023-06-01,138609,1,0,1,2,0,2
2023-06-01,50250,1,0,1,3,0,3
2023-06-01,207810,6,0,6,2,0,2
2023-06-01,6723,3,1,4,12,5,12
2023-06-01,43967,44,0,44,3,0,3
2023-06-01,201800,4,0,4,3,0,3
2023-06-01,207867,1,0,1,2,0,2
2023-06-01,60490,43,1,44,4,1,4
2023-06-01,42316,8,3,11,4,2,5
2023-06-01,212635,1,1,2,7,6,10
2023-06-01,208071,1,0,1,1,0,1
2023-06-01,200031,8,0,8,6,0,6
2023-06-01,208070,4,0,4,2,0,2
2023-06-01,200562,3,1,4,3,3,3
2023-06-01,16171,9,1,10,5,5,6
2023-06-01,15511,7,0,7,2,0,2
2023-06-01,48629,6,0,6,2,0,2
2023-06-01,200036,1,0,1,2,0,2
2023-06-01,45054,4,0,4,3,0,3
2023-06-01,206652,6,17,23,10,3,10
2023-06-01,208108,5,1,6,1,1,1
2023-06-01,268387,7,8,15,5,1,5
2023-06-01,266866,2,0,2,2,0,2
2023-06-01,262411,6,1,7,13,8,13
2023-06-01,271356,4,5,9,2,2,2
2023-06-01,61503,5,1,6,12,1,12
2023-06-01,266870,4,0,4,1,0,1
2023-06-01,268402,7,3,10,6,3,6
2023-06-01,268437,3,1,4,3,2,3
2023-06-01,268398,7,1,8,4,1,4
2023-06-01,264191,7,6,13,7,5,7
2023-06-01,266872,7,4,11,1,1,1
2023-06-01,266876,5,3,8,3,1,3
2023-06-01,269783,3,3,6,14,11,15
2023-06-01,268391,4,3,7,3,2,3
2023-06-01,262732,32,2,34,6,1,6
2023-06-01,268392,6,0,6,1,0,1
2023-06-01,268438,4,1,5,4,2,4
2023-06-01,266353,6,1,7,7,4,7
2023-06-01,268393,1,0,1,3,0,3
2023-06-01,264592,1,1,2,14,8,16
2023-06-01,268394,7,0,7,1,0,1
2023-06-01,268395,7,0,7,3,0,3
2023-06-01,268399,3,1,4,3,3,4
2023-06-01,268396,5,2,7,4,3,4
2023-06-01,263347,35,4,39,8,4,8
2023-06-01,268403,7,0,7,1,0,1
2023-06-01,266830,3,1,4,16,4,16
2023-06-01,266878,2,0,2,2,0,2
2023-06-01,262273,9,3,12,5,3,5
2023-06-01,268441,3,0,3,1,0,1
2023-06-01,61573,6,18,24,29,20,30
2023-06-01,267688,2,0,2,2,0,2
2023-06-01,263269,9,6,15,22,13,22
2023-06-01,268462,2,0,2,1,0,1
2023-06-01,268404,4,1,5,11,9,11
2023-06-01,53019,15,14,29,21,15,22
2023-06-01,28361,8,3,11,5,5,6
2023-06-01,28258,40,27,67,25,20,25
2023-06-01,262481,10,1,11,3,1,3
2023-06-01,268593,7,10,17,3,2,3
2023-06-01,268415,1,0,1,1,0,1
2023-06-01,263484,15,5,20,8,5,9
2023-06-01,268407,3,5,8,1,1,1
2023-06-01,263961,3,2,5,10,4,10
2023-06-01,268406,6,1,7,2,1,2
2023-06-01,268397,4,3,7,6,2,7
2023-06-01,268400,7,1,8,4,3,4
2023-06-01,268514,7,1,8,1,1,1
2023-06-01,61591,9,3,12,11,10,12
2023-06-01,267237,7,1,8,2,1,2
2023-06-01,268418,7,0,7,1,0,1
2023-06-01,268408,3,7,10,1,1,1
2023-06-01,263762,17,5,22,3,1,3
2023-06-01,266875,5,0,5,1,0,1
2023-06-01,268409,4,0,4,1,0,1
2023-06-01,268420,4,7,11,1,1,1
2023-06-01,268330,5,10,15,11,9,11
2023-06-01,268419,3,0,3,2,0,2
2023-06-01,264161,5,5,10,8,4,9
2023-06-01,268411,1,0,1,1,0,1
2023-06-01,265198,2,2,4,9,4,9
2023-06-01,268431,3,3,6,1,1,1
2023-06-01,266890,2,0,2,1,0,1
2023-06-01,268432,4,5,9,6,4,6
2023-06-01,263596,8,3,11,7,6,7
2023-06-01,268412,6,1,7,1,1,1
2023-06-01,268425,5,4,9,3,2,3
2023-06-01,268426,3,1,4,1,1,1
2023-06-01,268417,3,1,4,3,2,4
2023-06-01,268413,4,0,4,3,0,3
2023-06-01,268421,3,1,4,2,2,2
2023-06-01,266887,5,0,5,3,0,3
2023-06-01,268471,7,18,25,4,5,5
2023-06-01,266884,1,1,2,2,1,2
2023-06-01,268410,1,1,2,1,1,1
2023-06-01,262868,20,3,23,11,4,11
2023-06-01,268422,1,0,1,1,0,1
2023-06-01,266881,7,0,7,1,0,1
2023-06-01,61594,2,1,3,1,1,1
2023-06-01,268423,4,2,6,4,2,4
2023-06-01,267693,4,1,5,1,1,1
2023-06-01,268429,3,1,4,2,1,2
2023-06-01,268434,3,3,6,4,4,4
2023-06-01,263910,13,0,13,1,0,1
2023-06-01,263481,4,0,4,7,0,7
2023-06-01,268452,1,1,2,2,1,2
2023-06-01,268805,2,5,7,6,5,8
2023-06-01,268436,5,4,9,5,2,5
2023-06-01,268445,5,8,13,4,2,4
2023-06-01,61826,2,1,3,5,3,6
2023-06-01,268430,5,15,20,4,2,5
2023-06-01,268424,5,3,8,8,5,8
2023-06-01,266448,1,3,4,8,3,8
2023-06-01,264524,10,0,10,3,0,3
2023-06-01,266883,4,0,4,2,0,2
2023-06-01,268439,7,0,7,3,0,3
2023-06-01,267332,6,1,7,10,4,10
2023-06-01,268446,7,1,8,4,2,4
2023-06-01,268440,7,2,9,2,1,2
2023-06-01,266893,4,5,9,2,1,2
2023-06-01,262199,13,1,14,11,3,11
2023-06-01,268490,3,1,4,2,2,2
2023-06-01,52800,15,1,16,8,4,8
2023-06-01,262743,20,1,21,6,4,8
2023-06-01,266894,4,1,5,2,2,2
2023-06-01,267699,8,8,16,8,4,9
2023-06-01,268500,7,1,8,1,1,1
2023-06-01,268443,2,1,3,1,1,1
2023-06-01,266902,4,0,4,3,0,3
2023-06-01,6471,73,0,73,31,0,31
2023-06-01,268447,7,1,8,2,2,2
2023-06-01,269221,1,1,2,4,3,4
2023-06-01,268448,7,1,8,3,2,3
2023-06-01,268453,1,1,2,1,1,1
2023-06-01,52714,6,2,8,7,6,7
2023-06-01,268454,1,1,2,1,1,1
2023-06-01,268444,3,3,6,1,1,1
2023-06-01,268455,5,2,7,1,1,1
2023-06-01,264359,10,3,13,11,10,11
2023-06-01,268449,5,1,6,1,1,1
2023-06-01,268450,5,1,6,1,1,1
2023-06-01,268502,3,6,9,5,5,5
2023-06-01,268511,5,0,5,4,0,4
2023-06-01,268456,3,3,6,1,1,1
2023-06-01,52617,6,3,9,7,5,8
2023-06-01,268463,4,1,5,2,1,2
2023-06-01,268458,4,3,7,2,1,2
2023-06-01,263860,6,3,9,4,3,4
2023-06-01,267318,1,1,2,9,5,9
2023-06-01,52901,15,4,19,12,8,13
2023-06-01,268451,1,0,1,1,0,1
2023-06-01,266901,1,0,1,1,0,1
2023-06-01,264827,6,1,7,6,1,6
2023-06-01,266891,5,0,5,1,0,1
2023-06-01,266885,1,0,1,2,0,2
2023-06-01,268464,6,6,12,5,5,6
2023-06-01,267278,7,5,12,7,4,7
2023-06-01,268465,3,3,6,3,3,5
2023-06-01,268959,6,7,13,8,2,8
2023-06-01,262872,3,4,7,9,1,10
2023-06-01,268459,7,7,14,6,6,7
2023-06-01,263626,10,25,35,17,11,17
2023-06-01,267264,3,8,11,7,7,10
2023-06-01,268543,3,1,4,3,1,3
2023-06-01,268480,16,1,17,3,1,3
2023-06-01,268510,2,2,4,7,8,8
2023-06-01,268199,3,3,6,5,4,5
2023-06-01,268603,3,0,3,3,0,3
2023-06-01,268469,1,0,1,1,0,1
2023-06-01,268519,5,1,6,1,2,2
2023-06-01,262595,10,6,16,11,6,11
2023-06-01,268466,4,0,4,1,0,1
2023-06-01,264498,12,3,15,11,12,13
2023-06-01,268467,2,2,4,4,2,4
2023-06-01,270021,13,1,14,4,3,4
2023-06-01,28093,18,1,19,1,1,1
2023-06-01,52399,25,0,25,3,0,3
2023-06-01,52328,19,2,21,6,2,8
2023-06-01,266897,7,0,7,3,0,3
2023-06-01,61758,4,6,10,21,11,24
2023-06-01,268470,3,1,4,3,1,3
2023-06-01,266892,2,0,2,1,0,1
2023-06-01,268512,7,2,9,10,9,11
2023-06-01,64139,8,0,8,6,0,6
2023-06-01,266910,6,0,6,3,0,3
2023-06-01,268481,7,6,13,1,3,3
2023-06-01,269115,3,3,6,13,10,13
2023-06-01,268472,3,1,4,1,1,1
2023-06-01,268235,7,1,8,15,13,16
2023-06-01,266201,2,1,3,45,28,47
2023-06-01,268473,2,1,3,3,1,3
2023-06-01,268474,7,0,7,2,0,2
2023-06-01,265348,5,1,6,8,5,9
2023-06-01,268498,2,0,2,1,0,1
2023-06-01,268488,2,0,2,1,0,1
2023-06-01,268200,22,5,27,33,22,35
2023-06-01,269335,8,1,9,4,1,4
2023-06-01,266399,3,3,6,8,5,8
2023-06-01,267389,8,2,10,6,1,6
2023-06-01,272443,1,1,2,1,2,3
2023-06-01,268476,4,0,4,2,0,2
2023-06-01,268499,7,1,8,1,1,1
2023-06-01,268477,3,1,4,4,3,4
2023-06-01,265345,4,0,4,3,0,3
2023-06-01,268483,3,1,4,3,1,3
2023-06-01,268478,5,7,12,5,4,5
2023-06-01,264186,7,31,38,9,7,9
2023-06-01,268484,4,3,7,1,1,1
2023-06-01,268487,1,2,3,6,1,6
2023-06-01,263546,12,34,46,9,5,9
2023-06-01,262285,26,1,27,9,3,9
2023-06-01,262760,32,1,33,11,3,12
2023-06-01,263798,0,0,0,2,2,2
2023-06-01,14187,44,2,46,4,1,4
2023-06-01,270035,10,2,12,5,1,5
2023-06-01,266903,2,0,2,1,0,1
2023-06-01,268492,1,1,2,1,1,1
2023-06-01,268485,3,3,6,7,7,9
2023-06-01,268890,3,1,4,5,4,5
2023-06-01,262498,17,1,18,11,3,11
2023-06-01,268493,1,1,2,1,1,1
2023-06-01,267690,2,0,2,2,0,2
2023-06-01,262474,9,2,11,18,14,20
2023-06-01,268508,1,1,2,3,3,3
2023-06-01,264297,14,3,17,7,5,8
2023-06-01,268525,7,1,8,7,5,8
2023-06-01,258525,1,0,1,1,0,1
2023-06-01,268526,6,3,9,3,3,5
2023-06-01,265365,4,3,7,10,6,11
2023-06-01,271600,5,10,15,5,4,5
2023-06-01,268532,3,1,4,2,1,2
2023-06-01,268494,4,1,5,3,1,3
2023-06-01,268496,1,0,1,1,0,1
2023-06-01,268529,7,7,14,9,5,9
2023-06-01,266142,5,5,10,13,11,13
2023-06-01,268509,7,6,13,5,4,5
2023-06-01,267679,2,0,2,1,0,1
2023-06-01,268507,5,1,6,2,1,2
2023-06-01,267678,4,0,4,1,0,1
2023-06-01,267975,1,0,1,1,0,1
2023-06-01,262215,42,1,43,4,2,4
2023-06-01,267682,2,0,2,1,0,1
2023-06-01,263817,3,2,5,8,2,8
2023-06-01,267715,1,0,1,5,2,5
2023-06-01,267727,1,0,1,1,0,1
2023-06-01,267706,4,0,4,5,0,5
2023-06-01,271892,1,0,1,1,0,1
2023-06-01,263244,11,0,11,5,0,5
2023-06-01,268517,3,1,4,4,4,4
2023-06-01,266401,1,1,2,3,2,4
2023-06-01,268506,5,1,6,1,1,1
2023-06-01,266898,1,0,1,2,0,2
2023-06-01,268516,3,2,5,2,1,2
2023-06-01,267694,1,0,1,1,0,1
2023-06-01,266220,2,1,3,11,10,11
2023-06-01,268505,2,1,3,1,1,1
2023-06-01,265931,7,1,8,4,3,4
2023-06-01,268515,5,1,6,1,1,1
2023-06-01,268504,6,1,7,6,3,6
2023-06-01,262807,49,3,52,12,8,12
2023-06-01,268536,1,0,1,1,0,1
2023-06-01,266899,1,0,1,1,0,1
2023-06-01,267691,1,4,5,1,1,1
2023-06-01,268518,5,1,6,3,3,3
2023-06-01,271843,4,0,4,2,0,2
2023-06-01,268168,6,3,9,8,3,8
2023-06-01,266905,5,3,8,2,1,2
2023-06-01,268531,3,1,4,4,2,4
2023-06-01,268522,1,0,1,1,0,1
2023-06-01,268523,4,7,11,2,2,2
2023-06-01,268527,4,1,5,7,7,8
2023-06-01,268537,1,3,4,2,4,4
2023-06-01,265728,5,1,6,2,1,3
2023-06-01,267704,3,1,4,2,1,2
2023-06-01,265757,1,0,1,4,0,4
2023-06-01,267697,3,0,3,1,0,1
2023-06-01,268538,3,1,4,4,4,5
2023-06-01,267972,3,1,4,2,2,2
2023-06-01,268539,2,1,3,1,1,1
2023-06-01,271617,3,3,6,4,4,5
2023-06-01,269138,7,3,10,9,6,9
2023-06-01,11830,2270,37,2307,19,5,20
2023-06-01,267692,1,0,1,1,0,1
2023-06-01,267677,5,0,5,2,0,2
2023-06-01,268564,4,3,7,1,1,1
2023-06-01,268528,7,7,14,5,4,6
2023-06-01,268331,3,3,6,15,11,15
2023-06-01,268535,6,1,7,2,1,2
2023-06-01,268533,3,1,4,4,1,4
2023-06-01,268582,3,1,4,2,1,2
2023-06-01,268544,3,1,4,4,2,4
2023-06-01,263427,19,6,25,7,4,8
2023-06-01,265308,3,1,4,5,5,5
2023-06-01,268540,3,3,6,2,2,3
2023-06-01,52557,3,3,6,6,5,6
2023-06-01,268541,5,0,5,3,0,3
2023-06-01,268600,3,1,4,5,4,5
2023-06-01,268895,1,1,2,8,9,9
2023-06-01,52980,69,1,70,6,5,6
2023-06-01,264439,5,1,6,5,3,6
2023-06-01,268545,3,1,4,2,1,2
2023-06-01,268547,6,2,8,2,2,2
2023-06-01,268589,3,2,5,4,4,5
2023-06-01,262417,10,1,11,11,8,11
2023-06-01,271494,5,1,6,2,2,2
2023-06-01,268644,3,2,5,2,2,3
2023-06-01,267685,3,0,3,2,0,2
2023-06-01,263026,29,8,37,11,4,11
2023-06-01,268629,0,0,0,2,0,2
2023-06-01,264565,16,4,20,7,6,8
2023-06-01,267841,4,0,4,3,0,3
2023-06-01,267683,1,0,1,2,0,2
2023-06-01,268594,4,0,4,2,0,2
2023-06-01,267680,5,0,5,1,0,1
2023-06-01,268548,2,1,3,5,4,5
2023-06-01,61768,10,7,17,10,4,10
2023-06-01,268549,4,0,4,2,0,2
2023-06-01,271622,1,1,2,1,1,1
2023-06-01,268550,4,4,8,2,2,2
2023-06-01,262873,5,1,6,5,1,6
2023-06-01,268572,5,0,5,2,0,2
2023-06-01,268554,3,6,9,3,2,3
2023-06-01,268559,3,1,4,2,2,2
2023-06-01,268573,6,4,10,4,3,4
2023-06-01,263998,13,4,17,35,18,36
2023-06-01,265417,21,3,24,11,3,11
2023-06-01,268551,4,1,5,8,4,8
2023-06-01,267687,4,0,4,3,0,3
2023-06-01,268546,14,3,17,9,6,9
2023-06-01,264963,3,1,4,12,9,12
2023-06-01,268569,2,1,3,3,2,3
2023-06-01,270890,5,1,6,4,3,4
2023-06-01,268574,7,7,14,2,1,2
2023-06-01,267484,37,4,41,19,10,19
2023-06-01,268555,7,0,7,1,0,1
2023-06-01,271201,4,1,5,14,9,15
2023-06-01,270997,7,2,9,5,4,5
2023-06-01,268595,1,3,4,1,1,1
2023-06-01,268552,6,2,8,1,1,1
2023-06-01,266435,7,7,14,10,7,11
2023-06-01,268575,4,1,5,3,1,3
2023-06-01,268576,6,1,7,6,2,6
2023-06-01,268577,4,3,7,3,2,3
2023-06-01,271733,0,1,1,3,5,6
2023-06-01,267696,1,0,1,1,0,1
2023-06-01,268670,3,1,4,1,1,1
2023-06-01,270087,2,0,2,1,0,1
2023-06-01,267698,1,0,1,1,0,1
2023-06-01,263754,1,0,1,7,0,7
2023-06-01,267686,1,0,1,1,0,1
2023-06-01,268568,7,10,17,11,10,11
2023-06-01,268560,7,5,12,5,3,5
2023-06-01,263152,43,53,96,7,5,7
2023-06-01,52716,7,1,8,7,4,8
2023-06-01,268561,3,1,4,1,1,1
2023-06-01,52561,6,6,12,2,1,2
2023-06-01,268570,3,0,3,1,0,1
2023-06-01,262972,6,3,9,6,7,7
2023-06-01,268571,3,3,6,1,1,1
2023-06-01,268562,7,0,7,3,0,3
2023-06-01,52852,5,1,6,3,2,3
2023-06-01,61681,6,5,11,5,2,5
2023-06-01,265482,4,1,5,14,9,16
2023-06-01,268563,2,3,5,4,3,4
2023-06-01,268556,7,1,8,2,1,2
2023-06-01,262632,21,1,22,14,13,15
2023-06-01,268578,5,1,6,1,1,1
2023-06-01,268579,5,3,8,4,3,4
2023-06-01,268553,2,0,2,2,0,2
2023-06-01,61785,7,1,8,17,11,17
2023-06-01,267702,5,1,6,3,3,3
2023-06-01,28008,1,1,2,6,5,6
2023-06-01,23201,232,12,244,22,10,24
2023-06-01,268557,7,1,8,1,1,1
2023-06-01,264129,3,1,4,9,11,12
2023-06-01,268565,1,1,2,1,1,1
2023-06-01,268566,1,0,1,1,0,1
2023-06-01,267684,5,1,6,2,1,2
2023-06-01,268618,1,0,1,1,0,1
2023-06-01,265899,7,3,10,4,2,4
2023-06-01,268583,3,0,3,3,0,3
2023-06-01,268601,5,1,6,3,1,3
2023-06-01,268586,3,0,3,1,0,1
2023-06-01,266141,4,0,4,3,0,3
2023-06-01,268602,7,1,8,3,2,3
2023-06-01,268580,6,1,7,4,1,4
2023-06-01,264567,4,2,6,9,5,10
2023-06-01,268186,5,0,5,4,0,4
2023-06-01,268587,3,1,4,2,1,2
2023-06-01,53196,19,8,27,12,5,12
2023-06-01,267944,1,3,4,1,2,2
2023-06-01,268584,7,7,14,2,2,2
2023-06-01,268588,5,1,6,1,1,1
2023-06-01,267707,5,0,5,2,0,2
2023-06-01,263194,1,1,2,10,2,10
2023-06-01,268590,1,1,2,1,1,1
2023-06-01,268592,7,1,8,4,2,5
2023-06-01,268613,3,3,6,1,1,1
2023-06-01,266374,1,3,4,5,4,6
2023-06-01,268585,3,1,4,5,1,5
2023-06-01,264250,5,1,6,2,4,5
2023-06-01,267695,3,0,3,2,0,2
2023-06-01,268604,1,1,2,1,1,1
2023-06-01,268621,1,1,2,1,1,1
2023-06-01,268635,4,0,4,2,0,2
2023-06-01,268622,1,2,3,1,3,3
2023-06-01,268596,4,6,10,4,3,4
2023-06-01,266513,5,1,6,4,2,4
2023-06-01,268597,3,1,4,3,2,3
2023-06-01,271587,7,7,14,7,5,7
2023-06-01,271606,7,3,10,1,1,1
2023-06-01,269299,6,7,13,6,5,6
2023-06-01,268598,7,7,14,1,1,1
2023-06-01,266440,3,1,4,5,1,5
2023-06-01,268599,6,0,6,2,0,2
2023-06-01,268605,7,7,14,8,4,8
2023-06-01,268606,5,13,18,5,4,5
2023-06-01,268690,1,1,2,1,2,2
2023-06-01,268607,2,1,3,6,3,6
2023-06-01,52941,21,16,37,23,13,23
2023-06-01,268608,5,1,6,4,2,4
2023-06-01,268609,6,4,10,4,3,4
2023-06-01,268610,6,0,6,4,0,4
2023-06-01,263541,7,12,19,14,8,16
2023-06-01,268685,4,0,4,3,0,3
2023-06-01,28216,7,5,12,5,3,5
2023-06-01,53005,11,4,15,17,13,18
2023-06-01,268611,5,3,8,4,4,4
2023-06-01,28198,370,17,387,22,17,26
2023-06-01,263252,8,8,16,11,6,11
2023-06-01,268669,3,1,4,2,2,2
2023-06-01,268630,3,1,4,2,1,2
2023-06-01,262572,11,1,12,10,5,10
2023-06-01,270173,1,0,1,2,2,2
2023-06-01,268614,1,0,1,2,0,2
2023-06-01,268615,1,0,1,1,0,1
2023-06-01,268623,7,5,12,9,7,9
2023-06-01,263433,7,4,11,13,11,13
2023-06-01,268616,3,5,8,1,1,1
2023-06-01,262365,7,3,10,17,14,17
2023-06-01,268659,6,17,23,13,14,15
2023-06-01,268617,5,3,8,3,3,4
2023-06-01,269056,3,1,4,3,3,3
2023-06-01,265556,3,0,3,2,0,2
2023-06-01,263934,7,3,10,12,5,12
2023-06-01,263434,1,3,4,8,7,10
2023-06-01,270966,1,0,1,4,0,4
2023-06-01,268707,4,8,12,10,6,12
2023-06-01,268625,7,3,10,3,2,3
2023-06-01,61704,7,6,13,10,10,12
2023-06-01,268631,5,1,6,1,1,1
2023-06-01,267713,4,1,5,1,1,1
2023-06-01,271701,3,3,6,8,3,8
2023-06-01,268619,3,7,10,5,5,6
2023-06-01,268632,3,7,10,1,1,1
2023-06-01,268626,3,1,4,2,1,2
2023-06-01,268627,1,1,2,1,1,1
2023-06-01,268645,5,4,9,7,5,7
2023-06-01,268636,4,3,7,4,2,4
2023-06-01,266630,3,3,6,14,5,14
2023-06-01,268633,3,6,9,10,9,10
2023-06-01,267442,7,3,10,5,3,5
2023-06-01,264144,25,2,27,29,22,32
2023-06-01,268628,6,1,7,10,3,10
2023-06-01,26414,1,3,4,2,1,2
2023-06-01,61794,10,4,14,3,3,3
2023-06-01,268646,5,1,6,1,1,1
2023-06-01,268640,3,0,3,4,2,5
2023-06-01,263840,2,0,2,3,0,3
2023-06-01,268642,3,5,8,1,1,1
2023-06-01,272174,1,1,2,4,2,4
2023-06-01,267703,1,1,2,2,2,2
2023-06-01,267709,1,0,1,1,0,1
2023-06-01,268637,7,1,8,6,2,7
2023-06-01,268641,4,1,5,2,1,2
2023-06-01,268653,4,1,5,2,3,3
2023-06-01,268668,7,14,21,5,4,6
2023-06-01,265937,7,2,9,21,11,22
2023-06-01,268638,3,1,4,2,2,2
2023-06-01,264774,2,0,2,3,0,3
2023-06-01,268643,5,5,10,2,1,2
2023-06-01,52527,14,19,33,11,10,13
2023-06-01,265559,3,0,3,6,0,6
2023-06-01,268647,3,1,4,6,5,7
2023-06-01,268648,1,1,2,3,3,3
2023-06-01,268650,4,1,5,2,2,2
2023-06-01,268649,1,1,2,1,1,1
2023-06-01,268665,7,3,10,6,4,6
2023-06-01,268654,5,1,6,2,1,2
2023-06-01,268651,4,0,4,2,0,2
2023-06-01,268663,1,5,6,1,1,1
2023-06-01,268667,3,7,10,2,1,2
2023-06-01,263456,5,5,10,20,7,22
2023-06-01,263665,6,3,9,2,1,2
2023-06-01,264493,1,0,1,3,0,3
2023-06-01,268652,1,0,1,1,0,1
2023-06-01,268664,2,1,3,4,2,6
2023-06-01,268655,5,1,6,4,4,4
2023-06-01,264531,1,3,4,14,14,16
2023-06-01,268656,3,1,4,2,2,2
2023-06-01,267710,4,1,5,1,1,1
2023-06-01,267714,1,0,1,1,0,1
2023-06-01,28169,20,3,23,13,6,13
2023-06-01,268657,3,2,5,3,1,3
2023-06-01,272541,1,1,2,3,2,3
2023-06-01,267723,1,0,1,1,0,1
2023-06-01,268666,2,0,2,2,0,2
2023-06-01,262642,26,9,35,6,7,7
2023-06-01,270413,8,1,9,4,1,4
2023-06-01,52657,17,17,34,11,2,11
2023-06-01,267954,7,0,7,1,0,1
2023-06-01,268658,7,1,8,1,2,3
2023-06-01,262869,5,3,8,7,5,7
2023-06-01,268679,4,1,5,3,1,3
2023-06-01,262565,11,1,12,5,2,5
2023-06-01,28309,41,2,43,12,9,13
2023-06-01,268660,1,1,2,1,1,1
2023-06-01,268661,5,5,10,5,3,5
2023-06-01,268671,2,1,3,5,3,6
2023-06-01,266192,8,3,11,12,6,12
2023-06-01,270358,5,6,11,7,8,8
2023-06-01,270316,1,1,2,3,3,4
2023-06-01,268672,1,2,3,1,2,2
2023-06-01,268681,1,1,2,1,1,1
2023-06-01,268674,1,1,2,3,1,3
2023-06-01,268675,5,3,8,2,1,2
2023-06-01,268673,7,1,8,2,1,2
2023-06-01,267345,5,1,6,13,7,13
2023-06-01,268686,5,6,11,2,1,2
2023-06-01,267734,3,0,3,2,0,2
2023-06-01,269098,6,2,8,2,2,3
2023-06-01,52908,14,7,21,8,3,8
2023-06-01,268699,6,0,6,5,0,5
2023-06-01,268700,3,1,4,1,1,1
2023-06-01,265080,7,3,10,20,15,21
2023-06-01,262899,5,1,6,1,1,1
2023-06-01,268676,4,3,7,5,4,5
2023-06-01,268677,1,1,2,1,1,1
2023-06-01,268682,1,1,2,1,1,1
2023-06-01,265175,68,22,90,13,15,19
2023-06-01,268693,3,1,4,3,1,3
2023-06-01,61817,3,1,4,15,7,15
2023-06-01,265232,5,2,7,7,6,7
2023-06-01,271263,1,1,2,2,2,3
2023-06-01,267961,4,2,6,7,2,7
2023-06-01,263047,24,13,37,35,21,38
2023-06-01,264959,7,1,8,6,3,8
2023-06-01,268683,3,2,5,5,3,5
2023-06-01,263877,5,1,6,21,9,22
2023-06-01,265703,9,2,11,8,1,8
2023-06-01,267717,2,0,2,1,0,1
2023-06-01,268684,7,5,12,4,5,5
2023-06-01,263067,7,4,11,7,3,8
2023-06-01,271582,7,6,13,1,1,1
2023-06-01,270664,3,1,4,9,7,9
2023-06-01,265137,3,1,4,7,5,7
2023-06-01,268695,4,3,7,3,3,3
2023-06-01,268688,3,0,3,1,0,1
2023-06-01,53202,24,2,26,15,12,15
2023-06-01,267937,3,3,6,1,1,1
2023-06-01,267938,2,1,3,3,1,3
2023-06-01,269311,1,13,14,15,10,18
2023-06-01,269201,5,3,8,7,5,8
2023-06-01,267373,3,7,10,4,1,4
2023-06-01,268692,3,1,4,3,1,4
2023-06-01,265463,6,7,13,11,4,11
2023-06-01,267939,7,0,7,1,0,1
2023-06-01,271281,6,0,6,3,0,3
2023-06-01,267940,5,0,5,4,0,4
2023-06-01,267933,3,3,6,1,1,1
2023-06-01,61923,13,2,15,13,9,14
2023-06-01,262405,5,1,6,3,1,3
2023-06-01,11242,2,3,5,17,14,17
2023-06-01,268005,1,1,2,1,1,1
2023-06-01,263102,5,1,6,3,1,3
2023-06-01,267980,3,0,3,3,0,3
2023-06-01,268697,3,5,8,6,3,6
2023-06-01,263311,7,7,14,9,8,9
2023-06-01,262753,71,3,74,11,6,11
2023-06-01,264452,1,2,3,2,4,4
2023-06-01,267934,1,1,2,1,3,3
2023-06-01,267941,2,1,3,1,1,1
2023-06-01,267942,5,1,6,17,10,22
2023-06-01,268124,4,1,5,1,1,1
2023-06-01,264105,1,1,2,1,1,1
2023-06-01,263025,5,1,6,25,19,26
2023-06-01,267943,5,16,21,2,1,2
2023-06-01,265291,4,1,5,1,1,1
2023-06-01,265383,6,10,16,5,5,5
2023-06-01,267951,7,7,14,4,3,4
2023-06-01,268007,7,0,7,2,0,2
2023-06-01,267935,4,1,5,6,3,6
2023-06-01,265949,1,5,6,16,7,16
2023-06-01,267952,7,2,9,1,1,1
2023-06-01,267936,3,2,5,3,2,3
2023-06-01,264998,2,1,3,12,9,13
2023-06-01,264173,1,1,2,1,1,1
2023-06-01,262734,16,3,19,11,10,12
2023-06-01,267945,3,0,3,1,0,1
2023-06-01,267946,7,1,8,2,1,2
2023-06-01,267953,5,4,9,7,4,7
2023-06-01,264369,3,1,4,4,1,4
2023-06-01,267719,1,0,1,2,0,2
2023-06-01,52507,3,1,4,4,1,4
2023-06-01,267731,3,0,3,2,0,2
2023-06-01,268014,1,1,2,2,2,2
2023-06-01,28271,10,3,13,14,9,15
2023-06-01,263292,5,13,18,6,4,6
2023-06-01,267947,2,1,3,1,1,1
2023-06-01,267960,7,1,8,1,1,1
2023-06-01,267959,5,1,6,3,1,3
2023-06-01,263260,18,1,19,10,9,13
2023-06-01,28546,24,1,25,7,1,7
2023-06-01,267409,10,3,13,6,1,6
2023-06-01,267956,5,1,6,7,3,7
2023-06-01,267976,1,1,2,1,1,1
2023-06-01,267957,4,5,9,3,3,5
2023-06-01,267970,1,1,2,1,1,1
2023-06-01,267962,1,1,2,1,2,2
2023-06-01,267949,1,0,1,2,0,2
2023-06-01,267724,5,0,5,2,0,2
2023-06-01,267963,5,1,6,7,2,7
2023-06-01,269444,2,1,3,8,3,10
2023-06-01,262901,6,1,7,13,6,14
2023-06-01,267964,1,1,2,1,1,1
2023-06-01,267978,5,0,5,1,0,1
2023-06-01,267985,5,0,5,3,0,3
2023-06-01,264075,13,2,15,3,3,4
2023-06-01,267979,5,1,6,5,1,5
2023-06-01,266441,4,2,6,2,2,3
2023-06-01,268032,1,1,2,1,1,1
2023-06-01,267730,3,0,3,2,0,2
2023-06-01,267986,3,1,4,4,1,4
2023-06-01,267965,6,1,7,3,2,3
2023-06-01,269580,7,4,11,4,2,4
2023-06-01,267987,3,3,6,4,1,4
2023-06-01,266236,1,1,2,7,7,8
2023-06-01,267966,3,0,3,1,0,1
2023-06-01,267988,5,1,6,3,4,4
2023-06-01,268033,11,3,14,3,2,3
2023-06-01,264927,7,3,10,6,4,6
2023-06-01,267969,3,1,4,2,1,2
2023-06-01,262913,37,9,46,6,2,6
2023-06-01,267971,4,0,4,5,0,5
2023-06-01,265650,2,0,2,1,0,1
2023-06-01,268002,1,1,2,1,1,1
2023-06-01,264479,4,3,7,7,10,10
2023-06-01,267981,3,1,4,1,1,1
2023-06-01,267974,6,1,7,7,2,7
2023-06-01,266457,3,3,6,5,3,5
2023-06-01,262812,21,2,23,10,9,12
2023-06-01,271653,3,1,4,2,3,3
2023-06-01,268025,2,1,3,1,1,1
2023-06-01,262764,15,1,16,7,3,7
2023-06-01,268020,7,0,7,1,0,1
2023-06-01,268015,1,0,1,3,0,3
2023-06-01,267744,1,0,1,2,0,2
2023-06-01,267759,1,0,1,1,0,1
2023-06-01,264012,2,0,2,2,0,2
2023-06-01,267721,4,0,4,2,0,2
2023-06-01,267728,3,1,4,2,1,2
2023-06-01,267982,5,1,6,3,2,4
2023-06-01,263011,11,3,14,8,1,8
2023-06-01,267990,5,0,5,2,0,2
2023-06-01,262404,6,9,15,7,6,7
2023-06-01,267983,1,17,18,2,2,2
2023-06-01,267984,1,1,2,1,1,1
2023-06-01,268050,4,2,6,2,2,3
2023-06-01,267995,3,2,5,6,4,7
2023-06-01,267991,4,17,21,2,1,2
2023-06-01,22381,68,1,69,58,24,61
2023-06-01,267994,7,1,8,6,3,6
2023-06-01,262569,7,4,11,5,1,5
2023-06-01,268053,3,0,3,1,0,1
2023-06-01,268006,6,1,7,6,2,6
2023-06-01,267992,3,17,20,3,2,3
2023-06-01,268004,1,1,2,1,1,1
2023-06-01,267997,5,0,5,1,0,1
2023-06-01,268038,5,1,6,1,2,2
2023-06-01,267996,5,0,5,1,0,1
2023-06-01,263687,7,0,7,6,0,6
2023-06-01,272006,4,0,4,5,0,5
2023-06-01,267735,1,0,1,1,0,1
2023-06-01,267366,6,2,8,5,3,5
2023-06-01,267998,1,0,1,1,0,1
2023-06-01,268003,2,2,4,1,1,1
2023-06-01,268054,1,1,2,4,3,4
2023-06-01,267999,7,5,12,9,3,9
2023-06-01,52739,2,1,3,11,8,12
2023-06-01,264589,12,8,20,9,9,13
2023-06-01,265562,5,1,6,2,1,2
2023-06-01,268049,1,0,1,1,0,1
2023-06-01,267732,1,0,1,2,0,2
2023-06-01,267751,1,0,1,1,0,1
2023-06-01,268070,3,0,3,1,0,1
2023-06-01,268010,7,7,14,1,1,1
2023-06-01,268074,5,1,6,4,1,5
2023-06-01,267636,3,2,5,4,2,4
2023-06-01,28153,47,5,52,7,5,8
2023-06-01,268067,5,0,5,1,0,1
2023-06-01,268011,7,2,9,5,3,5
2023-06-01,52838,15,3,18,13,6,13
2023-06-01,268012,2,0,2,2,0,2
2023-06-01,61895,9,1,10,9,5,11
2023-06-01,268016,2,0,2,1,0,1
2023-06-01,268013,7,3,10,8,6,8
2023-06-01,268041,4,3,7,6,2,6
2023-06-01,27693,14,1,15,35,21,37
2023-06-01,270442,3,2,5,6,2,6
2023-06-01,271145,3,3,6,23,18,25
2023-06-01,268017,5,1,6,3,1,3
2023-06-01,264991,7,1,8,8,4,8
2023-06-01,267738,2,0,2,2,0,2
2023-06-01,267059,5,1,6,8,5,8
2023-06-01,265406,7,3,10,4,3,4
2023-06-01,268034,7,0,7,2,0,2
2023-06-01,263129,3,3,6,7,8,8
2023-06-01,265553,2,4,6,1,1,1
2023-06-01,262318,37,7,44,14,8,14
2023-06-01,268021,1,1,2,1,1,1
2023-06-01,268042,10,3,13,9,3,10
2023-06-01,268019,5,2,7,3,3,3
2023-06-01,262282,8,5,13,6,5,6
2023-06-01,268046,1,1,2,2,2,2
2023-06-01,267733,4,0,4,2,0,2
2023-06-01,263785,7,1,8,3,1,3
2023-06-01,267993,7,1,8,4,3,4
2023-06-01,266423,3,6,9,9,7,9
2023-06-01,266315,5,1,6,7,4,7
2023-06-01,268008,5,0,5,1,0,1
2023-06-01,271427,7,1,8,4,1,5
2023-06-01,268009,7,17,24,3,1,3
2023-06-01,267729,4,0,4,4,0,4
2023-06-01,268104,1,0,1,1,0,1
2023-06-01,267747,4,0,4,2,0,2
2023-06-01,266380,5,1,6,5,3,5
2023-06-01,268066,5,1,6,1,1,1
2023-06-01,61596,2,2,4,1,1,1
2023-06-01,268058,2,0,2,1,0,1
2023-06-01,268119,3,2,5,1,1,1
2023-06-01,273756,1,2,3,1,1,1
2023-06-01,272929,1,1,2,1,1,1
2023-06-01,267788,9,3,12,5,3,5
2023-06-01,28438,58,12,70,26,8,26
2023-06-01,265565,3,0,3,2,0,2
2023-06-01,268022,2,0,2,1,0,1
2023-06-01,268047,4,7,11,4,3,4
2023-06-01,268829,3,3,6,8,5,8
2023-06-01,52974,100,13,113,33,21,33
2023-06-01,268023,5,0,5,1,0,1
2023-06-01,268035,2,3,5,3,2,3
2023-06-01,268026,3,3,6,1,1,1
2023-06-01,271023,3,1,4,10,9,11
2023-06-01,268051,3,3,6,1,1,1
2023-06-01,268036,3,0,3,1,0,1
2023-06-01,268052,1,0,1,1,0,1
2023-06-01,268048,2,1,3,2,1,2
2023-06-01,268027,1,1,2,1,1,1
2023-06-01,268028,7,1,8,6,1,6
2023-06-01,268024,7,1,8,2,2,2
2023-06-01,268037,6,3,9,3,3,4
2023-06-01,263535,21,1,22,7,1,7
2023-06-01,268030,5,0,5,2,0,2
2023-06-01,268031,3,1,4,3,2,3
2023-06-01,267669,3,2,5,4,2,4
2023-06-01,264872,20,15,35,9,9,11
2023-06-01,268138,7,7,14,5,3,5
2023-06-01,61466,12,0,12,2,0,2
2023-06-01,263997,7,3,10,4,4,4
2023-06-01,268081,4,3,7,3,2,3
2023-06-01,265192,4,2,6,7,3,7
2023-06-01,270441,5,7,12,4,3,4
2023-06-01,268039,6,0,6,2,0,2
2023-06-01,267741,2,0,2,1,0,1
2023-06-01,268073,1,0,1,1,0,1
2023-06-01,268043,7,1,8,4,1,4
2023-06-01,268056,2,3,5,2,2,2
2023-06-01,268040,4,17,21,1,1,1
2023-06-01,268044,3,9,12,1,1,1
2023-06-01,266215,7,5,12,5,4,5
2023-06-01,268088,7,1,8,1,1,1
2023-06-01,268057,2,1,3,4,1,4
2023-06-01,264496,25,4,29,9,6,9
2023-06-01,268055,3,0,3,4,0,4
2023-06-01,268059,6,0,6,2,0,2
2023-06-01,271556,7,1,8,2,1,2
2023-06-01,268060,3,0,3,1,0,1
2023-06-01,268063,3,2,5,1,1,1
2023-06-01,268109,1,3,4,1,2,2
2023-06-01,268105,3,0,3,2,0,2
2023-06-01,272691,1,1,2,4,1,4
2023-06-01,268061,7,3,10,3,2,3
2023-06-01,267464,3,3,6,10,8,10
2023-06-01,268062,3,3,6,2,2,2
2023-06-01,2716,18,3,21,18,8,18
2023-06-01,268118,4,1,5,1,1,1
2023-06-01,268758,5,0,5,1,0,1
2023-06-01,268069,3,3,6,8,8,8
2023-06-01,263500,23,2,25,12,5,12
2023-06-01,268101,5,1,6,2,2,3
2023-06-01,268064,7,0,7,2,0,2
2023-06-01,268065,7,7,14,2,2,2
2023-06-01,266416,4,8,12,8,6,9
2023-06-01,52262,34,1,35,4,3,4
2023-06-01,23383,151,1,152,3,1,3
2023-06-01,267737,2,0,2,2,0,2
2023-06-01,265641,6,1,7,4,2,4
2023-06-01,269876,3,1,4,1,1,1
2023-06-01,268078,3,1,4,2,1,2
2023-06-01,268068,3,3,6,2,3,3
2023-06-01,264993,4,1,5,4,4,5
2023-06-01,268089,7,1,8,1,1,1
2023-06-01,268144,6,8,14,1,1,1
2023-06-01,268083,6,1,7,4,3,4
2023-06-01,268110,1,1,2,1,1,1
2023-06-01,267763,4,0,4,1,0,1
2023-06-01,268075,2,0,2,1,0,1
2023-06-01,268092,6,3,9,4,4,4
2023-06-01,268072,7,0,7,6,0,6
2023-06-01,270393,3,1,4,7,2,7
2023-06-01,265475,10,10,20,9,4,9
2023-06-01,28394,16,5,21,7,3,7
2023-06-01,40731,3,0,3,6,0,6
2023-06-01,61858,7,3,10,5,2,6
2023-06-01,268094,7,0,7,1,0,1
2023-06-01,268084,1,1,2,1,1,1
2023-06-01,268085,3,3,6,8,3,8
2023-06-01,268086,7,0,7,1,0,1
2023-06-01,268079,1,0,1,1,0,1
2023-06-01,268080,1,1,2,2,2,2
2023-06-01,268076,4,1,5,5,4,5
2023-06-01,264448,1,1,2,2,2,2
2023-06-01,268090,1,0,1,1,0,1
2023-06-01,268087,5,1,6,4,2,4
2023-06-01,269258,2,1,3,6,5,6
2023-06-01,272588,1,1,2,3,1,3
2023-06-01,272741,0,1,1,5,3,6
2023-06-01,266177,7,1,8,7,6,7
2023-06-01,268082,1,1,2,1,1,1
2023-06-01,268091,2,0,2,4,0,4
2023-06-01,263869,5,3,8,7,4,7
2023-06-01,268093,5,1,6,2,2,2
2023-06-01,263263,13,3,16,6,3,6
2023-06-01,268113,4,7,11,3,1,3
2023-06-01,267742,1,0,1,1,0,1
2023-06-01,268096,5,1,6,1,1,1
2023-06-01,264349,6,9,15,6,5,6
2023-06-01,268097,3,3,6,1,1,1
2023-06-01,268128,7,0,7,7,0,7
2023-06-01,27978,1,0,1,7,4,7
2023-06-01,6429,108,2,110,21,2,21
2023-06-01,267753,2,0,2,2,0,2
2023-06-01,268120,6,0,6,3,0,3
2023-06-01,267743,10,0,10,2,0,2
2023-06-01,262210,68,4,72,12,7,12
2023-06-01,268098,6,1,7,2,1,2
2023-06-01,268129,4,0,4,3,0,3
2023-06-01,268095,1,0,1,3,0,3
2023-06-01,268150,3,2,5,2,2,2
2023-06-01,268103,5,2,7,3,2,3
2023-06-01,264949,7,3,10,13,12,14
2023-06-01,268100,6,3,9,6,4,6
2023-06-01,268099,1,0,1,1,0,1
2023-06-01,268102,1,0,1,1,0,1
2023-06-01,267790,2,0,2,1,0,1
2023-06-01,64114,14,39,53,7,7,10
2023-06-01,267764,1,0,1,1,0,1
2023-06-01,268106,3,3,6,6,5,8
2023-06-01,267767,5,1,6,1,2,2
2023-06-01,268107,2,1,3,2,1,2
2023-06-01,268112,3,3,6,2,2,2
2023-06-01,265311,7,5,12,7,8,8
2023-06-01,61944,3,7,10,7,7,7
2023-06-01,268108,3,3,6,4,3,6
2023-06-01,263509,10,0,10,6,0,6
2023-06-01,28125,12,3,15,6,6,7
2023-06-01,268114,5,1,6,2,1,2
2023-06-01,52660,11,3,14,12,5,12
2023-06-01,268115,7,0,7,1,0,1
2023-06-01,268117,1,1,2,5,3,5
2023-06-01,61855,3,2,5,4,2,4
2023-06-01,53245,8,2,10,8,5,10
2023-06-01,267811,5,0,5,2,0,2
2023-06-01,264825,14,1,15,2,1,2
2023-06-01,267746,5,0,5,1,0,1
2023-06-01,268111,3,1,4,4,2,4
2023-06-01,268116,2,0,2,1,0,1
2023-06-01,268178,1,0,1,1,0,1
2023-06-01,266771,6,0,6,5,0,5
2023-06-01,267745,1,0,1,1,0,1
2023-06-01,52308,95,0,95,20,2,20
2023-06-01,267762,4,0,4,1,0,1
2023-06-01,268701,6,1,7,3,1,3
2023-06-01,265130,6,36,42,27,19,30
2023-06-01,264984,16,10,26,21,19,21
2023-06-01,268147,3,1,4,2,2,2
2023-06-01,28173,61,21,82,25,23,28
2023-06-01,268122,2,1,3,1,1,1
2023-06-01,268131,7,7,14,8,6,8
2023-06-01,52471,48,22,70,1,1,1
2023-06-01,268132,3,0,3,1,0,1
2023-06-01,271067,7,1,8,5,4,5
2023-06-01,268137,7,5,12,1,1,1
2023-06-01,271502,5,3,8,6,5,7
2023-06-01,267062,6,7,13,8,4,8
2023-06-01,268123,5,7,12,3,3,3
2023-06-01,268130,2,1,3,1,1,1
2023-06-01,268125,4,1,5,4,3,4
2023-06-01,268139,2,0,2,1,0,1
2023-06-01,268140,5,1,6,2,2,2
2023-06-01,268126,3,3,6,10,7,10
2023-06-01,61609,0,1,1,6,7,8
2023-06-01,268127,1,1,2,3,2,3
2023-06-01,263114,32,0,32,3,0,3
2023-06-01,265567,4,0,4,1,0,1
2023-06-01,268134,6,1,7,5,2,5
2023-06-01,267760,2,0,2,2,0,2
2023-06-01,267793,1,0,1,1,0,1
2023-06-01,267772,3,0,3,2,0,2
2023-06-01,13489,42,28,70,26,25,41
2023-06-01,268146,2,1,3,5,3,5
2023-06-01,268141,5,0,5,2,2,3
2023-06-01,268135,7,3,10,3,1,3
2023-06-01,267056,4,1,5,20,9,20
2023-06-01,267750,6,1,7,2,1,2
2023-06-01,61582,10,5,15,14,6,14
2023-06-01,268145,7,7,14,5,3,5
2023-06-01,268136,3,1,4,1,1,1
2023-06-01,268713,3,1,4,3,1,3
2023-06-01,267752,5,0,5,2,0,2
2023-06-01,267761,4,0,4,1,0,1
2023-06-01,271329,3,1,4,3,1,3
2023-06-01,267756,5,18,23,2,2,2
2023-06-01,268718,6,1,7,3,1,3
2023-06-01,53121,26,4,30,11,8,14
2023-06-01,271076,5,2,7,7,3,7
2023-06-01,268148,1,0,1,1,0,1
2023-06-01,262827,31,5,36,2,3,3
2023-06-01,268142,1,3,4,1,1,1
2023-06-01,268152,2,0,2,2,0,2
2023-06-01,268143,4,1,5,3,1,3
2023-06-01,268153,3,1,4,3,2,3
2023-06-01,263324,2,3,5,17,13,19
2023-06-01,268151,2,0,2,1,0,1
2023-06-01,28210,37,6,43,19,14,20
2023-06-01,262785,31,9,40,16,9,16
2023-06-01,268719,7,0,7,1,0,1
2023-06-01,268720,3,1,4,4,2,4
2023-06-01,268156,3,3,6,4,2,4
2023-06-01,265290,4,6,10,19,12,19
2023-06-01,268149,5,1,6,1,1,1
2023-06-01,268157,3,1,4,5,4,7
2023-06-01,267758,5,0,5,2,0,2
2023-06-01,263750,10,2,12,2,1,2
2023-06-01,267783,3,0,3,4,0,4
2023-06-01,268158,4,1,5,2,1,2
2023-06-01,263879,3,8,11,4,1,4
2023-06-01,265201,1,1,2,7,7,7
2023-06-01,268159,1,1,2,1,1,1
2023-06-01,268154,7,4,11,2,1,2
2023-06-01,267755,4,4,8,2,2,2
2023-06-01,268162,7,7,14,5,2,5
2023-06-01,265086,7,3,10,10,5,10
2023-06-01,268160,7,7,14,3,2,3
2023-06-01,268702,5,1,6,1,1,1
2023-06-01,269524,7,3,10,10,9,10
2023-06-01,268155,7,3,10,1,1,1
2023-06-01,264215,7,1,8,18,15,22
2023-06-01,268163,2,0,2,2,0,2
2023-06-01,269338,5,5,10,8,6,8
2023-06-01,268161,4,0,4,1,0,1
2023-06-01,268165,1,0,1,1,0,1
2023-06-01,268164,7,0,7,1,0,1
2023-06-01,268169,4,6,10,2,2,2
2023-06-01,28338,25,1,26,19,10,20
2023-06-01,269506,5,2,7,8,6,9
2023-06-01,268166,1,1,2,3,3,3
2023-06-01,267766,1,1,2,1,1,1
2023-06-01,268179,1,1,2,1,1,1
2023-06-01,268171,7,0,7,6,0,6
2023-06-01,22177,34,1,35,10,5,11
2023-06-01,268172,7,2,9,2,2,2
2023-06-01,268185,3,3,6,1,1,1
2023-06-01,268170,3,3,6,1,1,1
2023-06-01,267771,3,0,3,1,0,1
2023-06-01,61750,10,3,13,4,2,4
2023-06-01,268173,7,3,10,4,1,4
2023-06-01,263327,8,38,46,31,23,33
2023-06-01,268174,4,2,6,4,1,4
2023-06-01,267797,19,20,39,7,5,7
2023-06-01,268710,3,3,6,6,4,6
2023-06-01,267768,2,0,2,1,0,1
2023-06-01,262204,9,0,9,3,0,3
2023-06-01,268182,5,2,7,6,3,7
2023-06-01,272688,0,1,1,4,2,4
2023-06-01,267769,1,0,1,1,0,1
2023-06-01,139235,3,1,4,1,1,1
2023-06-01,268180,3,0,3,1,0,1
2023-06-01,269661,3,3,6,20,15,23
2023-06-01,268175,7,6,13,4,5,6
2023-06-01,268176,3,1,4,2,2,2
2023-06-01,265043,2,9,11,8,3,9
2023-06-01,268177,4,1,5,5,2,5
2023-06-01,268181,5,1,6,3,1,3
2023-06-01,268812,3,0,3,2,0,2
2023-06-01,268183,7,3,10,5,2,5
2023-06-01,268184,1,1,2,1,1,1
2023-06-01,264679,4,0,4,3,0,3
2023-06-01,268747,7,1,8,1,1,1
2023-06-01,268766,3,1,4,2,2,2
2023-06-01,268708,4,1,5,4,3,5
2023-06-01,268827,1,1,2,1,1,1
2023-06-01,61613,7,7,14,1,1,1
2023-06-01,268188,5,0,5,3,0,3
2023-06-01,268703,5,0,5,2,0,2
2023-06-01,265571,1,0,1,3,0,3
2023-06-01,263527,4,1,5,8,3,8
2023-06-01,272226,1,0,1,2,0,2
2023-06-01,264856,6,0,6,1,0,1
2023-06-01,271776,2,0,2,1,0,1
2023-06-01,268717,7,0,7,2,0,2
2023-06-01,61929,4,1,5,4,2,4
2023-06-01,268704,7,3,10,3,3,3
2023-06-01,268705,3,1,4,1,1,1
2023-06-01,268712,7,0,7,1,0,1
2023-06-01,268716,1,1,2,5,3,5
2023-06-01,268750,5,1,6,2,1,2
2023-06-01,267778,1,1,2,2,1,2
2023-06-01,268743,1,1,2,1,1,1
2023-06-01,268825,1,0,1,2,0,2
2023-06-01,267475,3,1,4,9,3,9
2023-06-01,269853,7,2,9,2,1,2
2023-06-01,268876,3,7,10,2,4,4
2023-06-01,268711,1,0,1,1,0,1
2023-06-01,268755,4,5,9,4,3,4
2023-06-01,267782,4,2,6,1,1,1
2023-06-01,268714,5,2,7,4,2,4
2023-06-01,263374,5,5,10,10,7,11
2023-06-01,266280,4,8,12,4,4,5
2023-06-01,28590,45,8,53,31,4,32
2023-06-01,272467,0,1,1,2,2,3
2023-06-01,268715,3,3,6,2,2,2
2023-06-01,268761,7,1,8,2,1,2
2023-06-01,268721,7,1,8,5,4,5
2023-06-01,265569,4,0,4,3,0,3
2023-06-01,267787,5,0,5,2,0,2
2023-06-01,267749,8,0,8,5,0,5
2023-06-01,272141,2,0,2,2,0,2
2023-06-01,268722,4,0,4,1,0,1
2023-06-01,268725,6,1,7,1,1,1
2023-06-01,267777,5,1,6,3,1,3
2023-06-01,268726,7,7,14,6,5,6
2023-06-01,266428,7,6,13,17,14,19
2023-06-01,268727,2,0,2,1,0,1
2023-06-01,268745,1,0,1,1,0,1
2023-06-01,268759,1,0,1,2,0,2
2023-06-01,268728,3,1,4,2,2,2
2023-06-01,268730,3,1,4,5,1,5
2023-06-01,27923,5,1,6,2,2,2
2023-06-01,267803,1,1,2,1,1,1
2023-06-01,262611,22,11,33,6,4,6
2023-06-01,268774,7,0,7,2,0,2
2023-06-01,52870,9,1,10,4,1,4
2023-06-01,268735,7,1,8,4,2,4
2023-06-01,268731,4,1,5,1,1,1
2023-06-01,268732,7,7,14,7,5,7
2023-06-01,267776,11,1,12,4,1,4
2023-06-01,267786,5,0,5,1,0,1
2023-06-01,268746,2,5,7,1,1,1
2023-06-01,268741,7,1,8,2,1,2
2023-06-01,268736,1,1,2,1,1,1
2023-06-01,265288,6,2,8,4,3,4
2023-06-01,268733,4,1,5,2,1,2
2023-06-01,272485,1,1,2,1,1,1
2023-06-01,268729,5,3,8,5,4,6
2023-06-01,268737,5,2,7,6,5,6
2023-06-01,267028,3,1,4,3,2,4
2023-06-01,268754,7,0,7,1,0,1
2023-06-01,266732,24,1,25,5,1,5
2023-06-01,267800,3,0,3,1,0,1
2023-06-01,265705,55,68,123,10,9,10
2023-06-01,268779,3,1,4,3,1,3
2023-06-01,264619,3,0,3,3,0,3
2023-06-01,267785,3,0,3,1,0,1
2023-06-01,266214,5,4,9,9,5,9
2023-06-01,268740,1,1,2,1,1,1
2023-06-01,267808,4,0,4,2,0,2
2023-06-01,267779,5,0,5,1,0,1
2023-06-01,268748,5,1,6,1,1,1
2023-06-01,268846,3,0,3,3,0,3
2023-06-01,268749,7,1,8,3,1,4
2023-06-01,268742,7,1,8,3,1,3
2023-06-01,268806,7,0,7,4,0,4
2023-06-01,268762,1,0,1,3,0,3
2023-06-01,268751,3,1,4,4,2,4
2023-06-01,268791,2,7,9,1,1,1
2023-06-01,265234,6,2,8,5,2,5
2023-06-01,268760,4,2,6,4,1,4
2023-06-01,268753,4,1,5,2,2,2
2023-06-01,264552,10,5,15,6,6,7
2023-06-01,265566,4,0,4,2,0,2
2023-06-01,268767,7,1,8,1,1,1
2023-06-01,268768,4,2,6,5,4,5
2023-06-01,262288,12,7,19,17,14,18
2023-06-01,28178,22,1,23,11,8,13
2023-06-01,268763,3,1,4,2,2,2
2023-06-01,265741,2,0,2,1,0,1
2023-06-01,268773,6,0,6,1,0,1
2023-06-01,268764,3,1,4,8,5,8
2023-06-01,268765,5,2,7,2,1,2
2023-06-01,53205,18,2,20,4,1,4
2023-06-01,263346,5,15,20,15,14,17
2023-06-01,268770,3,23,26,1,1,1
2023-06-01,268771,5,0,5,3,0,3
2023-06-01,264800,8,0,8,6,0,6
2023-06-01,265135,1,1,2,10,10,13
2023-06-01,268775,4,0,4,2,0,2
2023-06-01,27847,4,0,4,2,0,2
2023-06-01,52651,28,3,31,3,1,3
2023-06-01,268784,3,1,4,2,1,2
2023-06-01,269454,5,5,10,7,5,8
2023-06-01,268785,3,5,8,1,3,3
2023-06-01,268778,7,3,10,1,1,2
2023-06-01,268786,7,2,9,1,1,1
2023-06-01,268822,5,1,6,1,1,1
2023-06-01,267791,1,0,1,1,0,1
2023-06-01,267810,2,0,2,1,0,1
2023-06-01,268772,7,7,14,6,5,6
2023-06-01,267796,2,2,4,2,2,3
2023-06-01,267792,4,0,4,3,0,3
2023-06-01,27953,133,10,143,12,7,12
2023-06-01,271632,5,3,8,5,3,5
2023-06-01,268795,3,2,5,1,1,1
2023-06-01,268824,7,3,10,5,4,6
2023-06-01,264861,2,1,3,7,2,7
2023-06-01,270735,2,4,6,31,4,33
2023-06-01,268787,2,3,5,5,4,5
2023-06-01,262808,61,8,69,16,11,17
2023-06-01,264100,34,0,34,3,0,3
2023-06-01,268796,2,2,4,1,1,1
2023-06-01,262659,27,2,29,12,4,12
2023-06-01,268794,1,0,1,2,0,2
2023-06-01,267824,2,0,2,1,0,1
2023-06-01,267823,3,0,3,2,0,2
2023-06-01,267830,3,0,3,2,0,2
2023-06-01,262806,28,1,29,8,3,8
2023-06-01,267795,7,0,7,1,0,1
2023-06-01,268800,3,0,3,1,0,1
2023-06-01,268781,4,1,5,1,1,1
2023-06-01,268782,3,3,6,1,1,1
2023-06-01,266413,4,3,7,19,16,20
2023-06-01,268797,5,1,6,3,3,3
2023-06-01,267801,4,0,4,1,0,1
2023-06-01,61451,4,0,4,2,0,2
2023-06-01,267799,2,1,3,2,1,2
2023-06-01,267798,5,0,5,3,0,3
2023-06-01,268792,3,1,4,1,1,1
2023-06-01,272578,1,1,2,1,1,1
2023-06-01,268789,7,1,8,8,4,8
2023-06-01,268808,1,1,2,1,1,1
2023-06-01,268790,4,7,11,4,2,4
2023-06-01,271740,0,1,1,5,4,5
2023-06-01,266995,3,3,6,5,3,5
2023-06-01,267802,1,0,1,2,0,2
2023-06-01,265768,7,0,7,3,0,3
2023-06-01,268826,1,0,1,3,0,3
2023-06-01,28605,10,1,11,13,8,13
2023-06-01,268843,1,8,9,8,7,11
2023-06-01,268958,1,0,1,2,0,2
2023-06-01,268793,3,1,4,7,4,7
2023-06-01,267825,3,0,3,1,0,1
2023-06-01,27729,14,1,15,7,1,7
2023-06-01,264635,8,1,9,4,1,4
2023-06-01,267860,4,0,4,1,0,1
2023-06-01,52373,5,1,6,19,1,19
2023-06-01,264742,4,0,4,2,0,2
2023-06-01,268799,2,1,3,1,1,1
2023-06-01,267807,2,0,2,1,0,1
2023-06-01,263185,15,1,16,10,3,10
2023-06-01,267815,4,1,5,2,1,2
2023-06-01,263994,14,2,16,8,9,10
2023-06-01,268801,4,1,5,4,1,4
2023-06-01,264554,5,0,5,6,0,6
2023-06-01,264332,7,4,11,9,10,13
2023-06-01,268802,7,1,8,3,1,3
2023-06-01,268860,7,1,8,8,3,8
2023-06-01,268819,1,0,1,1,0,1
2023-06-01,268803,3,3,6,4,4,4
2023-06-01,264952,10,1,11,3,3,4
2023-06-01,265270,4,0,4,4,0,4
2023-06-01,268820,1,0,1,1,0,1
2023-06-01,268809,3,3,6,3,2,3
2023-06-01,268804,5,1,6,2,2,2
2023-06-01,264826,5,0,5,1,0,1
2023-06-01,268810,5,1,6,2,1,2
2023-06-01,267818,5,0,5,4,0,4
2023-06-01,263609,5,1,6,12,7,12
2023-06-01,268811,4,1,5,5,1,5
2023-06-01,267826,4,5,9,2,2,2
2023-06-01,268828,3,0,3,3,0,3
2023-06-01,268813,3,3,6,3,2,3
2023-06-01,268814,5,1,6,1,1,1
2023-06-01,268831,5,1,6,3,1,3
2023-06-01,268832,7,0,7,1,0,1
2023-06-01,268815,6,1,7,4,3,5
2023-06-01,268816,7,0,7,1,0,1
2023-06-01,268821,3,1,4,5,3,5
2023-06-01,268830,2,2,4,4,3,4
2023-06-01,268817,9,4,13,9,3,9
2023-06-01,268849,5,0,5,2,0,2
2023-06-01,53048,25,21,46,18,12,19
2023-06-01,268818,7,5,12,7,4,7
2023-06-01,270417,6,7,13,10,8,10
2023-06-01,271506,4,1,5,1,1,1
2023-06-01,267827,2,0,2,2,0,2
2023-06-01,264120,7,3,10,14,12,16
2023-06-01,268823,5,1,6,1,1,1
2023-06-01,61763,7,15,22,10,9,10
2023-06-01,268886,3,1,4,3,2,4
2023-06-01,267831,4,3,7,2,1,2
2023-06-01,267813,1,1,2,1,1,1
2023-06-01,267812,1,0,1,1,0,1
2023-06-01,267828,4,1,5,4,1,4
2023-06-01,268835,7,2,9,5,3,5
2023-06-01,262820,15,0,15,5,0,5
2023-06-01,268833,2,1,3,2,1,2
2023-06-01,272263,1,1,2,1,2,2
2023-06-01,268840,3,3,6,1,1,1
2023-06-01,268845,3,2,5,3,1,3
2023-06-01,267816,1,0,1,1,0,1
2023-06-01,268839,2,1,3,2,2,2
2023-06-01,268847,4,2,6,4,4,4
2023-06-01,268841,4,1,5,3,1,3
2023-06-01,272457,0,1,1,3,2,3
2023-06-01,268914,4,2,6,2,1,2
2023-06-01,268844,1,1,2,4,2,4
2023-06-01,268938,3,3,6,2,1,2
2023-06-01,268915,5,1,6,2,1,2
2023-06-01,268878,3,2,5,7,7,7
2023-06-01,266806,6,1,7,4,1,4
2023-06-01,267817,3,0,3,1,0,1
2023-06-01,268836,5,1,6,3,3,3
2023-06-01,268837,5,1,6,4,2,4
2023-06-01,268838,1,1,2,1,1,1
2023-06-01,268842,7,9,16,4,3,4
2023-06-01,28387,11,5,16,5,3,5
2023-06-01,28428,3,0,3,2,0,2
2023-06-01,267847,5,1,6,2,1,3
2023-06-01,267867,1,0,1,2,0,2
2023-06-01,265572,2,0,2,1,0,1
2023-06-01,265777,1,0,1,7,0,7
2023-06-01,267821,3,0,3,2,0,2
2023-06-01,52375,1,1,2,7,2,7
2023-06-01,11058,0,0,0,17,5,22
2023-06-01,272166,4,0,4,2,0,2
2023-06-01,265577,4,4,8,2,1,2
2023-06-01,28433,4,0,4,3,0,3
2023-06-01,268887,5,3,8,2,2,2
2023-06-01,28434,4,1,5,4,2,4
2023-06-01,265573,7,2,9,3,1,3
2023-06-01,28429,5,1,6,3,1,3
2023-06-01,265568,1,0,1,1,0,1
2023-06-01,268848,3,3,6,2,3,3
2023-06-01,28098,16,0,16,2,0,2
2023-06-01,266724,1,0,1,2,0,2
2023-06-01,265574,4,1,5,3,1,3
2023-06-01,268855,5,1,6,1,1,1
2023-06-01,268862,4,1,5,6,3,6
2023-06-01,268861,5,3,8,3,1,3
2023-06-01,61712,7,1,8,6,6,6
2023-06-01,263573,6,4,10,4,4,5
2023-06-01,268850,1,1,2,1,3,3
2023-06-01,267820,3,0,3,4,0,4
2023-06-01,268865,6,4,10,5,3,5
2023-06-01,268853,7,0,7,2,2,3
2023-06-01,268854,4,4,8,2,2,2
2023-06-01,267829,4,0,4,3,0,3
2023-06-01,268858,6,1,7,4,1,4
2023-06-01,262530,43,17,60,7,5,7
2023-06-01,265579,4,0,4,2,0,2
2023-06-01,265578,1,1,2,1,1,1
2023-06-01,268863,2,0,2,2,0,2
2023-06-01,267865,3,0,3,3,0,3
2023-06-01,268866,3,1,4,3,1,3
2023-06-01,268870,1,1,2,3,1,3
2023-06-01,263400,6,16,22,10,8,11
2023-06-01,268864,3,1,4,3,1,3
2023-06-01,262527,9,1,10,3,3,3
2023-06-01,271599,1,13,14,2,2,2
2023-06-01,265575,10,0,10,5,0,5
2023-06-01,267851,1,0,1,1,0,1
2023-06-01,268877,2,0,2,1,0,1
2023-06-01,268867,3,1,4,2,1,2
2023-06-01,270505,7,2,9,7,3,7
2023-06-01,270593,7,0,7,6,0,6
2023-06-01,268868,4,0,4,3,0,3
2023-06-01,268869,3,3,6,2,2,2
2023-06-01,267842,2,0,2,2,0,2
2023-06-01,267855,2,1,3,1,1,2
2023-06-01,52683,3,1,4,2,1,2
2023-06-01,268908,7,0,7,1,0,1
2023-06-01,268873,3,8,11,1,1,1
2023-06-01,265583,4,1,5,2,1,2
2023-06-01,265581,1,0,1,1,0,1
2023-06-01,265582,3,0,3,1,0,1
2023-06-01,265580,4,1,5,1,1,1
2023-06-01,268871,3,3,6,3,1,3
2023-06-01,268872,5,3,8,5,3,5
2023-06-01,269067,5,1,6,2,1,2
2023-06-01,270340,3,13,16,22,16,24
2023-06-01,268874,7,1,8,2,2,3
2023-06-01,268875,4,9,13,1,1,1
2023-06-01,267832,3,1,4,3,1,3
2023-06-01,267892,1,1,2,2,1,2
2023-06-01,268889,1,1,2,2,1,2
2023-06-01,28308,27,3,30,6,4,6
2023-06-01,268879,3,2,5,1,1,1
2023-06-01,268880,1,1,2,3,3,4
2023-06-01,268881,1,0,1,1,0,1
2023-06-01,268937,7,1,8,2,3,3
2023-06-01,268884,2,6,8,2,1,2
2023-06-01,268882,3,0,3,2,0,2
2023-06-01,268883,3,1,4,3,2,3
2023-06-01,268885,7,0,7,1,0,1
2023-06-01,263686,20,0,20,2,0,2
2023-06-01,267838,1,0,1,2,0,2
2023-06-01,268888,5,1,6,2,2,2
2023-06-01,53080,48,5,53,10,4,10
2023-06-01,265927,7,1,8,4,1,4
2023-06-01,268905,3,1,4,3,2,3
2023-06-01,268892,3,3,6,4,3,4
2023-06-01,268893,2,0,2,1,0,1
2023-06-01,268907,7,6,13,4,4,4
2023-06-01,268900,3,1,4,6,1,6
2023-06-01,263625,6,5,11,11,8,12
2023-06-01,262773,141,24,165,22,17,22
2023-06-01,268901,4,1,5,1,1,1
2023-06-01,266344,6,2,8,3,3,4
2023-06-01,262777,74,5,79,6,2,6
2023-06-01,266519,7,4,11,13,10,14
2023-06-01,268911,4,6,10,5,3,5
2023-06-01,262970,7,1,8,8,5,11
2023-06-01,268896,7,0,7,2,0,2
2023-06-01,268897,6,7,13,8,5,8
2023-06-01,268898,1,0,1,1,0,1
2023-06-01,267850,2,0,2,1,0,1
2023-06-01,265663,6,0,6,3,0,3
2023-06-01,268899,5,7,12,2,1,2
2023-06-01,267878,4,0,4,2,0,2
2023-06-01,267874,5,0,5,2,0,2
2023-06-01,267837,5,1,6,2,1,2
2023-06-01,267835,2,0,2,1,0,1
2023-06-01,267849,2,0,2,2,0,2
2023-06-01,263336,6,1,7,9,2,9
2023-06-01,268916,3,0,3,3,0,3
2023-06-01,52928,36,1,37,9,3,9
2023-06-01,268902,3,0,3,1,0,1
2023-06-01,268917,4,0,4,1,0,1
2023-06-01,53246,25,3,28,5,3,6
2023-06-01,266304,3,1,4,7,4,7
2023-06-01,268903,1,1,2,1,1,1
2023-06-01,52600,5,1,6,9,5,9
2023-06-01,268904,1,1,2,1,1,1
2023-06-01,268323,44,3,47,10,9,11
2023-06-01,268919,1,1,2,3,1,3
2023-06-01,268920,7,7,14,4,3,4
2023-06-01,268909,3,1,4,1,1,1
2023-06-01,268921,7,1,8,3,1,3
2023-06-01,268910,5,0,5,3,0,3
2023-06-01,267840,3,0,3,1,0,1
2023-06-01,268922,4,0,4,1,0,1
2023-06-01,7162,111,8,119,16,10,17
2023-06-01,13878,28,2,30,10,1,10
2023-06-01,268941,12,0,12,6,0,6
2023-06-01,18479,34,0,34,2,0,2
2023-06-01,268912,3,0,3,1,0,1
2023-06-01,268913,7,1,8,5,1,5
2023-06-01,265586,3,3,6,2,2,2
2023-06-01,263566,7,2,9,15,11,15
2023-06-01,268936,5,1,6,1,1,1
2023-06-01,53115,6,5,11,28,25,30
2023-06-01,268923,5,1,6,1,1,1
2023-06-01,265585,3,0,3,3,0,3
2023-06-01,268924,7,3,10,5,4,6
2023-06-01,267856,3,0,3,1,0,1
2023-06-01,265036,3,1,4,17,16,18
2023-06-01,268928,7,1,8,1,1,1
2023-06-01,268926,3,1,4,3,3,3
2023-06-01,267910,4,0,4,4,0,4
2023-06-01,268939,1,1,2,1,1,1
2023-06-01,52795,13,15,28,10,8,10
2023-06-01,268927,4,1,5,2,1,2
2023-06-01,267875,4,0,4,3,0,3
2023-06-01,268968,1,1,2,2,1,2
2023-06-01,268929,1,3,4,2,1,2
2023-06-01,268930,7,6,13,2,2,2
2023-06-01,268974,4,1,5,2,1,2
2023-06-01,268969,1,1,2,1,1,1
2023-06-01,268932,1,1,2,1,1,1
2023-06-01,268935,7,7,14,3,3,3
2023-06-01,268933,2,2,4,3,2,3
2023-06-01,269836,2,0,2,1,0,1
2023-06-01,268934,3,0,3,4,0,4
2023-06-01,268970,5,1,6,3,1,3
2023-06-01,264883,3,3,6,4,3,4
2023-06-01,269011,1,0,1,1,0,1
2023-06-01,267896,2,1,3,1,1,1
2023-06-01,272199,6,2,8,2,1,2
2023-06-01,267864,1,0,1,1,0,1
2023-06-01,268988,7,0,7,2,0,2
2023-06-01,268997,5,1,6,6,4,6
2023-06-01,266160,22,3,25,17,9,18
2023-06-01,52363,23,1,24,11,2,11
2023-06-01,269035,1,1,2,2,1,2
2023-06-01,267859,3,0,3,1,0,1
2023-06-01,269040,1,1,2,4,3,4
2023-06-01,268947,4,0,4,2,0,2
2023-06-01,267852,5,0,5,1,0,1
2023-06-01,268942,4,2,6,2,1,2
2023-06-01,268943,5,1,6,1,1,1
2023-06-01,268944,3,7,10,10,6,11
2023-06-01,268945,7,3,10,6,3,6
2023-06-01,269006,1,0,1,2,0,2
2023-06-01,269007,7,0,7,2,0,2
2023-06-01,268946,3,1,4,1,1,1
2023-06-01,269002,3,7,10,4,3,4
2023-06-01,267894,2,0,2,3,0,3
2023-06-01,53182,22,1,23,8,4,8
2023-06-01,268948,7,2,9,2,2,2
2023-06-01,268965,4,0,4,2,0,2
2023-06-01,262332,10,1,11,2,1,2
2023-06-01,268949,2,2,4,1,1,1
2023-06-01,268950,1,1,2,1,1,1
2023-06-01,271927,1,6,7,1,1,1
2023-06-01,265688,14,1,15,4,1,4
2023-06-01,272812,1,1,2,1,1,2
2023-06-01,267868,1,0,1,1,0,1
2023-06-01,267854,3,0,3,2,0,2
2023-06-01,265215,7,1,8,7,2,7
2023-06-01,268951,6,0,6,2,0,2
2023-06-01,268966,3,1,4,4,1,4
2023-06-01,272769,0,5,5,3,1,4
2023-06-01,268953,5,1,6,1,1,1
2023-06-01,262772,6,1,7,5,4,5
2023-06-01,268972,5,2,7,4,4,4
2023-06-01,268954,7,1,8,4,3,4
2023-06-01,264490,3,2,5,7,4,7
2023-06-01,271753,0,1,1,2,1,2
2023-06-01,267460,0,29,29,11,6,12
2023-06-01,269014,7,0,7,1,0,1
2023-06-01,268955,4,8,12,2,4,4
2023-06-01,268983,4,4,8,8,7,8
2023-06-01,268956,1,1,2,1,1,1
2023-06-01,267869,3,0,3,2,0,2
2023-06-01,270144,1,0,1,1,0,1
2023-06-01,262713,31,10,41,11,6,13
2023-06-01,268957,1,1,2,1,1,1
2023-06-01,268961,3,1,4,3,2,3
2023-06-01,262408,10,1,11,7,4,7
2023-06-01,268977,3,0,3,1,0,1
2023-06-01,267163,6,1,7,5,1,5
2023-06-01,268973,1,0,1,1,0,1
2023-06-01,268962,3,1,4,3,2,3
2023-06-01,268967,3,5,8,4,4,4
2023-06-01,53043,16,5,21,8,7,9
2023-06-01,263518,6,5,11,10,5,10
2023-06-01,268978,3,1,4,1,1,1
2023-06-01,265207,5,3,8,10,7,11
2023-06-01,266213,5,5,10,7,3,8
2023-06-01,267885,2,0,2,1,0,1
2023-06-01,267871,4,0,4,2,0,2
2023-06-01,269010,3,3,6,2,2,2
2023-06-01,266013,4,5,9,10,10,11
2023-06-01,268963,1,1,2,1,1,1
2023-06-01,269236,6,0,6,2,0,2
2023-06-01,264217,7,5,12,11,9,13
2023-06-01,268964,1,1,2,1,1,1
2023-06-01,270134,1,0,1,1,0,1
2023-06-01,269719,3,1,4,8,6,9
2023-06-01,268979,1,0,1,1,0,1
2023-06-01,268971,5,1,6,1,1,1
2023-06-01,272070,2,2,4,2,2,2
2023-06-01,28257,4,1,5,4,1,4
2023-06-01,268975,1,0,1,1,0,1
2023-06-01,269031,3,3,6,6,5,6
2023-06-01,267870,4,1,5,2,1,2
2023-06-01,267921,3,0,3,3,0,3
2023-06-01,267930,1,0,1,2,0,2
2023-06-01,267897,1,0,1,2,0,2
2023-06-01,269033,7,7,14,4,3,4
2023-06-01,267861,1,0,1,1,0,1
2023-06-01,267891,1,0,1,2,0,2
2023-06-01,267863,5,0,5,1,0,1
2023-06-01,268980,4,0,4,2,0,2
2023-06-01,264362,0,0,0,3,2,4
2023-06-01,268991,6,4,10,3,1,3
2023-06-01,268987,3,1,4,1,1,1
2023-06-01,267881,5,1,6,2,2,2
2023-06-01,267895,5,1,6,3,1,3
2023-06-01,268982,3,2,5,6,1,6
2023-06-01,264732,14,1,15,2,2,2
2023-06-01,268998,7,7,14,4,1,4
2023-06-01,268985,3,1,4,10,7,10
2023-06-01,53178,19,3,22,7,2,7
2023-06-01,268992,3,1,4,1,1,1
2023-06-01,269039,7,1,8,6,2,6
2023-06-01,269029,1,0,1,1,0,1
2023-06-01,268989,4,1,5,2,1,2
2023-06-01,269038,6,2,8,2,1,2
2023-06-01,263384,14,3,17,7,7,7
2023-06-01,268993,7,3,10,1,1,1
2023-06-01,263478,14,5,19,13,7,13
2023-06-01,268990,5,0,5,3,0,3
2023-06-01,263563,9,1,10,7,1,7
2023-06-01,269030,3,0,3,1,0,1
2023-06-01,269101,1,0,1,1,0,1
2023-06-01,267889,1,0,1,1,0,1
2023-06-01,267883,4,1,5,1,1,1
2023-06-01,268999,4,4,8,1,1,1
2023-06-01,268995,4,1,5,3,2,3
2023-06-01,52695,2,1,3,8,1,8
2023-06-01,269000,1,0,1,3,0,3
2023-06-01,262851,43,1,44,16,2,16
2023-06-01,269049,3,1,4,2,1,2
2023-06-01,268996,3,3,6,1,1,1
2023-06-01,269072,1,1,2,1,1,1
2023-06-01,269052,3,0,3,3,0,3
2023-06-01,269001,7,0,7,3,0,3
2023-06-01,269050,4,2,6,3,2,3
2023-06-01,269003,3,5,8,1,1,1
2023-06-01,267882,5,1,6,7,1,7
2023-06-01,64122,4,1,5,1,1,1
2023-06-01,267890,4,1,5,1,1,1
2023-06-01,269057,3,1,4,2,2,3
2023-06-01,28154,22,7,29,9,5,9
2023-06-01,269015,7,1,8,6,3,6
2023-06-01,269016,4,1,5,2,1,2
2023-06-01,28657,1,10,11,2,1,2
2023-06-01,269004,3,3,6,4,4,4
2023-06-01,271010,5,1,6,5,1,5
2023-06-01,269005,5,2,7,7,3,7
2023-06-01,267192,4,1,5,9,3,9
2023-06-01,264221,7,20,27,13,10,13
2023-06-01,262887,5,1,6,8,6,9
2023-06-01,269087,2,0,2,1,0,1
2023-06-01,267905,5,1,6,1,1,1
2023-06-01,269776,4,0,4,2,0,2
2023-06-01,269008,5,3,8,4,3,4
2023-06-01,269017,3,1,4,4,1,4
2023-06-01,267822,1,0,1,1,0,1
2023-06-01,265590,5,0,5,3,0,3
2023-06-01,269090,6,6,12,5,5,6
2023-06-01,271578,0,1,1,16,13,18
2023-06-01,271627,4,1,5,3,1,3
2023-06-01,272476,0,1,1,4,3,4
2023-06-01,267918,4,0,4,1,0,1
2023-06-01,6621,340,80,420,39,33,43
2023-06-01,265591,10,9,19,1,1,1
2023-06-01,269032,7,1,8,4,1,4
2023-06-01,267899,1,0,1,2,0,2
2023-06-01,269024,5,3,8,4,2,4
2023-06-01,265126,9,19,28,14,8,14
2023-06-01,269727,1,0,1,1,0,1
2023-06-01,269034,7,1,8,2,1,2
2023-06-01,52960,10,2,12,6,2,7
2023-06-01,269037,1,0,1,2,0,2
2023-06-01,269018,1,1,2,3,3,3
2023-06-01,269019,5,0,5,1,0,1
2023-06-01,269025,5,1,6,3,3,4
2023-06-01,267908,5,0,5,1,0,1
2023-06-01,269021,3,3,6,1,1,1
2023-06-01,270967,5,3,8,6,5,6
2023-06-01,269022,5,9,14,1,1,1
2023-06-01,269023,10,8,18,6,4,6
2023-06-01,269046,1,1,2,2,2,2
2023-06-01,272549,0,3,3,5,4,5
2023-06-01,269027,7,0,7,1,0,1
2023-06-01,269055,1,1,2,2,1,2
2023-06-01,267888,6,0,6,2,0,2
2023-06-01,269041,7,5,12,2,2,2
2023-06-01,269036,5,1,6,7,5,8
2023-06-01,269061,4,2,6,3,1,3
2023-06-01,27690,5,0,5,5,0,5
2023-06-01,269091,1,0,1,1,0,1
2023-06-01,267900,4,0,4,1,0,1
2023-06-01,267898,4,0,4,1,0,1
2023-06-01,269075,7,5,12,7,7,7
2023-06-01,267079,6,9,15,6,6,6
2023-06-01,269028,2,1,3,2,1,2
2023-06-01,269047,5,1,6,5,4,5
2023-06-01,263332,5,3,8,6,5,6
2023-06-01,269111,5,3,8,1,1,1
2023-06-01,269042,3,0,3,2,0,2
2023-06-01,269048,3,3,6,2,2,2
2023-06-01,269054,3,1,4,2,1,2
2023-06-01,264417,7,9,16,7,4,8
2023-06-01,269043,7,2,9,3,1,3
2023-06-01,269044,7,1,8,4,4,6
2023-06-01,269102,5,1,6,1,1,1
2023-06-01,269132,1,0,1,2,0,2
2023-06-01,269045,1,1,2,3,2,3
2023-06-01,53153,41,2,43,19,2,19
2023-06-01,267915,1,0,1,1,0,1
2023-06-01,266498,7,1,8,9,5,9
2023-06-01,269051,7,0,7,2,0,2
2023-06-01,264643,10,0,10,1,0,1
2023-06-01,262420,39,3,42,5,3,5
2023-06-01,269112,3,1,4,1,1,1
2023-06-01,269120,4,0,4,1,0,1
2023-06-01,269058,3,1,4,1,1,1
2023-06-01,27648,16,0,16,3,0,3
2023-06-01,269063,2,1,3,3,3,3
2023-06-01,269064,5,2,7,4,3,4
2023-06-01,269065,5,0,5,3,0,3
2023-06-01,269073,16,1,17,2,1,2
2023-06-01,264920,3,3,6,6,5,6
2023-06-01,269082,3,0,3,1,0,1
2023-06-01,269077,3,3,6,3,2,4
2023-06-01,269060,5,2,7,6,4,6
2023-06-01,269053,3,3,6,4,2,4
2023-06-01,267903,2,0,2,1,0,1
2023-06-01,269066,6,0,6,1,0,1
2023-06-01,53112,15,3,18,7,5,7
2023-06-01,269133,1,1,2,1,1,1
2023-06-01,269086,3,3,6,2,2,2
2023-06-01,269113,4,0,4,1,0,1
2023-06-01,269109,5,7,12,3,1,3
2023-06-01,267912,5,0,5,3,0,3
2023-06-01,269083,1,1,2,1,1,1
2023-06-01,269068,5,1,6,6,2,6
2023-06-01,269069,2,1,3,3,1,3
2023-06-01,263661,20,8,28,13,11,15
2023-06-01,269070,4,4,8,3,3,3
2023-06-01,267913,5,2,7,3,1,3
2023-06-01,269074,4,1,5,2,1,2
2023-06-01,269088,4,3,7,3,2,4
2023-06-01,269129,3,3,6,5,4,5
2023-06-01,269119,7,7,14,1,1,1
2023-06-01,264111,4,7,11,8,6,9
2023-06-01,269076,5,3,8,2,3,3
2023-06-01,269084,4,8,12,5,4,5
2023-06-01,269078,7,0,7,2,0,2
2023-06-01,269079,4,1,5,2,1,2
2023-06-01,269080,4,0,4,3,0,3
2023-06-01,267916,5,10,15,2,1,2
2023-06-01,269089,3,1,4,5,2,5
2023-06-01,269107,3,1,4,1,1,1
2023-06-01,267914,1,1,2,1,1,1
2023-06-01,61633,7,4,11,14,8,15
2023-06-01,269097,5,3,8,2,2,2
2023-06-01,269743,2,1,3,1,1,1
2023-06-01,269092,1,3,4,1,1,1
2023-06-01,269093,7,7,14,2,1,2
2023-06-01,269099,1,0,1,2,0,2
2023-06-01,269195,5,1,6,3,1,3
2023-06-01,264909,6,1,7,3,3,3
2023-06-01,267920,1,1,2,1,1,1
2023-06-01,267917,2,0,2,1,0,1
2023-06-01,267919,3,4,7,1,2,2
2023-06-01,269100,4,9,13,1,1,1
2023-06-01,61589,7,8,15,13,9,13
2023-06-01,61587,7,7,14,6,3,6
2023-06-01,269116,1,0,1,1,0,1
2023-06-01,269103,7,3,10,4,2,4
2023-06-01,269193,5,1,6,1,1,1
2023-06-01,269121,4,1,5,4,1,4
2023-06-01,52662,26,3,29,9,9,12
2023-06-01,263390,23,23,46,7,5,9
2023-06-01,269118,4,2,6,3,3,4
2023-06-01,269122,1,1,2,1,1,1
2023-06-01,269144,2,7,9,4,2,5
2023-06-01,272458,0,1,1,5,4,6
2023-06-01,267929,5,0,5,1,0,1
2023-06-01,269108,7,1,8,2,1,2
2023-06-01,266694,4,1,5,3,2,3
2023-06-01,266784,1,1,2,3,3,3
2023-06-01,269726,1,1,2,1,1,1
2023-06-01,269123,2,1,3,1,1,1
2023-06-01,269110,5,1,6,1,1,1
2023-06-01,272264,0,14,14,5,8,9
2023-06-01,271585,1,1,2,1,1,1
2023-06-01,207688,4,2,6,4,2,4
2023-06-01,28005,8,0,8,5,0,5
2023-06-01,269742,2,1,3,2,1,2
2023-06-01,267926,1,0,1,1,0,1
2023-06-01,269114,7,0,7,1,0,1
2023-06-01,263443,7,5,12,10,5,10
2023-06-01,269162,4,1,5,3,1,3
2023-06-01,269124,5,2,7,2,2,2
2023-06-01,264517,4,1,5,14,11,14
2023-06-01,269130,5,1,6,1,1,1
2023-06-01,267924,3,1,4,1,1,1
2023-06-01,269125,3,0,3,2,0,2
2023-06-01,269139,5,3,8,5,1,5
2023-06-01,269117,1,0,1,1,0,1
2023-06-01,269131,5,1,6,4,3,4
2023-06-01,269778,5,0,5,1,0,1
2023-06-01,263363,1,3,4,7,5,8
2023-06-01,269164,1,3,4,1,1,1
2023-06-01,52638,11,10,21,3,3,3
2023-06-01,269126,4,1,5,1,1,1
2023-06-01,263470,14,1,15,10,6,10
2023-06-01,269431,3,1,4,1,1,1
2023-06-01,269127,2,0,2,2,0,2
2023-06-01,269167,3,2,5,2,1,2
2023-06-01,269128,5,3,8,1,1,1
2023-06-01,269173,3,1,4,2,2,2
2023-06-01,269174,5,3,8,3,1,3
2023-06-01,269186,6,3,9,4,1,4
2023-06-01,11802,50,2,52,7,4,7
2023-06-01,269191,1,1,2,1,1,1
2023-06-01,27895,66,18,84,7,2,7
2023-06-01,269731,1,0,1,1,0,1
2023-06-01,269271,7,1,8,6,2,6
2023-06-01,262239,10,1,11,5,2,5
2023-06-01,267932,3,1,4,2,3,3
2023-06-01,267931,5,0,5,4,0,4
2023-06-01,269134,4,2,6,3,2,4
2023-06-01,271303,7,5,12,6,2,6
2023-06-01,28247,7,1,8,4,2,4
2023-06-01,269135,4,1,5,1,1,1
2023-06-01,269136,7,3,10,1,1,1
2023-06-01,269728,2,0,2,1,0,1
2023-06-01,269137,3,3,6,3,4,5
2023-06-01,269568,2,1,3,7,6,7
2023-06-01,269140,2,5,7,2,1,2
2023-06-01,263495,6,3,9,9,6,10
2023-06-01,269141,3,1,4,1,1,1
2023-06-01,269142,2,1,3,2,1,2
2023-06-01,269143,4,0,4,1,0,1
2023-06-01,269158,1,0,1,1,0,1
2023-06-01,269404,1,0,1,1,0,1
2023-06-01,269849,1,0,1,1,0,1
2023-06-01,269725,5,0,5,1,0,1
2023-06-01,269145,3,3,6,1,1,1
2023-06-01,269154,5,1,6,4,3,4
2023-06-01,269146,3,2,5,3,1,3
2023-06-01,269147,5,7,12,2,1,2
2023-06-01,265421,3,3,6,11,8,12
2023-06-01,269148,3,1,4,1,1,1
2023-06-01,53152,12,3,15,9,8,11
2023-06-01,269155,3,2,5,1,1,1
2023-06-01,270776,5,2,7,6,5,6
2023-06-01,269150,5,1,6,1,1,1
2023-06-01,52532,12,6,18,16,15,17
2023-06-01,269227,5,2,7,3,2,3
2023-06-01,269151,7,3,10,4,3,4
2023-06-01,16531,48,0,48,5,0,5
2023-06-01,269153,6,1,7,6,2,6
2023-06-01,269734,3,0,3,2,0,2
2023-06-01,265595,1,0,1,1,0,1
2023-06-01,263077,29,5,34,14,7,14
2023-06-01,269210,7,0,7,1,0,1
2023-06-01,269157,3,2,5,3,2,3
2023-06-01,262698,6,3,9,3,2,3
2023-06-01,269289,3,0,3,3,0,3
2023-06-01,269769,2,0,2,1,0,1
2023-06-01,269216,1,1,2,1,1,1
2023-06-01,269159,7,7,14,3,3,3
2023-06-01,265523,7,0,7,3,0,3
2023-06-01,269177,4,1,5,1,1,1
2023-06-01,269166,7,0,7,3,0,3
2023-06-01,269163,3,1,4,5,3,5
2023-06-01,272717,0,0,0,3,4,4
2023-06-01,269160,5,4,9,2,2,2
2023-06-01,269553,3,3,6,13,10,16
2023-06-01,269211,3,1,4,3,3,6
2023-06-01,269161,5,0,5,1,0,1
2023-06-01,265596,1,1,2,1,1,1
2023-06-01,265584,1,1,2,1,1,1
2023-06-01,269168,1,1,2,1,1,1
2023-06-01,269172,1,2,3,1,1,1
2023-06-01,269169,2,1,3,1,1,1
2023-06-01,269170,1,1,2,4,3,5
2023-06-01,267458,12,24,36,12,11,15
2023-06-01,269171,6,3,9,3,3,3
2023-06-01,61934,21,5,26,6,5,6
2023-06-01,269188,7,3,10,1,1,1
2023-06-01,271429,3,1,4,4,1,4
2023-06-01,269178,7,3,10,3,3,3
2023-06-01,269729,5,0,5,2,0,2
2023-06-01,269290,1,0,1,1,0,1
2023-06-01,269175,7,5,12,7,3,7
2023-06-01,269179,3,1,4,1,1,1
2023-06-01,269182,3,1,4,6,2,6
2023-06-01,269180,3,3,6,2,2,2
2023-06-01,269183,4,1,5,8,1,8
2023-06-01,265432,3,0,3,7,2,7
2023-06-01,269181,4,4,8,6,3,6
2023-06-01,269733,5,0,5,1,0,1
2023-06-01,269732,4,0,4,1,0,1
2023-06-01,264765,6,1,7,1,1,1
2023-06-01,269184,7,1,8,1,1,1
2023-06-01,269198,1,1,2,3,1,3
2023-06-01,269187,1,2,3,2,1,2
2023-06-01,269185,3,1,4,1,1,1
2023-06-01,269192,7,3,10,3,2,3
2023-06-01,269199,7,1,8,3,4,4
2023-06-01,269755,2,1,3,3,1,3
2023-06-01,269228,5,1,6,7,2,7
2023-06-01,269762,2,0,2,2,0,2
2023-06-01,269196,4,3,7,1,1,1
2023-06-01,269224,7,1,8,2,3,3
2023-06-01,269189,5,0,5,3,0,3
2023-06-01,52541,7,1,8,5,4,6
2023-06-01,269190,3,1,4,2,1,2
2023-06-01,266502,3,1,4,3,3,4
2023-06-01,267076,3,7,10,7,5,8
2023-06-01,269200,7,1,8,1,1,1
2023-06-01,269735,4,1,5,2,1,2
2023-06-01,264035,3,1,4,2,1,2
2023-06-01,269203,3,0,3,1,0,1
2023-06-01,269197,4,1,5,1,1,1
2023-06-01,61827,3,0,3,4,0,4
2023-06-01,269241,3,0,3,1,0,1
2023-06-01,269746,3,0,3,4,0,4
2023-06-01,269737,2,0,2,1,0,1
2023-06-01,269202,6,15,21,1,1,1
2023-06-01,269204,5,1,6,2,1,2
2023-06-01,269252,5,0,5,1,0,1
2023-06-01,269738,1,1,2,1,1,1
2023-06-01,269207,1,0,1,1,0,1
2023-06-01,269205,4,2,6,2,2,3
2023-06-01,269218,3,3,6,2,2,2
2023-06-01,269739,5,0,5,1,0,1
2023-06-01,269741,2,0,2,2,0,2
2023-06-01,269206,4,1,5,2,1,2
2023-06-01,262343,15,1,16,10,7,10
2023-06-01,269219,6,1,7,5,1,5
2023-06-01,269208,1,1,2,3,2,3
2023-06-01,269262,7,3,10,2,1,2
2023-06-01,271662,3,21,24,2,1,2
2023-06-01,262837,8,0,8,7,0,7
2023-06-01,263170,9,3,12,2,1,2
2023-06-01,263917,7,4,11,9,6,9
2023-06-01,269265,1,1,2,1,1,1
2023-06-01,269751,5,0,5,2,0,2
2023-06-01,269209,1,1,2,2,1,2
2023-06-01,269212,3,1,4,2,1,2
2023-06-01,267175,3,3,6,6,3,6
2023-06-01,262509,16,1,17,8,2,8
2023-06-01,269225,5,0,5,2,0,2
2023-06-01,269285,3,0,3,1,0,1
2023-06-01,267647,7,1,8,7,6,7
2023-06-01,269267,7,1,8,6,3,7
2023-06-01,28667,12,1,13,10,9,10
2023-06-01,269220,4,1,5,4,6,6
2023-06-01,269214,5,1,6,1,1,1
2023-06-01,269215,6,7,13,7,6,8
2023-06-01,269226,3,1,4,2,1,2
2023-06-01,265434,7,3,10,9,5,9
2023-06-01,269234,1,1,2,1,1,1
2023-06-01,269766,4,0,4,3,0,3
2023-06-01,269328,7,1,8,1,1,1
2023-06-01,269276,3,1,4,3,1,3
2023-06-01,269307,7,3,10,6,3,6
2023-06-01,269280,3,7,10,4,1,5
2023-06-01,270955,5,2,7,8,2,8
2023-06-01,271749,0,1,1,2,1,2
2023-06-01,269339,3,3,6,1,1,1
2023-06-01,269222,1,0,1,1,0,1
2023-06-01,61597,1,1,2,3,1,3
2023-06-01,264321,9,3,12,6,5,7
2023-06-01,269223,2,7,9,6,5,7
2023-06-01,269785,5,0,5,2,0,2
2023-06-01,269774,1,3,4,1,1,1
2023-06-01,61468,48,37,85,21,17,21
2023-06-01,269792,1,1,2,1,1,1
2023-06-01,269790,1,1,2,1,1,1
2023-06-01,269275,4,0,4,1,0,1
2023-06-01,269747,4,0,4,3,0,3
2023-06-01,265759,5,0,5,2,0,2
2023-06-01,269748,7,0,7,1,0,1
2023-06-01,269232,4,0,4,1,0,1
2023-06-01,269229,7,7,14,1,1,1
2023-06-01,269757,4,0,4,3,0,3
2023-06-01,269217,6,8,14,6,7,8
2023-06-01,269240,5,1,6,2,2,2
2023-06-01,269230,1,0,1,1,0,1
2023-06-01,262317,30,1,31,17,17,18
2023-06-01,269231,5,2,7,1,1,1
2023-06-01,262607,17,28,45,13,7,13
2023-06-01,269281,7,1,8,3,1,3
2023-06-01,269302,1,1,2,1,1,1
2023-06-01,269274,1,1,2,2,2,2
2023-06-01,269233,5,0,5,1,0,1
2023-06-01,269250,6,5,11,7,3,7
2023-06-01,269754,3,0,3,1,0,1
2023-06-01,53089,38,31,69,8,4,8
2023-06-01,269246,7,1,8,2,2,2
2023-06-01,269235,7,7,14,6,4,6
2023-06-01,269237,7,7,14,5,3,5
2023-06-01,269238,1,1,2,1,1,1
2023-06-01,269251,5,1,6,1,1,1
2023-06-01,262645,29,5,34,12,7,12
2023-06-01,269239,3,2,5,1,1,1
2023-06-01,269768,5,1,6,2,2,2
2023-06-01,269242,4,1,5,3,1,3
2023-06-01,269247,4,2,6,3,1,3
2023-06-01,269260,5,1,6,1,1,1
2023-06-01,269753,2,0,2,3,0,3
2023-06-01,269243,3,3,6,3,2,3
2023-06-01,269244,5,1,6,5,1,5
2023-06-01,267488,5,7,12,3,2,3
2023-06-01,269245,4,3,7,3,3,3
2023-06-01,270553,5,1,6,6,4,6
2023-06-01,269248,5,1,6,1,1,1
2023-06-01,269249,5,1,6,3,1,3
2023-06-01,263270,6,9,15,9,8,9
2023-06-01,269269,4,2,6,2,1,2
2023-06-01,269253,1,1,2,3,3,3
2023-06-01,269254,7,5,12,5,4,5
2023-06-01,269309,7,1,8,3,1,3
2023-06-01,269255,7,1,8,4,1,4
2023-06-01,269310,7,7,14,4,3,4
2023-06-01,269256,7,1,8,3,2,3
2023-06-01,269758,1,1,2,1,1,1
2023-06-01,271920,1,1,2,1,1,1
2023-06-01,269319,5,1,6,3,2,3
2023-06-01,53169,40,3,43,18,8,19
2023-06-01,269759,4,0,4,1,0,1
2023-06-01,269263,3,3,6,2,2,2
2023-06-01,269763,6,0,6,2,0,2
2023-06-01,269264,4,1,5,2,2,2
2023-06-01,269273,7,5,12,3,3,3
2023-06-01,269321,5,2,7,1,1,1
2023-06-01,269333,3,1,4,2,1,2
2023-06-01,265019,5,6,11,9,5,9
2023-06-01,269270,3,1,4,1,2,2
2023-06-01,269268,1,1,2,3,1,3
2023-06-01,269336,5,5,10,2,1,2
2023-06-01,269272,4,3,7,2,1,2
2023-06-01,269279,3,0,3,1,0,1
2023-06-01,269761,4,1,5,2,1,2
2023-06-01,28634,6,1,7,9,5,9
2023-06-01,269324,2,1,3,2,2,2
2023-06-01,265942,1,1,2,2,2,2
2023-06-01,269773,3,0,3,1,0,1
2023-06-01,269286,5,1,6,6,1,6
2023-06-01,267016,7,7,14,6,4,6
2023-06-01,269327,3,3,6,1,3,3
2023-06-01,269399,7,1,8,1,1,1
2023-06-01,269330,3,3,6,5,2,5
2023-06-01,267390,1,1,2,3,2,3
2023-06-01,269277,3,1,4,1,1,1
2023-06-01,269296,1,0,1,1,0,1
2023-06-01,269282,3,0,3,1,0,1
2023-06-01,271840,5,0,5,4,0,4
2023-06-01,264824,5,1,6,2,1,2
2023-06-01,269287,2,5,7,1,3,3
2023-06-01,265229,14,7,21,9,8,10
2023-06-01,269398,3,3,6,2,1,2
2023-06-01,269283,4,1,5,5,1,5
2023-06-01,272161,0,3,3,5,3,6
2023-06-01,269781,2,0,2,2,0,2
2023-06-01,269278,4,2,6,1,1,1
2023-06-01,269288,5,1,6,4,2,4
2023-06-01,269297,7,1,8,1,1,1
2023-06-01,269767,1,0,1,1,0,1
2023-06-01,271609,1,1,2,2,3,3
2023-06-01,270142,1,1,2,1,1,1
2023-06-01,64121,1,0,1,1,0,1
2023-06-01,266154,7,5,12,4,6,6
2023-06-01,269337,7,3,10,1,1,1
2023-06-01,269797,3,2,5,2,2,2
2023-06-01,271962,4,0,4,3,2,3
2023-06-01,269298,7,3,10,5,4,5
2023-06-01,269306,4,1,5,3,2,3
2023-06-01,263959,6,1,7,8,6,8
2023-06-01,269403,1,1,2,1,1,1
2023-06-01,269284,3,0,3,2,0,2
2023-06-01,265171,28,1,29,15,4,15
2023-06-01,269291,4,3,7,3,2,3
2023-06-01,269292,7,3,10,3,2,3
2023-06-01,269360,4,2,6,5,4,5
2023-06-01,263763,7,1,8,2,2,3
2023-06-01,269406,2,1,3,2,1,2
2023-06-01,269312,5,3,8,3,1,3
2023-06-01,269293,5,2,7,2,2,2
2023-06-01,270796,7,3,10,8,4,8
2023-06-01,269294,5,1,6,1,1,1
2023-06-01,269295,5,1,6,4,2,4
2023-06-01,269346,3,2,5,2,2,2
2023-06-01,269400,1,1,2,2,2,2
2023-06-01,269777,1,0,1,2,0,2
2023-06-01,269300,1,0,1,3,0,3
2023-06-01,269301,3,2,5,2,2,2
2023-06-01,269365,2,1,3,3,1,3
2023-06-01,269318,1,0,1,1,0,1
2023-06-01,269438,3,1,4,2,1,2
2023-06-01,269313,4,1,5,4,1,4
2023-06-01,269308,4,2,6,7,5,7
2023-06-01,269779,1,0,1,2,0,2
2023-06-01,269303,4,11,15,2,2,2
2023-06-01,269304,4,1,5,2,1,2
2023-06-01,269353,3,1,4,1,1,1
2023-06-01,269305,5,1,6,1,1,1
2023-06-01,267234,1,1,2,2,2,2
2023-06-01,269325,1,1,2,1,1,1
2023-06-01,269314,4,1,5,3,1,3
2023-06-01,269315,5,3,8,3,3,4
2023-06-01,269316,2,1,3,2,2,2
2023-06-01,28668,35,12,47,9,5,9
2023-06-01,269317,3,0,3,1,0,1
2023-06-01,269320,4,3,7,2,2,2
2023-06-01,269359,10,1,11,4,4,4
2023-06-01,271049,3,1,4,17,11,17
2023-06-01,269326,5,3,8,5,2,5
2023-06-01,266935,5,1,6,6,2,6
2023-06-01,269322,1,0,1,1,0,1
2023-06-01,264000,7,1,8,2,3,3
2023-06-01,269323,3,2,5,2,2,2
2023-06-01,269793,1,0,1,2,0,2
2023-06-01,262952,17,4,21,12,10,12
2023-06-01,270255,6,1,7,1,1,1
2023-06-01,269780,4,0,4,1,0,1
2023-06-01,269791,1,1,2,1,1,1
2023-06-01,269771,1,0,1,1,0,1
2023-06-01,52279,47,1,48,6,1,6
2023-06-01,269823,2,0,2,3,0,3
2023-06-01,269396,3,1,4,7,6,8
2023-06-01,14845,1,0,1,2,0,2
2023-06-01,269784,1,0,1,1,0,1
2023-06-01,266242,3,1,4,10,5,10
2023-06-01,269459,7,0,7,1,0,1
2023-06-01,265598,1,0,1,1,0,1
2023-06-01,269329,3,3,6,3,2,3
2023-06-01,269382,7,0,7,1,0,1
2023-06-01,269340,1,4,5,1,1,1
2023-06-01,269818,5,0,5,1,0,1
2023-06-01,262900,15,7,22,11,9,12
2023-06-01,269794,7,7,14,1,1,1
2023-06-01,269383,1,0,1,4,0,4
2023-06-01,28165,121,4,125,17,6,17
2023-06-01,269401,7,7,14,7,2,7
2023-06-01,269331,2,1,3,2,3,4
2023-06-01,52780,18,1,19,11,6,12
2023-06-01,269332,3,1,4,1,1,1
2023-06-01,269392,3,0,3,1,0,1
2023-06-01,269393,1,1,2,3,1,3
2023-06-01,265978,4,3,7,5,2,5
2023-06-01,269347,3,1,4,2,1,2
2023-06-01,52845,5,1,6,3,1,3
2023-06-01,271649,5,5,10,3,2,3
2023-06-01,269364,5,4,9,2,1,2
2023-06-01,269342,4,3,7,4,2,4
2023-06-01,28300,215,1,216,11,7,11
2023-06-01,269354,4,3,7,5,4,5
2023-06-01,269343,6,1,7,1,1,1
2023-06-01,269361,3,1,4,5,3,5
2023-06-01,264150,14,1,15,4,3,5
2023-06-01,269344,7,7,14,2,2,2
2023-06-01,269345,6,1,7,3,2,3
2023-06-01,269519,6,2,8,4,4,5
2023-06-01,269805,5,0,5,2,0,2
2023-06-01,267378,4,1,5,5,8,9
2023-06-01,269348,2,1,3,1,1,1
2023-06-01,269349,3,1,4,2,2,2
2023-06-01,269362,3,0,3,1,0,1
2023-06-01,269350,1,2,3,1,1,1
2023-06-01,269782,7,1,8,1,2,2
2023-06-01,269452,3,1,4,1,1,1
2023-06-01,269351,7,3,10,8,6,9
2023-06-01,269355,4,2,6,2,1,2
2023-06-01,268216,7,7,14,2,2,2
2023-06-01,269369,4,1,5,2,1,2
2023-06-01,61650,7,5,12,9,5,9
2023-06-01,269352,6,1,7,5,2,5
2023-06-01,263222,34,10,44,2,1,2
2023-06-01,269356,3,0,3,1,0,1
2023-06-01,269482,3,1,4,1,1,1
2023-06-01,264637,11,2,13,5,5,6
2023-06-01,269796,1,0,1,1,0,1
2023-06-01,269363,3,1,4,1,1,1
2023-06-01,269441,3,0,3,5,0,5
2023-06-01,271208,7,2,9,4,3,4
2023-06-01,269543,1,1,2,1,1,1
2023-06-01,269357,5,0,5,1,0,1
2023-06-01,269358,4,1,5,1,1,1
2023-06-01,269800,1,4,5,1,1,1
2023-06-01,269366,1,1,2,6,6,7
2023-06-01,270979,2,1,3,4,2,4
2023-06-01,269407,5,1,6,2,1,3
2023-06-01,28227,9,7,16,7,5,7
2023-06-01,269427,3,1,4,2,1,2
2023-06-01,53230,15,3,18,7,2,7
2023-06-01,269370,7,7,14,5,4,5
2023-06-01,263445,4,4,8,8,8,11
2023-06-01,269385,5,3,8,4,2,4
2023-06-01,269367,3,2,5,3,2,3
2023-06-01,269371,5,1,6,1,1,1
2023-06-01,269408,1,0,1,1,0,1
2023-06-01,269379,4,1,5,1,1,1
2023-06-01,269380,2,0,2,3,0,3
2023-06-01,269372,5,2,7,6,2,7
2023-06-01,263583,7,7,14,10,8,10
2023-06-01,269368,1,1,2,2,2,2
2023-06-01,269375,7,3,10,5,3,5
2023-06-01,269389,7,1,8,4,2,4
2023-06-01,269373,3,3,6,1,1,1
2023-06-01,271722,0,1,1,6,2,6
2023-06-01,271511,3,1,4,3,2,4
2023-06-01,266636,4,4,8,11,6,12
2023-06-01,272561,5,3,8,7,3,7
2023-06-01,269374,4,3,7,1,1,1
2023-06-01,269376,7,1,8,5,3,5
2023-06-01,269377,5,1,6,4,1,4
2023-06-01,269378,5,0,5,1,0,1
2023-06-01,269480,1,0,1,1,0,1
2023-06-01,269807,2,0,2,1,0,1
2023-06-01,269560,3,0,3,2,0,2
2023-06-01,269386,4,0,4,5,0,5
2023-06-01,269384,6,4,10,1,1,1
2023-06-01,271355,5,1,6,1,1,1
2023-06-01,265268,8,1,9,13,4,13
2023-06-01,264420,3,1,4,2,1,2
2023-06-01,269387,3,1,4,1,3,3
2023-06-01,269391,6,1,7,8,2,8
2023-06-01,267248,4,2,6,7,2,7
2023-06-01,269397,5,0,5,1,0,1
2023-06-01,269388,4,1,5,1,2,2
2023-06-01,269811,2,1,3,1,1,1
2023-06-01,269835,1,0,1,1,0,1
2023-06-01,262616,6,3,9,2,1,2
2023-06-01,264881,6,1,7,3,1,3
2023-06-01,269402,3,1,4,3,1,3
2023-06-01,270070,3,0,3,4,0,4
2023-06-01,269559,5,1,6,2,2,2
2023-06-01,264384,1,1,2,3,3,4
2023-06-01,263517,10,16,26,7,5,8
2023-06-01,269443,1,0,1,1,0,1
2023-06-01,269394,3,3,6,4,2,4
2023-06-01,64117,5,1,6,1,1,1
2023-06-01,269405,4,0,4,3,0,3
2023-06-01,269433,4,3,7,3,1,3
2023-06-01,272284,0,2,2,5,2,5
2023-06-01,263024,14,3,17,10,5,10
2023-06-01,269395,4,1,5,2,2,2
2023-06-01,269565,3,1,4,1,1,1
2023-06-01,265602,3,0,3,2,0,2
2023-06-01,28539,45,1,46,7,2,7
2023-06-01,265599,4,0,4,1,0,1
2023-06-01,265600,3,0,3,1,0,1
2023-06-01,269502,7,1,8,1,1,1
2023-06-01,269806,4,1,5,2,1,2
2023-06-01,52705,11,9,20,10,4,10
2023-06-01,269453,1,1,2,1,2,2
2023-06-01,264750,8,3,11,3,2,3
2023-06-01,269468,2,0,2,5,0,5
2023-06-01,269798,4,0,4,2,0,2
2023-06-01,269814,4,0,4,4,0,4
2023-06-01,263213,4,0,4,4,0,4
2023-06-01,263809,10,0,10,6,0,6
2023-06-01,269425,6,2,8,1,1,1
2023-06-01,53094,19,8,27,10,6,11
2023-06-01,269409,5,4,9,1,1,1
2023-06-01,269410,14,2,16,3,1,3
2023-06-01,269808,4,0,4,3,0,3
2023-06-01,269411,3,3,6,2,2,2
2023-06-01,266400,18,7,25,6,6,7
2023-06-01,269412,7,7,14,2,2,2
2023-06-01,269413,4,0,4,2,0,2
2023-06-01,269421,7,0,7,3,0,3
2023-06-01,269414,4,0,4,2,0,2
2023-06-01,269415,7,3,10,4,3,4
2023-06-01,269430,1,0,1,1,0,1
2023-06-01,269417,3,1,4,3,1,3
2023-06-01,262587,10,1,11,6,3,6
2023-06-01,269422,6,1,7,4,5,6
2023-06-01,269815,1,0,1,1,0,1
2023-06-01,269419,5,0,5,3,0,3
2023-06-01,269420,1,3,4,2,1,2
2023-06-01,269423,2,3,5,9,6,12
2023-06-01,269801,1,0,1,1,0,1
2023-06-01,269802,5,0,5,3,0,3
2023-06-01,269424,7,1,8,1,1,1
2023-06-01,27997,55,1,56,12,1,12
2023-06-01,269813,1,0,1,1,0,1
2023-06-01,264141,5,7,12,7,5,9
2023-06-01,269549,1,0,1,2,0,2
2023-06-01,269828,3,0,3,1,0,1
2023-06-01,266842,1,1,2,1,1,1
2023-06-01,269499,8,1,9,4,1,4
2023-06-01,269500,5,1,6,2,1,2
2023-06-01,263405,31,1,32,4,1,4
2023-06-01,264492,3,1,4,7,4,7
2023-06-01,269432,3,2,5,1,1,1
2023-06-01,264223,9,17,26,9,6,9
2023-06-01,269518,3,4,7,2,2,2
2023-06-01,269449,3,1,4,3,1,3
2023-06-01,28610,8,5,13,9,5,9
2023-06-01,264930,5,2,7,2,1,2
2023-06-01,269445,5,1,6,3,1,3
2023-06-01,265441,5,1,6,3,2,3
2023-06-01,269434,3,0,3,1,0,1
2023-06-01,269435,3,1,4,7,1,7
2023-06-01,269817,4,0,4,1,0,1
2023-06-01,269436,1,2,3,1,1,1
2023-06-01,269437,1,1,2,1,1,1
2023-06-01,269439,7,7,14,4,3,4
2023-06-01,271656,1,1,2,2,1,2
2023-06-01,263450,9,0,9,1,0,1
2023-06-01,269514,7,7,14,3,1,3
2023-06-01,264974,7,7,14,6,4,6
2023-06-01,269442,5,1,6,4,1,4
2023-06-01,269526,5,1,6,1,1,1
2023-06-01,269455,1,1,2,1,1,2
2023-06-01,269826,2,0,2,4,0,4
2023-06-01,269831,5,0,5,3,0,3
2023-06-01,269846,1,1,2,1,1,1
2023-06-01,269460,4,1,5,1,1,1
2023-06-01,263989,3,3,6,5,2,5
2023-06-01,269447,3,3,6,1,1,1
2023-06-01,269448,2,3,5,3,1,3
2023-06-01,265379,7,3,10,7,3,7
2023-06-01,266623,4,20,24,17,12,17
2023-06-01,269483,5,1,6,1,1,1
2023-06-01,269469,7,0,7,1,0,1
2023-06-01,269450,1,1,2,1,1,1
2023-06-01,269847,3,0,3,2,0,2
2023-06-01,269484,3,1,4,5,3,5
2023-06-01,265603,1,0,1,1,0,1
2023-06-01,269855,4,0,4,1,0,1
2023-06-01,266020,7,7,14,5,5,6
2023-06-01,269456,7,3,10,3,2,3
2023-06-01,269546,7,1,8,1,1,1
2023-06-01,269457,3,7,10,1,1,1
2023-06-01,269528,4,2,6,4,1,4
2023-06-01,269461,4,3,7,5,1,5
2023-06-01,269470,3,1,4,3,3,3
2023-06-01,269600,3,2,5,2,1,2
2023-06-01,263542,7,3,10,5,3,6
2023-06-01,269589,4,2,6,8,3,8
2023-06-01,269915,3,0,3,2,0,2
2023-06-01,269865,1,0,1,1,0,1
2023-06-01,269829,7,1,8,3,1,3
2023-06-01,269462,7,7,14,4,4,5
2023-06-01,269493,5,0,5,1,0,1
2023-06-01,269494,5,0,5,1,0,1
2023-06-01,263888,10,1,11,4,3,4
2023-06-01,269463,7,2,9,3,3,3
2023-06-01,269464,7,1,8,2,2,2
2023-06-01,263633,1,1,2,2,3,3
2023-06-01,271322,1,1,2,1,1,1
2023-06-01,269471,3,1,4,2,2,2
2023-06-01,269466,4,6,10,3,3,3
2023-06-01,269819,1,1,2,2,1,3
2023-06-01,269479,3,3,6,4,3,4
2023-06-01,265915,5,1,6,5,1,5
2023-06-01,269467,3,0,3,1,0,1
2023-06-01,269495,3,3,6,3,3,3
2023-06-01,265604,2,0,2,1,0,1
2023-06-01,269627,4,2,6,4,3,4
2023-06-01,269472,4,0,4,1,0,1
2023-06-01,265436,7,1,8,16,7,17
2023-06-01,269496,7,0,7,5,0,5
2023-06-01,269539,7,1,8,1,1,1
2023-06-01,269540,2,2,4,3,1,3
2023-06-01,269473,1,1,2,1,1,1
2023-06-01,269474,5,3,8,5,4,5
2023-06-01,269475,7,5,12,5,5,6
2023-06-01,270586,3,3,6,5,3,5
2023-06-01,269481,3,1,4,2,1,2
2023-06-01,266284,4,1,5,12,6,12
2023-06-01,269476,1,1,2,1,1,1
2023-06-01,269555,1,8,9,1,1,1
2023-06-01,269477,5,9,14,3,2,3
2023-06-01,269556,1,1,2,3,1,3
2023-06-01,269497,3,1,4,5,2,5
2023-06-01,270804,3,2,5,7,3,7
2023-06-01,269911,1,0,1,1,0,1
2023-06-01,262815,9,8,17,8,5,8
2023-06-01,269554,3,6,9,3,1,3
2023-06-01,262883,4,1,5,9,8,9
2023-06-01,269498,1,1,2,1,1,1
2023-06-01,269487,1,1,2,1,1,1
2023-06-01,269488,1,3,4,3,4,4
2023-06-01,269507,3,1,4,1,1,1
2023-06-01,269489,3,1,4,1,1,1
2023-06-01,269490,4,0,4,3,0,3
2023-06-01,269491,1,1,2,1,1,1
2023-06-01,27751,41,1,42,6,1,6
2023-06-01,265660,1,0,1,1,0,1
2023-06-01,269610,1,1,2,1,1,1
2023-06-01,269525,3,0,3,1,0,1
2023-06-01,265938,3,1,4,8,6,8
2023-06-01,269513,4,0,4,6,0,6
2023-06-01,264126,3,3,6,8,8,11
2023-06-01,269840,4,0,4,1,0,1
2023-06-01,269564,5,0,5,1,0,1
2023-06-01,269566,7,5,12,5,1,5
2023-06-01,265950,7,3,10,7,4,7
2023-06-01,268311,3,5,8,7,5,8
2023-06-01,263397,15,1,16,4,3,4
2023-06-01,269567,5,1,6,1,1,1
2023-06-01,269833,1,0,1,1,0,1
2023-06-01,263945,14,7,21,6,7,8
2023-06-01,269503,7,6,13,1,1,1
2023-06-01,269504,4,6,10,1,1,1
2023-06-01,264202,5,18,23,3,1,3
2023-06-01,269520,3,0,3,1,0,1
2023-06-01,269508,3,1,4,1,1,1
2023-06-01,269505,1,1,2,2,1,2
2023-06-01,269531,4,4,8,4,1,4
2023-06-01,269571,3,5,8,4,2,4
2023-06-01,269825,3,1,4,3,2,4
2023-06-01,269830,1,0,1,1,0,1
2023-06-01,269585,5,3,8,3,1,3
2023-06-01,269715,5,1,6,12,9,13
2023-06-01,269522,3,1,4,4,3,4
2023-06-01,269523,7,3,10,5,4,6
2023-06-01,269517,5,3,8,6,3,6
2023-06-01,265608,4,7,11,2,2,2
2023-06-01,269587,4,1,5,4,6,6
2023-06-01,269516,7,0,7,3,0,3
2023-06-01,269527,7,3,10,4,2,4
2023-06-01,269515,3,1,4,1,1,1
2023-06-01,267362,1,7,8,2,1,2
2023-06-01,269511,1,0,1,1,0,1
2023-06-01,269512,2,1,3,5,2,5
2023-06-01,265607,6,4,10,2,1,2
2023-06-01,269510,1,1,2,1,1,1
2023-06-01,269521,5,1,6,1,1,1
2023-06-01,269841,4,0,4,3,0,3
2023-06-01,269544,1,0,1,1,0,1
2023-06-01,265616,1,0,1,1,0,1
2023-06-01,269631,3,1,4,3,2,4
2023-06-01,52496,3,0,3,3,0,3
2023-06-01,269532,3,1,4,1,1,1
2023-06-01,269536,6,2,8,2,2,2
2023-06-01,265335,6,2,8,3,1,3
2023-06-01,269581,6,2,8,1,1,1
2023-06-01,269839,3,0,3,3,0,3
2023-06-01,269537,7,0,7,2,0,2
2023-06-01,269961,1,0,1,1,0,1
2023-06-01,269535,7,7,14,7,3,7
2023-06-01,263508,31,3,34,6,4,6
2023-06-01,269529,7,3,10,4,2,4
2023-06-01,269530,3,1,4,3,1,3
2023-06-01,269599,3,1,4,1,1,1
2023-06-01,269538,3,3,6,4,2,4
2023-06-01,269534,4,6,10,4,1,5
2023-06-01,272460,0,1,1,3,1,3
2023-06-01,269786,3,0,3,1,0,1
2023-06-01,269884,1,0,1,1,0,1
2023-06-01,269562,1,0,1,3,0,3
2023-06-01,269844,1,2,3,1,1,1
2023-06-01,269541,5,1,6,4,1,4
2023-06-01,61680,1,1,2,4,2,4
2023-06-01,269542,5,1,6,1,1,1
2023-06-01,269852,2,1,3,2,1,2
2023-06-01,264744,10,3,13,4,2,4
2023-06-01,269561,5,1,6,6,2,6
2023-06-01,264398,10,1,11,10,6,10
2023-06-01,272559,0,1,1,5,4,5
2023-06-01,264568,7,7,14,10,6,11
2023-06-01,270741,7,1,8,8,4,9
2023-06-01,269551,7,7,14,1,1,1
2023-06-01,269864,4,1,5,3,1,3
2023-06-01,269552,4,3,7,4,2,4
2023-06-01,269648,7,1,8,4,1,4
2023-06-01,269557,7,1,8,5,3,5
2023-06-01,269563,7,7,14,4,3,5
2023-06-01,269547,7,2,9,4,3,4
2023-06-01,269548,3,3,6,2,3,3
2023-06-01,267050,7,5,12,2,1,2
2023-06-01,269649,7,1,8,3,1,3
2023-06-01,269569,5,0,5,3,0,3
2023-06-01,269576,2,0,2,1,0,1
2023-06-01,269859,2,0,2,2,0,2
2023-06-01,269570,7,1,8,1,1,1
2023-06-01,266195,3,3,6,4,3,4
2023-06-01,269577,3,3,6,1,1,1
2023-06-01,269578,7,0,7,1,0,1
2023-06-01,269586,5,2,7,3,1,3
2023-06-01,269572,5,1,6,6,3,6
2023-06-01,269573,7,0,7,3,0,3
2023-06-01,265852,3,0,3,3,0,3
2023-06-01,269854,4,0,4,1,0,1
2023-06-01,269609,3,5,8,4,3,4
2023-06-01,271084,4,4,8,7,2,7
2023-06-01,269574,6,15,21,4,3,4
2023-06-01,269593,4,0,4,3,0,3
2023-06-01,262424,16,13,29,11,9,14
2023-06-01,269579,3,3,6,2,2,2
2023-06-01,262416,9,1,10,7,1,7
2023-06-01,269592,4,0,4,2,0,2
2023-06-01,262544,43,5,48,2,1,2
2023-06-01,269575,5,17,22,2,1,2
2023-06-01,269843,5,0,5,2,0,2
2023-06-01,266783,9,0,9,3,0,3
2023-06-01,269857,2,0,2,3,0,3
2023-06-01,269867,1,0,1,1,0,1
2023-06-01,269582,4,3,7,1,1,1
2023-06-01,269583,3,0,3,1,0,1
2023-06-01,269584,5,1,6,2,2,2
2023-06-01,269588,5,0,5,1,0,1
2023-06-01,269590,7,0,7,1,0,1
2023-06-01,61719,3,7,10,4,2,4
2023-06-01,269591,6,1,7,1,1,1
2023-06-01,269596,7,1,8,1,1,1
2023-06-01,28435,3,2,5,2,1,2
2023-06-01,265611,4,0,4,3,0,3
2023-06-01,269724,1,5,6,2,2,2
2023-06-01,270237,7,1,8,2,2,2
2023-06-01,269666,2,0,2,1,0,1
2023-06-01,269860,4,0,4,1,0,1
2023-06-01,269598,1,0,1,1,0,1
2023-06-01,269874,4,1,5,2,1,2
2023-06-01,269862,11,5,16,7,6,9
2023-06-01,269873,1,0,1,1,0,1
2023-06-01,269858,1,0,1,1,0,1
2023-06-01,271794,2,0,2,5,0,5
2023-06-01,269872,1,0,1,1,0,1
2023-06-01,269601,5,1,6,5,1,5
2023-06-01,269602,2,0,2,2,0,2
2023-06-01,269614,5,1,6,4,3,4
2023-06-01,269615,3,10,13,1,1,1
2023-06-01,269611,3,1,4,4,3,4
2023-06-01,53218,15,3,18,4,4,5
2023-06-01,269612,3,3,6,1,1,1
2023-06-01,265612,2,2,4,2,2,2
2023-06-01,269604,2,1,3,2,1,2
2023-06-01,269605,4,0,4,1,0,1
2023-06-01,269603,3,1,4,2,1,2
2023-06-01,265613,4,1,5,1,1,1
2023-06-01,269606,1,2,3,1,1,1
2023-06-01,269616,6,6,12,3,5,5
2023-06-01,269617,5,1,6,2,1,2
2023-06-01,266644,3,1,4,4,1,4
2023-06-01,269607,1,1,2,2,1,2
2023-06-01,269934,3,0,3,1,0,1
2023-06-01,269613,1,0,1,1,0,1
2023-06-01,269912,3,0,3,2,0,2
2023-06-01,269875,6,1,7,1,2,3
2023-06-01,269608,6,3,9,4,3,5
2023-06-01,265277,1,1,2,9,7,9
2023-06-01,269618,1,1,2,1,1,1
2023-06-01,269632,7,1,8,6,4,6
2023-06-01,269622,5,0,5,1,0,1
2023-06-01,269623,7,1,8,3,2,3
2023-06-01,265294,4,3,7,7,5,7
2023-06-01,269619,4,2,6,5,2,5
2023-06-01,272657,0,3,3,3,1,3
2023-06-01,52648,1,1,2,8,8,8
2023-06-01,269628,5,0,5,6,0,6
2023-06-01,269620,1,1,2,3,1,3
2023-06-01,269640,7,3,10,5,3,5
2023-06-01,269702,2,0,2,1,0,1
2023-06-01,265614,4,3,7,1,1,1
2023-06-01,269621,3,0,3,2,0,2
2023-06-01,269891,2,0,2,1,0,1
2023-06-01,269893,3,3,6,2,2,2
2023-06-01,45272,13,0,13,4,0,4
2023-06-01,52698,6,1,7,3,1,3
2023-06-01,269644,3,0,3,1,0,1
2023-06-01,269878,3,1,4,1,1,1
2023-06-01,269645,3,0,3,2,0,2
2023-06-01,269624,4,0,4,1,0,1
2023-06-01,269625,7,17,24,2,1,2
2023-06-01,269626,7,1,8,4,4,4
2023-06-01,269641,5,28,33,4,5,5
2023-06-01,28265,14,1,15,5,3,5
2023-06-01,28656,38,5,43,4,5,5
2023-06-01,269634,7,7,14,3,3,3
2023-06-01,269879,1,0,1,3,0,3
2023-06-01,262940,7,0,7,4,0,4
2023-06-01,269660,5,1,6,3,1,4
2023-06-01,262541,5,0,5,2,0,2
2023-06-01,269638,1,1,2,1,1,1
2023-06-01,269647,5,7,12,5,2,5
2023-06-01,269662,7,0,7,1,0,1
2023-06-01,269639,3,3,6,6,4,6
2023-06-01,269657,3,3,6,3,2,3
2023-06-01,269901,1,0,1,1,0,1
2023-06-01,269675,1,1,2,2,1,2
2023-06-01,52952,11,5,16,6,3,6
2023-06-01,269642,3,0,3,3,0,3
2023-06-01,269643,4,0,4,2,0,2
2023-06-01,265618,1,0,1,1,0,1
2023-06-01,269914,2,0,2,1,0,1
2023-06-01,269868,3,0,3,1,0,1
2023-06-01,265609,4,4,8,2,1,2
2023-06-01,269650,3,3,6,1,1,1
2023-06-01,269630,3,0,3,3,0,3
2023-06-01,269635,6,4,10,1,1,1
2023-06-01,269636,6,4,10,1,4,4
2023-06-01,269637,4,1,5,1,1,1
2023-06-01,264455,7,7,14,6,5,6
2023-06-01,269651,5,3,8,4,4,5
2023-06-01,269652,3,0,3,2,0,2
2023-06-01,269653,1,1,2,1,1,1
2023-06-01,265954,7,1,8,10,7,10
2023-06-01,269654,5,1,6,3,1,3
2023-06-01,272665,0,7,7,5,5,6
2023-06-01,272526,0,5,5,4,4,5
2023-06-01,265617,3,0,3,1,0,1
2023-06-01,265615,12,1,13,3,1,3
2023-06-01,269655,7,7,14,1,1,1
2023-06-01,269809,4,2,6,3,1,3
2023-06-01,52322,6,1,7,3,1,3
2023-06-01,269698,5,2,7,3,2,3
2023-06-01,265278,3,8,11,5,5,5
2023-06-01,270258,3,7,10,2,1,2
2023-06-01,269658,2,1,3,1,1,1
2023-06-01,269679,1,0,1,1,0,1
2023-06-01,269664,1,1,2,1,1,1
2023-06-01,266168,2,1,3,5,5,5
2023-06-01,272689,1,7,8,1,1,1
2023-06-01,269659,7,1,8,3,2,3
2023-06-01,269668,3,5,8,3,2,5
2023-06-01,269665,5,7,12,3,3,4
2023-06-01,270246,7,0,7,1,0,1
2023-06-01,270254,7,2,9,1,1,1
2023-06-01,262213,19,3,22,2,1,2
2023-06-01,265619,5,7,12,4,1,4
2023-06-01,269882,3,0,3,1,0,1
2023-06-01,269672,3,1,4,7,7,8
2023-06-01,269667,7,1,8,1,1,1
2023-06-01,269670,7,1,8,3,3,3
2023-06-01,269678,1,1,2,2,1,2
2023-06-01,61688,11,0,11,2,0,2
2023-06-01,269700,3,3,6,6,3,6
2023-06-01,52973,18,0,18,13,5,14
2023-06-01,269906,5,0,5,1,0,1
2023-06-01,52409,2,2,4,10,5,10
2023-06-01,269910,1,0,1,2,0,2
2023-06-01,269887,5,0,5,2,0,2
2023-06-01,266805,3,1,4,2,1,2
2023-06-01,269703,5,1,6,1,1,1
2023-06-01,269894,4,0,4,1,0,1
2023-06-01,269877,5,0,5,1,0,1
2023-06-01,269704,5,1,6,4,1,4
2023-06-01,265320,4,1,5,7,4,8
2023-06-01,269886,3,0,3,2,0,2
2023-06-01,269680,5,0,5,1,0,1
2023-06-01,263474,9,3,12,7,5,7
2023-06-01,269681,3,3,6,1,1,1
2023-06-01,269671,3,3,6,6,7,7
2023-06-01,264514,8,3,11,7,6,8
2023-06-01,269673,7,1,8,4,4,5
2023-06-01,269674,7,7,14,7,6,7
2023-06-01,269690,2,1,3,4,3,4
2023-06-01,269676,7,0,7,1,0,1
2023-06-01,269677,3,1,4,3,2,3
2023-06-01,269957,3,0,3,2,0,2
2023-06-01,52432,9,0,9,4,0,4
2023-06-01,269707,3,1,4,2,1,2
2023-06-01,269683,7,1,8,4,2,4
2023-06-01,269917,5,1,6,2,1,2
2023-06-01,269691,5,1,6,2,1,2
2023-06-01,269687,6,0,6,2,0,2
2023-06-01,269916,4,0,4,3,0,3
2023-06-01,262187,20,6,26,6,2,6
2023-06-01,269933,2,0,2,1,0,1
2023-06-01,272878,1,1,2,1,1,1
2023-06-01,269692,5,1,6,1,1,1
2023-06-01,269684,3,3,6,1,1,1
2023-06-01,269685,7,1,8,1,1,1
2023-06-01,269686,3,1,4,2,1,2
2023-06-01,269688,3,2,5,2,2,2
2023-06-01,269890,5,1,6,1,1,1
2023-06-01,267221,7,6,13,11,5,12
2023-06-01,269695,4,0,4,2,0,2
2023-06-01,269895,1,0,1,1,0,1
2023-06-01,269693,1,1,2,1,1,1
2023-06-01,270240,3,3,6,7,5,7
2023-06-01,264512,6,3,9,11,11,12
2023-06-01,52286,66,2,68,9,1,9
2023-06-01,263218,9,2,11,3,1,3
2023-06-01,52451,4,0,4,3,0,3
2023-06-01,269701,3,0,3,3,0,3
2023-06-01,269699,5,1,6,2,1,2
2023-06-01,140403,20,0,20,4,0,4
2023-06-01,132372,16,7,23,5,3,5
2023-06-01,211014,3,0,3,1,0,1
2023-06-01,262167,7,0,7,3,0,3
2023-06-01,271916,2,1,3,1,1,1
2023-06-01,138456,19,1,20,5,1,5
2023-06-01,132513,17,3,20,3,1,3
2023-06-01,39159,14,0,14,3,0,3
2023-06-01,134175,53,0,53,1,0,1
2023-06-01,137263,27,1,28,10,3,10
2023-06-01,18233,44,0,44,15,0,15
2023-06-01,137577,20,0,20,2,0,2
2023-06-01,132813,39,0,39,1,0,1
2023-06-01,139811,16,0,16,6,0,6
2023-06-01,199614,2,2,4,1,2,2
2023-06-01,271929,7,2,9,5,1,5
2023-06-01,139056,9,20,29,3,2,3
2023-06-01,135717,1,0,1,1,0,1
2023-06-01,138168,5,0,5,4,0,4
2023-06-01,139805,8,0,8,1,0,1
2023-06-01,133771,48,1,49,14,2,14
2023-06-01,397071,2,1,3,1,1,1
2023-06-01,149024,4,0,4,5,0,5
2023-06-01,26617,136,1,137,6,2,6
2023-06-01,141721,0,0,0,5,0,5
2023-06-01,141735,3,0,3,2,0,2
2023-06-01,140883,8,0,8,2,0,2
2023-06-01,140925,3,0,3,1,0,1
2023-06-01,212552,37,0,37,3,0,3
2023-06-01,45710,16,0,16,5,0,5
2023-06-01,201815,3,1,4,2,2,2
2023-06-01,272111,2,0,2,2,0,2
2023-06-01,210008,18,5,23,6,1,6
2023-06-01,39974,1,0,1,1,0,1
2023-06-01,141190,13,1,14,7,1,7
2023-06-01,148994,17,0,17,1,0,1
2023-06-01,151206,11,0,11,1,0,1
2023-06-01,131618,26,0,26,13,0,13
2023-06-01,139265,10,0,10,1,0,1
2023-06-01,138905,4,0,4,1,0,1
2023-06-01,132537,3,0,3,5,0,5
2023-06-01,142423,8,0,8,3,0,3
2023-06-01,135026,7,0,7,2,0,2
2023-06-01,399626,20,0,20,3,0,3
2023-06-01,23749,20,0,20,10,0,10
2023-06-01,137510,16,2,18,5,1,5
2023-06-01,138630,25,0,25,1,0,1
2023-06-01,136778,10,0,10,1,0,1
2023-06-01,131471,15,0,15,8,0,8
2023-06-01,58470,8,4,12,15,5,15
2023-06-01,140900,10,0,10,1,0,1
2023-06-01,3132,58,2,60,18,1,18
2023-06-01,132698,7,0,7,1,0,1
2023-06-01,327901,233,1,234,10,2,10
2023-06-01,328499,1,0,1,4,0,4
2023-06-01,328119,1,0,1,2,0,2
2023-06-01,328112,8,4,12,8,2,8
2023-06-01,37474,1,1,2,4,1,4
2023-06-01,328118,1,0,1,1,0,1
2023-06-01,327892,7,0,7,4,0,4
2023-06-01,327992,1,0,1,16,0,16
2023-06-01,328264,1,0,1,1,0,1
2023-06-01,328114,41,1,42,6,2,6
2023-06-01,328576,29,17,46,5,3,5
2023-06-01,328106,12,0,12,2,0,2
2023-06-01,327943,4,0,4,4,0,4
2023-06-01,37652,15,0,15,3,0,3
2023-06-01,327750,12,7,19,5,3,5
2023-06-01,328092,2,0,2,2,0,2
2023-06-01,327849,12,5,17,4,3,4
2023-06-01,328039,1,1,2,4,2,4
2023-06-01,328076,2,0,2,2,0,2
2023-06-01,37640,2,1,3,6,2,7
2023-06-01,328035,4,1,5,2,1,2
2023-06-01,328041,9,1,10,7,2,7
2023-06-01,328422,1,1,2,3,1,3
2023-06-01,327886,1,0,1,1,0,1
2023-06-01,62571,9,5,14,5,1,5
2023-06-01,267652,2,1,3,1,1,1
2023-06-01,267646,4,1,5,3,3,4
2023-06-01,266982,1,0,1,1,0,1
2023-06-01,266976,2,1,3,1,1,1
2023-06-01,271160,3,3,6,3,2,3
2023-06-01,265835,4,0,4,3,0,3
2023-06-01,52971,21,7,28,12,12,15
2023-06-01,266924,4,2,6,3,2,3
2023-06-01,267637,3,7,10,4,3,4
2023-06-01,267641,5,3,8,6,5,6
2023-06-01,266939,5,0,5,2,0,2
2023-06-01,266932,2,0,2,8,0,8
2023-06-01,52327,49,7,56,9,1,9
2023-06-01,267663,2,1,3,2,2,2
2023-06-01,263582,13,3,16,8,6,8
2023-06-01,266916,5,1,6,1,1,1
2023-06-01,272182,0,5,5,2,2,3
2023-06-01,267668,5,3,8,3,2,3
2023-06-01,267649,7,0,7,5,0,5
2023-06-01,267650,1,1,2,1,1,1
2023-06-01,267653,5,0,5,1,0,1
2023-06-01,266946,1,1,2,1,1,1
2023-06-01,271797,5,0,5,2,0,2
2023-06-01,263769,3,0,3,4,0,4
2023-06-01,265848,1,0,1,1,0,1
2023-06-01,262378,18,9,27,8,7,9
2023-06-01,266911,7,0,7,3,0,3
2023-06-01,267657,2,4,6,1,2,2
2023-06-01,265838,3,0,3,2,0,2
2023-06-01,272695,0,3,3,2,2,2
2023-06-01,271315,4,1,5,6,3,7
2023-06-01,28606,8,1,9,9,4,9
2023-06-01,52566,18,1,19,4,4,5
2023-06-01,267659,3,0,3,1,0,1
2023-06-01,266922,7,1,8,3,2,3
2023-06-01,265843,4,0,4,1,0,1
2023-06-01,267661,7,0,7,1,0,1
2023-06-01,267662,3,1,4,1,1,1
2023-06-01,266919,3,1,4,1,1,1
2023-06-01,266923,7,1,8,5,3,6
2023-06-01,266918,6,0,6,3,0,3
2023-06-01,267660,4,6,10,1,1,1
2023-06-01,265859,1,0,1,2,0,2
2023-06-01,267086,1,1,2,1,2,2
2023-06-01,61570,0,0,0,5,4,5
2023-06-01,267670,2,1,3,1,1,1
2023-06-01,265862,5,0,5,3,0,3
2023-06-01,267672,7,3,10,1,1,1
2023-06-01,264686,4,0,4,4,0,4
2023-06-01,266907,1,0,1,1,0,1
2023-06-01,265842,4,0,4,3,0,3
2023-06-01,267665,3,3,6,6,4,6
2023-06-01,267666,3,3,6,3,1,3
2023-06-01,267671,7,0,7,1,0,1
2023-06-01,267673,1,1,2,1,1,1
2023-06-01,267674,4,1,5,1,1,1
2023-06-01,265849,1,1,2,2,1,2
2023-06-01,266914,2,1,3,3,1,4
2023-06-01,267675,1,1,2,3,3,3
2023-06-01,267676,3,0,3,1,0,1
2023-06-01,262529,3,1,4,1,1,1
2023-06-01,265857,4,0,4,4,0,4
2023-06-01,269851,3,0,3,2,0,2
2023-06-01,266971,3,3,6,1,1,1
2023-06-01,266915,5,5,10,3,2,3
2023-06-01,266920,3,1,4,1,1,1
2023-06-01,266926,7,1,8,6,1,6
2023-06-01,266927,6,1,7,4,3,4
2023-06-01,265841,3,0,3,1,0,1
2023-06-01,61584,5,7,12,6,4,6
2023-06-01,266928,2,7,9,1,1,1
2023-06-01,266921,7,7,14,7,4,7
2023-06-01,266655,2,0,2,1,0,1
2023-06-01,266880,2,1,3,2,1,2
2023-06-01,266941,6,1,7,5,2,5
2023-06-01,266942,5,1,6,6,1,6
2023-06-01,266943,3,1,4,2,2,2
2023-06-01,266670,2,0,2,1,0,1
2023-06-01,266929,2,0,2,3,0,3
2023-06-01,266671,1,1,2,2,2,2
2023-06-01,271025,4,4,8,2,1,2
2023-06-01,271437,3,1,4,5,3,5
2023-06-01,263526,2,1,3,6,4,6
2023-06-01,266963,1,0,1,1,0,1
2023-06-01,266933,5,3,8,4,3,4
2023-06-01,266934,1,3,4,7,6,7
2023-06-01,266936,4,7,11,2,2,2
2023-06-01,266937,1,1,2,1,1,1
2023-06-01,262259,6,0,6,7,0,7
2023-06-01,266654,1,0,1,1,0,1
2023-06-01,267003,3,0,3,1,0,1
2023-06-01,266938,7,5,12,6,2,6
2023-06-01,266944,7,0,7,1,0,1
2023-06-01,267021,2,3,5,1,1,1
2023-06-01,262182,22,18,40,15,10,15
2023-06-01,265515,21,18,39,2,2,2
2023-06-01,266960,3,0,3,3,0,3
2023-06-01,266656,7,0,7,1,0,1
2023-06-01,266950,1,2,3,1,1,1
2023-06-01,266959,7,1,8,7,3,7
2023-06-01,266998,6,1,7,1,1,1
2023-06-01,266940,5,1,6,2,1,2
2023-06-01,266951,7,7,14,5,3,5
2023-06-01,265440,19,1,20,3,1,3
2023-06-01,265851,1,0,1,2,0,2
2023-06-01,266945,5,1,6,2,1,2
2023-06-01,266948,7,3,10,5,4,5
2023-06-01,266949,3,3,6,1,1,1
2023-06-01,267072,5,1,6,3,1,3
2023-06-01,265858,7,0,7,3,0,3
2023-06-01,64131,1,1,2,4,1,4
2023-06-01,266972,3,0,3,2,0,2
2023-06-01,265853,1,0,1,1,0,1
2023-06-01,265854,3,0,3,1,0,1
2023-06-01,266973,5,1,6,1,1,1
2023-06-01,266964,4,1,5,4,1,4
2023-06-01,263086,6,1,7,7,5,8
2023-06-01,266955,5,3,8,2,2,2
2023-06-01,266366,7,1,8,4,1,4
2023-06-01,266974,7,0,7,1,0,1
2023-06-01,271667,1,1,2,1,1,1
2023-06-01,266952,4,3,7,3,3,3
2023-06-01,267512,3,1,4,3,3,3
2023-06-01,270892,3,1,4,2,2,2
2023-06-01,266987,4,0,4,1,0,1
2023-06-01,266953,5,1,6,4,3,4
2023-06-01,267032,6,3,9,7,3,7
2023-06-01,266954,5,2,7,1,3,3
2023-06-01,266956,3,0,3,2,0,2
2023-06-01,53167,16,1,17,7,4,7
2023-06-01,265868,4,0,4,1,0,1
2023-06-01,270716,7,4,11,5,4,5
2023-06-01,265880,4,0,4,2,0,2
2023-06-01,266975,3,0,3,4,0,4
2023-06-01,266986,7,49,56,7,4,7
2023-06-01,266958,5,1,6,2,1,2
2023-06-01,267015,3,1,4,2,2,2
2023-06-01,266985,3,1,4,1,1,1
2023-06-01,267109,2,0,2,1,0,1
2023-06-01,265865,4,6,10,2,2,3
2023-06-01,272009,1,0,1,1,0,1
2023-06-01,266965,7,1,8,4,3,4
2023-06-01,262202,29,1,30,7,5,8
2023-06-01,265873,2,0,2,1,0,1
2023-06-01,266961,7,3,10,5,2,5
2023-06-01,266984,5,1,6,1,1,1
2023-06-01,266990,4,0,4,1,0,1
2023-06-01,266991,7,1,8,2,1,2
2023-06-01,266992,7,1,8,3,2,3
2023-06-01,267020,2,3,5,4,2,4
2023-06-01,263458,13,1,14,4,1,4
2023-06-01,266003,3,23,26,7,5,8
2023-06-01,267013,1,3,4,1,1,1
2023-06-01,271331,5,0,5,3,0,3
2023-06-01,266993,2,0,2,1,0,1
2023-06-01,265861,1,0,1,1,0,1
2023-06-01,266433,2,1,3,1,1,1
2023-06-01,266962,4,4,8,10,9,10
2023-06-01,266996,4,0,4,2,0,2
2023-06-01,264590,7,3,10,8,5,8
2023-06-01,266966,13,3,16,1,1,1
2023-06-01,266967,3,3,6,6,4,7
2023-06-01,52729,5,1,6,10,8,10
2023-06-01,266983,7,7,14,1,1,1
2023-06-01,53160,38,7,45,7,3,7
2023-06-01,262634,15,0,15,4,2,4
2023-06-01,265844,5,2,7,2,1,2
2023-06-01,266968,3,12,15,7,5,7
2023-06-01,266969,5,0,5,1,0,1
2023-06-01,266970,1,0,1,1,0,1
2023-06-01,267045,5,1,6,2,2,2
2023-06-01,267046,4,0,4,1,0,1
2023-06-01,64108,4,2,6,2,2,2
2023-06-01,265874,3,0,3,2,0,2
2023-06-01,269745,1,0,1,1,0,1
2023-06-01,265864,7,0,7,3,0,3
2023-06-01,266786,3,0,3,2,0,2
2023-06-01,266997,3,0,3,1,0,1
2023-06-01,53047,12,2,14,11,7,12
2023-06-01,271167,3,0,3,3,0,3
2023-06-01,61868,9,3,12,5,4,5
2023-06-01,263551,1,1,2,3,3,3
2023-06-01,266978,3,0,3,1,0,1
2023-06-01,266979,1,1,2,1,1,1
2023-06-01,265863,3,0,3,3,0,3
2023-06-01,267002,1,0,1,3,0,3
2023-06-01,267004,7,0,7,1,0,1
2023-06-01,267006,6,0,6,2,0,2
2023-06-01,265866,3,0,3,4,0,4
2023-06-01,265760,1,1,2,3,1,3
2023-06-01,265876,1,0,1,3,0,3
2023-06-01,267025,4,0,4,4,0,4
2023-06-01,267026,3,3,6,6,5,6
2023-06-01,267022,6,1,7,2,2,2
2023-06-01,266999,5,1,6,1,1,1
2023-06-01,267000,4,2,6,1,1,1
2023-06-01,267009,1,1,2,4,4,4
2023-06-01,267501,3,1,4,3,3,3
2023-06-01,267001,1,1,2,1,1,1
2023-06-01,266669,1,4,5,3,2,3
2023-06-01,267049,1,0,1,2,0,2
2023-06-01,265882,4,0,4,2,0,2
2023-06-01,266740,1,0,1,1,0,1
2023-06-01,265869,4,0,4,2,0,2
2023-06-01,267008,5,1,6,2,1,2
2023-06-01,267040,3,1,4,1,1,1
2023-06-01,267047,4,1,5,2,1,2
2023-06-01,265879,4,0,4,2,0,2
2023-06-01,265877,5,0,5,1,0,1
2023-06-01,265426,5,4,9,4,2,4
2023-06-01,267042,1,1,2,1,1,1
2023-06-01,265872,1,0,1,1,0,1
2023-06-01,267007,2,2,4,2,2,2
2023-06-01,266662,1,0,1,1,0,1
2023-06-01,271366,1,0,1,2,0,2
2023-06-01,265871,3,0,3,1,0,1
2023-06-01,272447,0,1,1,6,3,6
2023-06-01,271452,5,0,5,4,0,4
2023-06-01,265870,1,0,1,1,0,1
2023-06-01,267031,2,0,2,1,0,1
2023-06-01,267055,8,4,12,9,6,9
2023-06-01,270857,5,7,12,4,6,7
2023-06-01,267070,3,1,4,3,1,3
2023-06-01,267010,1,1,2,2,2,2
2023-06-01,272037,1,2,3,2,2,2
2023-06-01,266653,1,0,1,1,0,1
2023-06-01,267069,7,2,9,3,1,3
2023-06-01,271024,5,1,6,1,1,1
2023-06-01,267019,4,0,4,1,0,1
2023-06-01,267023,4,2,6,4,5,7
2023-06-01,267024,5,1,6,5,1,5
2023-06-01,267011,7,7,14,5,4,5
2023-06-01,267012,1,1,2,1,1,1
2023-06-01,267014,1,1,2,1,1,1
2023-06-01,266778,2,0,2,1,0,1
2023-06-01,10778,28,1,29,10,1,10
2023-06-01,266726,1,0,1,1,0,1
2023-06-01,271469,1,1,2,1,1,1
2023-06-01,267017,4,0,4,2,0,2
2023-06-01,267036,7,0,7,2,0,2
2023-06-01,267035,4,1,5,1,2,2
2023-06-01,267034,5,3,8,4,3,5
2023-06-01,266660,1,0,1,1,0,1
2023-06-01,52724,9,1,10,3,2,3
2023-06-01,265883,10,0,10,1,0,1
2023-06-01,267033,3,4,7,1,1,1
2023-06-01,266683,3,0,3,3,0,3
2023-06-01,263649,18,3,21,11,6,11
2023-06-01,52843,13,3,16,7,5,7
2023-06-01,3790,172,3,175,6,3,7
2023-06-01,266665,2,0,2,2,0,2
2023-06-01,267030,2,1,3,1,1,1
2023-06-01,267029,7,3,10,4,4,5
2023-06-01,267043,4,2,6,1,1,1
2023-06-01,267711,1,0,1,2,0,2
2023-06-01,266371,7,1,8,9,5,9
2023-06-01,267052,1,1,2,1,1,1
2023-06-01,28188,57,2,59,8,2,8
2023-06-01,267097,4,0,4,1,0,1
2023-06-01,267044,4,5,9,3,1,3
2023-06-01,267784,3,2,5,3,2,3
2023-06-01,270399,1,1,2,2,2,2
2023-06-01,267054,3,3,6,3,2,3
2023-06-01,262973,17,7,24,9,9,11
2023-06-01,267039,3,1,4,4,2,4
2023-06-01,266685,5,1,6,3,2,3
2023-06-01,267100,1,1,2,1,1,1
2023-06-01,267106,6,1,7,2,1,2
2023-06-01,263055,13,1,14,8,5,8
2023-06-01,267088,4,3,7,2,2,2
2023-06-01,267101,5,2,7,5,4,5
2023-06-01,267068,3,0,3,2,0,2
2023-06-01,267048,7,1,8,2,1,2
2023-06-01,267041,5,0,5,1,0,1
2023-06-01,262196,13,1,14,2,1,2
2023-06-01,27768,45,1,46,15,4,15
2023-06-01,266677,7,1,8,2,1,3
2023-06-01,14234,50,0,50,4,0,4
2023-06-01,266886,2,0,2,1,0,1
2023-06-01,20002,14,0,14,5,0,5
2023-06-01,265542,3,0,3,3,0,3
2023-06-01,266674,5,0,5,2,0,2
2023-06-01,266682,4,0,4,2,0,2
2023-06-01,267053,5,0,5,2,0,2
2023-06-01,267067,3,3,6,1,1,1
2023-06-01,264879,3,24,27,6,4,6
2023-06-01,267057,3,0,3,1,0,1
2023-06-01,267058,6,1,7,1,1,1
2023-06-01,267051,2,1,3,1,1,1
2023-06-01,267077,5,1,6,1,1,1
2023-06-01,267060,1,1,2,1,1,1
2023-06-01,267081,5,0,5,3,0,3
2023-06-01,267061,6,4,10,7,6,8
2023-06-01,267071,5,0,5,3,0,3
2023-06-01,267064,7,0,7,2,0,2
2023-06-01,267065,3,3,6,1,1,1
2023-06-01,262567,12,7,19,11,3,11
2023-06-01,266673,7,1,8,3,1,3
2023-06-01,267102,1,1,2,2,3,3
2023-06-01,263523,0,0,0,6,0,6
2023-06-01,267078,3,3,6,3,3,3
2023-06-01,266143,3,1,4,7,7,8
2023-06-01,266666,5,0,5,3,0,3
2023-06-01,267130,1,1,2,3,2,3
2023-06-01,267073,4,1,5,1,1,1
2023-06-01,267066,6,3,9,2,1,2
2023-06-01,267074,5,0,5,2,0,2
2023-06-01,266667,4,0,4,2,0,2
2023-06-01,61449,2,1,3,6,2,6
2023-06-01,266675,5,0,5,2,0,2
2023-06-01,263801,24,3,27,8,1,8
2023-06-01,266681,2,0,2,2,0,2
2023-06-01,267092,7,0,7,2,0,2
2023-06-01,266668,3,1,4,4,3,5
2023-06-01,267093,4,1,5,2,1,2
2023-06-01,267117,7,1,8,6,3,6
2023-06-01,52508,2,0,2,5,0,5
2023-06-01,266689,1,0,1,1,0,1
2023-06-01,270093,1,1,2,1,1,1
2023-06-01,267119,1,0,1,1,0,1
2023-06-01,266684,6,0,6,3,0,3
2023-06-01,267080,6,3,9,3,3,3
2023-06-01,267122,5,1,6,1,1,1
2023-06-01,267125,3,3,6,3,3,3
2023-06-01,263165,15,1,16,3,2,3
2023-06-01,267085,3,2,5,1,1,1
2023-06-01,267083,7,3,10,6,5,6
2023-06-01,267126,1,1,2,1,1,1
2023-06-01,267089,5,5,10,2,1,2
2023-06-01,267090,1,0,1,1,0,1
2023-06-01,266676,3,1,4,1,1,1
2023-06-01,267123,5,1,6,2,2,2
2023-06-01,264255,15,3,18,9,7,9
2023-06-01,61754,6,1,7,6,2,7
2023-06-01,267138,7,0,7,1,0,1
2023-06-01,266690,1,0,1,1,0,1
2023-06-01,267091,4,1,5,2,3,3
2023-06-01,267096,3,3,6,2,2,2
2023-06-01,270089,2,0,2,1,0,1
2023-06-01,266704,5,0,5,2,0,2
2023-06-01,23243,170,26,196,9,4,10
2023-06-01,28009,20,0,20,5,2,5
2023-06-01,52294,1,1,2,6,5,6
2023-06-01,266687,2,3,5,1,3,3
2023-06-01,64110,5,0,5,1,0,1
2023-06-01,267124,14,2,16,7,6,8
2023-06-01,266692,3,0,3,1,0,1
2023-06-01,269752,1,0,1,5,0,5
2023-06-01,266693,5,1,6,2,1,2
2023-06-01,267103,4,7,11,1,1,1
2023-06-01,267222,1,1,2,1,1,1
2023-06-01,266698,2,1,3,1,1,1
2023-06-01,266729,1,0,1,1,0,1
2023-06-01,267111,1,1,2,1,1,1
2023-06-01,267104,5,0,5,1,0,1
2023-06-01,267105,1,1,2,1,1,1
2023-06-01,266705,3,0,3,3,0,3
2023-06-01,266728,2,1,3,1,1,1
2023-06-01,267107,1,1,2,1,1,1
2023-06-01,267110,1,1,2,2,2,2
2023-06-01,267147,3,1,4,1,1,1
2023-06-01,267121,7,2,9,8,4,9
2023-06-01,267108,3,1,4,1,1,1
2023-06-01,267115,6,1,7,6,3,6
2023-06-01,267116,3,4,7,1,1,1
2023-06-01,267114,5,1,6,3,1,3
2023-06-01,264358,4,1,5,2,1,2
2023-06-01,266688,5,1,6,1,2,2
2023-06-01,271273,4,4,8,1,1,1
2023-06-01,270377,5,1,6,3,1,3
2023-06-01,271297,2,1,3,2,1,3
2023-06-01,266715,3,1,4,3,1,4
2023-06-01,267128,1,5,6,1,2,2
2023-06-01,267127,3,0,3,1,0,1
2023-06-01,264138,2,1,3,4,5,5
2023-06-01,267155,1,1,2,1,1,1
2023-06-01,266709,2,0,2,2,0,2
2023-06-01,267230,1,0,1,1,0,1
2023-06-01,266738,1,0,1,1,0,1
2023-06-01,267156,7,3,10,1,2,2
2023-06-01,267120,3,3,6,7,4,7
2023-06-01,267129,4,3,7,5,5,7
2023-06-01,266211,6,3,9,10,9,12
2023-06-01,267162,3,0,3,1,0,1
2023-06-01,267132,6,0,6,2,0,2
2023-06-01,266706,4,0,4,3,0,3
2023-06-01,267757,1,1,2,1,1,1
2023-06-01,262360,24,31,55,9,4,9
2023-06-01,267259,1,0,1,2,0,2
2023-06-01,266723,3,0,3,2,0,2
2023-06-01,266695,4,0,4,1,0,1
2023-06-01,267133,1,1,2,1,1,1
2023-06-01,266721,1,97,98,2,2,2
2023-06-01,267149,3,1,4,4,1,4
2023-06-01,267141,1,0,1,1,0,1
2023-06-01,267134,4,0,4,1,0,1
2023-06-01,267151,7,0,7,2,0,2
2023-06-01,267135,7,7,14,3,1,3
2023-06-01,267136,3,1,4,1,1,1
2023-06-01,267137,7,0,7,1,0,1
2023-06-01,267142,7,2,9,1,1,1
2023-06-01,266746,1,0,1,3,0,3
2023-06-01,266711,1,0,1,3,0,3
2023-06-01,266707,1,0,1,3,0,3
2023-06-01,266720,1,1,2,1,1,1
2023-06-01,267140,3,3,6,3,3,3
2023-06-01,263656,30,1,31,7,3,7
2023-06-01,266489,3,1,4,5,2,5
2023-06-01,267143,3,0,3,1,0,1
2023-06-01,266710,4,0,4,3,0,3
2023-06-01,267148,1,1,2,1,1,1
2023-06-01,266700,1,1,2,1,1,1
2023-06-01,271803,1,0,1,2,0,2
2023-06-01,262893,37,18,55,7,4,7
2023-06-01,267145,3,1,4,2,1,2
2023-06-01,262531,9,3,12,5,2,5
2023-06-01,267179,1,0,1,1,0,1
2023-06-01,64109,3,1,4,2,1,2
2023-06-01,270102,5,0,5,2,0,2
2023-06-01,266713,2,0,2,1,0,1
2023-06-01,271869,3,0,3,1,0,1
2023-06-01,267146,1,1,2,1,2,2
2023-06-01,269750,16,0,16,4,0,4
2023-06-01,266731,7,0,7,3,0,3
2023-06-01,267170,3,3,6,3,3,3
2023-06-01,28140,6,3,9,6,6,6
2023-06-01,267150,2,1,3,3,2,3
2023-06-01,266702,5,0,5,6,0,6
2023-06-01,267158,2,4,6,5,1,5
2023-06-01,264857,3,0,3,2,0,2
2023-06-01,262557,16,3,19,5,6,6
2023-06-01,267159,7,1,8,1,2,2
2023-06-01,266703,4,1,5,1,1,1
2023-06-01,267166,1,1,2,1,1,1
2023-06-01,267174,1,0,1,1,0,1
2023-06-01,267160,3,1,4,3,1,3
2023-06-01,267178,6,2,8,2,1,2
2023-06-01,267171,3,3,6,2,1,2
2023-06-01,267152,1,0,1,1,0,1
2023-06-01,263297,32,5,37,3,2,3
2023-06-01,267157,7,5,12,5,4,5
2023-06-01,267167,5,4,9,4,3,4
2023-06-01,267168,1,1,2,3,4,4
2023-06-01,52694,6,1,7,11,6,11
2023-06-01,267367,7,9,16,7,5,7
2023-06-01,267161,5,1,6,3,1,3
2023-06-01,61873,3,1,4,10,4,10
2023-06-01,267172,4,1,5,1,1,1
2023-06-01,267169,1,1,2,1,1,1
2023-06-01,267186,5,1,6,2,3,3
2023-06-01,267164,4,4,8,3,2,3
2023-06-01,267214,3,1,4,2,2,2
2023-06-01,266742,4,0,4,2,0,2
2023-06-01,269918,5,1,6,3,1,4
2023-06-01,265545,4,0,4,1,0,1
2023-06-01,267173,5,0,5,2,0,2
2023-06-01,52967,35,7,42,8,1,8
2023-06-01,263031,3,0,3,3,0,3
2023-06-01,267235,6,0,6,4,0,4
2023-06-01,267206,7,0,7,1,0,1
2023-06-01,267196,7,0,7,1,0,1
2023-06-01,267197,3,3,6,4,2,4
2023-06-01,270007,1,1,2,2,1,2
2023-06-01,266716,1,0,1,1,0,1
2023-06-01,267208,7,1,8,3,1,3
2023-06-01,266743,1,0,1,1,0,1
2023-06-01,267246,1,1,2,1,1,1
2023-06-01,267184,2,1,3,6,2,6
2023-06-01,267209,7,3,10,4,3,4
2023-06-01,267226,7,1,8,2,1,2
2023-06-01,267177,7,1,8,6,3,6
2023-06-01,263936,5,0,5,5,0,5
2023-06-01,267176,5,0,5,1,0,1
2023-06-01,267187,1,0,1,1,0,1
2023-06-01,267904,4,0,4,1,0,1
2023-06-01,267181,5,1,6,1,1,1
2023-06-01,266253,7,4,11,10,4,10
2023-06-01,267185,7,0,7,1,0,1
2023-06-01,267215,1,1,2,1,1,1
2023-06-01,28330,30,10,40,11,8,15
2023-06-01,267244,1,0,1,1,0,1
2023-06-01,267223,7,1,8,2,2,2
2023-06-01,267180,4,5,9,3,2,3
2023-06-01,267191,4,1,5,4,3,4
2023-06-01,267183,7,3,10,3,1,3
2023-06-01,267188,7,1,8,2,1,2
2023-06-01,52637,12,1,13,13,9,13
2023-06-01,267220,1,3,4,1,1,1
2023-06-01,265546,4,0,4,4,0,4
2023-06-01,266717,1,1,2,1,1,1
2023-06-01,262197,371,19,390,15,5,16
2023-06-01,266719,1,0,1,1,0,1
2023-06-01,267200,3,0,3,2,0,2
2023-06-01,263345,3,1,4,3,1,3
2023-06-01,267233,5,1,6,1,1,1
2023-06-01,267204,6,7,13,1,1,1
2023-06-01,267202,7,1,8,4,2,4
2023-06-01,267194,7,3,10,1,1,1
2023-06-01,267189,7,1,8,1,1,1
2023-06-01,267205,4,1,5,4,3,5
2023-06-01,262482,8,3,11,3,3,4
2023-06-01,267190,3,3,6,1,1,1
2023-06-01,267236,3,1,4,2,1,2
2023-06-01,28425,5,0,5,1,0,1
2023-06-01,267195,3,0,3,3,0,3
2023-06-01,267207,4,0,4,3,0,3
2023-06-01,263491,6,1,7,4,1,4
2023-06-01,267211,6,0,6,2,0,2
2023-06-01,267198,1,1,2,1,1,1
2023-06-01,267239,2,0,2,1,0,1
2023-06-01,267212,5,5,10,4,3,4
2023-06-01,267203,3,3,6,4,1,4
2023-06-01,267199,3,1,4,5,3,5
2023-06-01,267245,3,1,4,1,1,1
2023-06-01,267255,3,1,4,2,1,2
2023-06-01,264746,8,1,9,3,1,3
2023-06-01,265775,1,0,1,1,0,1
2023-06-01,267261,8,4,12,1,1,1
2023-06-01,266758,2,0,2,1,0,1
2023-06-01,267300,1,1,2,2,2,2
2023-06-01,267227,3,1,4,2,1,2
2023-06-01,267210,4,1,5,2,1,2
2023-06-01,265547,2,8,10,4,3,4
2023-06-01,267216,5,0,5,7,0,7
2023-06-01,272679,6,0,6,2,0,2
2023-06-01,267217,7,0,7,3,0,3
2023-06-01,266737,6,2,8,1,1,1
2023-06-01,267231,7,1,8,1,1,1
2023-06-01,267224,7,7,14,1,1,1
2023-06-01,267218,5,9,14,1,1,1
2023-06-01,267232,7,0,7,1,0,1
2023-06-01,267247,3,1,4,2,1,2
2023-06-01,10954,31,7,38,14,5,15
2023-06-01,267225,3,1,4,3,1,3
2023-06-01,270360,3,3,6,4,1,4
2023-06-01,266768,4,12,16,2,2,2
2023-06-01,264691,6,0,6,3,0,3
2023-06-01,272803,5,0,5,1,0,1
2023-06-01,28424,3,0,3,3,0,3
2023-06-01,263150,3,0,3,2,0,2
2023-06-01,266735,1,0,1,2,0,2
2023-06-01,267256,6,1,7,10,5,10
2023-06-01,267228,3,0,3,4,0,4
2023-06-01,267240,7,0,7,1,0,1
2023-06-01,267243,5,0,5,1,0,1
2023-06-01,267229,5,1,6,4,3,4
2023-06-01,266754,4,0,4,3,0,3
2023-06-01,265181,13,9,22,9,6,10
2023-06-01,267238,7,0,7,3,0,3
2023-06-01,262403,9,3,12,13,7,15
2023-06-01,262450,9,1,10,7,3,7
2023-06-01,267281,4,1,5,3,1,4
2023-06-01,266741,5,0,5,4,0,4
2023-06-01,267301,10,1,11,1,1,1
2023-06-01,263175,5,3,8,3,2,3
2023-06-01,267241,1,0,1,1,0,1
2023-06-01,52341,41,3,44,5,3,5
2023-06-01,267242,7,13,20,5,4,5
2023-06-01,267265,3,1,4,1,1,1
2023-06-01,267266,3,1,4,2,3,3
2023-06-01,266745,2,0,2,2,0,2
2023-06-01,267260,7,1,8,1,1,1
2023-06-01,267249,1,1,2,3,2,3
2023-06-01,53195,5,3,8,3,4,4
2023-06-01,267316,5,3,8,2,2,2
2023-06-01,267267,5,0,5,2,0,2
2023-06-01,268355,3,2,5,12,8,12
2023-06-01,267250,3,0,3,1,0,1
2023-06-01,267251,6,1,7,5,1,5
2023-06-01,267252,7,0,7,1,0,1
2023-06-01,267257,7,3,10,1,1,1
2023-06-01,271254,5,1,6,1,1,1
2023-06-01,263361,9,3,12,2,1,2
2023-06-01,266753,5,0,5,1,0,1
2023-06-01,267262,3,1,4,2,3,3
2023-06-01,267258,3,4,7,2,2,2
2023-06-01,27735,5,1,6,7,1,7
2023-06-01,265282,1,1,2,3,1,3
2023-06-01,267268,5,0,5,1,0,1
2023-06-01,272213,1,1,2,5,4,7
2023-06-01,267321,3,0,3,4,0,4
2023-06-01,267329,1,3,4,1,1,1
2023-06-01,266752,4,1,5,1,1,1
2023-06-01,266761,1,0,1,1,0,1
2023-06-01,267270,5,10,15,2,2,2
2023-06-01,267274,7,1,8,2,1,2
2023-06-01,266759,5,0,5,3,0,3
2023-06-01,264569,5,0,5,5,0,5
2023-06-01,266417,2,1,3,4,3,4
2023-06-01,267282,1,3,4,1,1,1
2023-06-01,267271,2,2,4,2,1,2
2023-06-01,267279,7,9,16,4,3,4
2023-06-01,263980,13,18,31,3,4,4
2023-06-01,266760,2,0,2,3,0,3
2023-06-01,271846,4,0,4,2,0,2
2023-06-01,267283,7,5,12,3,2,3
2023-06-01,267277,3,0,3,4,0,4
2023-06-01,267280,7,1,8,4,3,4
2023-06-01,267302,1,1,2,2,1,3
2023-06-01,267358,5,0,5,4,0,4
2023-06-01,267284,5,2,7,3,1,3
2023-06-01,267285,4,1,5,2,1,2
2023-06-01,267297,2,1,3,1,1,1
2023-06-01,265548,7,3,10,1,1,1
2023-06-01,262473,20,6,26,7,2,7
2023-06-01,267303,5,0,5,1,0,1
2023-06-01,263471,6,1,7,7,2,7
2023-06-01,267286,3,0,3,1,0,1
2023-06-01,267287,3,3,6,2,2,2
2023-06-01,267288,3,1,4,6,3,6
2023-06-01,267309,3,0,3,5,0,5
2023-06-01,267298,2,2,4,2,2,2
2023-06-01,267290,1,3,4,1,1,1
2023-06-01,267304,4,1,5,1,2,2
2023-06-01,267291,4,1,5,4,3,4
2023-06-01,267292,5,0,5,3,0,3
2023-06-01,267293,5,4,9,2,4,4
2023-06-01,267294,2,1,3,7,5,7
2023-06-01,267299,3,7,10,5,5,5
2023-06-01,267289,7,7,14,5,5,6
2023-06-01,267295,7,1,8,2,1,2
2023-06-01,266755,4,1,5,2,1,2
2023-06-01,22798,1,0,1,3,0,3
2023-06-01,267296,5,0,5,2,0,2
2023-06-01,267354,1,3,4,1,1,1
2023-06-01,268192,16,5,21,6,4,6
2023-06-01,267305,3,1,4,1,1,1
2023-06-01,267317,4,1,5,1,2,2
2023-06-01,266756,4,0,4,1,0,1
2023-06-01,267306,5,19,24,5,2,5
2023-06-01,262689,37,2,39,9,8,10
2023-06-01,266790,2,1,3,2,1,2
2023-06-01,269799,2,4,6,2,3,3
2023-06-01,267307,7,0,7,1,0,1
2023-06-01,267308,7,0,7,2,0,2
2023-06-01,267327,6,0,6,1,0,1
2023-06-01,265549,4,0,4,1,0,1
2023-06-01,267323,3,1,4,1,1,1
2023-06-01,267311,2,0,2,2,0,2
2023-06-01,52981,15,1,16,9,6,9
2023-06-01,267312,4,0,4,1,0,1
2023-06-01,267324,3,5,8,3,2,3
2023-06-01,266781,3,1,4,1,1,1
2023-06-01,267314,1,0,1,1,0,1
2023-06-01,267328,7,3,10,1,1,1
2023-06-01,267319,5,1,6,6,2,6
2023-06-01,271015,7,1,8,2,1,2
2023-06-01,267315,4,2,6,2,2,2
2023-06-01,267320,6,3,9,2,2,2
2023-06-01,266816,3,2,5,1,1,1
2023-06-01,267372,3,1,4,4,2,4
2023-06-01,267325,7,5,12,8,6,8
2023-06-01,267347,5,0,5,2,0,2
2023-06-01,265205,5,4,9,4,1,4
2023-06-01,267326,3,3,6,3,5,5
2023-06-01,267348,7,3,10,1,1,1
2023-06-01,267349,3,0,3,2,0,2
2023-06-01,267395,7,7,14,1,1,1
2023-06-01,267396,4,3,7,4,1,4
2023-06-01,52652,3,1,4,3,1,3
2023-06-01,61784,14,1,15,6,3,7
2023-06-01,267397,5,1,6,5,3,5
2023-06-01,267339,4,6,10,1,2,2
2023-06-01,267380,5,1,6,7,4,8
2023-06-01,262320,1,1,2,4,2,4
2023-06-01,267340,2,1,3,1,1,1
2023-06-01,271675,1,1,2,1,1,1
2023-06-01,267341,1,5,6,1,1,1
2023-06-01,267330,6,2,8,2,2,3
2023-06-01,267350,3,1,4,2,2,2
2023-06-01,267352,3,0,3,2,0,2
2023-06-01,263699,49,1,50,4,2,4
2023-06-01,266773,2,1,3,1,1,1
2023-06-01,267331,2,2,4,1,1,1
2023-06-01,267334,7,1,8,7,5,7
2023-06-01,263411,15,7,22,11,6,11
2023-06-01,26592,62,2,64,14,5,15
2023-06-01,262898,14,1,15,7,5,8
2023-06-01,267351,5,1,6,2,2,2
2023-06-01,267408,2,2,4,4,3,6
2023-06-01,61590,5,0,5,3,0,3
2023-06-01,264939,4,1,5,6,1,6
2023-06-01,267336,4,2,6,3,2,3
2023-06-01,267342,3,1,4,1,1,1
2023-06-01,268212,1,0,1,1,0,1
2023-06-01,267415,3,1,4,1,1,1
2023-06-01,266769,1,0,1,1,0,1
2023-06-01,267359,5,1,6,1,1,1
2023-06-01,28669,111,3,114,22,6,22
2023-06-01,267343,1,1,2,4,4,4
2023-06-01,267353,1,1,2,1,1,1
2023-06-01,267360,7,7,14,4,2,4
2023-06-01,270561,4,1,5,4,3,4
2023-06-01,267361,3,3,6,3,3,3
2023-06-01,266766,4,0,4,1,0,1
2023-06-01,267363,7,7,14,6,6,6
2023-06-01,267364,3,1,4,1,1,1
2023-06-01,267344,3,1,4,3,3,4
2023-06-01,266782,2,0,2,1,0,1
2023-06-01,266762,5,0,5,1,0,1
2023-06-01,267355,5,4,9,5,4,6
2023-06-01,267401,7,0,7,3,0,3
2023-06-01,267370,5,1,6,1,1,1
2023-06-01,266780,5,1,6,3,1,3
2023-06-01,266772,1,0,1,1,0,1
2023-06-01,266800,4,0,4,3,0,3
2023-06-01,267374,7,0,7,1,0,1
2023-06-01,267365,3,1,4,3,2,3
2023-06-01,263908,3,3,6,4,1,4
2023-06-01,263265,13,1,14,6,1,6
2023-06-01,267382,3,0,3,1,0,1
2023-06-01,267383,4,3,7,3,2,3
2023-06-01,267368,5,3,8,3,1,3
2023-06-01,262237,40,1,41,6,3,7
2023-06-01,52290,4,0,4,2,0,2
2023-06-01,268203,3,1,4,2,2,2
2023-06-01,264811,1,0,1,3,2,3
2023-06-01,266792,4,0,4,1,0,1
2023-06-01,267375,7,1,8,2,1,2
2023-06-01,266763,4,0,4,1,0,1
2023-06-01,267369,7,3,10,5,4,5
2023-06-01,7005,9,0,9,6,0,6
2023-06-01,266764,1,0,1,1,0,1
2023-06-01,267377,2,0,2,2,0,2
2023-06-01,267384,5,1,6,2,3,3
2023-06-01,267403,7,1,8,1,1,1
2023-06-01,267385,3,0,3,3,0,3
2023-06-01,52626,21,7,28,4,1,4
2023-06-01,267393,6,0,6,2,0,2
2023-06-01,267379,3,1,4,2,1,2
2023-06-01,266765,7,0,7,2,0,2
2023-06-01,266785,4,0,4,1,0,1
2023-06-01,267386,5,4,9,6,3,6
2023-06-01,53191,16,7,23,5,5,5
2023-06-01,267404,5,2,7,2,1,2
2023-06-01,267387,7,3,10,5,4,5
2023-06-01,267391,1,1,2,1,1,1
2023-06-01,267405,5,1,6,2,1,2
2023-06-01,262391,38,9,47,1,1,1
2023-06-01,272021,5,3,8,3,2,3
2023-06-01,267398,6,7,13,8,6,8
2023-06-01,267381,5,4,9,1,1,1
2023-06-01,267407,5,1,6,2,2,2
2023-06-01,267399,3,0,3,2,0,2
2023-06-01,266779,7,0,7,2,0,2
2023-06-01,267400,1,0,1,1,0,1
2023-06-01,267411,4,0,4,3,0,3
2023-06-01,267394,3,1,4,2,1,2
2023-06-01,267412,4,0,4,5,0,5
2023-06-01,61731,5,3,8,4,4,5
2023-06-01,268209,1,3,4,1,1,2
2023-06-01,267417,4,0,4,1,0,1
2023-06-01,267356,7,3,10,3,3,3
2023-06-01,268194,5,0,5,4,0,4
2023-06-01,264848,3,0,3,4,0,4
2023-06-01,267410,5,0,5,3,0,3
2023-06-01,266348,4,3,7,7,5,7
2023-06-01,266775,2,0,2,2,0,2
2023-06-01,266777,4,0,4,3,0,3
2023-06-01,268195,1,1,2,1,1,1
2023-06-01,267413,1,0,1,1,0,1
2023-06-01,267416,5,1,6,4,1,4
2023-06-01,268190,4,2,6,2,1,2
2023-06-01,28201,185,7,192,11,7,11
2023-06-01,268196,3,1,4,3,2,3
2023-06-01,28585,8,2,10,13,5,13
2023-06-01,267422,7,3,10,2,1,2
2023-06-01,268189,7,5,12,2,2,2
2023-06-01,262399,35,1,36,2,2,3
2023-06-01,53238,24,15,39,15,7,15
2023-06-01,268197,3,0,3,2,0,2
2023-06-01,268253,4,3,7,6,2,6
2023-06-01,268202,1,0,1,4,0,4
2023-06-01,267418,7,3,10,2,1,2
2023-06-01,267419,1,2,3,2,2,2
2023-06-01,264238,12,0,12,2,0,2
2023-06-01,267421,3,0,3,1,0,1
2023-06-01,268193,1,0,1,1,0,1
2023-06-01,268191,3,1,4,4,1,4
2023-06-01,268198,1,0,1,1,0,1
2023-06-01,268206,3,1,4,1,1,1
2023-06-01,267564,3,1,4,3,2,3
2023-06-01,268229,7,0,7,3,0,3
2023-06-01,268237,3,3,6,2,2,2
2023-06-01,268214,3,1,4,7,7,8
2023-06-01,268201,7,1,8,4,4,4
2023-06-01,268230,7,5,12,2,2,2
2023-06-01,26426,21,0,21,2,0,2
2023-06-01,266797,1,0,1,2,0,2
2023-06-01,268217,7,1,8,1,1,1
2023-06-01,52892,61,6,67,10,5,10
2023-06-01,268218,5,3,8,1,1,1
2023-06-01,268208,1,0,1,1,0,1
2023-06-01,268215,3,0,3,1,0,1
2023-06-01,268210,5,1,6,4,3,4
2023-06-01,268213,3,1,4,2,1,2
2023-06-01,268219,3,1,4,1,1,1
2023-06-01,268211,1,1,2,1,1,1
2023-06-01,268222,4,3,7,6,6,7
2023-06-01,266788,4,0,4,1,0,1
2023-06-01,266791,1,0,1,2,0,2
2023-06-01,268239,7,1,8,1,1,1
2023-06-01,266813,5,0,5,3,0,3
2023-06-01,27881,62,0,62,4,0,4
2023-06-01,268221,3,3,6,6,3,6
2023-06-01,268232,1,1,2,2,2,2
2023-06-01,271204,7,0,7,6,0,6
2023-06-01,268224,5,1,6,1,1,1
2023-06-01,268228,3,0,3,1,0,1
2023-06-01,268225,7,1,8,5,5,5
2023-06-01,271478,4,4,8,5,5,5
2023-06-01,268226,1,0,1,1,0,1
2023-06-01,266794,3,0,3,1,0,1
2023-06-01,268227,7,1,8,1,1,1
2023-06-01,268233,3,1,4,4,2,4
2023-06-01,268231,5,1,6,5,5,5
2023-06-01,268234,3,23,26,4,3,4
2023-06-01,267701,2,0,2,2,0,2
2023-06-01,268306,1,1,2,1,1,1
2023-06-01,272187,7,5,12,5,3,5
2023-06-01,268317,3,5,8,4,2,4
2023-06-01,266801,5,0,5,2,0,2
2023-06-01,64111,1,0,1,2,0,2
2023-06-01,268240,1,0,1,2,0,2
2023-06-01,266812,5,1,6,2,1,2
2023-06-01,268255,11,2,13,1,1,1
2023-06-01,262945,5,0,5,6,0,6
2023-06-01,268254,5,0,5,1,0,1
2023-06-01,268241,3,0,3,1,0,1
2023-06-01,262256,21,0,21,2,0,2
2023-06-01,266802,2,0,2,2,0,2
2023-06-01,266818,4,0,4,2,0,2
2023-06-01,268256,4,1,5,2,1,2
2023-06-01,268244,7,0,7,2,0,2
2023-06-01,266803,5,0,5,1,0,1
2023-06-01,268351,1,1,2,3,2,3
2023-06-01,266804,2,0,2,2,0,2
2023-06-01,268261,5,4,9,3,2,3
2023-06-01,266611,4,3,7,4,1,4
2023-06-01,268243,7,31,38,4,3,4
2023-06-01,268245,4,1,5,2,1,2
2023-06-01,268251,5,1,6,4,3,5
2023-06-01,268247,5,1,6,4,3,4
2023-06-01,268249,5,3,8,2,2,2
2023-06-01,268250,1,1,2,3,2,3
2023-06-01,264899,5,1,6,8,5,8
2023-06-01,268257,8,1,9,2,1,2
2023-06-01,268252,6,1,7,3,2,3
2023-06-01,268292,4,0,4,1,0,1
2023-06-01,28142,28,4,32,12,5,12
2023-06-01,262437,8,1,9,3,2,3
2023-06-01,268258,3,2,5,2,2,2
2023-06-01,268274,3,1,4,2,1,2
2023-06-01,268277,5,0,5,1,0,1
2023-06-01,268262,5,7,12,3,3,3
2023-06-01,268263,4,1,5,2,2,2
2023-06-01,268310,5,1,6,1,1,1
2023-06-01,266814,5,2,7,1,2,2
2023-06-01,52318,2,0,2,2,0,2
2023-06-01,268300,1,1,2,1,1,1
2023-06-01,268275,7,0,7,1,0,1
2023-06-01,266612,2,1,3,2,1,2
2023-06-01,268264,3,0,3,3,0,3
2023-06-01,268265,7,1,8,1,1,1
2023-06-01,266820,2,4,6,1,1,1
2023-06-01,61478,5,1,6,3,3,3
2023-06-01,268268,3,1,4,4,1,4
2023-06-01,268269,3,1,4,3,3,3
2023-06-01,268280,5,0,5,3,0,3
2023-06-01,268285,3,3,6,1,1,1
2023-06-01,268271,3,0,3,1,0,1
2023-06-01,268272,4,2,6,4,2,4
2023-06-01,268273,7,0,7,1,0,1
2023-06-01,268276,5,1,6,4,1,4
2023-06-01,266835,1,0,1,2,0,2
2023-06-01,268281,5,0,5,2,0,2
2023-06-01,61593,7,1,8,3,1,3
2023-06-01,268278,1,2,3,3,1,3
2023-06-01,268356,3,3,6,2,1,2
2023-06-01,268286,5,0,5,2,0,2
2023-06-01,268284,1,1,2,1,1,1
2023-06-01,268314,4,1,5,3,1,3
2023-06-01,266827,1,1,2,1,1,1
2023-06-01,266823,4,1,5,3,1,3
2023-06-01,266828,2,0,2,2,0,2
2023-06-01,268287,4,0,4,2,0,2
2023-06-01,268288,7,3,10,4,4,6
2023-06-01,268294,7,9,16,1,1,1
2023-06-01,268289,1,1,2,5,4,5
2023-06-01,268290,5,2,7,4,3,4
2023-06-01,268298,7,1,8,1,1,1
2023-06-01,265958,3,1,4,3,1,3
2023-06-01,268303,5,0,5,2,0,2
2023-06-01,268299,5,0,5,3,0,3
2023-06-01,262560,7,0,7,3,0,3
2023-06-01,266819,1,0,1,5,0,5
2023-06-01,268291,4,0,4,1,0,1
2023-06-01,268302,3,1,4,4,1,4
2023-06-01,268304,7,1,8,3,1,3
2023-06-01,268295,3,1,4,3,1,3
2023-06-01,270581,7,1,8,7,3,7
2023-06-01,268307,5,0,5,1,0,1
2023-06-01,268296,7,17,24,7,4,7
2023-06-01,268297,1,1,2,1,1,1
2023-06-01,268333,3,0,3,3,0,3
2023-06-01,268305,3,1,4,4,2,4
2023-06-01,268308,6,4,10,6,3,6
2023-06-01,266825,5,0,5,3,0,3
2023-06-01,52360,2,1,3,10,2,10
2023-06-01,266837,4,0,4,3,0,3
2023-06-01,266836,5,0,5,2,0,2
2023-06-01,52372,3,0,3,3,0,3
2023-06-01,266831,7,1,8,4,3,5
2023-06-01,268312,3,1,4,4,1,4
2023-06-01,266829,1,0,1,2,0,2
2023-06-01,268321,7,9,16,5,4,5
2023-06-01,268328,5,1,6,3,2,3
2023-06-01,266460,7,5,12,19,14,22
2023-06-01,268319,5,1,6,3,1,3
2023-06-01,268316,2,0,2,1,0,1
2023-06-01,268329,3,1,4,1,1,1
2023-06-01,268318,2,0,2,1,0,1
2023-06-01,268335,6,4,10,3,2,3
2023-06-01,28326,16,2,18,9,1,9
2023-06-01,263822,5,0,5,3,0,3
2023-06-01,266861,5,0,5,1,0,1
2023-06-01,268324,4,1,5,1,1,1
2023-06-01,268325,2,0,2,3,0,3
2023-06-01,52906,7,1,8,2,2,2
2023-06-01,263027,8,3,11,5,2,5
2023-06-01,28187,9,1,10,7,5,7
2023-06-01,268327,1,1,2,1,1,1
2023-06-01,268332,3,2,5,1,1,1
2023-06-01,266832,2,0,2,1,0,1
2023-06-01,268542,4,0,4,1,0,1
2023-06-01,266844,1,1,2,1,1,1
2023-06-01,268347,5,1,6,2,1,2
2023-06-01,268341,5,1,6,1,1,1
2023-06-01,268334,4,1,5,4,4,5
2023-06-01,52950,3,1,4,7,5,7
2023-06-01,268558,1,1,2,1,1,1
2023-06-01,266860,4,0,4,4,0,4
2023-06-01,268336,3,0,3,4,0,4
2023-06-01,265551,4,0,4,3,0,3
2023-06-01,266807,4,0,4,1,0,1
2023-06-01,266848,3,1,4,1,1,1
2023-06-01,268360,7,1,8,1,1,1
2023-06-01,268339,6,1,7,5,5,5
2023-06-01,268361,2,1,3,2,2,2
2023-06-01,27730,5,0,5,4,0,4
2023-06-01,266843,5,0,5,2,0,2
2023-06-01,268343,5,1,6,1,1,1
2023-06-01,268342,5,1,6,1,1,1
2023-06-01,268350,7,4,11,4,2,4
2023-06-01,268364,7,7,14,1,1,1
2023-06-01,268344,7,3,10,5,6,6
2023-06-01,266838,1,0,1,1,0,1
2023-06-01,268367,2,1,3,1,1,1
2023-06-01,268349,3,3,6,1,2,2
2023-06-01,268346,7,3,10,6,5,6
2023-06-01,21623,15,2,17,3,2,3
2023-06-01,263616,2,1,3,15,12,15
2023-06-01,268352,3,3,6,2,1,2
2023-06-01,262657,3,1,4,3,1,3
2023-06-01,266859,2,0,2,1,0,1
2023-06-01,268374,7,1,8,2,2,2
2023-06-01,266840,5,0,5,1,0,1
2023-06-01,266845,5,0,5,1,0,1
2023-06-01,266871,1,0,1,1,0,1
2023-06-01,268375,3,3,6,3,3,3
2023-06-01,266858,4,8,12,1,2,2
2023-06-01,268353,3,3,6,3,3,3
2023-06-01,265438,7,2,9,6,2,6
2023-06-01,268354,3,1,4,1,1,2
2023-06-01,266854,5,0,5,1,0,1
2023-06-01,268384,5,3,8,5,4,7
2023-06-01,266873,1,0,1,1,0,1
2023-06-01,266862,1,0,1,1,0,1
2023-06-01,266874,5,0,5,1,0,1
2023-06-01,266864,1,0,1,1,0,1
2023-06-01,61942,49,4,53,4,5,6
2023-06-01,268475,1,0,1,3,0,3
2023-06-01,268497,1,0,1,2,0,2
2023-06-01,266855,4,1,5,3,1,3
2023-06-01,268460,1,1,2,2,2,2
2023-06-01,266868,1,0,1,1,0,1
2023-06-01,266850,4,0,4,6,0,6
2023-06-01,27833,40,6,46,6,4,6
2023-06-01,266852,5,0,5,2,0,2
2023-06-01,266863,5,1,6,4,1,4
2023-06-01,268366,1,1,2,2,1,2
2023-06-01,268362,4,1,5,3,1,3
2023-06-01,268365,5,0,5,2,0,2
2023-06-01,268372,7,1,8,1,1,1
2023-06-01,268369,5,2,7,3,2,3
2023-06-01,268359,7,3,10,4,5,6
2023-06-01,266856,4,0,4,2,0,2
2023-06-01,268357,3,3,6,1,1,1
2023-06-01,268368,5,0,5,3,0,3
2023-06-01,268373,5,1,6,1,1,1
2023-06-01,273593,2,3,5,1,2,2
2023-06-01,268385,7,7,14,6,5,6
2023-06-01,268371,5,1,6,1,1,1
2023-06-01,268379,7,4,11,2,1,2
2023-06-01,268380,5,1,6,1,1,1
2023-06-01,268381,4,1,5,1,1,1
2023-06-01,268468,2,1,3,4,3,4
2023-06-01,268405,1,0,1,1,0,1
2023-06-01,266857,5,0,5,1,0,1
2023-06-01,268388,7,1,8,2,1,2
2023-06-01,271839,3,0,3,1,0,1
2023-06-01,267463,7,1,8,7,4,7
2023-06-01,268383,4,1,5,2,1,2
2023-06-01,268376,4,0,4,1,0,1
2023-06-01,271019,5,3,8,3,3,3
2023-06-01,268389,3,1,4,1,1,1
2023-06-01,273624,1,1,2,1,1,1
2023-06-01,268390,5,1,6,6,1,6
2023-06-01,268377,7,1,8,2,3,3
2023-06-01,268482,3,3,6,3,3,3
2023-06-01,268378,5,1,6,1,1,1
2023-06-01,268401,2,0,2,1,0,1
2023-06-01,135257,12,0,12,3,0,3
2023-06-01,132772,2,0,2,1,0,1
2023-06-01,134697,56,9,65,4,3,4
2023-06-01,9270,34,2,36,19,1,19
2023-06-01,146772,6,0,6,2,0,2
2023-06-01,133712,10,0,10,3,0,3
2023-06-01,40310,2,0,2,1,0,1
2023-06-01,40313,1,0,1,1,0,1
2023-06-01,134732,45,17,62,11,5,11
2023-06-01,141257,4,0,4,2,0,2
2023-06-01,136342,14,2,16,4,1,4
2023-06-01,135256,6,0,6,1,0,1
2023-06-01,135259,3,8,11,3,1,3
2023-06-01,135407,32,1,33,1,1,1
2023-06-01,212879,26,0,26,2,0,2
2023-06-01,135188,8,3,11,2,2,2
2023-06-01,135794,1,0,1,1,0,1
2023-06-01,137386,16,0,16,6,0,6
2023-06-01,141366,1,0,1,1,0,1
2023-06-01,135411,2,0,2,3,0,3
2023-06-01,134090,26,22,48,9,6,10
2023-06-01,133997,0,0,0,2,0,2
2023-06-01,135420,7,0,7,5,0,5
2023-06-01,134772,6,48,54,1,1,1
2023-06-01,63655,10,0,10,1,0,1
2023-06-01,140031,11,0,11,4,0,4
2023-06-01,131265,9,0,9,5,0,5
2023-06-01,55664,7,1,8,1,1,1
2023-06-01,149600,7,0,7,5,0,5
2023-06-01,135189,8,0,8,1,0,1
2023-06-01,135125,11,0,11,1,0,1
2023-06-01,24669,4,0,4,1,0,1
2023-06-01,135036,8,0,8,3,0,3
2023-06-01,135423,6,0,6,13,0,13
2023-06-01,135427,4,0,4,2,0,2
2023-06-01,134864,4,0,4,1,0,1
2023-06-01,134180,14,0,14,3,0,3
2023-06-01,55769,31,2,33,5,1,5
2023-06-01,135433,8,0,8,3,0,3
2023-06-01,135795,9,1,10,6,1,6
2023-06-01,38511,332,4,336,6,1,6
2023-06-01,135247,19,2,21,5,2,5
2023-06-01,134325,15,1,16,1,1,1
2023-06-01,63182,22,0,22,5,0,5
2023-06-01,55406,20,1,21,13,1,13
2023-06-01,131711,14,0,14,7,0,7
2023-06-01,135356,24,1,25,4,2,4
2023-06-01,58668,10,1,11,3,1,4
2023-06-01,59362,25,3,28,4,1,4
2023-06-01,132757,12,0,12,1,0,1
2023-06-01,135212,17,3,20,14,5,14
2023-06-01,135235,2,1,3,2,1,2
2023-06-01,139259,63,0,63,2,0,2
2023-06-01,137702,98,13,111,2,1,2
2023-06-01,13896,20,0,20,13,0,13
2023-06-01,63747,16,0,16,4,0,4
2023-06-01,63760,4,0,4,2,0,2
2023-06-01,56212,2,0,2,2,0,2
2023-06-01,135530,2,0,2,3,0,3
2023-06-01,207636,32,0,32,1,0,1
2023-06-01,38136,50,20,70,6,218,218
2023-06-01,62352,40,0,40,5,0,5
2023-06-01,200509,33,0,33,3,0,3
2023-06-01,60592,19,3,22,10,6,12
2023-06-01,209005,2,0,2,4,0,4
2023-06-01,205204,1,0,1,1,0,1
2023-06-01,203481,6,0,6,2,0,2
2023-06-01,206424,2,0,2,2,0,2
2023-06-01,204684,1,0,1,7,0,7
2023-06-01,57803,17,0,17,1,0,1
2023-06-01,203087,15,0,15,4,0,4
2023-06-01,208825,2,0,2,2,0,2
2023-06-01,47513,2,0,2,3,0,3
2023-06-01,61058,1,0,1,3,0,3
2023-06-01,20850,8,0,8,7,0,7
2023-06-01,61019,2,0,2,1,0,1
2023-06-01,61009,1,0,1,3,0,3
2023-06-01,208852,1,0,1,1,0,1
2023-06-01,60873,2,0,2,3,0,3
2023-06-01,212614,1,0,1,3,0,3
2023-06-01,30881,24,2,26,2,1,2
2023-06-01,59502,2,0,2,1,0,1
2023-06-01,196768,4,0,4,1,0,1
2023-06-01,43330,4,0,4,4,0,4
2023-06-01,203173,1,0,1,3,0,3
2023-06-01,38976,7,0,7,4,0,4
2023-06-01,60986,5,0,5,5,0,5
2023-06-01,48293,25,1,26,20,6,20
2023-06-01,205569,7,0,7,4,0,4
2023-06-01,58238,3,0,3,2,0,2
2023-06-01,60919,1,0,1,3,0,3
2023-06-01,200401,1,0,1,1,0,1
2023-06-01,44341,4,0,4,1,0,1
2023-06-01,211150,1,0,1,2,0,2
2023-06-01,56669,3,0,3,5,0,5
2023-06-01,39853,1,0,1,4,0,4
2023-06-01,47193,6,0,6,4,0,4
2023-06-01,60931,3,0,3,1,0,1
2023-06-01,44927,12,0,12,7,0,7
2023-06-01,207952,2,0,2,3,0,3
2023-06-01,204848,1,0,1,2,0,2
2023-06-01,211399,2,0,2,1,0,1
2023-06-01,211951,1,0,1,1,0,1
2023-06-01,204735,4,0,4,3,0,3
2023-06-01,201179,7,0,7,1,0,1
2023-06-01,212999,9,0,9,2,0,2
2023-06-01,213119,1,0,1,1,0,1
2023-06-01,208936,2,0,2,1,0,1
2023-06-01,200819,4,0,4,1,0,1
2023-06-01,203527,2,0,2,2,0,2
2023-06-01,197163,4,0,4,1,0,1
2023-06-01,212487,2,0,2,2,0,2
2023-06-01,203695,2,0,2,3,0,3
2023-06-01,198185,2,0,2,6,0,6
2023-06-01,204199,2,0,2,1,0,1
2023-06-01,39927,21,0,21,17,0,17
2023-06-01,203493,2,1,3,5,1,5
2023-06-01,206134,1,0,1,1,0,1
2023-06-01,211526,3,1,4,12,1,12
2023-06-01,60457,1,0,1,3,0,3
2023-06-01,205132,10,0,10,20,0,20
2023-06-01,201384,1,0,1,1,0,1
2023-06-01,60560,4,0,4,2,0,2
2023-06-01,34295,131,0,131,4,0,4
2023-06-01,15735,133,3,136,8,3,8
2023-06-01,12929,6,2,8,2,1,2
2023-06-01,51551,7,2,9,7,2,7
2023-06-01,212421,0,0,0,7,6,7
2023-06-01,45005,2,1,3,1,1,1
2023-06-01,210728,2,1,3,8,7,11
2023-06-01,44694,2,0,2,1,0,1
2023-06-01,42816,1,0,1,2,0,2
2023-06-01,197369,3,0,3,3,0,3
2023-06-01,197712,23,0,23,4,0,4
2023-06-01,51572,1,0,1,1,0,1
2023-06-01,52030,16,1,17,4,4,4
2023-06-01,51504,4,0,4,3,0,3
2023-06-01,44430,1,0,1,4,0,4
2023-06-01,202263,4,0,4,1,0,1
2023-06-01,202054,7,0,7,4,0,4
2023-06-01,51606,9,0,9,6,0,6
2023-06-01,51878,4,0,4,2,0,2
2023-06-01,47337,2,0,2,2,0,2
2023-06-01,43584,4,0,4,1,0,1
2023-06-01,50020,3,0,3,17,0,17
2023-06-01,59746,1,0,1,3,0,3
2023-06-01,202864,1,0,1,1,0,1
2023-06-01,210299,1,0,1,2,0,2
2023-06-01,207758,3,0,3,2,0,2
2023-06-01,48961,8,1,9,1,1,1
2023-06-01,44391,50,1,51,4,1,4
2023-06-01,44136,4,1,5,2,2,2
2023-06-01,198847,10,0,10,4,0,4
2023-06-01,51682,12,0,12,1,0,1
2023-06-01,20741,3,1,4,5,5,5
2023-06-01,35012,25,2,27,6,4,6
2023-06-01,207658,4,0,4,4,0,4
2023-06-01,51910,2,0,2,2,0,2
2023-06-01,204154,3,1,4,1,1,1
2023-06-01,51675,5,1,6,3,2,3
2023-06-01,58307,2,1,3,16,10,19
2023-06-01,197324,5,0,5,1,0,1
2023-06-01,41902,9,0,9,3,0,3
2023-06-01,34273,2,0,2,3,0,3
2023-06-01,49675,12,3,15,9,3,10
2023-06-01,59455,13,1,14,7,5,7
2023-06-01,8387,17,3,20,11,3,11
2023-06-01,44628,8,0,8,11,0,11
2023-06-01,201260,2,0,2,1,0,1
2023-06-01,20677,13,1,14,10,8,12
2023-06-01,43149,2,0,2,2,0,2
2023-06-01,50409,1,0,1,3,0,3
2023-06-01,58351,1,0,1,3,0,3
2023-06-01,25071,31,0,31,3,0,3
2023-06-01,51707,3,0,3,1,0,1
2023-06-01,47253,100,0,100,3,0,3
2023-06-01,51708,2,1,3,5,2,5
2023-06-01,50507,3,0,3,5,0,5
2023-06-01,203148,5,3,8,4,3,4
2023-06-01,41354,18,1,19,11,7,12
2023-06-01,15689,2,1,3,3,2,3
2023-06-01,34156,2,1,3,4,3,4
2023-06-01,39280,18,1,19,3,1,3
2023-06-01,50535,6,3,9,1,1,1
2023-06-01,35665,17,1,18,7,2,7
2023-06-01,50811,2,0,2,3,0,3
2023-06-01,61418,6,0,6,2,0,2
2023-06-01,61271,1,1,2,2,2,2
2023-06-01,60345,2,1,3,6,1,6
2023-06-01,61150,1,1,2,1,1,1
2023-06-01,51762,8,1,9,4,1,4
2023-06-01,35328,21,0,21,6,0,6
2023-06-01,197989,4,0,4,3,0,3
2023-06-01,197370,4,0,4,2,0,2
2023-06-01,6738,11,0,11,4,0,4
2023-06-01,60803,1,0,1,1,0,1
2023-06-01,51795,9,0,9,3,0,3
2023-06-01,51785,4,0,4,2,0,2
2023-06-01,58123,2,1,3,3,2,4
2023-06-01,49082,8,0,8,1,0,1
2023-06-01,51806,1,1,2,2,2,2
2023-06-01,52125,11,0,11,2,0,2
2023-06-01,8723,30,1,31,5,4,6
2023-06-01,39271,4,0,4,5,0,5
2023-06-01,49603,5,1,6,1,1,1
2023-06-01,197407,3,0,3,1,0,1
2023-06-01,39102,11,0,11,2,0,2
2023-06-01,208030,1,0,1,1,0,1
2023-06-01,51865,5,5,10,10,3,10
2023-06-01,13035,4,0,4,2,0,2
2023-06-01,207319,2,2,4,2,2,2
2023-06-01,201783,1,1,2,3,2,3
2023-06-01,20681,8,1,9,8,5,9
2023-06-01,28785,12,1,13,6,4,6
2023-06-01,34458,16,0,16,3,0,3
2023-06-01,51737,3,0,3,1,0,1
2023-06-01,15925,6,1,7,5,5,6
2023-06-01,197352,5,0,5,2,0,2
2023-06-01,16229,160,0,160,1,0,1
2023-06-01,5504,27,0,27,7,0,7
2023-06-01,197785,1,0,1,1,0,1
2023-06-01,43265,4,0,4,2,0,2
2023-06-01,34518,18,1,19,3,1,3
2023-06-01,42062,5,0,5,1,0,1
2023-06-01,39308,23,0,23,2,0,2
2023-06-01,39886,3,0,3,6,3,6
2023-06-01,35184,2,1,3,1,1,1
2023-06-01,39288,6,1,7,10,3,10
2023-06-01,210016,3,0,3,1,0,1
2023-06-01,212095,1,0,1,3,0,3
2023-06-01,48781,8,0,8,5,0,5
2023-06-01,210359,1,0,1,3,0,3
2023-06-01,209030,4,2,6,17,5,19
2023-06-01,43853,8,2,10,4,2,4
2023-06-01,51908,1,0,1,1,0,1
2023-06-01,205039,16,0,16,3,0,3
2023-06-01,61242,2,0,2,4,0,4
2023-06-01,197615,5,0,5,3,0,3
2023-06-01,208892,2,0,2,7,0,7
2023-06-01,49102,2,0,2,18,0,18
2023-06-01,41997,5,1,6,1,1,1
2023-06-01,42514,7,1,8,5,2,5
2023-06-01,197441,1,1,2,2,1,2
2023-06-01,60131,4,1,5,1,1,1
2023-06-01,49747,1,1,2,5,2,5
2023-06-01,51968,2,1,3,2,1,2
2023-06-01,43314,6,0,6,6,0,6
2023-06-01,60822,9,0,9,11,0,11
2023-06-01,207194,2,0,2,2,0,2
2023-06-01,197465,3,1,4,2,2,2
2023-06-01,206837,29,0,29,4,0,4
2023-06-01,209087,29,0,29,4,0,4
2023-06-01,51309,6,0,6,4,0,4
2023-06-01,51300,20,1,21,4,1,4
2023-06-01,58053,1,0,1,2,0,2
2023-06-01,35205,17,5,22,4,7,9
2023-06-01,197208,2,0,2,1,0,1
2023-06-01,47927,6,1,7,8,3,9
2023-06-01,39586,4,0,4,2,0,2
2023-06-01,197403,2,1,3,1,2,3
2023-06-01,199312,11,0,11,1,0,1
2023-06-01,51326,1,1,2,3,4,4
2023-06-01,28858,3,0,3,7,0,7
2023-06-01,48923,1,0,1,1,0,1
2023-06-01,197988,3,1,4,3,1,3
2023-06-01,51773,2,0,2,1,0,1
2023-06-01,41885,6,1,7,2,2,2
2023-06-01,42339,3,1,4,6,4,7
2023-06-01,60442,1,0,1,1,0,1
2023-06-01,199402,1,0,1,1,0,1
2023-06-01,49318,10,0,10,4,0,4
2023-06-01,12905,5,1,6,8,3,8
2023-06-01,201924,14,2,16,3,2,3
2023-06-01,197204,10,5,15,12,2,12
2023-06-01,197226,15,2,17,7,2,7
2023-06-01,206833,6,1,7,3,1,3
2023-06-01,29394,3,1,4,2,3,3
2023-06-01,51718,4,0,4,2,0,2
2023-06-01,51406,1,0,1,1,0,1
2023-06-01,51378,1,1,2,2,2,2
2023-06-01,13247,10,3,13,9,8,11
2023-06-01,197235,7,0,7,8,0,8
2023-06-01,197247,2,0,2,1,0,1
2023-06-01,34086,22,2,24,8,4,9
2023-06-01,5605,11,3,14,14,9,15
2023-06-01,6878,33,3,36,3,2,3
2023-06-01,199669,7,5,12,6,5,7
2023-06-01,51437,11,0,11,4,0,4
2023-06-01,51405,1,0,1,1,0,1
2023-06-01,35592,30,1,31,9,3,9
2023-06-01,44300,5,1,6,3,2,3
2023-06-01,15659,11,2,13,6,4,6
2023-06-01,44764,4,2,6,2,2,2
2023-06-01,35266,9,3,12,20,12,21
2023-06-01,44585,13,0,13,3,0,3
2023-06-01,20694,6,2,8,4,4,5
2023-06-01,5567,4,0,4,4,0,4
2023-06-01,60925,1,0,1,1,0,1
2023-06-01,28905,2,0,2,3,0,3
2023-06-01,41431,3,0,3,2,0,2
2023-06-01,43503,6,0,6,4,0,4
2023-06-01,197277,3,1,4,3,1,3
2023-06-01,56637,3,0,3,2,0,2
2023-06-01,197240,4,0,4,2,0,2
2023-06-01,51978,7,1,8,7,6,9
2023-06-01,196881,5,1,6,8,4,8
2023-06-01,198957,2,0,2,1,0,1
2023-06-01,43070,7,3,10,4,3,4
2023-06-01,25521,10,1,11,11,7,13
2023-06-01,48953,32,1,33,1,1,1
2023-06-01,51489,5,0,5,3,0,3
2023-06-01,39444,8,1,9,6,4,6
2023-06-01,196708,7,0,7,1,0,1
2023-06-01,51539,3,1,4,2,1,2
2023-06-01,33883,3,1,4,1,1,1
2023-06-01,51499,2,0,2,3,0,3
2023-06-01,51764,28,0,28,6,0,6
2023-06-01,41942,5,0,5,2,0,2
2023-06-01,43088,10,1,11,4,2,4
2023-06-01,3342,7,1,8,16,5,17
2023-06-01,29124,41,1,42,9,1,9
2023-06-01,44141,4,1,5,10,1,10
2023-06-01,12334,29,8,37,6,2,6
2023-06-01,210944,1,0,1,1,0,1
2023-06-01,47168,5,0,5,6,0,6
2023-06-01,202024,15,1,16,2,2,3
2023-06-01,207707,3,0,3,2,0,2
2023-06-01,196987,2,0,2,5,0,5
2023-06-01,59547,1,0,1,2,0,2
2023-06-01,51825,27,1,28,2,2,2
2023-06-01,51625,6,0,6,2,0,2
2023-06-01,197290,1,0,1,1,0,1
2023-06-01,51989,1,0,1,2,0,2
2023-06-01,51540,25,0,25,6,0,6
2023-06-01,51532,1,0,1,1,0,1
2023-06-01,50758,2,1,3,3,1,3
2023-06-01,39295,3,0,3,1,0,1
2023-06-01,47159,15,0,15,2,2,2
2023-06-01,50181,10,1,11,2,1,2
2023-06-01,210611,1,1,2,1,1,1
2023-06-01,44297,7,1,8,4,2,4
2023-06-01,39884,3,0,3,1,0,1
2023-06-01,48416,8,0,8,7,0,7
2023-06-01,204151,8,1,9,6,4,6
2023-06-01,211418,2,0,2,3,0,3
2023-06-01,211790,3,0,3,2,0,2
2023-06-01,213402,2,1,3,1,1,1
2023-06-01,205547,1,0,1,1,0,1
2023-06-01,34187,11,1,12,14,2,14
2023-06-01,31593,4,0,4,1,0,1
2023-06-01,44668,11,2,13,3,1,3
2023-06-01,35588,3,0,3,1,0,1
2023-06-01,206621,4,0,4,11,0,11
2023-06-01,51993,15,0,15,4,0,4
2023-06-01,47389,2,0,2,1,0,1
2023-06-01,48082,8,0,8,2,0,2
2023-06-01,50583,43,0,43,3,0,3
2023-06-01,197100,4,0,4,1,0,1
2023-06-01,48608,1,0,1,1,0,1
2023-06-01,15599,6,1,7,3,1,3
2023-06-01,207381,7,0,7,2,0,2
2023-06-01,12670,51,1,52,12,2,12
2023-06-01,9003,10,0,10,1,0,1
2023-06-01,12931,2,1,3,8,4,9
2023-06-01,199226,2,0,2,3,0,3
2023-06-01,21230,22,1,23,4,1,5
2023-06-01,25206,29,0,29,4,0,4
2023-06-01,51660,12,0,12,2,0,2
2023-06-01,44247,18,0,18,1,0,1
2023-06-01,58079,19,0,19,1,0,1
2023-06-01,8967,6,0,6,1,0,1
2023-06-01,49101,2,2,4,9,9,10
2023-06-01,49025,5,2,7,13,12,15
2023-06-01,42422,12,2,14,1,1,1
2023-06-01,34120,12,0,12,4,0,4
2023-06-01,43627,28,0,28,4,0,4
2023-06-01,51759,17,0,17,2,0,2
2023-06-01,48434,34,0,34,7,0,7
2023-06-01,204079,1,0,1,1,0,1
2023-06-01,210650,1,0,1,1,0,1
2023-06-01,39824,155,2,157,7,1,7
2023-06-01,16178,16,0,16,6,0,6
2023-06-01,51918,22,2,24,5,4,5
2023-06-01,200704,1,0,1,1,0,1
2023-06-01,29538,1,0,1,1,0,1
2023-06-01,206275,2,0,2,1,0,1
2023-06-01,15595,17,1,18,12,1,12
2023-06-01,44078,2,0,2,2,0,2
2023-06-01,29449,2,1,3,6,5,7
2023-06-01,52201,18,1,19,4,1,4
2023-06-01,8752,4,1,5,4,6,8
2023-06-01,34837,17,0,17,10,0,10
2023-06-01,44889,19,0,19,12,0,12
2023-06-01,211705,1,0,1,1,0,1
2023-06-01,52015,12,0,12,2,0,2
2023-06-01,15582,13,1,14,1,1,1
2023-06-01,50821,14,1,15,6,3,6
2023-06-01,31246,5,3,8,5,2,5
2023-06-01,207286,4,0,4,1,0,1
2023-06-01,15987,17,6,23,3,3,3
2023-06-01,8820,41,4,45,14,6,15
2023-06-01,12824,20,3,23,6,4,7
2023-06-01,29125,54,0,54,4,0,4
2023-06-01,39477,10,2,12,3,3,3
2023-06-01,44347,8,0,8,5,0,5
2023-06-01,51515,31,0,31,3,0,3
2023-06-01,201570,2,0,2,1,0,1
2023-06-01,51484,2,0,2,11,0,11
2023-06-01,208066,7,0,7,1,0,1
2023-06-01,197091,4,0,4,18,0,18
2023-06-01,201091,2,0,2,3,0,3
2023-06-01,206518,1,0,1,1,0,1
2023-06-01,201342,2,1,3,3,2,3
2023-06-01,15638,17,0,17,2,0,2
2023-06-01,48045,3,1,4,3,1,3
2023-06-01,200453,1,0,1,3,0,3
2023-06-01,50820,1,0,1,1,0,1
2023-06-01,203995,13,3,16,1,1,1
2023-06-01,197298,13,0,13,6,0,6
2023-06-01,201294,5,0,5,2,0,2
2023-06-01,198918,8,0,8,4,0,4
2023-06-01,25185,2,0,2,2,0,2
2023-06-01,21487,7,0,7,5,0,5
2023-06-01,201771,21,2,23,3,1,3
2023-06-01,43987,13,1,14,2,1,2
2023-06-01,24588,19,0,19,1,0,1
2023-06-01,51582,28,33,61,4,2,4
2023-06-01,34841,5,0,5,1,0,1
2023-06-01,197350,35,0,35,3,0,3
2023-06-01,5503,14,1,15,9,5,9
2023-06-01,51704,2,1,3,3,1,3
2023-06-01,21403,1,0,1,1,0,1
2023-06-01,212732,1,0,1,2,0,2
2023-06-01,205576,1,0,1,2,0,2
2023-06-01,205060,1,0,1,3,0,3
2023-06-01,51784,4,1,5,5,2,5
2023-06-01,35664,4,0,4,2,0,2
2023-06-01,56885,2,0,2,2,0,2
2023-06-01,44184,1,0,1,1,0,1
2023-06-01,59398,4,2,6,3,1,3
2023-06-01,52044,2,0,2,1,0,1
2023-06-01,203120,7,0,7,1,0,1
2023-06-01,205993,13,0,13,2,0,2
2023-06-01,50887,6,0,6,1,0,1
2023-06-01,39758,6,0,6,1,0,1
2023-06-01,56654,10,1,11,10,1,10
2023-06-01,40975,10,3,13,3,1,3
2023-06-01,31554,18,2,20,9,3,9
2023-06-01,39474,2,0,2,1,0,1
2023-06-01,201665,31,0,31,1,0,1
2023-06-01,43927,26,14,40,10,9,10
2023-06-01,39756,13,0,13,5,0,5
2023-06-01,51239,1,0,1,2,0,2
2023-06-01,57136,18,0,18,12,0,12
2023-06-01,62211,3,0,3,1,0,1
2023-06-01,35067,1,0,1,6,0,6
2023-06-01,58098,9,0,9,2,0,2
2023-06-01,202070,3,0,3,2,0,2
2023-06-01,35244,13,3,16,1,1,1
2023-06-01,21395,4,1,5,2,2,2
2023-06-01,49524,3,0,3,6,0,6
2023-06-01,51897,1,0,1,1,0,1
2023-06-01,57405,1,0,1,1,0,1
2023-06-01,61008,1,0,1,1,0,1
2023-06-01,61962,2,0,2,1,0,1
2023-06-01,34590,51,5,56,1,2,2
2023-06-01,62179,25,1,26,4,1,4
2023-06-01,50297,11,1,12,3,2,3
2023-06-01,209612,0,0,0,2,2,2
2023-06-01,51788,6,0,6,1,0,1
2023-06-01,203903,1,0,1,2,0,2
2023-06-01,15828,3,0,3,1,0,1
2023-06-01,51812,28,0,28,2,0,2
2023-06-01,35491,24,1,25,7,3,8
2023-06-01,51175,16,2,18,9,1,9
2023-06-01,25584,1,1,2,4,1,4
2023-06-01,48659,8,2,10,6,1,7
2023-06-01,197405,4,0,4,6,0,6
2023-06-01,47579,3,0,3,1,0,1
2023-06-01,48000,5,0,5,2,0,2
2023-06-01,17394,10,3,13,3,3,4
2023-06-01,51973,6,1,7,4,2,4
2023-06-01,41722,35,1,36,19,7,19
2023-06-01,207209,1,0,1,1,0,1
2023-06-01,31370,5,2,7,9,2,10
2023-06-01,196936,3,0,3,2,0,2
2023-06-01,34814,13,0,13,4,0,4
2023-06-01,57000,3,0,3,1,0,1
2023-06-01,50541,1,0,1,1,0,1
2023-06-01,48346,1,0,1,1,0,1
2023-06-01,49830,3,0,3,4,0,4
2023-06-01,210054,3,2,5,2,2,2
2023-06-01,207456,15,0,15,7,0,7
2023-06-01,41047,1,4,5,8,8,13
2023-06-01,208059,1,5,6,4,6,8
2023-06-01,212446,1,0,1,1,0,1
2023-06-01,52092,2,1,3,1,3,3
2023-06-01,42740,5,0,5,1,0,1
2023-06-01,197503,8,0,8,4,0,4
2023-06-01,52195,2,1,3,4,4,7
2023-06-01,52175,7,0,7,4,0,4
2023-06-01,13106,2,0,2,3,0,3
2023-06-01,51891,1,0,1,1,0,1
2023-06-01,49106,8,0,8,9,0,9
2023-06-01,51947,2,0,2,1,0,1
2023-06-01,197406,3,0,3,2,0,2
2023-06-01,51836,1,0,1,1,0,1
2023-06-01,44387,7,0,7,3,0,3
2023-06-01,48326,14,2,16,14,1,14
2023-06-01,51653,11,0,11,5,0,5
2023-06-01,197398,2,0,2,1,0,1
2023-06-01,58219,2,0,2,3,0,3
2023-06-01,210104,6,0,6,18,0,18
2023-06-01,57213,4,0,4,2,0,2
2023-06-01,51943,1,0,1,1,0,1
2023-06-01,49893,21,0,21,5,0,5
2023-06-01,50802,2,0,2,1,0,1
2023-06-01,197418,1,0,1,5,0,5
2023-06-01,25337,3,0,3,2,0,2
2023-06-01,197437,2,0,2,4,0,4
2023-06-01,12507,2,0,2,4,0,4
2023-06-01,56587,2,0,2,2,0,2
2023-06-01,25504,17,2,19,6,5,7
2023-06-01,52079,1,0,1,4,0,4
2023-06-01,50718,6,0,6,1,0,1
2023-06-01,51975,4,1,5,3,1,3
2023-06-01,52009,1,0,1,4,0,4
2023-06-01,50437,8,0,8,1,0,1
2023-06-01,197470,3,0,3,2,0,2
2023-06-01,52043,5,0,5,3,0,3
2023-06-01,48117,3,0,3,3,0,3
2023-06-01,6712,7,1,8,2,1,2
2023-06-01,33993,7,0,7,1,0,1
2023-06-01,49536,1,0,1,1,0,1
2023-06-01,209272,3,0,3,3,0,3
2023-06-01,205254,14,2,16,4,4,7
2023-06-01,51935,10,1,11,1,1,1
2023-06-01,6856,7,1,8,12,3,12
2023-06-01,49218,1,0,1,4,0,4
2023-06-01,41272,3,0,3,1,0,1
2023-06-01,44417,5,1,6,4,3,4
2023-06-01,31357,4,0,4,4,0,4
2023-06-01,50851,10,0,10,1,0,1
2023-06-01,9066,5,2,7,4,3,5
2023-06-01,206761,2,0,2,2,0,2
2023-06-01,209040,6,0,6,2,0,2
2023-06-01,42442,16,8,24,4,2,4
2023-06-01,197023,11,1,12,2,1,2
2023-06-01,43110,8,0,8,3,0,3
2023-06-01,208531,1,0,1,2,0,2
2023-06-01,35614,2,1,3,15,5,16
2023-06-01,203980,2,0,2,4,0,4
2023-06-01,203088,4,0,4,2,0,2
2023-06-01,44416,9,1,10,10,3,10
2023-06-01,212621,2,0,2,3,0,3
2023-06-01,9177,3,0,3,3,0,3
2023-06-01,196791,2,0,2,3,0,3
2023-06-01,49125,4,1,5,8,2,8
2023-06-01,48044,3,0,3,1,0,1
2023-06-01,6752,47,1,48,6,2,6
2023-06-01,43235,4,0,4,2,0,2
2023-06-01,49120,6,0,6,4,0,4
2023-06-01,48004,5,3,8,4,2,4
2023-06-01,44318,6,0,6,1,0,1
2023-06-01,34743,5,0,5,6,0,6
2023-06-01,52194,9,0,9,3,0,3
2023-06-01,197550,1,0,1,1,0,1
2023-06-01,56364,6,0,6,3,0,3
2023-06-01,1741,39,2,41,11,5,11
2023-06-01,39857,2,0,2,1,0,1
2023-06-01,52101,2,0,2,3,0,3
2023-06-01,200524,5,0,5,3,0,3
2023-06-01,52110,1,0,1,1,0,1
2023-06-01,52029,1,0,1,1,0,1
2023-06-01,34573,19,0,19,4,0,4
2023-06-01,52058,2,0,2,2,0,2
2023-06-01,52103,5,0,5,1,0,1
2023-06-01,42832,5,0,5,3,0,3
2023-06-01,31028,5,0,5,3,0,3
2023-06-01,52105,1,0,1,1,0,1
2023-06-01,49325,5,0,5,3,0,3
2023-06-01,200814,5,0,5,3,0,3
2023-06-01,24642,8,2,10,3,2,3
2023-06-01,211560,3,0,3,1,0,1
2023-06-01,209671,3,0,3,1,0,1
2023-06-01,47388,12,0,12,6,0,6
2023-06-01,52154,9,0,9,3,0,3
2023-06-01,8788,10,3,13,20,6,20
2023-06-01,39742,2,0,2,3,0,3
2023-06-01,198430,13,2,15,4,3,5
2023-06-01,52142,18,1,19,9,1,9
2023-06-01,50159,6,0,6,1,0,1
2023-06-01,57217,9,0,9,2,0,2
2023-06-01,16110,7,0,7,8,0,8
2023-06-01,211938,2,0,2,2,0,2
2023-06-01,39248,6,0,6,1,0,1
2023-06-01,197113,3,7,10,2,2,2
2023-06-01,35562,2,0,2,2,0,2
2023-06-01,56326,2,0,2,3,0,3
2023-06-01,44206,6,0,6,6,0,6
2023-06-01,56356,1,0,1,1,0,1
2023-06-01,39574,25,1,26,3,1,3
2023-06-01,199178,1,1,2,1,1,1
2023-06-01,41913,18,1,19,17,6,18
2023-06-01,60384,4,2,6,1,1,1
2023-06-01,49821,11,1,12,4,3,4
2023-06-01,34251,20,0,20,17,0,17
2023-06-01,197460,41,0,41,2,0,2
2023-06-01,15880,12,0,12,3,0,3
2023-06-01,203067,9,0,9,2,0,2
2023-06-01,56347,4,0,4,1,0,1
2023-06-01,197565,1,0,1,1,0,1
2023-06-01,48470,13,0,13,4,0,4
2023-06-01,197345,2,0,2,2,0,2
2023-06-01,51426,4,2,6,3,3,5
2023-06-01,210923,1,0,1,1,0,1
2023-06-01,56385,1,0,1,1,0,1
2023-06-01,56404,8,0,8,4,0,4
2023-06-01,50590,5,0,5,2,0,2
2023-06-01,56427,1,0,1,1,0,1
2023-06-01,42905,9,1,10,7,1,7
2023-06-01,44800,4,0,4,3,0,3
2023-06-01,47562,5,1,6,5,3,5
2023-06-01,196739,3,0,3,4,0,4
2023-06-01,43171,5,0,5,9,0,9
2023-06-01,56386,4,0,4,5,0,5
2023-06-01,49327,6,0,6,3,0,3
2023-06-01,56610,1,0,1,4,0,4
2023-06-01,31103,28,1,29,13,5,14
2023-06-01,45050,7,0,7,3,0,3
2023-06-01,39480,3,0,3,3,0,3
2023-06-01,15451,8,1,9,3,2,3
2023-06-01,49283,4,0,4,3,0,3
2023-06-01,48861,3,0,3,1,0,1
2023-06-01,43571,6,1,7,1,1,1
2023-06-01,51940,1,0,1,3,0,3
2023-06-01,51922,1,1,2,2,2,2
2023-06-01,25220,14,4,18,12,7,14
2023-06-01,41357,4,1,5,2,2,3
2023-06-01,200744,2,0,2,1,0,1
2023-06-01,51933,2,1,3,6,2,6
2023-06-01,48425,3,0,3,2,0,2
2023-06-01,48426,5,1,6,5,1,5
2023-06-01,197442,1,0,1,1,0,1
2023-06-01,51941,5,5,10,3,3,3
2023-06-01,56468,10,0,10,7,0,7
2023-06-01,50973,18,2,20,8,3,8
2023-06-01,21183,39,1,40,13,2,13
2023-06-01,16245,23,5,28,9,3,9
2023-06-01,202752,1,0,1,3,0,3
2023-06-01,197475,1,0,1,1,0,1
2023-06-01,197453,10,1,11,15,3,15
2023-06-01,196897,4,0,4,3,0,3
2023-06-01,202259,4,0,4,1,0,1
2023-06-01,51996,1,0,1,3,0,3
2023-06-01,52048,16,5,21,2,2,2
2023-06-01,52013,2,0,2,1,0,1
2023-06-01,15693,4,1,5,4,2,4
2023-06-01,43118,4,0,4,4,0,4
2023-06-01,8334,33,0,33,1,0,1
2023-06-01,6660,8,1,9,26,8,26
2023-06-01,39593,6,0,6,3,0,3
2023-06-01,57128,8,2,10,2,1,2
2023-06-01,59962,40,0,40,4,0,4
2023-06-01,209544,1,0,1,1,0,1
2023-06-01,61209,10,0,10,3,0,3
2023-06-01,41164,90,3,93,4,2,4
2023-06-01,48161,407,0,407,17,0,17
2023-06-01,41557,49,0,49,5,0,5
2023-06-01,31148,610,7,617,15,3,15
2023-06-01,65989,1,0,1,1,0,1
2023-06-01,56402,24,3,27,3,1,3
2023-06-01,39783,8,1,9,2,1,2
2023-06-01,204172,1,0,1,3,0,3
2023-06-01,52176,2,1,3,3,1,3
2023-06-01,39155,84,0,84,3,0,3
2023-06-01,44158,1,0,1,11,0,11
2023-06-01,34703,7,0,7,4,0,4
2023-06-01,197529,4,1,5,4,1,4
2023-06-01,33920,8,1,9,13,9,13
2023-06-01,38927,6,1,7,2,2,2
2023-06-01,15965,7,1,8,16,8,18
2023-06-01,29169,8,1,9,15,13,17
2023-06-01,203476,4,3,7,1,1,1
2023-06-01,8240,4,2,6,14,4,14
2023-06-01,56588,1,1,2,1,1,1
2023-06-01,16230,4,0,4,1,0,1
2023-06-01,56320,2,0,2,3,0,3
2023-06-01,39438,1,0,1,1,0,1
2023-06-01,202773,1,0,1,1,0,1
2023-06-01,52214,1,0,1,1,0,1
2023-06-01,205294,1,0,1,2,0,2
2023-06-01,22001,3,0,3,3,0,3
2023-06-01,211189,1,0,1,2,0,2
2023-06-01,203750,5,0,5,3,0,3
2023-06-01,201267,1,0,1,1,0,1
2023-06-01,44187,2,0,2,1,0,1
2023-06-01,34315,3,1,4,1,1,1
2023-06-01,51155,3,1,4,9,1,9
2023-06-01,60788,7,0,7,2,0,2
2023-06-01,44180,6,0,6,3,0,3
2023-06-01,8819,4,1,5,4,5,6
2023-06-01,20963,4,0,4,3,0,3
2023-06-01,39231,1,0,1,1,0,1
2023-06-01,15844,6,0,6,5,0,5
2023-06-01,56329,26,3,29,7,4,7
2023-06-01,31059,21,1,22,18,2,18
2023-06-01,39904,3,1,4,7,3,8
2023-06-01,199604,1,1,2,3,3,3
2023-06-01,205724,1,0,1,1,0,1
2023-06-01,56349,1,1,2,5,3,5
2023-06-01,201600,5,1,6,1,1,1
2023-06-01,42760,3,1,4,4,3,4
2023-06-01,41833,65,1,66,6,1,6
2023-06-01,57188,3,1,4,3,3,3
2023-06-01,34010,46,7,53,1,1,1
2023-06-01,13110,20,1,21,40,6,40
2023-06-01,16273,4,0,4,1,0,1
2023-06-01,201056,1,0,1,1,0,1
2023-06-01,56396,2,1,3,3,2,3
2023-06-01,49798,5,1,6,3,1,3
2023-06-01,2607,34,3,37,8,2,8
2023-06-01,44514,4,1,5,1,1,1
2023-06-01,20902,10,3,13,5,5,5
2023-06-01,57395,19,13,32,4,3,4
2023-06-01,64396,1,1,2,1,1,1
2023-06-01,25276,1,1,2,1,1,2
2023-06-01,210050,1,0,1,3,0,3
2023-06-01,12593,5,1,6,25,3,25
2023-06-01,211967,1,0,1,1,0,1
2023-06-01,42641,1,0,1,2,0,2
2023-06-01,210490,1,1,2,1,1,2
2023-06-01,204549,1,0,1,2,0,2
2023-06-01,204294,1,0,1,3,0,3
2023-06-01,201948,1,1,2,1,1,1
2023-06-01,39399,6,1,7,9,2,9
2023-06-01,208965,2,0,2,1,0,1
2023-06-01,201041,5,0,5,1,0,1
2023-06-01,29491,9,5,14,26,2,26
2023-06-01,197254,2,0,2,1,0,1
2023-06-01,212956,1,0,1,4,0,4
2023-06-01,8711,7,0,7,4,0,4
2023-06-01,204678,1,0,1,3,0,3
2023-06-01,13097,12,1,13,7,4,7
2023-06-01,56450,2,1,3,1,2,2
2023-06-01,20911,137,0,137,8,0,8
2023-06-01,60460,11,1,12,3,1,4
2023-06-01,210143,1,0,1,2,0,2
2023-06-01,209386,2,0,2,2,0,2
2023-06-01,34093,7,1,8,1,1,1
2023-06-01,44185,3,1,4,6,4,6
2023-06-01,48304,2,1,3,3,3,3
2023-06-01,42612,6,1,7,8,4,9
2023-06-01,5550,1,1,2,7,5,7
2023-06-01,34999,3,0,3,3,0,3
2023-06-01,12775,7,3,10,3,3,3
2023-06-01,198745,4,0,4,1,0,1
2023-06-01,21069,9,1,10,2,2,2
2023-06-01,212641,2,0,2,4,0,4
2023-06-01,39361,1,0,1,2,0,2
2023-06-01,200737,1,0,1,2,0,2
2023-06-01,196906,2,0,2,4,0,4
2023-06-01,199986,1,0,1,1,0,1
2023-06-01,15726,3,1,4,3,2,3
2023-06-01,211882,1,2,3,5,4,6
2023-06-01,21162,2,0,2,1,0,1
2023-06-01,209218,1,11,12,4,8,8
2023-06-01,56391,9,0,9,17,0,17
2023-06-01,198291,13,0,13,2,0,2
2023-06-01,213260,8,0,8,2,0,2
2023-06-01,30922,14,0,14,7,0,7
2023-06-01,56422,1,0,1,1,0,1
2023-06-01,35206,6,1,7,2,2,2
2023-06-01,34442,6,1,7,8,5,8
2023-06-01,202257,1,0,1,7,0,7
2023-06-01,25498,2,0,2,1,0,1
2023-06-01,198720,9,0,9,6,0,6
2023-06-01,56480,2,0,2,2,0,2
2023-06-01,35212,3,0,3,1,0,1
2023-06-01,42431,7,0,7,3,0,3
2023-06-01,43431,9,3,12,1,1,1
2023-06-01,212298,6,0,6,1,0,1
2023-06-01,60447,14,1,15,12,4,12
2023-06-01,44077,3,0,3,1,0,1
2023-06-01,42410,1,0,1,2,0,2
2023-06-01,41339,1,0,1,1,0,1
2023-06-01,35228,87,0,87,11,0,11
2023-06-01,39636,5,1,6,7,1,7
2023-06-01,47165,14,1,15,9,4,11
2023-06-01,57914,2,0,2,4,0,4
2023-06-01,58156,1,0,1,3,0,3
2023-06-01,35185,5,0,5,3,0,3
2023-06-01,65646,1,0,1,1,0,1
2023-06-01,34288,5,2,7,14,9,15
2023-06-01,31012,7,3,10,1,1,1
2023-06-01,197722,10,0,10,1,0,1
2023-06-01,56360,1,0,1,1,0,1
2023-06-01,4913,62,0,62,11,0,11
2023-06-01,57740,2,0,2,1,0,1
2023-06-01,31515,41,1,42,10,3,10
2023-06-01,25222,30,3,33,1,1,1
2023-06-01,202013,11,0,11,2,0,2
2023-06-01,56403,7,0,7,6,0,6
2023-06-01,206934,14,0,14,10,0,10
2023-06-01,206690,4,0,4,2,0,2
2023-06-01,206689,3,0,3,3,0,3
2023-06-01,206733,5,0,5,5,0,5
2023-06-01,213192,3,2,5,1,1,1
2023-06-01,39337,6,0,6,6,0,6
2023-06-01,25353,4,1,5,2,2,2
2023-06-01,39040,3,1,4,18,10,18
2023-06-01,42149,1,0,1,6,0,6
2023-06-01,62169,3,0,3,3,0,3
2023-06-01,24232,14,0,14,6,0,6
2023-06-01,19806,12,0,12,5,0,5
2023-06-01,11158,19,0,19,14,0,14
2023-06-01,51483,7,2,9,7,5,8
2023-06-01,197630,1,0,1,3,0,3
2023-06-01,34497,6,1,7,2,1,2
2023-06-01,197589,6,0,6,7,0,7
2023-06-01,48218,3,1,4,2,2,2
2023-06-01,33814,1,1,2,1,1,1
2023-06-01,33828,3,1,4,3,3,3
2023-06-01,35457,21,0,21,2,0,2
2023-06-01,197581,9,1,10,3,3,3
2023-06-01,25260,8,1,9,3,2,3
2023-06-01,38963,1,0,1,3,0,3
2023-06-01,16645,10,0,10,7,0,7
2023-06-01,60128,1,0,1,1,0,1
2023-06-01,61244,3,1,4,6,6,8
2023-06-01,13118,43,0,43,5,0,5
2023-06-01,12958,18,0,18,6,0,6
2023-06-01,39374,1,0,1,3,0,3
2023-06-01,29009,4,1,5,6,5,7
2023-06-01,35141,429,0,429,1,0,1
2023-06-01,12618,13,2,15,13,3,14
2023-06-01,204873,6,1,7,3,1,4
2023-06-01,48789,0,1,1,2,2,3
2023-06-01,2840,3,1,4,3,1,3
2023-06-01,8326,5,1,6,3,2,3
2023-06-01,209929,5,3,8,1,1,1
2023-06-01,49759,3,0,3,6,0,6
2023-06-01,197305,5,0,5,2,0,2
2023-06-01,57908,2,0,2,1,0,1
2023-06-01,6819,1,1,2,4,2,4
2023-06-01,43541,13,3,16,11,11,13
2023-06-01,201923,1,0,1,2,0,2
2023-06-01,62459,5,0,5,3,0,3
2023-06-01,29686,10,5,15,10,2,10
2023-06-01,211600,2,0,2,2,0,2
2023-06-01,61109,5,0,5,5,0,5
2023-06-01,210560,11,1,12,1,1,1
2023-06-01,204551,1,0,1,3,0,3
2023-06-01,20698,1,0,1,3,0,3
2023-06-01,206323,1,0,1,3,0,3
2023-06-01,50523,1,0,1,2,0,2
2023-06-01,43148,10,0,10,3,0,3
2023-06-01,51470,1,0,1,3,0,3
2023-06-01,202857,1,0,1,3,0,3
2023-06-01,202795,1,0,1,3,0,3
2023-06-01,203563,1,0,1,2,0,2
2023-06-01,60124,2,0,2,3,0,3
2023-06-01,60058,2,0,2,1,0,1
2023-06-01,201244,1,0,1,2,0,2
2023-06-01,35469,2,0,2,5,0,5
2023-06-01,201282,1,0,1,2,0,2
2023-06-01,207676,7,0,7,4,0,4
2023-06-01,209283,4,1,5,1,1,1
2023-06-01,49200,6,0,6,7,0,7
2023-06-01,213291,1,5,6,2,2,2
2023-06-01,200619,1,0,1,2,0,2
2023-06-01,197858,1,0,1,2,0,2
2023-06-01,60954,1,0,1,1,0,1
2023-06-01,49784,57,2,59,1,1,1
2023-06-01,47262,8,0,8,1,0,1
2023-06-01,43591,3,1,4,3,1,3
2023-06-01,197143,16,0,16,2,0,2
2023-06-01,48848,2,0,2,2,0,2
2023-06-01,41412,24,1,25,2,4,4
2023-06-01,35518,7,1,8,3,2,3
2023-06-01,8821,6,1,7,12,9,16
2023-06-01,43957,12,3,15,10,5,10
2023-06-01,199997,2,1,3,1,2,2
2023-06-01,39852,4,0,4,2,0,2
2023-06-01,48618,3,2,5,2,2,2
2023-06-01,39545,7,1,8,10,2,10
2023-06-01,205801,2,1,3,4,4,4
2023-06-01,64476,15,4,19,1,1,1
2023-06-01,44931,7,0,7,3,0,3
2023-06-01,50009,13,2,15,5,1,5
2023-06-01,197826,5,0,5,6,0,6
2023-06-01,198202,1,0,1,3,0,3
2023-06-01,12697,1,0,1,1,0,1
2023-06-01,202269,11,0,11,4,0,4
2023-06-01,8462,24,1,25,10,7,12
2023-06-01,25406,11,0,11,1,0,1
2023-06-01,34857,8,0,8,1,0,1
2023-06-01,49455,4,0,4,1,0,1
2023-06-01,21332,62,0,62,4,0,4
2023-06-01,41911,3,0,3,1,0,1
2023-06-01,51218,5,1,6,2,1,2
2023-06-01,28824,3,1,4,6,3,6
2023-06-01,211936,5,0,5,1,0,1
2023-06-01,43529,7,2,9,1,1,1
2023-06-01,50223,37,0,37,4,0,4
2023-06-01,212804,1,1,2,1,1,1
2023-06-01,206774,13,3,16,7,5,7
2023-06-01,16117,5,1,6,6,4,6
2023-06-01,202111,1,0,1,2,0,2
2023-06-01,60087,5,1,6,2,1,2
2023-06-01,38951,5,0,5,2,0,2
2023-06-01,52115,1,1,2,1,1,1
2023-06-01,48225,2,0,2,4,0,4
2023-06-01,44814,27,1,28,27,8,29
2023-06-01,198228,6,2,8,6,3,7
2023-06-01,206346,4,0,4,4,0,4
2023-06-01,34624,11,1,12,9,4,10
2023-06-01,43926,21,0,21,1,0,1
2023-06-01,51984,22,0,22,1,0,1
2023-06-01,197558,8,1,9,4,4,5
2023-06-01,52145,17,0,17,3,0,3
2023-06-01,208498,10,0,10,1,0,1
2023-06-01,210727,1,0,1,1,0,1
2023-06-01,212217,2,4,6,3,1,3
2023-06-01,207046,19,0,19,3,0,3
2023-06-01,213005,13,0,13,2,0,2
2023-06-01,48162,1,0,1,1,0,1
2023-06-01,197297,16,0,16,2,0,2
2023-06-01,24889,5,1,6,8,5,10
2023-06-01,56345,8,0,8,2,0,2
2023-06-01,201035,24,11,35,6,6,6
2023-06-01,197806,1,1,2,2,1,2
2023-06-01,197907,2,0,2,2,0,2
2023-06-01,38972,3,0,3,1,0,1
2023-06-01,34618,5,0,5,1,0,1
2023-06-01,52033,8,0,8,1,0,1
2023-06-01,56993,2,1,3,2,1,2
2023-06-01,210958,2,1,3,2,2,2
2023-06-01,59607,10,0,10,5,0,5
2023-06-01,50898,1,0,1,3,0,3
2023-06-01,39256,4,1,5,3,1,3
2023-06-01,39125,2,0,2,4,0,4
2023-06-01,59589,1,1,2,16,5,16
2023-06-01,34867,2,1,3,27,7,28
2023-06-01,57167,3,1,4,2,1,2
2023-06-01,58070,1,0,1,1,0,1
2023-06-01,47480,13,0,13,10,0,10
2023-06-01,47374,6,0,6,1,0,1
2023-06-01,29694,6,0,6,1,0,1
2023-06-01,210154,5,0,5,1,0,1
2023-06-01,203469,2,0,2,4,0,4
2023-06-01,52083,2,0,2,1,0,1
2023-06-01,205716,3,0,3,3,0,3
2023-06-01,35485,11,0,11,2,0,2
2023-06-01,52063,2,1,3,1,1,1
2023-06-01,6894,4,1,5,11,7,13
2023-06-01,39116,14,0,14,3,0,3
2023-06-01,48149,5,2,7,2,1,2
2023-06-01,52084,1,0,1,1,0,1
2023-06-01,48680,1,0,1,2,0,2
2023-06-01,34510,6,0,6,1,0,1
2023-06-01,197508,8,0,8,2,0,2
2023-06-01,31203,16,0,16,1,0,1
2023-06-01,35576,11,0,11,1,0,1
2023-06-01,197156,4,0,4,7,0,7
2023-06-01,42358,2,0,2,1,0,1
2023-06-01,48285,5,0,5,1,0,1
2023-06-01,197505,2,0,2,1,0,1
2023-06-01,29425,2,1,3,3,2,3
2023-06-01,47394,51,1,52,10,2,10
2023-06-01,52122,7,0,7,1,0,1
2023-06-01,51164,5,3,8,4,4,4
2023-06-01,42774,3,0,3,2,0,2
2023-06-01,52140,1,0,1,1,0,1
2023-06-01,43614,2,1,3,1,1,1
2023-06-01,43873,32,0,32,3,0,3
2023-06-01,212086,2,0,2,3,0,3
2023-06-01,201502,22,1,23,10,3,10
2023-06-01,395117,1,0,1,2,0,2
2023-06-01,46183,2,0,2,2,0,2
2023-06-01,62677,1,0,1,1,0,1
2023-06-01,55052,3,0,3,3,0,3
2023-06-01,22271,1,0,1,3,0,3
2023-06-01,19642,1,0,1,1,0,1
2023-06-01,3408,1,0,1,1,0,1
2023-06-01,33645,4,0,4,2,0,2
2023-06-01,63329,2,0,2,3,0,3
2023-06-01,19926,1,0,1,2,0,2
2023-06-01,63397,4,0,4,4,0,4
2023-06-01,63378,1,0,1,1,0,1
2023-06-01,31774,2,0,2,2,0,2
2023-06-01,394245,1,0,1,1,0,1
2023-06-01,23069,1,0,1,3,0,3
2023-06-01,394454,1,0,1,3,0,3
2023-06-01,27536,2,0,2,2,0,2
2023-06-01,394817,1,0,1,3,0,3
2023-06-01,40294,12,2,14,2,1,2
2023-06-01,395961,1,0,1,3,0,3
2023-06-01,396080,1,0,1,1,0,1
2023-06-01,393483,2,0,2,2,0,2
2023-06-01,399121,2,0,2,2,0,2
2023-06-01,396491,1,0,1,1,0,1
2023-06-01,30426,1,0,1,2,0,2
2023-06-01,397141,1,0,1,1,0,1
2023-06-01,33468,2,0,2,1,0,1
2023-06-01,397492,1,0,1,1,0,1
2023-06-01,54537,2,0,2,1,0,1
2023-06-01,62817,1,0,1,2,0,2
2023-06-01,399520,3,1,4,2,2,2
2023-06-01,32933,1,0,1,2,0,2
2023-06-01,400216,1,0,1,2,0,2
2023-06-01,32324,1,0,1,1,0,1
2023-06-01,22298,0,0,0,2,0,2
2023-06-01,400013,2,5,7,2,3,3
2023-06-01,134798,4,0,4,2,0,2
2023-06-01,55834,2,0,2,1,0,1
2023-06-01,24249,8,1,9,5,4,6
2023-06-01,139272,1,0,1,1,0,1
2023-06-01,38744,26,0,26,3,0,3
2023-06-01,400318,29,0,29,8,0,8
2023-06-01,133481,425,100,525,2,1,2
2023-06-01,141454,2,0,2,1,0,1
2023-06-01,133848,12,2,14,1,1,1
2023-06-01,38818,6,0,6,2,0,2
2023-06-01,9700,1,0,1,1,0,1
2023-06-01,38529,19,2,21,3,1,3
2023-06-01,55597,1,0,1,1,0,1
2023-06-01,55660,5,1,6,2,1,3
2023-06-01,9862,19,0,19,1,0,1
2023-06-01,55587,9,0,9,1,0,1
2023-06-01,10049,31,0,31,5,0,5
2023-06-01,55470,87,1,88,9,1,9
2023-06-01,55853,25,1,26,1,1,1
2023-06-01,4741,33,1,34,8,3,8
2023-06-01,24514,25,6,31,25,7,26
2023-06-01,55856,2,0,2,1,0,1
2023-06-01,24466,7,1,8,3,3,3
2023-06-01,139580,6,1,7,1,1,1
2023-06-01,146966,34,15,49,1,1,1
2023-06-01,55843,8,1,9,1,1,1
2023-06-01,55797,4,0,4,2,0,2
2023-06-01,17698,37,0,37,1,0,1
2023-06-01,23780,5,1,6,6,3,6
2023-06-01,23822,13,0,13,4,0,4
2023-06-01,23829,8,0,8,4,0,4
2023-06-01,55446,7,1,8,4,1,4
2023-06-01,10135,10,1,11,7,1,7
2023-06-01,10001,10,1,11,7,5,8
2023-06-01,131745,25,11,36,7,1,7
2023-06-01,140405,3,1,4,3,2,3
2023-06-01,137286,5,0,5,3,0,3
2023-06-01,9232,23,0,23,8,0,8
2023-06-01,146834,25,1,26,4,1,4
2023-06-01,38456,49,2,51,11,2,11
2023-06-01,5666,11,0,11,9,0,9
2023-06-01,24371,1,1,2,1,1,2
2023-06-01,58464,1,0,1,2,0,2
2023-06-01,55861,3,0,3,2,0,2
2023-06-01,45475,24,0,24,3,0,3
2023-06-01,21509,10,0,10,8,0,8
2023-06-01,7506,36,6,42,11,6,11
2023-06-01,24251,22,0,22,4,0,4
2023-06-01,134630,7,3,10,4,1,4
2023-06-01,55803,35,3,38,5,3,6
2023-06-01,38800,6,1,7,5,2,5
2023-06-01,55885,5,0,5,1,0,1
2023-06-01,56141,8,1,9,3,1,3
2023-06-01,141983,3,0,3,5,0,5
2023-06-01,55667,4,0,4,1,0,1
2023-06-01,141137,1,1,2,20,6,22
2023-06-01,150251,2,0,2,1,0,1
2023-06-01,38462,6,1,7,4,3,4
2023-06-01,56291,3,0,3,1,0,1
2023-06-01,18190,108,0,108,5,0,5
2023-06-01,136955,6,0,6,3,0,3
2023-06-01,24165,5,3,8,1,1,1
2023-06-01,131269,59,12,71,3,1,3
2023-06-01,9371,20,1,21,7,4,8
2023-06-01,7684,50,1,51,2,2,2
2023-06-01,9293,137,2,139,24,4,24
2023-06-01,24158,288,211,499,1,1,1
2023-06-01,38444,60,2,62,2,1,2
2023-06-01,135329,2,1,3,2,1,2
2023-06-01,133791,4,2,6,4,2,4
2023-06-01,140032,2,0,2,2,0,2
2023-06-01,45199,4,0,4,3,0,3
2023-06-01,134240,9,2,11,1,1,1
2023-06-01,149640,3,2,5,1,1,1
2023-06-01,9546,7,0,7,4,0,4
2023-06-01,136538,8,0,8,1,0,1
2023-06-01,132681,1,0,1,1,0,1
2023-06-01,55488,2,1,3,1,1,2
2023-06-01,45255,1,0,1,2,0,2
2023-06-01,147187,2,0,2,3,0,3
2023-06-01,55423,56,23,79,14,4,14
2023-06-01,150148,2,0,2,1,0,1
2023-06-01,7630,13,1,14,5,1,5
2023-06-01,9551,14,0,14,2,0,2
2023-06-01,38690,17,0,17,3,0,3
2023-06-01,18206,35,3,38,10,3,10
2023-06-01,17971,83,3,86,4,1,4
2023-06-01,55668,4,0,4,1,0,1
2023-06-01,17948,3,1,4,4,4,4
2023-06-01,9365,14,1,15,8,3,9
2023-06-01,17957,6,0,6,1,0,1
2023-06-01,134688,6,0,6,12,0,12
2023-06-01,7469,1,0,1,1,0,1
2023-06-01,132618,74,1,75,2,1,2
2023-06-01,9614,21,0,21,1,0,1
2023-06-01,17878,59,0,59,2,0,2
2023-06-01,46011,2,0,2,1,0,1
2023-06-01,4663,51,0,51,3,0,3
2023-06-01,10054,88,0,88,3,0,3
2023-06-01,38735,52,0,52,5,0,5
2023-06-01,38700,6,0,6,1,0,1
2023-06-01,58693,5,0,5,1,0,1
2023-06-01,9617,85,33,118,1,1,1
2023-06-01,137199,10,1,11,3,1,3
2023-06-01,138928,2,0,2,1,0,1
2023-06-01,9714,13,7,20,2,1,2
2023-06-01,138475,4,0,4,2,0,2
2023-06-01,24375,2,0,2,1,0,1
2023-06-01,45186,1,2,3,1,1,1
2023-06-01,7065,36,0,36,4,0,4
2023-06-01,11403,38,4,42,23,9,23
2023-06-01,19871,285,16,301,5,2,5
2023-06-01,30058,43,15,58,9,4,9
2023-06-01,17184,273,16,289,5,2,5
2023-06-01,11696,178,8,186,5,3,6
2023-06-01,397303,15,8,23,2,2,2
2023-06-01,26097,26,0,26,4,0,4
2023-06-01,9471,223,3,226,1,1,1
2023-06-01,397005,5,1,6,3,1,3
2023-06-01,14102,11,0,11,1,0,1
2023-06-01,27338,55,0,55,2,0,2
2023-06-01,20334,14,0,14,3,0,3
2023-06-01,22645,26,3,29,54,14,55
2023-06-01,13359,2,2,4,12,3,13
2023-06-01,1044,1,0,1,1,0,1
2023-06-01,53824,6,3,9,2,1,2
2023-06-01,13796,3,0,3,1,0,1
2023-06-01,1406,11,0,11,2,0,2
2023-06-01,30688,57,6,63,12,4,13
2023-06-01,394195,9,1,10,5,2,5
2023-06-01,394568,9,0,9,1,0,1
2023-06-01,46193,13,0,13,5,0,5
2023-06-01,54245,1,0,1,1,0,1
2023-06-01,30083,56,2,58,4,2,4
2023-06-01,13694,2,1,3,5,2,5
2023-06-01,54075,24,0,24,3,0,3
2023-06-01,14749,6,2,8,4,2,5
2023-06-01,26406,0,0,0,4,0,4
2023-06-01,46925,7,0,7,5,0,5
2023-06-01,46811,66,1,67,7,1,7
2023-06-01,11377,61,0,61,9,0,9
2023-06-01,25773,72,12,84,13,9,13
2023-06-01,10493,10,0,10,2,0,2
2023-06-01,7014,19,0,19,6,0,6
2023-06-01,32771,6,10,16,2,2,2
2023-06-01,399437,2,0,2,3,0,3
2023-06-01,3593,66,0,66,2,0,2
2023-06-01,394681,1,0,1,2,0,2
2023-06-01,54794,1,0,1,1,0,1
2023-06-01,31862,1,0,1,2,0,2
2023-06-01,20359,2,0,2,2,0,2
2023-06-01,397250,8,0,8,1,0,1
2023-06-01,394764,2,0,2,1,0,1
2023-06-01,201385,1,0,1,3,0,3
2023-06-01,10532,1,0,1,1,0,1
2023-06-01,36434,1,0,1,1,0,1
2023-06-01,14328,35,0,35,11,0,11
2023-06-01,14096,1,0,1,1,0,1
2023-06-01,36706,5,0,5,1,0,1
2023-06-01,55131,2,0,2,3,0,3
2023-06-01,395058,1,0,1,1,0,1
2023-06-01,11372,5,0,5,3,0,3
2023-06-01,32763,1,0,1,3,0,3
2023-06-01,53787,1,0,1,3,0,3
2023-06-01,20236,2,0,2,3,0,3
2023-06-01,19102,2,0,2,1,0,1
2023-06-01,26729,12,0,12,1,0,1
2023-06-01,16981,2,0,2,2,0,2
2023-06-01,7213,1,0,1,2,0,2
2023-06-01,394714,2,0,2,2,0,2
2023-06-01,54030,1,2,3,3,3,3
2023-06-01,32822,1,0,1,2,0,2
2023-06-01,40034,23,3,26,3,2,3
2023-06-01,27637,1,0,1,1,0,1
2023-06-01,19725,1,0,1,1,0,1
2023-06-01,22384,5,0,5,2,0,2
2023-06-01,46672,4,0,4,5,0,5
2023-06-01,26781,1,0,1,2,0,2
2023-06-01,26845,2,0,2,1,0,1
2023-06-01,62561,1,0,1,2,0,2
2023-06-01,62533,5,0,5,3,0,3
2023-06-01,8077,1,0,1,1,0,1
2023-06-01,54341,1,0,1,1,0,1
2023-06-01,17274,4,0,4,5,0,5
2023-06-01,25679,8,0,8,2,0,2
2023-06-01,27610,1,0,1,2,0,2
2023-06-01,53759,4,0,4,2,0,2
2023-06-01,63483,28,0,28,2,0,2
2023-06-01,54349,1,0,1,1,0,1
2023-06-01,32837,2,0,2,4,0,4
2023-06-01,54571,3,0,3,3,0,3
2023-06-01,16391,22,1,23,7,2,7
2023-06-01,25670,6,4,10,5,3,5
2023-06-01,26709,12,2,14,5,3,5
2023-06-01,397854,1,0,1,1,0,1
2023-06-01,396241,1,0,1,2,0,2
2023-06-01,46220,2,0,2,1,0,1
2023-06-01,40464,5,1,6,4,1,4
2023-06-01,54770,1,0,1,1,0,1
2023-06-01,18906,1,0,1,2,0,2
2023-06-01,54683,1,0,1,2,0,2
2023-06-01,393693,2,0,2,1,0,1
2023-06-01,44954,1,1,2,1,2,3
2023-06-01,16770,1,0,1,1,0,1
2023-06-01,63243,2,0,2,3,0,3
2023-06-01,14313,12,1,13,5,1,5
2023-06-01,54089,1,0,1,2,0,2
2023-06-01,15155,2,0,2,3,0,3
2023-06-01,59345,4,0,4,6,0,6
2023-06-01,12176,2,0,2,3,0,3
2023-06-01,5071,2,0,2,7,0,7
2023-06-01,6407,277,0,277,8,0,8
2023-06-01,53435,21,1,22,4,1,4
2023-06-01,53974,13,0,13,1,0,1
2023-06-01,46262,6,28,34,3,1,3
2023-06-01,14654,252,1,253,1,1,1
2023-06-01,603,1,1,2,1,1,1
2023-06-01,399047,2,0,2,1,0,1
2023-06-01,26127,7,1,8,1,1,1
2023-06-01,26650,4,0,4,5,0,5
2023-06-01,46590,1,0,1,3,0,3
2023-06-01,6536,6,1,7,11,3,11
2023-06-01,5078,33,2,35,27,10,27
2023-06-01,393844,52,0,52,3,0,3
2023-06-01,142519,4,1,5,1,1,1
2023-06-01,273612,2,2,4,4,2,4
2023-06-01,33601,3,0,3,2,0,2
2023-06-01,397720,7,5,12,4,3,4
2023-06-01,398385,2,0,2,1,0,1
2023-06-01,13370,20,4,24,7,3,7
2023-06-01,53861,9,0,9,2,0,2
2023-06-01,39991,1,0,1,2,0,2
2023-06-01,11767,11,1,12,9,2,9
2023-06-01,54045,17,0,17,3,0,3
2023-06-01,20248,5,0,5,1,0,1
2023-06-01,15165,15,1,16,5,1,5
2023-06-01,397298,11,0,11,1,0,1
2023-06-01,54057,22,0,22,1,0,1
2023-06-01,399033,3,1,4,4,1,4
2023-06-01,20264,18,1,19,4,3,4
2023-06-01,46792,4,1,5,5,2,5
2023-06-01,398781,4,2,6,1,1,1
2023-06-01,26481,22,0,22,2,0,2
2023-06-01,22573,42,0,42,5,0,5
2023-06-01,6058,33,0,33,1,0,1
2023-06-01,53910,26,0,26,2,0,2
2023-06-01,393542,1,0,1,1,0,1
2023-06-01,32587,4,0,4,2,0,2
2023-06-01,46519,2,0,2,3,0,3
2023-06-01,400357,2,0,2,2,0,2
2023-06-01,15124,1,0,1,3,0,3
2023-06-01,11343,1,0,1,3,0,3
2023-06-01,399716,1,0,1,3,0,3
2023-06-01,33248,5,0,5,1,0,1
2023-06-01,400063,3,0,3,1,0,1
2023-06-01,46336,1,0,1,1,0,1
2023-06-01,54946,1,0,1,2,0,2
2023-06-01,15142,3,0,3,2,0,2
2023-06-01,399514,1,0,1,4,0,4
2023-06-01,394713,2,0,2,1,0,1
2023-06-01,33378,8,0,8,5,0,5
2023-06-01,62870,1,0,1,1,0,1
2023-06-01,32549,3,0,3,2,0,2
2023-06-01,26912,6,0,6,2,0,2
2023-06-01,46675,2,0,2,1,0,1
2023-06-01,18744,2,0,2,1,0,1
2023-06-01,54870,1,0,1,1,0,1
2023-06-01,30248,1,0,1,1,0,1
2023-06-01,54787,2,0,2,3,0,3
2023-06-01,32074,1,0,1,3,0,3
2023-06-01,11056,2,0,2,1,0,1
2023-06-01,40644,1,0,1,2,0,2
2023-06-01,14682,1,0,1,2,0,2
2023-06-01,32291,2,0,2,2,0,2
2023-06-01,62868,1,0,1,1,0,1
2023-06-01,14021,4,0,4,1,0,1
2023-06-01,55161,2,0,2,1,0,1
2023-06-01,40039,1,0,1,1,0,1
2023-06-01,393604,2,0,2,2,0,2
2023-06-01,26966,2,0,2,2,0,2
2023-06-01,395707,1,0,1,1,0,1
2023-06-01,63487,1,0,1,1,0,1
2023-06-01,32285,1,0,1,2,0,2
2023-06-01,32749,1,0,1,2,0,2
2023-06-01,16539,3,1,4,2,1,2
2023-06-01,46305,1,0,1,1,0,1
2023-06-01,46807,3,0,3,1,0,1
2023-06-01,23411,1,0,1,1,0,1
2023-06-01,32688,10,0,10,4,0,4
2023-06-01,393320,2,0,2,3,0,3
2023-06-01,19231,5,0,5,3,0,3
2023-06-01,23412,1,0,1,1,0,1
2023-06-01,14711,1,0,1,2,0,2
2023-06-01,39942,9,0,9,3,0,3
2023-06-01,26998,2,0,2,4,0,4
2023-06-01,397030,1,0,1,1,0,1
2023-06-01,27369,2,0,2,2,0,2
2023-06-01,13339,1,0,1,3,0,3
2023-06-01,23408,2,0,2,3,0,3
2023-06-01,393272,1,0,1,3,0,3
2023-06-01,36679,3,0,3,1,0,1
2023-06-01,395536,1,0,1,3,0,3
2023-06-01,63422,1,0,1,2,0,2
2023-06-01,62977,2,0,2,2,0,2
2023-06-01,55086,1,0,1,1,0,1
2023-06-01,62644,4,0,4,4,0,4
2023-06-01,18743,2,0,2,1,0,1
2023-06-01,394518,1,0,1,1,0,1
2023-06-01,393418,2,0,2,3,0,3
2023-06-01,14538,1,0,1,2,0,2
2023-06-01,394953,3,0,3,2,0,2
2023-06-01,26453,2,0,2,5,0,5
2023-06-01,27178,3,0,3,4,0,4
2023-06-01,33261,5,0,5,3,0,3
2023-06-01,40745,2,0,2,3,0,3
2023-06-01,63057,2,0,2,2,0,2
2023-06-01,393426,1,0,1,3,0,3
2023-06-01,16399,21,7,28,11,3,11
2023-06-01,22214,1,0,1,3,0,3
2023-06-01,22897,1,0,1,1,0,1
2023-06-01,26419,1,1,2,1,1,1
2023-06-01,40279,1,0,1,1,0,1
2023-06-01,17131,1,0,1,2,0,2
2023-06-01,32602,2,0,2,2,0,2
2023-06-01,53531,1,0,1,1,0,1
2023-06-01,63207,1,0,1,1,0,1
2023-06-01,35961,1,0,1,2,0,2
2023-06-01,22241,15,3,18,4,3,4
2023-06-01,25671,9,0,9,4,0,4
2023-06-01,393786,1,0,1,3,0,3
2023-06-01,18661,1,0,1,1,0,1
2023-06-01,393459,1,0,1,2,0,2
2023-06-01,21514,1,0,1,1,0,1
2023-06-01,397777,1,0,1,2,0,2
2023-06-01,397527,1,0,1,3,0,3
2023-06-01,395779,1,0,1,1,0,1
2023-06-01,32280,3,0,3,3,0,3
2023-06-01,40831,5,0,5,4,0,4
2023-06-01,398204,2,0,2,4,0,4
2023-06-01,30196,3,0,3,3,0,3
2023-06-01,32302,3,0,3,6,0,6
2023-06-01,393286,1,0,1,2,0,2
2023-06-01,399540,1,0,1,2,0,2
2023-06-01,39946,1,0,1,1,0,1
2023-06-01,31927,1,0,1,2,0,2
2023-06-01,40382,7,3,10,6,2,6
2023-06-01,25652,2,0,2,2,0,2
2023-06-01,14191,2,0,2,4,0,4
2023-06-01,396409,1,0,1,3,0,3
2023-06-01,16748,1,0,1,2,0,2
2023-06-01,54128,3,0,3,7,0,7
2023-06-01,26963,2,0,2,1,0,1
2023-06-01,396415,1,0,1,3,0,3
2023-06-01,54792,1,0,1,3,0,3
2023-06-01,22304,2,0,2,3,0,3
2023-06-01,30395,2,0,2,2,0,2
2023-06-01,395581,1,0,1,2,0,2
2023-06-01,40471,2,0,2,3,0,3
2023-06-01,395358,1,0,1,1,0,1
2023-06-01,398873,1,0,1,1,0,1
2023-06-01,399271,1,0,1,3,0,3
2023-06-01,399101,1,0,1,2,0,2
2023-06-01,398572,1,0,1,2,0,2
2023-06-01,53882,1,0,1,2,0,2
2023-06-01,399549,4,0,4,2,0,2
2023-06-01,397567,1,0,1,3,0,3
2023-06-01,397764,1,0,1,2,0,2
2023-06-01,33654,1,21,22,8,3,9
2023-06-01,31883,3,0,3,2,0,2
2023-06-01,398214,1,0,1,3,0,3
2023-06-01,399241,2,0,2,3,0,3
2023-06-01,399505,1,0,1,2,0,2
2023-06-01,27292,6,0,6,7,0,7
2023-06-01,398374,2,0,2,2,0,2
2023-06-01,32985,1,0,1,1,0,1
2023-06-01,393708,1,0,1,2,0,2
2023-06-01,32108,3,0,3,2,0,2
2023-06-01,395269,1,0,1,2,0,2
2023-06-01,64203,1,0,1,1,0,1
2023-06-01,393385,4,0,4,5,0,5
2023-06-01,395009,2,0,2,2,0,2
2023-06-01,6254,9,0,9,4,0,4
2023-06-01,395270,3,0,3,3,0,3
2023-06-01,22032,2,0,2,2,0,2
2023-06-01,395293,1,0,1,1,0,1
2023-06-01,394930,3,0,3,1,0,1
2023-06-01,394123,2,0,2,2,0,2
2023-06-01,394304,2,1,3,2,1,2
2023-06-01,32669,3,0,3,3,0,3
2023-06-01,20066,4,0,4,3,0,3
2023-06-01,13744,2,0,2,3,0,3
2023-06-01,396115,1,0,1,3,0,3
2023-06-01,395772,4,0,4,2,0,2
2023-06-01,54321,3,0,3,2,0,2
2023-06-01,395976,1,0,1,4,0,4
2023-06-01,396021,5,0,5,7,0,7
2023-06-01,396017,1,0,1,3,0,3
2023-06-01,396019,1,0,1,3,0,3
2023-06-01,395974,1,0,1,3,0,3
2023-06-01,395980,1,0,1,3,0,3
2023-06-01,393305,1,0,1,1,0,1
2023-06-01,395835,1,0,1,1,0,1
2023-06-01,395820,1,0,1,3,0,3
2023-06-01,36717,1,0,1,2,0,2
2023-06-01,396210,1,0,1,1,0,1
2023-06-01,396224,2,0,2,2,0,2
2023-06-01,396178,1,0,1,2,0,2
2023-06-01,396332,1,0,1,2,0,2
2023-06-01,396036,1,0,1,1,0,1
2023-06-01,396272,1,0,1,3,0,3
2023-06-01,395858,1,0,1,3,0,3
2023-06-01,397612,1,0,1,3,0,3
2023-06-01,36690,2,0,2,3,0,3
2023-06-01,396489,1,0,1,3,0,3
2023-06-01,36457,2,0,2,2,0,2
2023-06-01,29891,4,0,4,5,0,5
2023-06-01,394498,1,0,1,1,0,1
2023-06-01,394621,5,1,6,4,1,4
2023-06-01,14337,2,0,2,3,0,3
2023-06-01,15099,1,0,1,1,0,1
2023-06-01,395132,2,0,2,2,0,2
2023-06-01,23531,2,0,2,1,0,1
2023-06-01,22289,1,0,1,2,0,2
2023-06-01,16825,3,0,3,3,0,3
2023-06-01,26436,1,0,1,2,0,2
2023-06-01,397258,1,0,1,3,0,3
2023-06-01,397840,1,0,1,3,0,3
2023-06-01,397284,1,0,1,2,0,2
2023-06-01,3778,3,1,4,4,3,4
2023-06-01,397380,11,0,11,2,0,2
2023-06-01,10466,2,1,3,9,6,10
2023-06-01,54040,3,2,5,2,2,3
2023-06-01,397062,4,0,4,2,0,2
2023-06-01,397167,1,0,1,1,0,1
2023-06-01,30330,2,1,3,2,1,2
2023-06-01,398322,1,0,1,1,0,1
2023-06-01,53752,2,0,2,2,0,2
2023-06-01,396995,3,0,3,3,0,3
2023-06-01,63201,19,0,19,4,0,4
2023-06-01,400691,1,0,1,3,0,3
2023-06-01,400652,1,0,1,2,0,2
2023-06-01,397487,1,0,1,1,0,1
2023-06-01,3751,1,0,1,1,0,1
2023-06-01,399965,1,0,1,2,0,2
2023-06-01,40710,2,0,2,2,0,2
2023-06-01,30620,3,0,3,2,0,2
2023-06-01,398030,1,0,1,1,0,1
2023-06-01,40106,2,0,2,3,0,3
2023-06-01,22987,2,1,3,9,6,9
2023-06-01,398924,1,0,1,1,0,1
2023-06-01,27402,3,0,3,2,0,2
2023-06-01,398752,1,0,1,3,0,3
2023-06-01,400203,1,0,1,2,0,2
2023-06-01,400096,1,0,1,1,0,1
2023-06-01,63206,1,0,1,3,0,3
2023-06-01,26696,1,0,1,1,0,1
2023-06-01,40101,1,0,1,1,0,1
2023-06-01,393696,2,0,2,2,0,2
2023-06-01,27421,2,0,2,2,0,2
2023-06-01,393781,1,0,1,2,0,2
2023-06-01,16609,0,0,0,3,0,3
2023-06-01,26840,4,0,4,2,0,2
2023-06-01,394132,1,0,1,1,0,1
2023-06-01,394254,1,0,1,3,0,3
2023-06-01,394156,3,0,3,4,0,4
2023-06-01,394174,1,0,1,1,0,1
2023-06-01,31836,1,0,1,2,0,2
2023-06-01,394662,1,1,2,2,1,2
2023-06-01,46740,1,0,1,1,0,1
2023-06-01,394754,2,0,2,3,0,3
2023-06-01,22402,7,0,7,8,0,8
2023-06-01,394063,1,0,1,3,0,3
2023-06-01,23172,9,0,9,6,0,6
2023-06-01,394412,1,0,1,3,0,3
2023-06-01,394115,1,0,1,1,0,1
2023-06-01,394604,1,0,1,1,0,1
2023-06-01,54883,2,0,2,2,0,2
2023-06-01,394879,1,0,1,3,0,3
2023-06-01,394390,1,0,1,2,0,2
2023-06-01,394535,1,0,1,2,0,2
2023-06-01,26820,4,0,4,3,0,3
2023-06-01,27026,30,1,31,15,1,15
2023-06-01,30067,2,0,2,3,0,3
2023-06-01,395676,1,1,2,2,1,2
2023-06-01,395680,1,1,2,2,1,2
2023-06-01,395691,1,0,1,1,0,1
2023-06-01,395928,1,0,1,3,0,3
2023-06-01,396307,2,0,2,4,0,4
2023-06-01,13799,1,0,1,1,0,1
2023-06-01,396204,3,0,3,4,0,4
2023-06-01,27330,6,2,8,14,5,14
2023-06-01,395979,1,0,1,2,0,2
2023-06-01,396023,2,0,2,1,0,1
2023-06-01,40774,1,0,1,3,0,3
2023-06-01,19406,12,2,14,6,3,7
2023-06-01,400284,1,0,1,2,0,2
2023-06-01,394782,1,0,1,2,0,2
2023-06-01,394627,1,0,1,1,0,1
2023-06-01,397842,0,0,0,2,0,2
2023-06-01,31929,5,0,5,5,0,5
2023-06-01,395334,1,0,1,1,0,1
2023-06-01,395556,2,0,2,2,0,2
2023-06-01,22637,0,0,0,6,0,6
2023-06-01,395614,1,0,1,2,0,2
2023-06-01,395503,3,0,3,3,0,3
2023-06-01,394268,2,0,2,2,0,2
2023-06-01,35962,5,0,5,5,0,5
2023-06-01,13333,42,1,43,13,2,13
2023-06-01,18860,1,0,1,1,0,1
2023-06-01,18729,1,0,1,2,0,2
2023-06-01,396456,2,0,2,2,0,2
2023-06-01,11200,2,0,2,3,0,3
2023-06-01,30484,2,0,2,2,0,2
2023-06-01,26758,1,0,1,1,0,1
2023-06-01,13484,2,0,2,1,0,1
2023-06-01,19596,2,0,2,3,0,3
2023-06-01,16785,2,0,2,4,0,4
2023-06-01,21954,1,0,1,1,0,1
2023-06-01,20458,4,0,4,1,0,1
2023-06-01,12230,1,0,1,1,0,1
2023-06-01,22007,1,0,1,2,0,2
2023-06-01,18957,2,0,2,3,0,3
2023-06-01,396849,1,0,1,3,0,3
2023-06-01,54308,1,0,1,1,0,1
2023-06-01,30553,2,0,2,3,0,3
2023-06-01,40724,4,0,4,3,0,3
2023-06-01,36361,1,0,1,3,0,3
2023-06-01,32535,1,0,1,3,0,3
2023-06-01,64287,1,0,1,3,0,3
2023-06-01,29864,2,0,2,2,0,2
2023-06-01,23472,4,0,4,5,0,5
2023-06-01,53957,1,0,1,2,0,2
2023-06-01,398469,1,0,1,2,0,2
2023-06-01,14816,1,0,1,1,0,1
2023-06-01,54472,1,0,1,1,0,1
2023-06-01,396967,1,0,1,1,0,1
2023-06-01,396897,1,0,1,2,0,2
2023-06-01,63342,1,0,1,3,0,3
2023-06-01,17060,8,0,8,7,0,7
2023-06-01,63120,1,0,1,1,0,1
2023-06-01,13550,1,0,1,3,0,3
2023-06-01,12876,15,5,20,11,9,13
2023-06-01,211077,2,0,2,1,0,1
2023-06-01,211015,1,0,1,2,0,2
2023-06-01,15796,2,1,3,4,4,5
2023-06-01,137840,4,1,5,1,1,1
2023-06-01,32550,12,2,14,15,5,15
2023-06-01,47973,7,1,8,17,9,18
2023-06-01,200350,26,6,32,9,5,9
2023-06-01,46151,1,0,1,1,0,1
2023-06-01,395802,4,0,4,3,0,3
2023-06-01,5048,12,0,12,3,0,3
2023-06-01,19131,2,0,2,3,0,3
2023-06-01,27217,1,3,4,1,2,2
2023-06-01,397434,1,0,1,1,0,1
2023-06-01,395113,1,0,1,1,0,1
2023-06-01,7314,5,0,5,3,0,3
2023-06-01,40735,2,0,2,6,0,6
2023-06-01,22561,332,0,332,20,0,20
2023-06-01,396321,2,0,2,2,0,2
2023-06-01,395363,4,5,9,8,2,8
2023-06-01,394949,3,0,3,3,0,3
2023-06-01,397279,6,0,6,2,0,2
2023-06-01,18616,9,1,10,10,2,11
2023-06-01,22768,48,8,56,19,5,19
2023-06-01,4150,8,2,10,8,6,9
2023-06-01,26068,2,0,2,8,0,8
2023-06-01,394569,3,0,3,2,0,2
2023-06-01,11589,9,0,9,1,0,1
2023-06-01,13911,13,0,13,2,0,2
2023-06-01,36240,3,0,3,1,0,1
2023-06-01,32786,2,0,2,3,0,3
2023-06-01,399134,1,0,1,1,0,1
2023-06-01,395467,1,0,1,1,0,1
2023-06-01,21766,84,1,85,12,3,12
2023-06-01,54501,8,3,11,4,2,4
2023-06-01,394669,1,0,1,1,0,1
2023-06-01,394884,1,0,1,2,0,2
2023-06-01,395186,1,0,1,3,0,3
2023-06-01,395233,1,0,1,3,0,3
2023-06-01,53764,51,1,52,7,3,7
2023-06-01,396158,2,2,4,4,3,4
2023-06-01,10302,5,0,5,7,0,7
2023-06-01,33012,2,0,2,2,0,2
2023-06-01,394468,9,0,9,2,0,2
2023-06-01,55232,36,0,36,4,0,4
2023-06-01,26727,20,4,24,3,1,3
2023-06-01,30665,3,0,3,1,0,1
2023-06-01,36016,3,0,3,4,0,4
2023-06-01,30481,3,0,3,2,0,2
2023-06-01,394835,1,0,1,1,0,1
2023-06-01,40089,8,0,8,7,0,7
2023-06-01,394954,1,0,1,2,0,2
2023-06-01,394667,1,0,1,2,0,2
2023-06-01,62642,312,0,312,13,0,13
2023-06-01,11320,27,8,35,20,6,20
2023-06-01,63296,10,0,10,4,0,4
2023-06-01,393347,10,4,14,1,3,4
2023-06-01,400116,1,0,1,2,0,2
2023-06-01,394875,1,0,1,1,0,1
2023-06-01,394982,1,0,1,2,0,2
2023-06-01,397091,1,0,1,3,0,3
2023-06-01,397018,2,0,2,2,0,2
2023-06-01,54676,4,0,4,6,0,6
2023-06-01,32832,1,0,1,3,0,3
2023-06-01,50292,25,0,25,9,0,9
2023-06-01,396257,1,0,1,1,0,1
2023-06-01,394960,1,0,1,3,0,3
2023-06-01,395599,1,0,1,1,0,1
2023-06-01,395861,4,0,4,2,0,2
2023-06-01,395454,1,0,1,1,0,1
2023-06-01,31399,27,2,29,7,6,9
2023-06-01,306,319,0,319,54,0,54
2023-06-01,359,1,0,1,1,0,1
2023-06-01,344,21,0,21,3,0,3
2023-06-01,345,15,0,15,3,0,3
2023-06-01,360,94,0,94,1,0,1
2023-06-01,361,7,0,7,1,0,1
2023-06-01,362,28,0,28,1,0,1
2023-06-01,316,9,0,9,1,0,1
2023-06-01,317,3,0,3,3,0,3
2023-06-01,346,20,0,20,1,0,1
2023-06-01,364,1,0,1,1,0,1
2023-06-01,365,2,0,2,1,0,1
2023-06-01,331,8,0,8,1,0,1
2023-06-01,1530,18,0,18,1,0,1
2023-06-01,348,13,0,13,2,0,2
2023-06-01,349,16,0,16,1,0,1
2023-06-01,321,12,0,12,2,0,2
2023-06-01,320,10,0,10,1,0,1
2023-06-01,319,6,0,6,1,0,1
2023-06-01,337,69,0,69,2,0,2
2023-06-01,350,3,0,3,1,0,1
2023-06-01,352,5,0,5,1,0,1
2023-06-01,338,3,0,3,1,0,1
2023-06-01,322,3,0,3,1,0,1
2023-06-01,323,3,0,3,1,0,1
2023-06-01,351,3,0,3,1,0,1
2023-06-01,324,4,0,4,1,0,1
2023-06-01,340,6,0,6,1,0,1
2023-06-01,353,1,0,1,1,0,1
2023-06-01,325,29,0,29,1,0,1
2023-06-01,327,2,0,2,1,0,1
2023-06-01,355,39,0,39,1,0,1
2023-06-01,341,7,0,7,2,0,2
2023-06-01,356,124,0,124,1,0,1
2023-06-01,357,16,0,16,1,0,1
2023-06-01,369,100,0,100,1,0,1
2023-06-01,358,1,0,1,1,0,1
2023-06-01,328,10,0,10,1,0,1
2023-06-01,343,2,0,2,1,0,1
2023-06-01,342,9,0,9,1,0,1
2023-06-01,347,5,0,5,1,0,1
2023-06-01,334,44,0,44,1,0,1
2023-06-01,335,97,0,97,1,0,1
2023-06-01,336,23,0,23,1,0,1
2023-06-01,329,11,0,11,2,0,2
2023-06-01,366,1,1,2,1,1,2
2023-06-01,339,4,0,4,1,0,1
2023-06-01,368,20,0,20,1,0,1
2023-06-01,370,58,0,58,1,0,1
2023-06-01,371,1,0,1,1,0,1
2023-06-01,326,18,0,18,1,0,1
2023-06-01,307,1,0,1,1,0,1
2023-06-01,1590,34,0,34,2,0,2
2023-06-01,500,6,0,6,1,0,1
2023-06-01,6224,1,0,1,3,2,3
2023-06-01,5774,28,2,30,5,2,5
2023-06-01,4296,0,0,0,2,2,2
2023-06-01,6085,20,0,20,1,0,1
2023-06-01,4004,1,0,1,12,4,13
2023-06-01,6853,0,0,0,7,6,9
2023-06-01,4805,0,0,0,7,0,7
2023-06-01,2281,11,0,11,1,0,1
2023-06-01,400666,6,0,6,1,0,1
2023-06-01,62654,50,0,50,2,0,2
2023-06-01,205080,23,19,42,22,17,22
2023-06-01,206433,5,0,5,2,0,2
2023-06-01,198912,3,3,6,5,3,5
2023-06-01,132399,1,0,1,2,0,2
2023-06-01,11868,2,1,3,2,2,2
2023-06-01,19545,6,0,6,3,0,3
2023-06-01,2510,45,1,46,3,1,3
2023-06-01,9812,138,3,141,3,2,4
2023-06-01,17435,3,1,4,2,1,2
2023-06-01,9316,17,0,17,1,0,1
2023-06-01,9871,16,0,16,3,0,3
2023-06-01,139203,15,2,17,1,1,1
2023-06-01,139462,3,3,6,1,1,1
2023-06-01,136191,5,3,8,1,1,1
2023-06-01,58540,37,10,47,2,2,2
2023-06-01,58541,56,3,59,2,1,2
2023-06-01,139887,11,5,16,1,1,1
2023-06-01,141157,5,3,8,1,1,1
2023-06-01,136040,2,0,2,1,0,1
2023-06-01,132920,2,0,2,2,0,2
2023-06-01,58930,2,0,2,1,0,1
2023-06-01,18256,5,0,5,3,0,3
2023-06-01,17444,36,1,37,3,1,3
2023-06-01,24462,34,0,34,3,0,3
2023-06-01,45794,3,0,3,1,0,1
2023-06-01,23777,21,2,23,5,2,5
2023-06-01,17961,14,1,15,12,6,13
2023-06-01,9694,102,0,102,3,0,3
2023-06-01,23956,186,7,193,23,1,23
2023-06-01,38054,4,0,4,3,0,3
2023-06-01,38203,58,3,61,24,4,24
2023-06-01,24538,10,2,12,19,6,20
2023-06-01,24535,52,1,53,8,2,8
2023-06-01,17987,3,2,5,2,2,2
2023-06-01,38332,2,2,4,2,2,2
2023-06-01,136200,10,2,12,1,2,2
2023-06-01,24456,6,0,6,3,0,3
2023-06-01,24451,2,0,2,2,0,2
2023-06-01,17615,5,0,5,2,0,2
2023-06-01,38665,1,0,1,1,0,1
2023-06-01,23591,28,0,28,2,0,2
2023-06-01,134718,6,0,6,3,0,3
2023-06-01,9802,58,0,58,2,0,2
2023-06-01,9308,38,0,38,4,0,4
2023-06-01,134700,47,0,47,3,0,3
2023-06-01,272432,14,2,16,2,2,2
2023-06-01,133993,8,0,8,8,2,8
2023-06-01,134006,10,0,10,3,0,3
2023-06-01,138191,6,0,6,5,0,5
2023-06-01,59249,6,1,7,4,1,4
2023-06-01,131227,8,0,8,2,0,2
2023-06-01,134269,7,0,7,1,0,1
2023-06-01,45603,6,0,6,1,0,1
2023-06-01,38172,25,0,25,4,0,4
2023-06-01,24111,1,0,1,2,0,2
2023-06-01,9601,7,3,10,6,4,6
2023-06-01,18042,8,1,9,4,1,4
2023-06-01,45411,19,0,19,7,0,7
2023-06-01,9524,83,0,83,4,0,4
2023-06-01,9224,10,0,10,1,0,1
2023-06-01,45173,2,0,2,3,0,3
2023-06-01,38554,2,0,2,2,0,2
2023-06-01,18197,4,0,4,3,0,3
2023-06-01,38599,2,0,2,1,0,1
2023-06-01,131162,1,0,1,1,0,1
2023-06-01,55545,15,1,16,3,1,3
2023-06-01,55916,2,0,2,2,0,2
2023-06-01,58884,1,0,1,1,0,1
2023-06-01,9595,48,4,52,6,6,6
2023-06-01,45393,8,0,8,2,0,2
2023-06-01,23580,4,0,4,2,0,2
2023-06-01,38120,141,0,141,1,0,1
2023-06-01,23990,8,0,8,1,0,1
2023-06-01,45388,4,0,4,1,0,1
2023-06-01,38127,5,0,5,1,0,1
2023-06-01,45399,42,0,42,2,0,2
2023-06-01,9841,2,0,2,2,0,2
2023-06-01,10169,8,0,8,1,0,1
2023-06-01,9806,4,3,7,1,1,1
2023-06-01,56223,4,0,4,3,0,3
2023-06-01,24097,2,0,2,2,0,2
2023-06-01,23891,2,0,2,3,0,3
2023-06-01,136457,2,0,2,3,0,3
2023-06-01,56112,2,0,2,3,0,3
2023-06-01,17980,2,0,2,2,0,2
2023-06-01,55868,2,0,2,2,0,2
2023-06-01,18408,1,0,1,2,0,2
2023-06-01,135620,2,0,2,2,0,2
2023-06-01,140326,4,0,4,3,0,3
2023-06-01,55634,2,0,2,3,0,3
2023-06-01,37983,1,0,1,1,0,1
2023-06-01,24083,2,0,2,3,0,3
2023-06-01,38231,3,0,3,3,0,3
2023-06-01,9765,10,0,10,1,0,1
2023-06-01,9689,165,0,165,2,0,2
2023-06-01,38096,142,0,142,1,0,1
2023-06-01,38097,27,0,27,1,0,1
2023-06-01,59108,45,1,46,1,1,1
2023-06-01,46054,7,0,7,1,0,1
2023-06-01,45166,12,3,15,4,3,4
2023-06-01,56251,6,0,6,3,0,3
2023-06-01,17529,12,1,13,1,1,1
2023-06-01,140928,2,1,3,4,1,4
2023-06-01,140929,2,1,3,4,2,4
2023-06-01,17411,44,0,44,2,0,2
2023-06-01,37891,8,0,8,3,0,3
2023-06-01,38071,24,0,24,2,0,2
2023-06-01,63516,0,0,0,6,5,7
2023-06-01,7671,63,2,65,6,4,6
2023-06-01,9866,2,0,2,2,0,2
2023-06-01,9982,11,0,11,2,0,2
2023-06-01,4670,391,0,391,8,0,8
2023-06-01,4664,11,0,11,2,0,2
2023-06-01,9842,46,0,46,7,0,7
2023-06-01,24570,7,0,7,1,0,1
2023-06-01,4661,2,0,2,1,0,1
2023-06-01,45471,1,0,1,1,0,1
2023-06-01,149762,2,0,2,3,0,3
2023-06-01,9950,34,0,34,7,0,7
2023-06-01,10043,2,0,2,3,0,3
2023-06-01,38102,1,0,1,2,0,2
2023-06-01,24355,9,0,9,1,0,1
2023-06-01,139774,0,0,0,2,0,2
2023-06-01,9406,1,0,1,1,0,1
2023-06-01,138949,7,0,7,1,0,1
2023-06-01,134770,43,10,53,1,1,1
2023-06-01,134769,26,11,37,1,1,1
2023-06-01,131094,5,0,5,5,0,5
2023-06-01,45375,1,0,1,2,0,2
2023-06-01,9966,2,0,2,2,0,2
2023-06-01,10188,4,0,4,2,0,2
2023-06-01,10035,13,0,13,2,0,2
2023-06-01,131834,1,0,1,1,0,1
2023-06-01,131824,2,0,2,1,0,1
2023-06-01,9850,4,0,4,3,0,3
2023-06-01,38088,2,0,2,2,0,2
2023-06-01,38426,10,0,10,1,0,1
2023-06-01,7560,25,0,25,3,0,3
2023-06-01,131814,2,0,2,2,0,2
2023-06-01,9954,10,0,10,2,0,2
2023-06-01,38681,26,0,26,1,0,1
2023-06-01,23587,3,0,3,2,0,2
2023-06-01,17843,3,0,3,1,0,1
2023-06-01,23555,3,0,3,2,0,2
2023-06-01,45377,6,0,6,1,0,1
2023-06-01,55613,2,0,2,2,0,2
2023-06-01,9776,10,0,10,4,0,4
2023-06-01,38395,7,0,7,1,0,1
2023-06-01,131817,1,0,1,2,0,2
2023-06-01,23581,16,0,16,2,0,2
2023-06-01,131093,7,0,7,3,0,3
2023-06-01,17567,3,0,3,2,0,2
2023-06-01,131836,1,0,1,2,0,2
2023-06-01,38104,6,0,6,3,0,3
2023-06-01,9782,12,0,12,1,0,1
2023-06-01,18029,6,0,6,1,0,1
2023-06-01,9775,10,0,10,1,0,1
2023-06-01,10058,5,0,5,3,0,3
2023-06-01,23552,20,0,20,1,0,1
2023-06-01,134238,63,9,72,1,13,13
2023-06-01,139201,41,10,51,1,1,1
2023-06-01,140330,4,101,105,2,10,11
2023-06-01,24348,17,1,18,3,5,5
2023-06-01,24358,13,0,13,1,0,1
2023-06-01,24364,24,1,25,2,4,4
2023-06-01,9881,5,0,5,1,0,1
2023-06-01,38561,2,0,2,12,0,12
2023-06-01,131596,483,31,514,1,1,1
2023-06-01,141342,45,0,45,2,0,2
2023-06-01,140594,3,1,4,7,4,7
2023-06-01,9919,816,13,829,3,1,3
2023-06-01,134773,31,2,33,2,2,3
2023-06-01,18245,18,1,19,2,1,3
2023-06-01,137670,4,3,7,2,2,2
2023-06-01,17838,8,0,8,3,0,3
2023-06-01,149876,0,0,0,4,0,4
2023-06-01,18230,13,2,15,2,2,4
2023-06-01,133542,3,0,3,1,0,1
2023-06-01,135006,1,0,1,1,0,1
2023-06-01,63565,3,0,3,1,0,1
2023-06-01,58967,8,0,8,2,0,2
2023-06-01,64078,14,0,14,5,0,5
2023-06-01,23771,9,0,9,4,0,4
2023-06-01,64043,11,1,12,3,2,3
2023-06-01,4049,30,2,32,17,5,17
2023-06-01,59285,2,0,2,2,0,2
2023-06-01,132901,7,0,7,4,0,4
2023-06-01,58655,5,2,7,18,8,18
2023-06-01,134128,20,9,29,2,2,2
2023-06-01,134712,8,6,14,4,4,4
2023-06-01,56293,2,1,3,1,1,1
2023-06-01,134004,10,9,19,4,2,4
2023-06-01,134736,6,0,6,5,0,5
2023-06-01,133527,4,1,5,6,5,6
2023-06-01,63620,2,1,3,1,1,1
2023-06-01,132471,26,0,26,7,0,7
2023-06-01,63980,10,18,28,4,2,4
2023-06-01,140825,25,1,26,2,1,2
2023-06-01,56080,4,0,4,2,0,2
2023-06-01,26685,13,0,13,6,0,6
2023-06-01,17908,255,0,255,2,0,2
2023-06-01,17583,53,0,53,2,0,2
2023-06-01,17683,3,1,4,6,5,7
2023-06-01,17530,4,1,5,2,2,2
2023-06-01,38280,50,1,51,5,1,6
2023-06-01,38749,7,0,7,5,0,5
2023-06-01,37937,1,0,1,1,0,1
2023-06-01,136188,77,3,80,1,1,1
2023-06-01,147038,1,0,1,1,0,1
2023-06-01,141998,139,0,139,1,0,1
2023-06-01,140527,12,4,16,1,1,1
2023-06-01,142608,4,3,7,1,1,1
2023-06-01,9847,2,0,2,2,0,2
2023-06-01,17213,13,0,13,5,0,5
2023-06-01,131634,41,0,41,4,0,4
2023-06-01,1500,0,0,0,2,0,2
2023-06-01,1599,1,0,1,1,0,1
2023-06-01,24143,4,0,4,3,0,3
2023-06-01,140220,68,1,69,1,1,1
2023-06-01,9942,63,1,64,4,1,4
2023-06-01,7482,89,1,90,4,1,4
2023-06-01,24154,299,10,309,1,1,1
2023-06-01,7656,30,1,31,4,1,4
2023-06-01,9676,294,2,296,6,1,6
2023-06-01,7533,0,0,0,7,4,7
2023-06-01,131602,163,0,163,1,0,1
2023-06-01,17968,45,17,62,1,1,1
2023-06-01,4792,21,0,21,1,0,1
2023-06-01,38144,48,0,48,7,0,7
2023-06-01,17964,50,2,52,3,1,4
2023-06-01,10132,50,0,50,1,0,1
2023-06-01,24077,4,0,4,6,0,6
2023-06-01,131322,12,0,12,6,0,6
2023-06-01,18399,37,0,37,1,0,1
2023-06-01,17691,7,0,7,4,0,4
2023-06-01,64500,1,18,19,1,4,4
2023-06-01,10094,190,0,190,19,0,19
2023-06-01,18150,7,0,7,7,0,7
2023-06-01,63134,44,0,44,4,0,4
2023-06-01,9908,259,0,259,13,0,13
2023-06-01,17820,55,8,63,2,1,2
2023-06-01,3300,86,31,117,30,14,33
2023-06-01,17898,0,0,0,5,3,5
2023-06-01,9738,50,1,51,5,1,5
2023-06-01,393513,4,0,4,4,0,4
2023-06-01,63731,17,1,18,9,2,9
2023-06-01,63501,9,1,10,3,1,3
2023-06-01,18252,1,0,1,1,0,1
2023-06-01,135635,3,0,3,2,0,2
2023-06-01,7715,3,0,3,3,0,3
2023-06-01,24042,7,0,7,4,0,4
2023-06-01,17490,4,0,4,1,0,1
2023-06-01,17978,73,0,73,19,0,19
2023-06-01,58507,183,8,191,10,3,10
2023-06-01,17442,2,0,2,2,0,2
2023-06-01,9641,11,0,11,2,0,2
2023-06-01,17853,256,555,811,1,1,1
2023-06-01,38428,4,0,4,2,0,2
2023-06-01,9522,4,0,4,3,0,3
2023-06-01,45408,3,0,3,2,0,2
2023-06-01,10072,2,0,2,2,0,2
2023-06-01,9846,2,0,2,1,0,1
2023-06-01,23714,18,0,18,2,0,2
2023-06-01,9857,9,0,9,1,0,1
2023-06-01,18294,4,0,4,2,0,2
2023-06-01,131855,3,0,3,3,0,3
2023-06-01,9863,1,0,1,1,0,1
2023-06-01,9955,33,0,33,2,0,2
2023-06-01,9968,4,0,4,2,0,2
2023-06-01,45978,1,0,1,3,0,3
2023-06-01,18295,4,0,4,1,0,1
2023-06-01,9629,3,0,3,2,0,2
2023-06-01,131799,3,0,3,1,0,1
2023-06-01,17863,5,0,5,2,0,2
2023-06-01,18326,3,0,3,3,0,3
2023-06-01,55585,2,0,2,1,0,1
2023-06-01,23560,1,0,1,2,0,2
2023-06-01,131858,3,0,3,2,0,2
2023-06-01,45979,3,0,3,2,0,2
2023-06-01,10073,18,0,18,3,0,3
2023-06-01,45384,4,0,4,2,0,2
2023-06-01,23573,4,0,4,2,0,2
2023-06-01,38427,8,0,8,2,0,2
2023-06-01,38418,1,0,1,2,0,2
2023-06-01,59127,13,5,18,3,2,3
2023-06-01,9600,15,1,16,1,1,1
2023-06-01,4765,208,1,209,7,2,7
2023-06-01,7539,15,2,17,19,6,20
2023-06-01,18183,4,4,8,5,1,5
2023-06-01,9264,3,2,5,13,7,14
2023-06-01,24167,5,1,6,5,3,5
2023-06-01,18411,6,0,6,2,0,2
2023-06-01,9244,22,1,23,6,1,6
2023-06-01,9584,32,5,37,24,9,24
2023-06-01,4782,16,2,18,1,1,1
2023-06-01,17710,14,0,14,2,0,2
2023-06-01,18415,8,0,8,2,0,2
2023-06-01,18040,1,0,1,1,0,1
2023-06-01,18018,32,0,32,9,0,9
2023-06-01,132819,11,0,11,7,0,7
2023-06-01,18419,48,0,48,2,0,2
2023-06-01,9918,11,0,11,1,0,1
2023-06-01,9922,24,0,24,3,0,3
2023-06-01,18422,33,3,36,5,3,5
2023-06-01,18413,6,0,6,2,0,2
2023-06-01,18111,30,0,30,1,0,1
2023-06-01,18031,18,0,18,2,0,2
2023-06-01,17847,1,0,1,2,0,2
2023-06-01,10061,2,0,2,2,0,2
2023-06-01,9631,33,0,33,2,0,2
2023-06-01,38406,4,0,4,1,0,1
2023-06-01,55593,29,0,29,1,0,1
2023-06-01,9784,3,0,3,2,0,2
2023-06-01,38110,8,0,8,2,0,2
2023-06-01,38391,5,0,5,1,0,1
2023-06-01,38404,5,0,5,1,0,1
2023-06-01,18341,2,0,2,2,0,2
2023-06-01,18023,34,0,34,2,0,2
2023-06-01,4793,19,0,19,3,0,3
2023-06-01,131805,2,0,2,2,0,2
2023-06-01,55624,8,0,8,2,0,2
2023-06-01,10184,4,0,4,2,0,2
2023-06-01,18164,12,0,12,2,0,2
2023-06-01,9960,1,0,1,2,0,2
2023-06-01,37931,1,0,1,1,0,1
2023-06-01,38815,2,0,2,2,0,2
2023-06-01,17468,1,0,1,3,0,3
2023-06-01,136581,2,0,2,1,0,1
2023-06-01,55938,4,1,5,5,1,5
2023-06-01,136579,2,0,2,3,0,3
2023-06-01,17475,2,0,2,3,0,3
2023-06-01,37992,33,3,36,3,1,3
2023-06-01,133167,4,1,5,3,1,3
2023-06-01,4776,37,1,38,5,1,5
2023-06-01,21734,22,0,22,14,0,14
2023-06-01,45200,1,0,1,1,0,1
2023-06-01,38448,4,0,4,4,0,4
2023-06-01,24067,2,0,2,1,0,1
2023-06-01,23683,2,0,2,2,0,2
2023-06-01,45374,38,0,38,4,0,4
2023-06-01,10056,5,0,5,3,0,3
2023-06-01,38434,3,0,3,1,0,1
2023-06-01,38101,5,0,5,3,0,3
2023-06-01,38661,112,0,112,3,0,3
2023-06-01,10172,3,0,3,2,0,2
2023-06-01,9952,98,0,98,2,0,2
2023-06-01,17609,16,0,16,1,0,1
2023-06-01,38698,3,0,3,2,0,2
2023-06-01,38703,1,0,1,1,0,1
2023-06-01,38130,6,0,6,3,0,3
2023-06-01,38114,7,0,7,1,0,1
2023-06-01,38117,16,0,16,1,0,1
2023-06-01,10160,63,0,63,3,0,3
2023-06-01,55623,2,0,2,1,0,1
2023-06-01,45361,25,0,25,4,0,4
2023-06-01,9528,155,0,155,1,0,1
2023-06-01,17600,7,0,7,2,0,2
2023-06-01,9711,2,0,2,1,0,1
2023-06-01,55610,2,0,2,2,0,2
2023-06-01,17582,2,0,2,2,0,2
2023-06-01,9707,5,0,5,2,0,2
2023-06-01,45394,1,0,1,2,0,2
2023-06-01,131828,1,0,1,1,0,1
2023-06-01,9980,62,0,62,2,0,2
2023-06-01,10002,5,1,6,5,2,5
2023-06-01,10003,12,1,13,5,3,5
2023-06-01,138384,31,1,32,8,6,8
2023-06-01,10012,4,1,5,1,1,1
2023-06-01,10006,53,2,55,6,4,6
2023-06-01,10015,3,0,3,5,0,5
2023-06-01,10019,10,1,11,6,3,6
2023-06-01,9997,7,1,8,5,3,5
2023-06-01,394646,17,0,17,6,0,6
2023-06-01,9998,9,0,9,1,0,1
2023-06-01,2522,15,0,15,1,0,1
2023-06-01,4723,7,0,7,3,0,3
2023-06-01,17504,9,0,9,2,0,2
2023-06-01,134420,122,16,138,2,1,2
2023-06-01,134425,14,0,14,1,0,1
2023-06-01,136194,6,3,9,1,1,1
2023-06-01,140278,54,0,54,1,0,1
2023-06-01,140083,4,2,6,1,18,18
2023-06-01,4678,4,1,5,4,3,5
2023-06-01,2915,4,1,5,1,1,1
2023-06-01,146969,6,1,7,2,2,2
2023-06-01,17685,2,0,2,9,0,9
2023-06-01,2554,39,0,39,1,0,1
2023-06-01,146977,7,0,7,2,0,2
2023-06-01,10016,1,0,1,3,0,3
2023-06-01,18121,6,1,7,6,4,7
2023-06-01,7686,2,0,2,1,0,1
2023-06-01,4693,7,1,8,4,3,5
2023-06-01,17680,2,0,2,1,0,1
2023-06-01,38341,16,0,16,1,0,1
2023-06-01,23786,5,1,6,3,2,3
2023-06-01,9271,4,0,4,1,0,1
2023-06-01,38031,66,18,84,3,3,3
2023-06-01,38660,7,0,7,2,0,2
2023-06-01,9642,4,0,4,2,0,2
2023-06-01,9973,9,0,9,1,0,1
2023-06-01,38667,7,0,7,3,0,3
2023-06-01,17592,6,0,6,5,0,5
2023-06-01,38121,107,0,107,1,0,1
2023-06-01,45389,5,0,5,2,0,2
2023-06-01,4202,6,0,6,3,0,3
2023-06-01,205450,2,0,2,2,0,2
2023-06-01,210520,1,0,1,2,0,2
2023-06-01,201737,1,0,1,2,0,2
2023-06-01,211332,2,2,4,1,1,2
2023-06-01,209743,1,0,1,1,0,1
2023-06-01,64484,2,2,4,1,1,1
2023-06-01,211005,1,1,2,1,1,1
2023-06-01,210506,4,0,4,4,0,4
2023-06-01,209014,7,1,8,1,1,1
2023-06-01,206170,20,3,23,2,2,2
2023-06-01,200146,1,0,1,1,0,1
2023-06-01,212963,1,1,2,1,1,1
2023-06-01,208210,1,3,4,3,4,4
2023-06-01,203421,3,1,4,9,1,9
2023-06-01,51902,1,0,1,1,0,1
2023-06-01,15869,1,0,1,2,0,2
2023-06-01,9112,2,1,3,4,2,4
2023-06-01,8364,2,2,4,7,2,7
2023-06-01,9105,70,0,70,1,0,1
2023-06-01,25035,1,0,1,4,0,4
2023-06-01,206718,3,0,3,5,0,5
2023-06-01,202756,13,0,13,16,0,16
2023-06-01,15933,34,0,34,7,0,7
2023-06-01,328299,2,0,2,3,0,3
2023-06-01,60969,7,0,7,3,0,3
2023-06-01,48943,16,2,18,15,4,15
2023-06-01,15498,6,1,7,3,2,3
2023-06-01,35339,3,1,4,7,4,7
2023-06-01,50429,6,0,6,3,0,3
2023-06-01,15640,77,1,78,5,1,5
2023-06-01,15612,1,0,1,6,0,6
2023-06-01,13662,5,0,5,2,0,2
2023-06-01,1270,1,1,2,2,1,2
2023-06-01,2822,0,0,0,3,0,3
2023-06-01,9055,1,0,1,2,0,2
2023-06-01,59739,2,0,2,1,0,1
2023-06-01,212458,2,0,2,3,0,3
2023-06-01,2830,80,1,81,9,1,9
2023-06-01,50272,8,2,10,8,9,12
2023-06-01,49694,10,3,13,3,1,3
2023-06-01,15525,32,2,34,23,3,24
2023-06-01,21232,20,1,21,5,2,5
2023-06-01,24753,11,1,12,11,2,11
2023-06-01,209665,1,0,1,1,0,1
2023-06-01,9193,4,0,4,3,0,3
2023-06-01,197832,9,0,9,3,0,3
2023-06-01,20921,7,0,7,1,0,1
2023-06-01,212377,1,0,1,1,0,1
2023-06-01,29322,3,0,3,4,0,4
2023-06-01,14616,7,1,8,2,2,2
2023-06-01,41707,9,0,9,6,0,6
2023-06-01,6802,44,1,45,13,8,13
2023-06-01,5421,1,2,3,3,3,3
2023-06-01,15435,12,3,15,14,9,17
2023-06-01,8271,1,1,2,4,3,4
2023-06-01,13284,3,1,4,2,1,2
2023-06-01,12374,7,1,8,2,3,4
2023-06-01,8928,4,0,4,4,0,4
2023-06-01,36892,7,0,7,3,0,3
2023-06-01,51263,13,1,14,6,1,6
2023-06-01,49572,7,1,8,10,3,10
2023-06-01,15611,15,0,15,2,0,2
2023-06-01,35372,3,0,3,1,0,1
2023-06-01,16200,5,0,5,3,0,3
2023-06-01,3218,21,3,24,5,1,5
2023-06-01,5386,6,0,6,1,0,1
2023-06-01,15516,10,3,13,3,2,4
2023-06-01,12566,25,0,25,1,0,1
2023-06-01,20985,18,1,19,4,1,4
2023-06-01,35182,5,0,5,1,0,1
2023-06-01,15517,4,1,5,3,5,5
2023-06-01,23023,6,0,6,5,0,5
2023-06-01,15968,3,0,3,1,0,1
2023-06-01,44517,1,0,1,1,0,1
2023-06-01,202309,3,1,4,7,4,8
2023-06-01,394381,8,0,8,2,0,2
2023-06-01,209438,1,0,1,1,0,1
2023-06-01,206402,1,1,2,2,1,2
2023-06-01,207924,1,0,1,1,0,1
2023-06-01,198252,38,1,39,2,1,2
2023-06-01,56833,9,0,9,2,0,2
2023-06-01,13227,2,1,3,4,1,4
2023-06-01,5587,16,1,17,3,2,3
2023-06-01,59766,3,0,3,7,0,7
2023-06-01,199196,8,0,8,3,0,3
2023-06-01,201785,4,1,5,2,2,2
2023-06-01,32641,24,0,24,4,0,4
2023-06-01,5427,12,0,12,1,0,1
2023-06-01,213382,2,0,2,5,0,5
2023-06-01,209186,1,0,1,1,0,1
2023-06-01,24751,5,1,6,4,2,4
2023-06-01,8999,8,0,8,1,0,1
2023-06-01,51987,1,0,1,1,0,1
2023-06-01,203484,1,0,1,3,0,3
2023-06-01,210229,1,0,1,1,0,1
2023-06-01,48851,65,22,87,15,8,15
2023-06-01,18994,11,0,11,6,0,6
2023-06-01,12361,16,0,16,1,0,1
2023-06-01,43600,2,0,2,1,0,1
2023-06-01,199377,2,0,2,1,0,1
2023-06-01,60854,1,0,1,1,0,1
2023-06-01,60753,1,0,1,2,0,2
2023-06-01,60827,1,0,1,3,0,3
2023-06-01,20483,2,0,2,5,0,5
2023-06-01,208991,2,0,2,1,0,1
2023-06-01,12999,1,0,1,2,0,2
2023-06-01,8475,3,0,3,1,0,1
2023-06-01,29194,40,0,40,4,0,4
2023-06-01,60915,1,1,2,4,1,4
2023-06-01,60796,1,0,1,3,0,3
2023-06-01,60702,1,0,1,3,0,3
2023-06-01,59833,4,1,5,3,1,3
2023-06-01,28891,3,0,3,9,0,9
2023-06-01,211078,1,0,1,2,0,2
2023-06-01,60834,1,1,2,1,1,1
2023-06-01,57645,4,0,4,8,0,8
2023-06-01,60892,4,0,4,1,0,1
2023-06-01,13185,1,0,1,2,0,2
2023-06-01,34629,8,1,9,7,1,7
2023-06-01,42548,5,0,5,2,0,2
2023-06-01,9157,2,0,2,1,0,1
2023-06-01,45029,5,3,8,8,6,8
2023-06-01,43832,13,9,22,14,11,15
2023-06-01,42139,2,2,4,4,4,5
2023-06-01,45018,3,2,5,6,3,6
2023-06-01,42385,26,22,48,25,16,25
2023-06-01,51054,11,0,11,5,0,5
2023-06-01,47104,2,0,2,4,0,4
2023-06-01,207397,1,0,1,4,0,4
2023-06-01,51408,7,1,8,6,2,6
2023-06-01,49199,13,0,13,1,0,1
2023-06-01,44597,3,2,5,6,4,6
2023-06-01,47445,3,3,6,5,5,5
2023-06-01,49210,1,0,1,1,0,1
2023-06-01,57512,3,0,3,7,0,7
2023-06-01,60473,2,0,2,3,0,3
2023-06-01,60575,2,0,2,2,0,2
2023-06-01,211605,1,0,1,1,0,1
2023-06-01,49963,3,0,3,6,0,6
2023-06-01,15620,3,0,3,3,0,3
2023-06-01,60470,6,0,6,4,0,4
2023-06-01,15913,5,0,5,2,0,2
2023-06-01,56580,9,0,9,1,0,1
2023-06-01,13077,3,0,3,3,0,3
2023-06-01,61151,2,0,2,5,0,5
2023-06-01,50157,1,1,2,2,2,2
2023-06-01,41895,2,0,2,2,0,2
2023-06-01,213041,1,0,1,1,0,1
2023-06-01,8909,1,0,1,1,0,1
2023-06-01,60482,1,0,1,1,0,1
2023-06-01,197986,2,0,2,3,0,3
2023-06-01,199009,4,1,5,1,1,1
2023-06-01,199314,1,0,1,2,0,2
2023-06-01,60360,1,0,1,1,0,1
2023-06-01,60726,1,0,1,1,0,1
2023-06-01,51578,4,0,4,2,0,2
2023-06-01,60747,6,0,6,1,0,1
2023-06-01,43267,14,1,15,15,2,16
2023-06-01,62333,1,0,1,3,0,3
2023-06-01,60518,1,0,1,2,0,2
2023-06-01,30812,2,0,2,1,0,1
2023-06-01,24683,2,0,2,1,0,1
2023-06-01,60818,1,0,1,2,0,2
2023-06-01,48123,12,0,12,3,0,3
2023-06-01,60835,1,0,1,1,0,1
2023-06-01,43634,6,0,6,4,0,4
2023-06-01,48731,1,0,1,1,0,1
2023-06-01,60678,1,0,1,3,0,3
2023-06-01,62379,2,0,2,1,0,1
2023-06-01,62316,2,1,3,5,1,5
2023-06-01,8981,4,1,5,1,1,1
2023-06-01,34017,2,0,2,2,0,2
2023-06-01,64433,13,0,13,3,0,3
2023-06-01,60347,2,0,2,7,0,7
2023-06-01,201065,1,0,1,1,0,1
2023-06-01,61035,1,0,1,1,0,1
2023-06-01,60544,1,0,1,1,0,1
2023-06-01,60988,2,0,2,3,0,3
2023-06-01,12770,2,0,2,3,0,3
2023-06-01,211229,1,0,1,2,0,2
2023-06-01,199280,1,0,1,1,0,1
2023-06-01,60523,1,0,1,1,0,1
2023-06-01,21416,11,6,17,4,3,4
2023-06-01,24742,1,0,1,1,0,1
2023-06-01,15566,5,1,6,4,2,4
2023-06-01,43608,5,1,6,8,2,8
2023-06-01,15410,1,0,1,1,0,1
2023-06-01,12597,38,8,46,8,7,9
2023-06-01,24580,1,0,1,1,0,1
2023-06-01,210097,9,0,9,3,0,3
2023-06-01,197478,3,0,3,2,0,2
2023-06-01,211699,3,0,3,1,0,1
2023-06-01,42334,67,1,68,2,1,2
2023-06-01,48179,1,0,1,1,0,1
2023-06-01,12797,5,0,5,1,0,1
2023-06-01,21010,1,0,1,4,0,4
2023-06-01,47377,33,5,38,7,4,8
2023-06-01,25387,1,1,2,3,3,3
2023-06-01,60717,17,4,21,1,1,1
2023-06-01,8419,5,1,6,1,1,1
2023-06-01,200823,1,0,1,2,0,2
2023-06-01,204271,1,0,1,4,0,4
2023-06-01,204230,1,0,1,2,0,2
2023-06-01,60484,2,0,2,2,0,2
2023-06-01,3168,8,0,8,1,0,1
2023-06-01,207438,1,0,1,2,0,2
2023-06-01,205349,1,0,1,1,0,1
2023-06-01,43197,21,3,24,7,3,7
2023-06-01,20686,9,0,9,11,0,11
2023-06-01,25468,7,1,8,2,2,2
2023-06-01,50920,14,0,14,2,0,2
2023-06-01,49163,2,0,2,1,0,1
2023-06-01,43002,3,0,3,1,0,1
2023-06-01,18622,8,0,8,2,0,2
2023-06-01,20756,9,5,14,9,8,9
2023-06-01,8520,13,4,17,3,3,3
2023-06-01,205661,1,0,1,3,0,3
2023-06-01,60845,6,0,6,3,0,3
2023-06-01,15529,11,0,11,1,0,1
2023-06-01,9165,5,0,5,4,0,4
2023-06-01,8608,8,0,8,7,0,7
2023-06-01,15472,5,0,5,2,0,2
2023-06-01,16334,2,0,2,2,0,2
2023-06-01,12488,22,2,24,10,4,10
2023-06-01,28728,1,0,1,1,0,1
2023-06-01,15584,11,0,11,4,0,4
2023-06-01,197775,1,0,1,1,0,1
2023-06-01,197650,8,0,8,4,0,4
2023-06-01,5430,57,1,58,13,7,15
2023-06-01,25474,2,0,2,2,0,2
2023-06-01,65543,1,0,1,1,0,1
2023-06-01,8872,1,0,1,3,0,3
2023-06-01,199527,15,0,15,3,0,3
2023-06-01,21500,18,1,19,10,2,10
2023-06-01,210451,1,0,1,1,0,1
2023-06-01,211501,2,3,5,4,3,5
2023-06-01,203701,1,1,2,1,1,1
2023-06-01,8831,10,0,10,3,0,3
2023-06-01,203545,4,0,4,1,0,1
2023-06-01,6623,9,4,13,5,3,5
2023-06-01,51132,7,1,8,4,3,4
2023-06-01,25518,2,0,2,4,0,4
2023-06-01,24783,9,0,9,1,0,1
2023-06-01,200869,11,0,11,1,0,1
2023-06-01,211656,9,1,10,3,1,3
2023-06-01,13157,5,1,6,6,5,8
2023-06-01,24590,1,1,2,2,1,2
2023-06-01,51923,4,1,5,2,2,2
2023-06-01,16074,44,2,46,3,3,3
2023-06-01,29311,22,3,25,4,5,5
2023-06-01,200044,12,2,14,20,5,20
2023-06-01,25530,5,0,5,4,0,4
2023-06-01,60660,1,0,1,1,0,1
2023-06-01,209024,15,1,16,5,1,5
2023-06-01,13155,17,0,17,1,0,1
2023-06-01,41535,15,0,15,3,0,3
2023-06-01,6903,22,0,22,1,0,1
2023-06-01,49352,30,0,30,4,2,5
2023-06-01,48282,77,2,79,6,5,6
2023-06-01,1901,18,0,18,1,0,1
2023-06-01,15456,6,1,7,8,7,9
2023-06-01,48922,3,0,3,2,0,2
2023-06-01,15541,18,0,18,7,0,7
2023-06-01,25435,69,1,70,3,1,3
2023-06-01,48744,14,0,14,1,0,1
2023-06-01,48870,2,0,2,2,0,2
2023-06-01,29422,22,8,30,2,3,3
2023-06-01,47530,5,1,6,3,1,4
2023-06-01,34786,8,0,8,4,0,4
2023-06-01,48440,5,0,5,5,0,5
2023-06-01,208432,3,0,3,1,0,1
2023-06-01,16379,26,0,26,1,0,1
2023-06-01,49472,9,1,10,1,1,1
2023-06-01,24703,22,0,22,14,0,14
2023-06-01,49019,3,0,3,3,0,3
2023-06-01,49160,2,0,2,2,0,2
2023-06-01,197653,9,0,9,5,0,5
2023-06-01,207579,2,0,2,1,0,1
2023-06-01,49290,5,0,5,3,0,3
2023-06-01,20942,8,0,8,3,0,3
2023-06-01,13253,6,1,7,2,1,2
2023-06-01,12440,16,5,21,12,6,14
2023-06-01,31104,2,0,2,1,0,1
2023-06-01,16365,10,1,11,4,1,4
2023-06-01,15535,1,0,1,2,0,2
2023-06-01,25038,6,0,6,3,0,3
2023-06-01,209712,1,0,1,3,0,3
2023-06-01,207395,1,1,2,1,1,1
2023-06-01,207382,1,1,2,3,2,3
2023-06-01,57895,1,0,1,1,0,1
2023-06-01,208352,1,0,1,2,0,2
2023-06-01,28788,5,3,8,11,6,12
2023-06-01,200386,1,0,1,1,0,1
2023-06-01,28995,1,0,1,1,0,1
2023-06-01,24778,4,1,5,2,2,2
2023-06-01,24867,28,2,30,7,2,7
2023-06-01,47282,2,0,2,1,0,1
2023-06-01,208142,4,0,4,3,0,3
2023-06-01,20588,1,0,1,1,0,1
2023-06-01,13126,25,1,26,6,2,6
2023-06-01,39376,32,0,32,2,0,2
2023-06-01,5619,16,1,17,4,5,5
2023-06-01,13243,8,1,9,3,2,3
2023-06-01,206175,32,0,32,4,0,4
2023-06-01,25542,15,7,22,11,3,11
2023-06-01,64513,11,1,12,4,1,5
2023-06-01,196820,2,0,2,3,0,3
2023-06-01,1902,6,1,7,1,1,1
2023-06-01,8908,1,0,1,1,0,1
2023-06-01,39552,3,0,3,3,0,3
2023-06-01,205623,1,0,1,2,0,2
2023-06-01,199128,11,0,11,1,0,1
2023-06-01,2134,131,0,131,22,0,22
2023-06-01,8897,12,0,12,1,0,1
2023-06-01,28745,58,2,60,11,1,11
2023-06-01,6724,9,4,13,4,4,5
2023-06-01,6786,12,4,16,5,3,5
2023-06-01,28831,9,0,9,3,0,3
2023-06-01,12445,14,0,14,6,0,6
2023-06-01,204365,1,0,1,2,0,2
2023-06-01,24744,6,0,6,2,0,2
2023-06-01,208670,1,0,1,1,0,1
2023-06-01,208667,1,0,1,1,0,1
2023-06-01,208668,10,1,11,1,1,1
2023-06-01,35452,1,0,1,1,0,1
2023-06-01,34558,3,0,3,2,0,2
2023-06-01,34300,8,0,8,4,0,4
2023-06-01,60675,10,0,10,3,0,3
2023-06-01,212139,3,0,3,1,0,1
2023-06-01,199191,1,0,1,1,0,1
2023-06-01,210754,1,0,1,1,0,1
2023-06-01,35183,1,0,1,1,0,1
2023-06-01,39163,4,0,4,4,0,4
2023-06-01,201114,1,0,1,1,0,1
2023-06-01,203650,1,0,1,1,0,1
2023-06-01,39719,15,2,17,3,1,3
2023-06-01,28947,7,0,7,1,0,1
2023-06-01,41556,2,0,2,2,0,2
2023-06-01,15670,6,0,6,1,0,1
2023-06-01,21244,1,0,1,2,0,2
2023-06-01,42291,10,1,11,14,5,14
2023-06-01,62046,1,0,1,2,0,2
2023-06-01,206585,1,0,1,3,0,3
2023-06-01,15790,1,0,1,2,0,2
2023-06-01,42595,4,0,4,2,0,2
2023-06-01,51957,1,1,2,6,2,6
2023-06-01,44491,4,2,6,1,1,1
2023-06-01,200083,2,1,3,3,3,3
2023-06-01,202253,1,0,1,2,0,2
2023-06-01,44678,6,0,6,4,0,4
2023-06-01,196638,15,0,15,3,0,3
2023-06-01,197605,1,0,1,1,0,1
2023-06-01,34917,2,0,2,1,0,1
2023-06-01,50625,13,0,13,8,0,8
2023-06-01,34724,6,0,6,2,0,2
2023-06-01,210912,0,0,0,2,0,2
2023-06-01,197415,11,0,11,1,0,1
2023-06-01,51277,3,0,3,2,0,2
2023-06-01,47467,10,1,11,2,1,2
2023-06-01,13000,40,2,42,16,5,17
2023-06-01,15744,6,1,7,12,7,12
2023-06-01,47131,3,0,3,2,0,2
2023-06-01,201546,2,0,2,1,0,1
2023-06-01,47198,2,0,2,1,0,1
2023-06-01,25490,65,1,66,4,1,4
2023-06-01,43132,4,0,4,3,0,3
2023-06-01,15277,6,0,6,3,0,3
2023-06-01,20249,35,0,35,16,0,16
2023-06-01,18692,16,0,16,8,0,8
2023-06-01,206484,4,1,5,2,2,2
2023-06-01,31141,5,0,5,2,0,2
2023-06-01,39775,5,1,6,8,1,8
2023-06-01,15430,6,0,6,4,0,4
2023-06-01,210136,1,0,1,1,0,1
2023-06-01,208700,1,0,1,3,0,3
2023-06-01,205984,3,0,3,1,0,1
2023-06-01,211856,1,1,2,1,1,1
2023-06-01,15446,2,0,2,2,0,2
2023-06-01,5618,11,0,11,4,0,4
2023-06-01,16211,5,0,5,2,0,2
2023-06-01,12680,8,0,8,7,0,7
2023-06-01,12392,102,17,119,6,3,6
2023-06-01,208068,6,0,6,1,0,1
2023-06-01,205006,4,0,4,2,0,2
2023-06-01,15548,7,0,7,2,0,2
2023-06-01,31349,2,1,3,8,1,8
2023-06-01,57208,17,0,17,10,6,10
2023-06-01,58343,11,2,13,3,1,3
2023-06-01,204152,6,0,6,4,0,4
2023-06-01,62419,2,0,2,1,0,1
2023-06-01,48492,14,1,15,1,1,1
2023-06-01,59425,1,0,1,1,0,1
2023-06-01,204404,1,1,2,2,2,2
2023-06-01,210521,1,1,2,1,1,1
2023-06-01,49305,4,1,5,1,1,1
2023-06-01,210584,1,0,1,3,0,3
2023-06-01,202209,7,0,7,1,0,1
2023-06-01,62418,2,0,2,2,0,2
2023-06-01,42086,7,1,8,2,2,2
2023-06-01,48917,61,0,61,3,0,3
2023-06-01,12886,23,2,25,9,7,11
2023-06-01,15630,1,1,2,1,1,1
2023-06-01,34040,4,1,5,1,1,1
2023-06-01,44747,2,0,2,6,0,6
2023-06-01,42372,2,0,2,2,0,2
2023-06-01,9026,2,1,3,5,2,5
2023-06-01,201167,18,1,19,1,1,1
2023-06-01,29071,4,0,4,4,0,4
2023-06-01,205952,17,1,18,3,2,3
2023-06-01,28707,2,1,3,2,2,2
2023-06-01,29435,3,0,3,1,0,1
2023-06-01,52081,3,0,3,2,0,2
2023-06-01,3265,21,6,27,4,1,4
2023-06-01,41275,7,0,7,10,0,10
2023-06-01,202856,2,0,2,2,0,2
2023-06-01,48400,6,0,6,1,0,1
2023-06-01,41209,28,0,28,1,0,1
2023-06-01,15437,1,0,1,1,0,1
2023-06-01,21341,26,0,26,7,0,7
2023-06-01,6893,4,2,6,14,10,14
2023-06-01,45010,3,1,4,4,3,4
2023-06-01,29132,8,0,8,2,0,2
2023-06-01,6703,271,0,271,12,0,12
2023-06-01,13183,3,0,3,1,0,1
2023-06-01,8918,3,0,3,8,0,8
2023-06-01,203206,7,1,8,2,2,2
2023-06-01,204592,2,0,2,1,0,1
2023-06-01,208601,1,0,1,1,0,1
2023-06-01,205972,1,1,2,2,2,2
2023-06-01,202534,1,0,1,2,0,2
2023-06-01,203598,4,0,4,4,0,4
2023-06-01,200649,1,0,1,1,0,1
2023-06-01,207971,2,0,2,1,0,1
2023-06-01,202117,1,0,1,2,0,2
2023-06-01,202232,1,0,1,3,0,3
2023-06-01,51228,2,0,2,3,0,3
2023-06-01,15850,13,0,13,4,0,4
2023-06-01,65545,1,0,1,1,0,1
2023-06-01,16173,2,0,2,3,0,3
2023-06-01,44315,4,0,4,2,0,2
2023-06-01,25441,69,1,70,6,4,7
2023-06-01,206350,3,2,5,3,2,3
2023-06-01,41008,8,0,8,4,2,4
2023-06-01,9166,15,6,21,4,2,4
2023-06-01,210646,5,1,6,2,1,2
2023-06-01,29667,19,1,20,5,1,6
2023-06-01,210638,1,0,1,1,0,1
2023-06-01,15542,13,7,20,1,1,1
2023-06-01,203877,50,0,50,4,0,4
2023-06-01,13267,8,0,8,4,0,4
2023-06-01,15720,20,0,20,2,0,2
2023-06-01,43976,8,0,8,5,0,5
2023-06-01,207464,7,0,7,1,0,1
2023-06-01,3254,4,0,4,4,0,4
2023-06-01,8565,14,1,15,7,3,7
2023-06-01,12629,7,0,7,1,0,1
2023-06-01,31693,3,0,3,2,0,2
2023-06-01,201961,2,0,2,1,0,1
2023-06-01,30734,2,0,2,1,0,1
2023-06-01,62077,4,0,4,1,0,1
2023-06-01,38920,2,0,2,2,0,2
2023-06-01,39253,1,0,1,2,0,2
2023-06-01,29094,11,0,11,4,0,4
2023-06-01,61108,4,0,4,3,0,3
2023-06-01,6984,62,18,80,3,1,3
2023-06-01,6995,36,0,36,1,0,1
2023-06-01,3378,54,0,54,5,0,5
2023-06-01,3371,26,0,26,5,0,5
2023-06-01,3372,105,0,105,3,0,3
2023-06-01,1661,24,0,24,2,0,2
2023-06-01,30211,5,1,6,1,1,1
2023-06-01,13434,5,0,5,3,0,3
2023-06-01,13666,9,0,9,1,0,1
2023-06-01,16777,2,0,2,1,0,1
2023-06-01,12061,1,1,2,1,1,1
2023-06-01,396972,9,0,9,1,0,1
2023-06-01,27174,4,0,4,2,0,2
2023-06-01,1699,45,0,45,3,0,3
2023-06-01,26381,23,0,23,4,0,4
2023-06-01,19405,1,0,1,2,0,2
2023-06-01,15089,13,0,13,2,0,2
2023-06-01,12153,6,0,6,1,0,1
2023-06-01,25771,6,0,6,4,0,4
2023-06-01,7799,11,0,11,1,0,1
2023-06-01,32805,6,0,6,3,0,3
2023-06-01,23148,1,1,2,1,1,1
2023-06-01,54646,6,1,7,4,2,4
2023-06-01,26938,4,0,4,3,0,3
2023-06-01,46350,1,0,1,1,0,1
2023-06-01,28502,26,0,26,6,0,6
2023-06-01,21726,5,0,5,1,0,1
2023-06-01,22866,4,0,4,1,0,1
2023-06-01,20005,1,0,1,2,0,2
2023-06-01,13570,2,0,2,3,0,3
2023-06-01,11716,8,0,8,4,0,4
2023-06-01,397056,3,0,3,2,0,2
2023-06-01,7996,7,0,7,2,0,2
2023-06-01,16791,27,0,27,1,0,1
2023-06-01,13626,5,0,5,1,0,1
2023-06-01,30066,9,0,9,6,0,6
2023-06-01,26717,2,0,2,1,0,1
2023-06-01,62574,2,0,2,2,0,2
2023-06-01,10461,16,0,16,4,0,4
2023-06-01,20472,14,0,14,2,0,2
2023-06-01,12234,12,5,17,3,1,3
2023-06-01,36489,10,0,10,4,0,4
2023-06-01,19885,4,0,4,1,0,1
2023-06-01,23304,7,0,7,3,0,3
2023-06-01,11275,2,0,2,5,0,5
2023-06-01,14454,50,0,50,5,0,5
2023-06-01,396922,5,2,7,6,2,6
2023-06-01,3455,30,0,30,9,0,9
2023-06-01,30338,1,0,1,1,0,1
2023-06-01,705,128,0,128,1,0,1
2023-06-01,19627,15,0,15,2,0,2
2023-06-01,14958,1,0,1,1,0,1
2023-06-01,6303,45,0,45,4,0,4
2023-06-01,6203,23,0,23,5,0,5
2023-06-01,23219,3,0,3,2,0,2
2023-06-01,10695,57,0,57,5,0,5
2023-06-01,32851,6,0,6,4,0,4
2023-06-01,18573,5,0,5,1,0,1
2023-06-01,15572,12,1,13,1,1,1
2023-06-01,11988,1,0,1,1,0,1
2023-06-01,16578,75,5,80,3,3,3
2023-06-01,30548,6,5,11,3,3,4
2023-06-01,54546,1,0,1,1,0,1
2023-06-01,55182,4,0,4,3,0,3
2023-06-01,22135,10,0,10,3,0,3
2023-06-01,399579,1,0,1,2,0,2
2023-06-01,25967,4,0,4,3,0,3
2023-06-01,14329,2,0,2,3,0,3
2023-06-01,22530,13,0,13,4,0,4
2023-06-01,397844,1,0,1,3,0,3
2023-06-01,32330,2,0,2,2,0,2
2023-06-01,30004,1,0,1,2,0,2
2023-06-01,54519,6,1,7,10,2,10
2023-06-01,46630,2,0,2,3,0,3
2023-06-01,10790,4,0,4,3,0,3
2023-06-01,14414,9,1,10,4,1,4
2023-06-01,1663,5,0,5,1,0,1
2023-06-01,13883,1,0,1,1,0,1
2023-06-01,13462,8,1,9,4,1,4
2023-06-01,29782,2,0,2,3,0,3
2023-06-01,21973,12,3,15,6,3,6
2023-06-01,19462,6,0,6,3,0,3
2023-06-01,54301,19,0,19,5,0,5
2023-06-01,10388,4,0,4,1,0,1
2023-06-01,11621,6,0,6,3,0,3
2023-06-01,13517,6,0,6,5,0,5
2023-06-01,30462,8,0,8,3,0,3
2023-06-01,53603,4,0,4,1,0,1
2023-06-01,396240,2,0,2,3,0,3
2023-06-01,20127,4,2,6,4,1,4
2023-06-01,40234,1,0,1,1,0,1
2023-06-01,394260,3,0,3,3,0,3
2023-06-01,26860,1,1,2,2,2,2
2023-06-01,36152,2,1,3,1,1,1
2023-06-01,397890,1,0,1,3,0,3
2023-06-01,29712,1,0,1,2,0,2
2023-06-01,16756,3,0,3,1,0,1
2023-06-01,23057,2,0,2,1,0,1
2023-06-01,32929,2,0,2,1,0,1
2023-06-01,46303,9,0,9,4,0,4
2023-06-01,15250,13,0,13,5,0,5
2023-06-01,40160,98,0,98,10,0,10
2023-06-01,5006,107,0,107,7,0,7
2023-06-01,39947,1,0,1,1,0,1
2023-06-01,14566,37,0,37,1,0,1
2023-06-01,11486,44,15,59,2,1,2
2023-06-01,10361,99,0,99,20,0,20
2023-06-01,14473,2,0,2,2,0,2
2023-06-01,32058,8,2,10,5,2,5
2023-06-01,22778,2,0,2,2,0,2
2023-06-01,53945,1,0,1,3,0,3
2023-06-01,20088,3,0,3,1,0,1
2023-06-01,15227,19,0,19,1,0,1
2023-06-01,29898,12,0,12,3,0,3
2023-06-01,14135,28,1,29,7,3,7
2023-06-01,17119,16,0,16,3,0,3
2023-06-01,396524,3,0,3,1,0,1
2023-06-01,393977,2,0,2,1,0,1
2023-06-01,51129,1,0,1,1,0,1
2023-06-01,63321,2,0,2,2,0,2
2023-06-01,46202,5,0,5,3,0,3
2023-06-01,25907,3,0,3,3,0,3
2023-06-01,18867,8,0,8,2,0,2
2023-06-01,31892,5,0,5,3,0,3
2023-06-01,19250,4,0,4,2,0,2
2023-06-01,26843,2,0,2,2,0,2
2023-06-01,30523,3,0,3,3,0,3
2023-06-01,27235,4,0,4,4,0,4
2023-06-01,53470,1,0,1,1,0,1
2023-06-01,11653,18,0,18,5,0,5
2023-06-01,54692,1,0,1,1,0,1
2023-06-01,394661,1,0,1,2,0,2
2023-06-01,23079,3,0,3,3,0,3
2023-06-01,30515,2,0,2,2,0,2
2023-06-01,22848,2,0,2,1,0,1
2023-06-01,3605,22,3,25,16,5,16
2023-06-01,21996,7,0,7,1,0,1
2023-06-01,15045,5,0,5,1,0,1
2023-06-01,15173,2,0,2,3,0,3
2023-06-01,4565,156,0,156,1,0,1
2023-06-01,21975,4,0,4,3,0,3
2023-06-01,16898,2,0,2,2,0,2
2023-06-01,16952,10,0,10,2,0,2
2023-06-01,16801,6,0,6,4,0,4
2023-06-01,16769,2,0,2,1,0,1
2023-06-01,22587,4,0,4,2,0,2
2023-06-01,22417,2,0,2,2,0,2
2023-06-01,46773,2,0,2,2,0,2
2023-06-01,30276,3,0,3,1,0,1
2023-06-01,394322,3,0,3,2,0,2
2023-06-01,17373,5,0,5,1,0,1
2023-06-01,13782,23,0,23,1,0,1
2023-06-01,17305,3,0,3,1,0,1
2023-06-01,19606,10,0,10,4,0,4
2023-06-01,3855,81,4,85,14,1,14
2023-06-01,32373,5,0,5,1,0,1
2023-06-01,18728,1,0,1,1,0,1
2023-06-01,17155,5,0,5,3,0,3
2023-06-01,399894,1,0,1,1,0,1
2023-06-01,25763,2,0,2,3,0,3
2023-06-01,26417,1,0,1,1,0,1
2023-06-01,46442,1,0,1,3,0,3
2023-06-01,46765,1,0,1,3,0,3
2023-06-01,23500,16,0,16,5,0,5
2023-06-01,18746,2,0,2,2,0,2
2023-06-01,63374,4,0,4,3,0,3
2023-06-01,23402,1,0,1,3,0,3
2023-06-01,54589,1,0,1,3,0,3
2023-06-01,397109,1,0,1,2,0,2
2023-06-01,13508,1,0,1,1,0,1
2023-06-01,33366,1,0,1,2,0,2
2023-06-01,25936,2,0,2,3,0,3
2023-06-01,40527,3,0,3,2,0,2
2023-06-01,54698,1,0,1,1,0,1
2023-06-01,26535,2,0,2,4,0,4
2023-06-01,395284,1,0,1,1,0,1
2023-06-01,30510,3,0,3,3,0,3
2023-06-01,396392,1,0,1,2,0,2
2023-06-01,395414,1,0,1,1,0,1
2023-06-01,12120,2,0,2,1,0,1
2023-06-01,30441,1,0,1,2,0,2
2023-06-01,33199,1,0,1,3,0,3
2023-06-01,40025,1,0,1,2,0,2
2023-06-01,31840,1,0,1,1,0,1
2023-06-01,33620,1,0,1,1,0,1
2023-06-01,23512,1,0,1,3,0,3
2023-06-01,22794,19,0,19,3,0,3
2023-06-01,19140,1,0,1,1,0,1
2023-06-01,46424,4,0,4,1,0,1
2023-06-01,19587,1,0,1,1,0,1
2023-06-01,13888,3,0,3,1,0,1
2023-06-01,19670,2,0,2,3,0,3
2023-06-01,396959,1,0,1,1,0,1
2023-06-01,400440,1,0,1,1,0,1
2023-06-01,6620,96,0,96,9,0,9
2023-06-01,22664,1,0,1,2,0,2
2023-06-01,63137,1,0,1,3,0,3
2023-06-01,395538,1,0,1,1,0,1
2023-06-01,395410,2,0,2,1,0,1
2023-06-01,400188,1,0,1,2,0,2
2023-06-01,395319,1,0,1,1,0,1
2023-06-01,18842,4,0,4,4,0,4
2023-06-01,18829,2,0,2,1,0,1
2023-06-01,22314,1,0,1,2,0,2
2023-06-01,19103,3,0,3,2,0,2
2023-06-01,12087,18,0,18,9,0,9
2023-06-01,22204,1,0,1,2,0,2
2023-06-01,1689,16,0,16,3,0,3
2023-06-01,20397,3,0,3,2,0,2
2023-06-01,46711,1,0,1,3,0,3
2023-06-01,21547,76,2,78,9,1,9
2023-06-01,3614,32,9,41,18,5,18
2023-06-01,15148,26,0,26,4,0,4
2023-06-01,46263,13,0,13,3,0,3
2023-06-01,22013,6,0,6,3,0,3
2023-06-01,14492,186,1,187,7,4,7
2023-06-01,22205,70,1,71,2,2,2
2023-06-01,14140,21,1,22,5,1,5
2023-06-01,55105,2,1,3,2,1,2
2023-06-01,14543,13,1,14,6,4,6
2023-06-01,26133,11,0,11,4,0,4
2023-06-01,40414,7,0,7,2,0,2
2023-06-01,27596,3,0,3,1,0,1
2023-06-01,400212,2,0,2,1,0,1
2023-06-01,32709,2,1,3,9,1,9
2023-06-01,397150,1,0,1,3,0,3
2023-06-01,14992,14,0,14,3,0,3
2023-06-01,11090,66,1,67,10,5,11
2023-06-01,400141,1,0,1,1,0,1
2023-06-01,395336,44,1,45,5,5,5
2023-06-01,46295,8,0,8,1,0,1
2023-06-01,19331,24,1,25,12,4,12
2023-06-01,20240,1,0,1,1,0,1
2023-06-01,6639,22,16,38,1,1,1
2023-06-01,398701,1,0,1,2,0,2
2023-06-01,19389,4,0,4,3,0,3
2023-06-01,53286,1,0,1,1,0,1
2023-06-01,40114,4,0,4,2,0,2
2023-06-01,63527,5,0,5,1,0,1
2023-06-01,25764,11,10,21,4,2,4
2023-06-01,15224,74,8,82,8,5,9
2023-06-01,32809,3,0,3,1,0,1
2023-06-01,16565,3,0,3,4,0,4
2023-06-01,21840,1,0,1,2,0,2
2023-06-01,399566,2,0,2,1,0,1
2023-06-01,399024,2,0,2,1,0,1
2023-06-01,62804,2,0,2,4,0,4
2023-06-01,48582,56,22,78,6,7,9
2023-06-01,22608,16,1,17,2,1,2
2023-06-01,11397,1,0,1,1,0,1
2023-06-01,13728,5,1,6,2,2,2
2023-06-01,35900,30,1,31,3,1,3
2023-06-01,40122,6,0,6,2,0,2
2023-06-01,33265,2,0,2,3,0,3
2023-06-01,393795,1,0,1,3,0,3
2023-06-01,32008,2,0,2,4,0,4
2023-06-01,399408,4,1,5,1,1,1
2023-06-01,397345,1,0,1,1,0,1
2023-06-01,30278,8,0,8,4,0,4
2023-06-01,16901,1,0,1,1,0,1
2023-06-01,19087,2,0,2,2,0,2
2023-06-01,39965,1,0,1,3,0,3
2023-06-01,40171,2,0,2,2,0,2
2023-06-01,21963,1,0,1,2,0,2
2023-06-01,40067,2,0,2,3,0,3
2023-06-01,33032,1,0,1,1,0,1
2023-06-01,54208,2,0,2,2,0,2
2023-06-01,17385,37,0,37,4,0,4
2023-06-01,4200000013,41,0,41,1,0,1
2023-06-01,394815,3,0,3,3,0,3
2023-06-01,39984,4,1,5,3,1,3
2023-06-01,53323,2,0,2,2,0,2
2023-06-01,63443,2,0,2,1,0,1
2023-06-01,26664,6,0,6,3,0,3
2023-06-01,20380,1,0,1,1,0,1
2023-06-01,8002,3,1,4,12,2,12
2023-06-01,27554,1,0,1,1,0,1
2023-06-01,19013,1,0,1,3,0,3
2023-06-01,4200010348,1,0,1,1,0,1
2023-06-01,22310,3,0,3,1,0,1
2023-06-01,27013,2,0,2,2,0,2
2023-06-01,47095,14,0,14,4,0,4
2023-06-01,32194,6,0,6,3,0,3
2023-06-01,21969,2,0,2,1,0,1
2023-06-01,33543,3,0,3,3,0,3
2023-06-01,4200010001,8,0,8,1,0,1
2023-06-01,396311,2,0,2,1,0,1
2023-06-01,63333,5,0,5,2,0,2
2023-06-01,5777,5,0,5,3,0,3
2023-06-01,19031,7,0,7,5,0,5
2023-06-01,14045,32,0,32,6,0,6
2023-06-01,17143,13,1,14,10,3,10
2023-06-01,36659,1,0,1,1,0,1
2023-06-01,393806,7,0,7,1,0,1
2023-06-01,398459,2,0,2,2,0,2
2023-06-01,398331,1,0,1,1,0,1
2023-06-01,394935,1,0,1,1,0,1
2023-06-01,33564,1,0,1,1,0,1
2023-06-01,19936,5,0,5,6,0,6
2023-06-01,32996,3,0,3,3,0,3
2023-06-01,40959,7,0,7,1,0,1
2023-06-01,22230,2,0,2,3,0,3
2023-06-01,393860,1,0,1,1,0,1
2023-06-01,20145,3,0,3,2,0,2
2023-06-01,36177,1,0,1,1,0,1
2023-06-01,54244,1,0,1,1,0,1
2023-06-01,27377,9,0,9,6,0,6
2023-06-01,22273,3,0,3,3,0,3
2023-06-01,23249,2,0,2,2,0,2
2023-06-01,399416,1,0,1,1,0,1
2023-06-01,395728,1,0,1,2,0,2
2023-06-01,40799,3,0,3,5,0,5
2023-06-01,393353,1,0,1,2,0,2
2023-06-01,31752,1,0,1,1,0,1
2023-06-01,33238,2,0,2,1,0,1
2023-06-01,398332,2,0,2,2,0,2
2023-06-01,400807,12,0,12,1,0,1
2023-06-01,1790,25,0,25,2,0,2
2023-06-01,25873,4,0,4,3,0,3
2023-06-01,400317,6,0,6,7,0,7
2023-06-01,19360,1,0,1,1,0,1
2023-06-01,33088,1,0,1,3,0,3
2023-06-01,395506,4,3,7,2,3,4
2023-06-01,399139,2,1,3,1,1,1
2023-06-01,31937,2,0,2,2,0,2
2023-06-01,22891,5,0,5,3,0,3
2023-06-01,6103,4,0,4,2,0,2
2023-06-01,25612,14,0,14,2,0,2
2023-06-01,6222,36,0,36,1,0,1
2023-06-01,12133,3,0,3,4,0,4
2023-06-01,5778,112,0,112,1,0,1
2023-06-01,17046,7,0,7,1,0,1
2023-06-01,62759,13,0,13,4,0,4
2023-06-01,16389,1,0,1,3,0,3
2023-06-01,11398,64,0,64,1,0,1
2023-06-01,25916,2,0,2,1,0,1
2023-06-01,19390,4,0,4,1,0,1
2023-06-01,14921,36,0,36,1,0,1
2023-06-01,26307,2,0,2,2,0,2
2023-06-01,30526,8,1,9,6,2,6
2023-06-01,26148,2,0,2,1,0,1
2023-06-01,32254,2,0,2,2,0,2
2023-06-01,26005,1,0,1,1,0,1
2023-06-01,18494,37,0,37,1,0,1
2023-06-01,18632,79,0,79,5,0,5
2023-06-01,16610,22,0,22,2,0,2
2023-06-01,54437,5,0,5,1,0,1
2023-06-01,395694,1,0,1,1,0,1
2023-06-01,30435,1,0,1,1,0,1
2023-06-01,32325,1,0,1,2,0,2
2023-06-01,46140,2,0,2,3,0,3
2023-06-01,36549,6,0,6,4,0,4
2023-06-01,18593,15,0,15,3,0,3
2023-06-01,13866,8,1,9,3,1,3
2023-06-01,17129,3,0,3,1,0,1
2023-06-01,40157,5,0,5,4,0,4
2023-06-01,16747,2,0,2,1,0,1
2023-06-01,31920,7,0,7,1,0,1
2023-06-01,46718,5,0,5,1,0,1
2023-06-01,26410,33,0,33,4,0,4
2023-06-01,6062,27,1,28,5,1,6
2023-06-01,32068,15,0,15,1,0,1
2023-06-01,4972,12,0,12,3,0,3
2023-06-01,18618,67,1,68,4,1,4
2023-06-01,46536,25,0,25,2,0,2
2023-06-01,21950,1,0,1,1,0,1
2023-06-01,46325,1,0,1,1,0,1
2023-06-01,19201,23,0,23,2,0,2
2023-06-01,46853,15,0,15,3,0,3
2023-06-01,27470,1,0,1,2,0,2
2023-06-01,19409,5,0,5,1,0,1
2023-06-01,26451,25,0,25,3,0,3
2023-06-01,397361,26,1,27,3,1,3
2023-06-01,200010,19,0,19,1,0,1
2023-06-01,22885,2,0,2,2,0,2
2023-06-01,6109,16,1,17,5,1,5
2023-06-01,27462,2,0,2,1,0,1
2023-06-01,25765,3,0,3,3,0,3
2023-06-01,39953,2,0,2,2,0,2
2023-06-01,400379,1,0,1,2,0,2
2023-06-01,25664,5,1,6,1,1,1
2023-06-01,46880,1,0,1,1,0,1
2023-06-01,36437,2,0,2,1,0,1
2023-06-01,22352,9,0,9,2,0,2
2023-06-01,398098,1,0,1,1,0,1
2023-06-01,5033,20,0,20,7,0,7
2023-06-01,40795,2,0,2,1,0,1
2023-06-01,36714,3,0,3,3,0,3
2023-06-01,11525,7,1,8,3,1,3
2023-06-01,27553,15,1,16,4,1,4
2023-06-01,26637,18,0,18,3,0,3
2023-06-01,16559,36,1,37,3,2,3
2023-06-01,394937,2,0,2,1,0,1
2023-06-01,11572,13,2,15,1,1,1
2023-06-01,31881,4,0,4,1,0,1
2023-06-01,399432,1,0,1,1,0,1
2023-06-01,40940,1,0,1,1,0,1
2023-06-01,41041,4,2,6,10,6,11
2023-06-01,23875,6,2,8,3,2,4
2023-06-01,38340,3,0,3,2,0,2
2023-06-01,10082,7,0,7,2,0,2
2023-06-01,7262,9,2,11,2,1,2
2023-06-01,16260,2,1,3,7,3,7
2023-06-01,53345,1,0,1,1,0,1
2023-06-01,55034,16,0,16,4,0,4
2023-06-01,18781,11,0,11,2,0,2
2023-06-01,22566,25,1,26,2,1,2
2023-06-01,198148,2,0,2,4,0,4
2023-06-01,30449,20,0,20,3,0,3
2023-06-01,25786,4,0,4,1,0,1
2023-06-01,22180,8,0,8,3,0,3
2023-06-01,397923,1,0,1,1,0,1
2023-06-01,3912,15,1,16,7,1,7
2023-06-01,40498,12,1,13,10,6,11
2023-06-01,32210,1,0,1,2,0,2
2023-06-01,106,8,0,8,2,0,2
2023-06-01,26326,9,1,10,2,1,2
2023-06-01,18629,2,0,2,2,0,2
2023-06-01,15009,6,1,7,2,1,2
2023-06-01,395455,2,0,2,2,0,2
2023-06-01,22463,10,0,10,3,0,3
2023-06-01,20154,3,0,3,2,0,2
2023-06-01,18821,2,0,2,2,0,2
2023-06-01,17206,4,0,4,4,0,4
2023-06-01,4200010173,1,0,1,1,0,1
2023-06-01,14818,56,1,57,4,2,4
2023-06-01,395245,6,0,6,3,0,3
2023-06-01,395452,2,0,2,1,0,1
2023-06-01,36172,2,0,2,2,0,2
2023-06-01,16871,7,1,8,3,1,3
2023-06-01,399988,2,0,2,4,0,4
2023-06-01,394575,2,2,4,2,1,2
2023-06-01,29976,3,0,3,2,0,2
2023-06-01,53261,1,0,1,2,0,2
2023-06-01,398895,3,0,3,1,0,1
2023-06-01,16915,1,0,1,1,0,1
2023-06-01,33274,4,0,4,3,0,3
2023-06-01,54573,6,0,6,4,0,4
2023-06-01,12113,2,0,2,2,0,2
2023-06-01,15185,3,0,3,3,0,3
2023-06-01,19546,4,0,4,1,0,1
2023-06-01,11962,2,0,2,2,0,2
2023-06-01,14055,1,0,1,3,0,3
2023-06-01,14161,9,0,9,3,0,3
2023-06-01,395051,1,0,1,1,0,1
2023-06-01,53655,1,0,1,1,0,1
2023-06-01,393890,2,0,2,1,0,1
2023-06-01,399303,1,0,1,2,0,2
2023-06-01,18795,3,0,3,3,0,3
2023-06-01,35917,3,0,3,3,0,3
2023-06-01,17164,4,0,4,3,0,3
2023-06-01,33603,6,0,6,1,0,1
2023-06-01,26373,1,0,1,2,0,2
2023-06-01,14597,1,0,1,2,0,2
2023-06-01,54450,1,0,1,3,0,3
2023-06-01,3847,2,0,2,2,0,2
2023-06-01,21622,21,0,21,6,0,6
2023-06-01,394709,1,0,1,1,0,1
2023-06-01,27624,1,0,1,1,0,1
2023-06-01,22992,8,2,10,2,2,2
2023-06-01,16431,2,0,2,2,0,2
2023-06-01,22473,17,0,17,1,0,1
2023-06-01,11223,2,0,2,3,0,3
2023-06-01,33376,1,0,1,1,0,1
2023-06-01,11505,1,0,1,1,0,1
2023-06-01,394757,1,0,1,2,0,2
2023-06-01,14793,14,4,18,9,3,9
2023-06-01,46506,7,1,8,8,3,8
2023-06-01,32040,17,0,17,2,0,2
2023-06-01,40020,48,1,49,4,1,4
2023-06-01,395457,1,0,1,1,0,1
2023-06-01,397288,4,0,4,3,0,3
2023-06-01,23083,5,0,5,3,0,3
2023-06-01,397486,1,0,1,2,0,2
2023-06-01,55193,7,0,7,5,0,5
2023-06-01,13314,1,0,1,1,0,1
2023-06-01,53282,7,2,9,3,1,3
2023-06-01,53272,1,0,1,1,0,1
2023-06-01,13683,1,0,1,2,0,2
2023-06-01,393922,2,0,2,1,0,1
2023-06-01,7105,37,0,37,2,0,2
2023-06-01,16959,6,0,6,1,0,1
2023-06-01,53825,1,0,1,1,0,1
2023-06-01,394803,2,0,2,3,0,3
2023-06-01,393360,4,0,4,1,0,1
2023-06-01,18604,1,0,1,1,0,1
2023-06-01,25929,1,0,1,1,0,1
2023-06-01,49274,4,0,4,2,0,2
2023-06-01,28506,25,0,25,3,0,3
2023-06-01,52233,98,17,115,5,2,5
2023-06-01,32758,12,0,12,2,0,2
2023-06-01,32694,14,0,14,1,0,1
2023-06-01,32800,7,0,7,1,0,1
2023-06-01,23452,1,0,1,1,0,1
2023-06-01,36856,1,1,2,1,1,1
2023-06-01,395642,1,1,2,3,1,3
2023-06-01,395606,1,1,2,3,1,3
2023-06-01,19685,27,0,27,4,0,4
2023-06-01,27419,10,0,10,2,0,2
2023-06-01,397661,1,0,1,3,0,3
2023-06-01,395194,3,0,3,8,0,8
2023-06-01,20276,2,0,2,1,0,1
2023-06-01,12033,7,1,8,8,3,8
2023-06-01,397334,1,0,1,1,0,1
2023-06-01,40317,57,1,58,11,5,11
2023-06-01,46452,16,0,16,1,0,1
2023-06-01,27609,45,0,45,1,0,1
2023-06-01,40229,13,0,13,4,0,4
2023-06-01,23400,16,0,16,1,0,1
2023-06-01,26585,71,0,71,6,0,6
2023-06-01,40144,15,0,15,4,0,4
2023-06-01,30527,1,0,1,1,0,1
2023-06-01,36667,3,4,7,4,3,4
2023-06-01,15319,1,0,1,2,0,2
2023-06-01,17306,214,0,214,11,0,11
2023-06-01,3742,3,1,4,9,6,10
2023-06-01,13331,21,13,34,10,6,11
2023-06-01,4319,3,0,3,4,0,4
2023-06-01,22030,10,0,10,3,0,3
2023-06-01,14978,45,0,45,8,0,8
2023-06-01,11855,13,1,14,11,6,12
2023-06-01,11069,9,0,9,1,0,1
2023-06-01,36647,72,8,80,1,1,1
2023-06-01,26101,84,8,92,1,1,1
2023-06-01,26255,4,0,4,3,0,3
2023-06-01,63410,37,5,42,5,3,5
2023-06-01,14743,17,1,18,9,2,9
2023-06-01,25985,5,0,5,3,0,3
2023-06-01,22132,1,1,2,3,1,3
2023-06-01,30636,8,0,8,2,0,2
2023-06-01,46474,2,0,2,3,0,3
2023-06-01,24247,6,1,7,10,5,10
2023-06-01,33433,1,0,1,1,0,1
2023-06-01,14636,22,3,25,1,1,1
2023-06-01,27382,11,2,13,2,2,3
2023-06-01,393218,8,0,8,1,0,1
2023-06-01,21744,6,0,6,1,0,1
2023-06-01,46501,2,0,2,3,0,3
2023-06-01,395110,9,0,9,6,0,6
2023-06-01,395864,1,0,1,1,0,1
2023-06-01,5693,43,1,44,14,2,14
2023-06-01,15074,1,0,1,1,0,1
2023-06-01,394183,6,0,6,3,0,3
2023-06-01,18633,1,0,1,1,0,1
2023-06-01,19588,1,0,1,2,0,2
2023-06-01,47051,1,0,1,2,0,2
2023-06-01,14929,37,0,37,1,0,1
2023-06-01,10965,7,4,11,7,6,7
2023-06-01,398476,4,0,4,3,0,3
2023-06-01,36451,4,0,4,2,0,2
2023-06-01,32488,4,0,4,1,0,1
2023-06-01,54406,1,1,2,1,1,1
2023-06-01,397715,1,1,2,1,1,1
2023-06-01,36612,2,0,2,3,0,3
2023-06-01,17012,22,1,23,11,2,11
2023-06-01,11643,17,1,18,1,1,1
2023-06-01,14107,50,1,51,3,1,3
2023-06-01,32867,8,0,8,6,0,6
2023-06-01,33680,23,0,23,9,2,11
2023-06-01,22820,7,0,7,2,0,2
2023-06-01,397146,2,0,2,1,0,1
2023-06-01,14589,6,3,9,7,2,7
2023-06-01,26319,1,0,1,1,0,1
2023-06-01,11221,11,0,11,3,0,3
2023-06-01,40151,2,0,2,6,0,6
2023-06-01,19354,1,0,1,1,0,1
2023-06-01,14363,9,8,17,12,5,12
2023-06-01,23274,8,0,8,7,0,7
2023-06-01,396828,4,3,7,2,1,2
2023-06-01,29966,1,0,1,1,0,1
2023-06-01,11840,23,11,34,5,3,5
2023-06-01,7342,129,128,257,68,51,81
2023-06-01,26134,34,9,43,6,4,6
2023-06-01,30060,49,11,60,5,3,5
2023-06-01,19237,16,1,17,9,5,9
2023-06-01,19504,18,0,18,5,0,5
2023-06-01,8159,15,0,15,2,0,2
2023-06-01,18566,1852,0,1852,2,0,2
2023-06-01,19783,5,1,6,7,6,7
2023-06-01,11989,52,0,52,1,0,1
2023-06-01,8010,1,0,1,1,0,1
2023-06-01,400030,20,1,21,4,3,4
2023-06-01,53497,5,0,5,4,0,4
2023-06-01,15042,5,0,5,9,0,9
2023-06-01,11647,32,2,34,4,3,5
2023-06-01,13549,3,1,4,2,1,3
2023-06-01,46228,2,0,2,2,0,2
2023-06-01,36139,2,0,2,3,0,3
2023-06-01,1998,11,1,12,4,1,4
2023-06-01,14983,1,0,1,1,0,1
2023-06-01,15209,6,0,6,2,0,2
2023-06-01,397297,2,0,2,1,0,1
2023-06-01,36341,3,0,3,2,0,2
2023-06-01,32477,20,2,22,4,2,4
2023-06-01,11115,11,1,12,3,1,3
2023-06-01,393640,6,0,6,2,0,2
2023-06-01,36492,158,415,573,2,2,2
2023-06-01,14210,60,26,86,10,9,11
2023-06-01,395441,2,0,2,4,0,4
2023-06-01,63366,3,1,4,1,1,1
2023-06-01,31815,12,0,12,1,0,1
2023-06-01,19701,17,0,17,6,0,6
2023-06-01,14870,5,2,7,4,2,4
2023-06-01,8739,27,0,27,7,0,7
2023-06-01,23280,4,0,4,5,0,5
2023-06-01,46434,7,0,7,4,0,4
2023-06-01,21563,5,0,5,2,0,2
2023-06-01,393697,2,0,2,3,0,3
2023-06-01,32372,12,0,12,5,0,5
2023-06-01,9328,49,3,52,9,2,9
2023-06-01,21564,5,0,5,3,0,3
2023-06-01,17286,1,0,1,1,0,1
2023-06-01,22343,69,10,79,3,2,3
2023-06-01,36040,31,35,66,19,16,21
2023-06-01,6640,150,0,150,7,0,7
2023-06-01,21540,1,0,1,3,0,3
2023-06-01,63440,6,1,7,2,1,2
2023-06-01,35041,251,2,253,3,2,3
2023-06-01,5738,5,0,5,2,0,2
2023-06-01,54989,12,0,12,3,0,3
2023-06-01,1351,6,1,7,10,3,10
2023-06-01,22607,2,0,2,2,0,2
2023-06-01,22068,2,0,2,1,0,1
2023-06-01,19453,3,1,4,2,1,2
2023-06-01,40462,1,0,1,1,0,1
2023-06-01,29930,11,4,15,3,2,3
2023-06-01,394699,5,5,10,3,3,3
2023-06-01,19616,1,0,1,2,0,2
2023-06-01,27403,1,0,1,1,0,1
2023-06-01,21548,20,2,22,5,2,5
2023-06-01,35927,1,0,1,2,0,2
2023-06-01,19830,12,0,12,5,0,5
2023-06-01,14037,9,5,14,8,5,8
2023-06-01,211234,1,0,1,2,0,2
2023-06-01,19751,5,1,6,2,1,2
2023-06-01,19515,17,1,18,4,3,4
2023-06-01,40523,5,1,6,4,2,4
2023-06-01,62476,5,0,5,1,0,1
2023-06-01,397362,2,0,2,3,0,3
2023-06-01,7078,3,1,4,3,2,3
2023-06-01,22903,73,0,73,2,0,2
2023-06-01,32575,15,0,15,8,0,8
2023-06-01,14332,4,0,4,4,0,4
2023-06-01,3361,22,5,27,18,4,18
2023-06-01,16863,173,1,174,6,1,6
2023-06-01,16564,7,0,7,2,0,2
2023-06-01,19092,18,2,20,6,1,6
2023-06-01,16503,7,0,7,1,0,1
2023-06-01,27506,17,0,17,3,0,3
2023-06-01,53464,1,0,1,1,0,1
2023-06-01,53886,2,0,2,2,0,2
2023-06-01,23131,7,0,7,1,0,1
2023-06-01,14090,41,0,41,3,0,3
2023-06-01,14415,18,0,18,2,0,2
2023-06-01,698,12,1,13,1,1,1
2023-06-01,32400,8,1,9,2,2,2
2023-06-01,19535,3,0,3,4,0,4
2023-06-01,64275,4,1,5,8,2,8
2023-06-01,30588,18,0,18,3,0,3
2023-06-01,19133,27,14,41,10,4,10
2023-06-01,35977,15,1,16,3,3,4
2023-06-01,19356,1,0,1,1,0,1
2023-06-01,26251,3,0,3,2,0,2
2023-06-01,397189,1,1,2,1,1,1
2023-06-01,33549,22,0,22,5,0,5
2023-06-01,31785,3,0,3,3,0,3
2023-06-01,33521,1,0,1,1,0,1
2023-06-01,16822,1,0,1,2,0,2
2023-06-01,25636,6,0,6,1,0,1
2023-06-01,26271,11,0,11,4,0,4
2023-06-01,12055,2,1,3,1,1,1
2023-06-01,16384,2,0,2,2,0,2
2023-06-01,26891,23,1,24,4,2,4
2023-06-01,29938,1,0,1,1,0,1
2023-06-01,18447,35,1,36,2,2,2
2023-06-01,6189,3,1,4,3,1,3
2023-06-01,6059,6,1,7,15,3,16
2023-06-01,19835,0,0,0,4,0,4
2023-06-01,14343,22,0,22,8,0,8
2023-06-01,16805,7,1,8,5,1,5
2023-06-01,25843,22,3,25,8,2,8
2023-06-01,400099,1,0,1,2,0,2
2023-06-01,12067,6,1,7,5,4,5
2023-06-01,33227,18,0,18,3,0,3
2023-06-01,393227,21,1,22,4,2,4
2023-06-01,26949,2,1,3,1,2,2
2023-06-01,20385,30,0,30,4,0,4
2023-06-01,395279,14,0,14,6,0,6
2023-06-01,32222,4,0,4,3,0,3
2023-06-01,28067,9,1,10,2,1,2
2023-06-01,5639,173,1,174,8,3,8
2023-06-01,27516,3,0,3,2,0,2
2023-06-01,14335,1,1,2,2,2,2
2023-06-01,54139,29,0,29,3,0,3
2023-06-01,33470,6,1,7,4,1,4
2023-06-01,11093,1,0,1,1,0,1
2023-06-01,25963,1,0,1,3,0,3
2023-06-01,53477,3,0,3,2,0,2
2023-06-01,36509,1,0,1,2,0,2
2023-06-01,14959,3,0,3,1,0,1
2023-06-01,11563,5,1,6,3,1,3
2023-06-01,26052,3,0,3,3,0,3
2023-06-01,23342,23,5,28,7,3,7
2023-06-01,399808,1,1,2,1,1,1
2023-06-01,399819,1,1,2,2,2,2
2023-06-01,399817,1,1,2,2,2,2
2023-06-01,399818,1,1,2,1,1,1
2023-06-01,399816,1,1,2,2,2,2
2023-06-01,399815,1,1,2,2,1,2
2023-06-01,399814,1,1,2,2,2,2
2023-06-01,399813,1,1,2,2,1,2
2023-06-01,399812,1,1,2,2,2,2
2023-06-01,399810,1,1,2,2,2,2
2023-06-01,399809,1,1,2,1,1,1
2023-06-01,399811,1,1,2,2,2,2
2023-06-01,62815,1,1,2,1,1,1
2023-06-01,30447,18,3,21,4,3,4
2023-06-01,7835,2,0,2,1,0,1
2023-06-01,15149,6,0,6,2,0,2
2023-06-01,30412,1,0,1,1,0,1
2023-06-01,26402,2,2,4,4,3,4
2023-06-01,397575,5,0,5,1,0,1
2023-06-01,27279,2,0,2,1,0,1
2023-06-01,13547,1,0,1,3,0,3
2023-06-01,32076,3,0,3,1,0,1
2023-06-01,395699,1,0,1,3,0,3
2023-06-01,16682,1,0,1,1,0,1
2023-06-01,11123,61,0,61,11,0,11
2023-06-01,11841,40,0,40,2,0,2
2023-06-01,16617,27,0,27,4,0,4
2023-06-01,11138,55,0,55,3,0,3
2023-06-01,398383,1,0,1,1,0,1
2023-06-01,26135,2,0,2,1,0,1
2023-06-01,36043,2,0,2,2,0,2
2023-06-01,33130,9,1,10,5,2,5
2023-06-01,16896,2,0,2,1,0,1
2023-06-01,398316,1,0,1,1,0,1
2023-06-01,397140,2,0,2,2,0,2
2023-06-01,396412,1,1,2,1,1,1
2023-06-01,11330,1,0,1,1,0,1
2023-06-01,40069,4,2,6,3,2,3
2023-06-01,7828,103,2,105,10,3,10
2023-06-01,398336,1,0,1,2,0,2
2023-06-01,398384,1,0,1,1,0,1
2023-06-01,14569,22,0,22,1,0,1
2023-06-01,24255,6,1,7,6,3,7
2023-06-01,399439,15,0,15,2,0,2
2023-06-01,20014,6,0,6,2,0,2
2023-06-01,19202,4,0,4,1,0,1
2023-06-01,397766,5,0,5,3,0,3
2023-06-01,35947,4,0,4,2,0,2
2023-06-01,397474,7,0,7,1,0,1
2023-06-01,395806,1,0,1,2,0,2
2023-06-01,12111,5,0,5,1,0,1
2023-06-01,46595,17,1,18,4,1,4
2023-06-01,36378,4,0,4,1,0,1
2023-06-01,10320,2,1,3,2,1,2
2023-06-01,11269,22,1,23,15,4,16
2023-06-01,11618,4,0,4,3,0,3
2023-06-01,13720,26,0,26,6,0,6
2023-06-01,13507,6,0,6,2,0,2
2023-06-01,22087,1,0,1,1,0,1
2023-06-01,22576,10,0,10,1,0,1
2023-06-01,30041,138,1,139,9,5,9
2023-06-01,202695,2,1,3,1,1,1
2023-06-01,53942,3,0,3,1,0,1
2023-06-01,399307,1,1,2,2,1,2
2023-06-01,399698,1,0,1,1,0,1
2023-06-01,18568,2,0,2,4,0,4
2023-06-01,396032,7,0,7,1,0,1
2023-06-01,32161,3,0,3,2,0,2
2023-06-01,29656,2,0,2,2,0,2
2023-06-01,1408,0,0,0,3,0,3
2023-06-01,32164,2,0,2,1,0,1
2023-06-01,14469,2,1,3,2,2,2
2023-06-01,27521,27,0,27,3,0,3
2023-06-01,40718,25,4,29,1,1,1
2023-06-01,6142,29,21,50,2,2,2
2023-06-01,53703,28,2,30,4,3,4
2023-06-01,6428,49,0,49,6,0,6
2023-06-01,10510,0,0,0,2,0,2
2023-06-01,397754,9,0,9,3,0,3
2023-06-01,397859,1,0,1,2,0,2
2023-06-01,22702,25,0,25,10,0,10
2023-06-01,7962,2,0,2,1,0,1
2023-06-01,16835,16,0,16,1,0,1
2023-06-01,14280,5,1,6,4,4,4
2023-06-01,395532,11,0,11,1,0,1
2023-06-01,15035,25,0,25,4,0,4
2023-06-01,32900,1,0,1,1,0,1
2023-06-01,32624,64,16,80,2,2,2
2023-06-01,63942,1,0,1,1,0,1
2023-06-01,10325,4,0,4,3,0,3
2023-06-01,32453,2,0,2,5,0,5
2023-06-01,7215,2,2,4,2,2,2
2023-06-01,33717,24,0,24,10,0,10
2023-06-01,10381,10,1,11,2,1,2
2023-06-01,204229,9,0,9,2,0,2
2023-06-01,210878,2,0,2,2,0,2
2023-06-01,397451,4,0,4,3,0,3
2023-06-01,18704,7,0,7,2,0,2
2023-06-01,2773,10,11,21,1,1,1
2023-06-01,33633,4,0,4,1,0,1
2023-06-01,557,17,1,18,11,5,11
2023-06-01,396479,36,0,36,2,0,2
2023-06-01,399299,1,0,1,1,0,1
2023-06-01,13913,6,0,6,4,0,4
2023-06-01,399334,4,3,7,2,2,2
2023-06-01,397780,3,0,3,1,0,1
2023-06-01,2379,109,0,109,1,0,1
2023-06-01,31928,1,0,1,1,0,1
2023-06-01,22186,14,0,14,1,0,1
2023-06-01,20161,195,8,203,19,6,20
2023-06-01,55094,1,0,1,3,0,3
2023-06-01,5716,35,0,35,1,0,1
2023-06-01,23376,9,2,11,3,1,3
2023-06-01,10962,7,0,7,2,0,2
2023-06-01,27226,1,0,1,2,0,2
2023-06-01,63233,1,0,1,1,0,1
2023-06-01,401307,42,0,42,16,0,16
2023-06-01,39987,10,0,10,2,0,2
2023-06-01,53292,36,7,43,16,4,16
2023-06-01,11127,0,0,0,2,0,2
2023-06-01,11300,55,0,55,4,0,4
2023-06-01,11342,35,0,35,10,0,10
2023-06-01,60117,48,9,57,4,4,4
2023-06-01,399274,2,2,4,1,1,1
2023-06-01,15024,8,0,8,8,0,8
2023-06-01,397606,11,0,11,4,0,4
2023-06-01,26919,20,0,20,3,0,3
2023-06-01,212581,5,0,5,6,0,6
2023-06-01,14615,349,0,349,13,2,13
2023-06-01,21830,45,0,45,2,0,2
2023-06-01,396213,2,0,2,3,0,3
2023-06-01,40641,16,3,19,4,2,4
2023-06-01,10279,127,1,128,4,1,4
2023-06-01,19212,21,2,23,3,1,3
2023-06-01,29897,7,0,7,2,0,2
2023-06-01,5653,19,0,19,4,0,4
2023-06-01,17150,5,0,5,2,0,2
2023-06-01,32145,3,0,3,8,0,8
2023-06-01,40207,2,0,2,3,0,3
2023-06-01,22439,109,4,113,3,3,3
2023-06-01,36843,12,0,12,4,0,4
2023-06-01,4511,7,0,7,4,0,4
2023-06-01,7939,58,0,58,1,0,1
2023-06-01,13406,1,0,1,3,0,3
2023-06-01,31999,1,0,1,2,0,2
2023-06-01,16393,1,0,1,1,0,1
2023-06-01,394234,3,0,3,1,0,1
2023-06-01,14131,7,0,7,4,0,4
2023-06-01,22457,20,0,20,4,0,4
2023-06-01,22179,3,0,3,6,0,6
2023-06-01,394768,1,0,1,2,0,2
2023-06-01,7932,1,0,1,2,0,2
2023-06-01,395713,3,0,3,2,0,2
2023-06-01,8015,12,2,14,14,2,14
2023-06-01,63238,3,0,3,1,0,1
2023-06-01,10674,10,1,11,15,3,15
2023-06-01,15213,3,0,3,3,0,3
2023-06-01,396955,10,7,17,7,6,7
2023-06-01,13880,17,1,18,3,2,3
2023-06-01,29831,19,20,39,6,6,6
2023-06-01,11620,23,0,23,4,0,4
2023-06-01,25695,7,0,7,3,0,3
2023-06-01,18594,15,0,15,2,0,2
2023-06-01,18659,7,0,7,3,0,3
2023-06-01,23086,2,0,2,1,0,1
2023-06-01,396106,15,0,15,6,0,6
2023-06-01,11134,1,0,1,1,0,1
2023-06-01,14755,6,0,6,3,0,3
2023-06-01,1403,82,17,99,8,6,8
2023-06-01,36329,20,3,23,8,3,8
2023-06-01,54567,1,0,1,1,0,1
2023-06-01,22814,1,0,1,1,0,1
2023-06-01,32458,21,1,22,4,2,4
2023-06-01,6286,5,0,5,1,0,1
2023-06-01,23199,4,0,4,3,0,3
2023-06-01,5050,17,3,20,21,8,21
2023-06-01,16908,12,0,12,4,0,4
2023-06-01,27589,18,2,20,10,5,10
2023-06-01,13438,10,0,10,2,0,2
2023-06-01,400405,2,1,3,2,2,2
2023-06-01,398977,2,0,2,3,0,3
2023-06-01,10951,1,0,1,2,0,2
2023-06-01,393258,2,0,2,1,0,1
2023-06-01,32946,1,0,1,1,0,1
2023-06-01,14440,2,1,3,3,1,3
2023-06-01,40554,1,0,1,1,0,1
2023-06-01,394996,49,0,49,3,0,3
2023-06-01,53813,74,1,75,16,1,16
2023-06-01,397787,2,1,3,3,1,3
2023-06-01,15188,4,0,4,3,0,3
2023-06-01,54288,36,0,36,1,0,1
2023-06-01,394330,11,0,11,3,0,3
2023-06-01,18557,7,0,7,2,0,2
2023-06-01,13468,10,0,10,2,0,2
2023-06-01,1616,22,5,27,3,2,3
2023-06-01,3595,4,2,6,1,1,1
2023-06-01,21887,44,0,44,5,0,5
2023-06-01,396164,1,0,1,3,0,3
2023-06-01,18875,5,0,5,4,0,4
2023-06-01,397848,5,0,5,2,0,2
2023-06-01,30110,3,0,3,10,0,10
2023-06-01,18892,5,0,5,1,0,1
2023-06-01,397767,1,0,1,2,0,2
2023-06-01,16877,5,0,5,2,0,2
2023-06-01,29968,27,0,27,3,0,3
2023-06-01,53913,14,0,14,5,0,5
2023-06-01,15127,8,0,8,2,0,2
2023-06-01,398367,2,0,2,2,0,2
2023-06-01,15171,60,1,61,2,1,2
2023-06-01,394286,2,0,2,1,0,1
2023-06-01,27539,17,1,18,1,1,1
2023-06-01,14955,11,0,11,1,0,1
2023-06-01,16686,8,5,13,4,2,4
2023-06-01,30167,16,0,16,3,0,3
2023-06-01,15147,11,9,20,2,1,2
2023-06-01,53862,1,0,1,2,0,2
2023-06-01,394497,4,1,5,3,2,3
2023-06-01,6245,1,0,1,2,0,2
2023-06-01,399589,1,0,1,3,0,3
2023-06-01,25915,1,1,2,1,1,1
2023-06-01,16597,2,0,2,1,0,1
2023-06-01,14459,2,0,2,3,0,3
2023-06-01,393340,22,0,22,5,0,5
2023-06-01,33409,6,0,6,2,0,2
2023-06-01,63002,1,0,1,3,0,3
2023-06-01,26652,1,0,1,12,0,12
2023-06-01,14814,3,0,3,2,0,2
2023-06-01,6922,19,1,20,30,7,30
2023-06-01,1970,10,3,13,8,1,8
2023-06-01,16905,4,3,7,33,11,33
2023-06-01,276,5,0,5,12,4,12
2023-06-01,26760,38,0,38,1,0,1
2023-06-01,40050,9,1,10,2,1,2
2023-06-01,6565,4,0,4,1,0,1
2023-06-01,393885,5,16,21,3,2,3
2023-06-01,11745,2,1,3,6,2,6
2023-06-01,27405,1,0,1,7,0,7
2023-06-01,399703,1,0,1,1,0,1
2023-06-01,12184,5,0,5,5,0,5
2023-06-01,53778,1,0,1,2,0,2
2023-06-01,29905,2,0,2,3,0,3
2023-06-01,33493,1,0,1,1,0,1
2023-06-01,27501,58,0,58,9,0,9
2023-06-01,54458,14,0,14,1,0,1
2023-06-01,3599,15,4,19,9,4,9
2023-06-01,14216,1,0,1,3,0,3
2023-06-01,395424,2,0,2,1,0,1
2023-06-01,23463,2,0,2,4,0,4
2023-06-01,29949,6,0,6,4,0,4
2023-06-01,14586,19,1,20,9,5,9
2023-06-01,14136,3,0,3,5,0,5
2023-06-01,200596,16,0,16,18,0,18
2023-06-01,393982,2,0,2,1,0,1
2023-06-01,12178,6,1,7,5,3,5
2023-06-01,27545,1,0,1,2,0,2
2023-06-01,32873,4,0,4,3,0,3
2023-06-01,397808,3,0,3,4,0,4
2023-06-01,26275,1,0,1,3,0,3
2023-06-01,23335,1,0,1,3,0,3
2023-06-01,8084,3,0,3,1,0,1
2023-06-01,40686,2,0,2,5,0,5
2023-06-01,21371,3,0,3,20,0,20
2023-06-01,19950,9,0,9,5,0,5
2023-06-01,13713,10,0,10,7,0,7
2023-06-01,396167,11,0,11,5,0,5
2023-06-01,18705,37,5,42,5,3,5
2023-06-01,19963,7,0,7,1,0,1
2023-06-01,3776,2,0,2,2,0,2
2023-06-01,395618,1,0,1,2,0,2
2023-06-01,26048,1,0,1,1,0,1
2023-06-01,262228,2,0,2,3,0,3
2023-06-01,21765,7,0,7,1,0,1
2023-06-01,21838,0,0,0,2,0,2
2023-06-01,52246,5,0,5,3,0,3
2023-06-01,262257,2,0,2,1,0,1
2023-06-01,33178,3,0,3,1,0,1
2023-06-01,399918,6,0,6,2,0,2
2023-06-01,4452,21,1,22,1,1,1
2023-06-01,394859,9,1,10,2,1,2
2023-06-01,16406,49,0,49,10,0,10
2023-06-01,19689,3,0,3,4,0,4
2023-06-01,30410,1,0,1,1,0,1
2023-06-01,17322,1,0,1,2,0,2
2023-06-01,393713,23,3,26,7,3,7
2023-06-01,10297,18,1,19,4,5,6
2023-06-01,4882,5,0,5,4,0,4
2023-06-01,27496,3,0,3,1,0,1
2023-06-01,26914,56,3,59,7,2,7
2023-06-01,36288,1,1,2,2,2,2
2023-06-01,20098,6,0,6,3,0,3
2023-06-01,53374,2,0,2,1,0,1
2023-06-01,40702,8,0,8,7,0,7
2023-06-01,394552,2,0,2,1,0,1
2023-06-01,26424,3,0,3,2,0,2
2023-06-01,393547,2,0,2,2,0,2
2023-06-01,31947,2,0,2,2,0,2
2023-06-01,22712,1,0,1,1,0,1
2023-06-01,10594,15,0,15,11,0,11
2023-06-01,26286,1,0,1,1,0,1
2023-06-01,13894,1,0,1,1,0,1
2023-06-01,55246,22,0,22,2,0,2
2023-06-01,36012,15,1,16,14,3,14
2023-06-01,15247,41,0,41,1,0,1
2023-06-01,19435,18,0,18,1,0,1
2023-06-01,11929,2,0,2,1,0,1
2023-06-01,24439,16,2,18,1,2,2
2023-06-01,18563,18,1,19,5,2,5
2023-06-01,26463,45,0,45,2,0,2
2023-06-01,30361,17,3,20,1,1,1
2023-06-01,29789,33,16,49,1,1,1
2023-06-01,40181,13,1,14,3,2,3
2023-06-01,14919,8,0,8,6,0,6
2023-06-01,395896,1,0,1,2,0,2
2023-06-01,11714,34,2,36,9,2,9
2023-06-01,23126,17,0,17,1,0,1
2023-06-01,54804,66,1,67,2,1,2
2023-06-01,11961,7,1,8,7,5,8
2023-06-01,17204,2,1,3,2,2,2
2023-06-01,29979,4,0,4,3,0,3
2023-06-01,26347,25,3,28,6,6,7
2023-06-01,20283,15,1,16,1,1,1
2023-06-01,19797,16,0,16,2,0,2
2023-06-01,18787,9,0,9,6,0,6
2023-06-01,397448,1,0,1,1,0,1
2023-06-01,393474,14,0,14,3,0,3
2023-06-01,40684,1,0,1,2,0,2
2023-06-01,53951,4,0,4,4,0,4
2023-06-01,27216,49,1,50,8,2,8
2023-06-01,400470,2,0,2,3,0,3
2023-06-01,16599,6,0,6,5,0,5
2023-06-01,17185,7,1,8,4,2,4
2023-06-01,33059,25,14,39,9,4,9
2023-06-01,27006,6,1,7,5,1,5
2023-06-01,396037,14,0,14,1,0,1
2023-06-01,11246,2,0,2,1,0,1
2023-06-01,32733,1,0,1,1,0,1
2023-06-01,32234,3,1,4,2,1,2
2023-06-01,33498,2,0,2,3,0,3
2023-06-01,18965,1,0,1,2,0,2
2023-06-01,395951,1,0,1,1,0,1
2023-06-01,40015,6,1,7,6,1,6
2023-06-01,46373,4,0,4,3,0,3
2023-06-01,13792,2,0,2,12,0,12
2023-06-01,32374,8,1,9,3,2,4
2023-06-01,22844,6,0,6,3,0,3
2023-06-01,36544,5,0,5,1,0,1
2023-06-01,11823,2,0,2,2,0,2
2023-06-01,19592,3,0,3,3,0,3
2023-06-01,3846,1,0,1,1,0,1
2023-06-01,31982,1,0,1,3,0,3
2023-06-01,394779,1,0,1,3,0,3
2023-06-01,394471,5,0,5,4,0,4
2023-06-01,63441,1,0,1,1,0,1
2023-06-01,62831,8,6,14,5,4,5
2023-06-01,393818,1,1,2,3,3,4
2023-06-01,63363,1,1,2,3,2,3
2023-06-01,62087,1,2,3,2,2,2
2023-06-01,32636,3,2,5,1,1,1
2023-06-01,32491,12,1,13,1,1,1
2023-06-01,15348,12,1,13,3,2,3
2023-06-01,22070,11,1,12,4,1,4
2023-06-01,3388,8,0,8,2,0,2
2023-06-01,40085,1,0,1,1,0,1
2023-06-01,19480,2,0,2,1,0,1
2023-06-01,40038,5,0,5,3,0,3
2023-06-01,394031,1,0,1,2,0,2
2023-06-01,29885,2,0,2,2,0,2
2023-06-01,395068,1,0,1,3,0,3
2023-06-01,1777,3,0,3,2,0,2
2023-06-01,29993,2,0,2,4,0,4
2023-06-01,30043,28,0,28,3,0,3
2023-06-01,14371,12,1,13,11,6,12
2023-06-01,21902,2,0,2,2,0,2
2023-06-01,47965,2,0,2,1,0,1
2023-06-01,53859,3,1,4,2,1,2
2023-06-01,397412,9,1,10,3,3,3
2023-06-01,40185,6,12,18,5,6,6
2023-06-01,30303,17,0,17,6,0,6
2023-06-01,14679,2,0,2,3,0,3
2023-06-01,53809,2,1,3,4,2,4
2023-06-01,10750,31,1,32,3,1,3
2023-06-01,54723,19,0,19,2,0,2
2023-06-01,394778,23,0,23,3,0,3
2023-06-01,26400,8,0,8,1,0,1
2023-06-01,40551,16,0,16,6,0,6
2023-06-01,21686,5,0,5,5,0,5
2023-06-01,19371,1,0,1,1,0,1
2023-06-01,30602,7,0,7,2,0,2
2023-06-01,17049,50,1,51,3,2,3
2023-06-01,22747,5,0,5,6,0,6
2023-06-01,54372,3,0,3,3,0,3
2023-06-01,399603,1,1,2,1,1,1
2023-06-01,30689,200,2,202,6,1,6
2023-06-01,398566,1,0,1,2,0,2
2023-06-01,399567,2,0,2,1,0,1
2023-06-01,399640,1,0,1,1,0,1
2023-06-01,19773,72,1,73,6,1,6
2023-06-01,31827,2,1,3,3,1,3
2023-06-01,399913,1,0,1,1,0,1
2023-06-01,399537,3,0,3,2,0,2
2023-06-01,397078,2,0,2,1,0,1
2023-06-01,7354,5,0,5,1,0,1
2023-06-01,396163,19,0,19,3,0,3
2023-06-01,54702,4,0,4,2,0,2
2023-06-01,22448,2,0,2,2,0,2
2023-06-01,6368,2,1,3,6,2,6
2023-06-01,18683,4,1,5,13,3,13
2023-06-01,399411,3,0,3,3,0,3
2023-06-01,62893,3,0,3,1,0,1
2023-06-01,399203,6,0,6,2,0,2
2023-06-01,63336,1,0,1,3,0,3
2023-06-01,399552,2,0,2,1,0,1
2023-06-01,918,2,2,4,1,1,1
2023-06-01,1226,28,3,31,9,2,9
2023-06-01,30263,8,1,9,8,2,8
2023-06-01,394826,1,0,1,2,0,2
2023-06-01,3701,11,2,13,17,10,18
2023-06-01,4600,0,1,1,8,7,8
2023-06-01,19605,29,0,29,3,0,3
2023-06-01,20304,3,0,3,1,0,1
2023-06-01,22171,1,0,1,2,0,2
2023-06-01,31875,6,0,6,2,0,2
2023-06-01,53501,4,0,4,2,0,2
2023-06-01,15154,3,1,4,2,1,2
2023-06-01,63251,12,1,13,3,3,3
2023-06-01,2698,7,1,8,12,7,12
2023-06-01,3676,3,1,4,10,4,10
2023-06-01,46491,11,0,11,4,0,4
2023-06-01,11833,10,0,10,2,0,2
2023-06-01,30635,7,0,7,2,0,2
2023-06-01,7861,31,0,31,2,0,2
2023-06-01,14551,10,0,10,8,0,8
2023-06-01,18809,529,16,545,10,5,10
2023-06-01,21599,171,0,171,4,0,4
2023-06-01,27687,1,0,1,3,0,3
2023-06-01,26105,1,0,1,20,4,21
2023-06-01,13424,11,0,11,1,0,1
2023-06-01,33392,6,1,7,3,1,4
2023-06-01,266811,2,0,2,4,0,4
2023-06-01,27649,1,0,1,1,0,1
2023-06-01,25637,3,1,4,4,1,4
2023-06-01,5773,49,0,49,1,0,1
2023-06-01,33284,24,0,24,3,0,3
2023-06-01,36820,3,0,3,2,0,2
2023-06-01,14750,3,0,3,1,0,1
2023-06-01,36092,58,0,58,3,0,3
2023-06-01,10660,10,0,10,3,0,3
2023-06-01,18948,6,0,6,5,0,5
2023-06-01,19381,7,1,8,2,2,2
2023-06-01,64242,33,0,33,5,0,5
2023-06-01,26841,1,0,1,1,0,1
2023-06-01,19991,1,1,2,1,2,2
2023-06-01,25615,1,0,1,8,6,9
2023-06-01,23465,35,0,35,2,0,2
2023-06-01,393780,9,0,9,6,0,6
2023-06-01,36321,5,0,5,2,0,2
2023-06-01,25857,2,0,2,3,0,3
2023-06-01,36261,2,0,2,1,0,1
2023-06-01,17367,1,0,1,2,0,2
2023-06-01,2767,0,0,0,2,0,2
2023-06-01,14011,5,0,5,1,0,1
2023-06-01,204440,5,0,5,3,0,3
2023-06-01,55167,1,0,1,1,0,1
2023-06-01,40184,1,0,1,1,0,1
2023-06-01,25755,10,0,10,6,0,6
2023-06-01,394441,1,0,1,2,0,2
2023-06-01,19478,1,0,1,2,0,2
2023-06-01,7767,2,1,3,3,1,3
2023-06-01,395365,1,0,1,1,0,1
2023-06-01,30292,1,0,1,1,0,1
2023-06-01,21704,30,0,30,1,0,1
2023-06-01,11768,1,0,1,2,0,2
2023-06-01,394872,1,0,1,2,0,2
2023-06-01,30419,18,0,18,11,0,11
2023-06-01,14147,1,0,1,3,0,3
2023-06-01,36376,2,0,2,1,0,1
2023-06-01,398731,3,0,3,2,0,2
2023-06-01,63125,3,1,4,2,1,2
2023-06-01,53802,1,0,1,3,0,3
2023-06-01,393631,2,0,2,2,0,2
2023-06-01,31845,5,1,6,2,2,2
2023-06-01,33481,11,1,12,5,1,5
2023-06-01,33027,1,0,1,1,0,1
2023-06-01,18586,2,0,2,2,0,2
2023-06-01,32187,1,0,1,3,0,3
2023-06-01,20293,1,0,1,2,0,2
2023-06-01,54999,1,0,1,1,0,1
2023-06-01,13344,3,0,3,1,0,1
2023-06-01,17338,12,0,12,2,0,2
2023-06-01,12601,20,0,20,3,0,3
2023-06-01,36813,5,1,6,4,1,4
2023-06-01,399331,13,1,14,5,2,5
2023-06-01,22413,27,1,28,11,5,12
2023-06-01,23481,20,0,20,2,0,2
2023-06-01,134469,1,1,2,6,4,7
2023-06-01,19233,12,0,12,3,0,3
2023-06-01,54979,9,0,9,2,0,2
2023-06-01,395523,2,0,2,3,0,3
2023-06-01,394829,7,0,7,2,0,2
2023-06-01,33479,1,0,1,1,0,1
2023-06-01,23469,1,0,1,1,0,1
2023-06-01,19091,2,0,2,2,0,2
2023-06-01,22984,9,0,9,3,0,3
2023-06-01,395355,1,0,1,1,0,1
2023-06-01,19123,1,0,1,2,0,2
2023-06-01,40244,53,8,61,9,8,9
2023-06-01,18902,2,0,2,2,0,2
2023-06-01,29784,2,0,2,3,0,3
2023-06-01,30061,1,0,1,2,0,2
2023-06-01,15232,1,0,1,2,0,2
2023-06-01,26098,1,0,1,1,0,1
2023-06-01,53938,1,0,1,2,0,2
2023-06-01,39956,1,0,1,1,0,1
2023-06-01,396245,1,0,1,1,0,1
2023-06-01,393396,1,0,1,1,0,1
2023-06-01,31787,1,0,1,2,0,2
2023-06-01,31913,3,0,3,2,0,2
2023-06-01,40277,1,0,1,1,0,1
2023-06-01,20251,5,0,5,4,0,4
2023-06-01,54319,3,0,3,3,0,3
2023-06-01,11967,1,0,1,2,0,2
2023-06-01,40215,1,0,1,1,0,1
2023-06-01,18567,2,0,2,1,0,1
2023-06-01,25938,5,0,5,8,0,8
2023-06-01,26805,3,0,3,3,0,3
2023-06-01,7859,13,2,15,5,5,5
2023-06-01,29894,106,0,106,1,0,1
2023-06-01,13868,6,1,7,10,2,10
2023-06-01,12044,10,0,10,2,0,2
2023-06-01,23136,67,0,67,6,0,6
2023-06-01,54412,24,2,26,4,3,4
2023-06-01,29825,7,1,8,3,2,3
2023-06-01,53873,4,0,4,1,0,1
2023-06-01,393580,1,0,1,1,0,1
2023-06-01,396411,6,0,6,1,0,1
2023-06-01,33344,1,0,1,1,0,1
2023-06-01,394358,4,0,4,3,0,3
2023-06-01,393984,1,0,1,3,0,3
2023-06-01,33745,21,0,21,3,0,3
2023-06-01,15281,1,0,1,2,0,2
2023-06-01,395760,3,0,3,3,0,3
2023-06-01,33395,12,0,12,2,0,2
2023-06-01,32390,1,0,1,1,0,1
2023-06-01,13645,9,1,10,1,1,1
2023-06-01,40186,1,0,1,2,0,2
2023-06-01,397753,1,0,1,1,0,1
2023-06-01,13518,4,0,4,1,0,1
2023-06-01,10689,17,0,17,5,0,5
2023-06-01,13446,16,0,16,6,0,6
2023-06-01,13426,4,0,4,1,0,1
2023-06-01,8164,1,0,1,3,0,3
2023-06-01,22921,1,1,2,1,1,1
2023-06-01,397318,1,0,1,1,0,1
2023-06-01,394002,3,0,3,2,0,2
2023-06-01,22079,21,1,22,2,1,2
2023-06-01,16795,5,0,5,3,0,3
2023-06-01,36170,16,0,16,2,0,2
2023-06-01,149428,12,1,13,1,1,1
2023-06-01,329225,2,0,2,1,0,1
2023-06-01,205964,8,0,8,2,0,2
2023-06-01,150445,5,1,6,1,1,2
2023-06-01,22775,10,0,10,8,0,8
2023-06-01,21565,479,2,481,1,1,1
2023-06-01,11915,99,4,103,9,3,9
2023-06-01,18687,115,0,115,1,0,1
2023-06-01,46147,6,0,6,2,0,2
2023-06-01,398091,3,0,3,1,0,1
2023-06-01,31758,1,0,1,3,0,3
2023-06-01,33686,4,0,4,2,0,2
2023-06-01,53359,6,0,6,3,0,3
2023-06-01,53342,1,0,1,1,0,1
2023-06-01,394006,2,0,2,3,0,3
2023-06-01,396374,11,0,11,2,0,2
2023-06-01,399688,1,0,1,1,0,1
2023-06-01,21533,2,0,2,2,0,2
2023-06-01,32738,23,0,23,2,0,2
2023-06-01,19286,1,0,1,2,0,2
2023-06-01,27004,2,0,2,3,0,3
2023-06-01,55274,2,0,2,2,0,2
2023-06-01,396366,1,0,1,1,0,1
2023-06-01,18452,3,0,3,1,0,1
2023-06-01,20446,12,13,25,3,3,3
2023-06-01,12989,57,4,61,14,9,15
2023-06-01,18607,2,0,2,3,0,3
2023-06-01,20224,6,1,7,1,1,1
2023-06-01,396098,2,1,3,2,2,2
2023-06-01,400686,4,0,4,1,0,1
2023-06-01,27373,4,0,4,4,0,4
2023-06-01,32312,10,0,10,7,0,7
2023-06-01,54763,2,0,2,1,0,1
2023-06-01,27254,1,0,1,2,0,2
2023-06-01,55032,18,1,19,7,1,7
2023-06-01,19460,9,0,9,4,0,4
2023-06-01,32020,37,4,41,5,1,5
2023-06-01,11319,4,0,4,3,0,3
2023-06-01,394111,7,1,8,6,4,6
2023-06-01,21657,4,0,4,1,0,1
2023-06-01,36426,25,0,25,1,0,1
2023-06-01,1416,13,0,13,3,0,3
2023-06-01,23434,2,0,2,3,0,3
2023-06-01,5742,88,1,89,10,3,10
2023-06-01,22458,84,3,87,2,2,3
2023-06-01,18501,122,1,123,4,2,4
2023-06-01,26753,26,0,26,4,0,4
2023-06-01,46714,1,0,1,2,0,2
2023-06-01,33693,1,0,1,1,0,1
2023-06-01,33099,4,1,5,1,1,1
2023-06-01,397450,1,0,1,3,0,3
2023-06-01,17043,10,0,10,6,0,6
2023-06-01,23369,7,1,8,1,1,1
2023-06-01,19248,2,0,2,1,0,1
2023-06-01,13330,23,0,23,3,0,3
2023-06-01,19987,1,0,1,2,0,2
2023-06-01,396513,4,0,4,2,0,2
2023-06-01,6099,19,1,20,5,1,5
2023-06-01,32843,1,0,1,3,0,3
2023-06-01,20427,1,0,1,2,0,2
2023-06-01,36579,3,0,3,2,0,2
2023-06-01,21725,8,3,11,1,1,1
2023-06-01,14920,12,0,12,3,0,3
2023-06-01,396185,11,0,11,2,0,2
2023-06-01,397893,14,0,14,1,0,1
2023-06-01,30119,15,0,15,2,0,2
2023-06-01,46426,7,0,7,1,0,1
2023-06-01,26009,1,0,1,2,0,2
2023-06-01,11159,8,0,8,1,0,1
2023-06-01,22110,9,1,10,2,2,2
2023-06-01,11118,1,0,1,1,0,1
2023-06-01,400017,1,0,1,3,0,3
2023-06-01,3131,16,1,17,1,1,1
2023-06-01,54225,3,1,4,3,3,3
2023-06-01,55230,11,1,12,1,1,1
2023-06-01,40284,16,0,16,3,0,3
2023-06-01,23265,4,0,4,4,0,4
2023-06-01,395471,11,0,11,5,0,5
2023-06-01,18895,48,0,48,6,0,6
2023-06-01,20372,33,0,33,2,0,2
2023-06-01,398164,1,0,1,1,0,1
2023-06-01,398182,2,0,2,1,0,1
2023-06-01,399216,2,0,2,2,0,2
2023-06-01,53766,60,30,90,29,23,32
2023-06-01,62482,13,0,13,3,0,3
2023-06-01,29833,4,0,4,2,0,2
2023-06-01,12074,1,0,1,1,0,1
2023-06-01,13638,25,0,25,1,0,1
2023-06-01,27413,1,0,1,1,0,1
2023-06-01,29705,2,1,3,2,1,2
2023-06-01,14317,1,0,1,1,0,1
2023-06-01,16608,18,0,18,3,0,3
2023-06-01,33296,2,0,2,2,0,2
2023-06-01,399789,1,0,1,1,0,1
2023-06-01,394755,4,0,4,2,0,2
2023-06-01,198095,14,1,15,1,1,2
2023-06-01,398160,1,0,1,2,0,2
2023-06-01,397796,1,0,1,2,0,2
2023-06-01,398275,1,0,1,1,0,1
2023-06-01,397589,2,1,3,1,1,1
2023-06-01,397799,1,1,2,3,1,3
2023-06-01,397687,1,1,2,3,1,3
2023-06-01,19310,9,1,10,3,3,5
2023-06-01,397616,1,0,1,1,0,1
2023-06-01,40933,142,0,142,4,0,4
2023-06-01,36817,11,0,11,3,0,3
2023-06-01,21699,45,0,45,5,0,5
2023-06-01,207083,26,6,32,11,10,12
2023-06-01,45560,22,0,22,3,0,3
2023-06-01,46339,18,0,18,2,0,2
2023-06-01,54607,23,0,23,4,0,4
2023-06-01,81,146,3,149,41,12,41
2023-06-01,19161,2,0,2,1,0,1
2023-06-01,395465,1,0,1,1,0,1
2023-06-01,398426,1,0,1,1,0,1
2023-06-01,46273,25,0,25,3,0,3
2023-06-01,398703,3,0,3,2,0,2
2023-06-01,400348,1,0,1,1,0,1
2023-06-01,400483,5,0,5,1,0,1
2023-06-01,400651,1,0,1,1,0,1
2023-06-01,397721,2,0,2,1,0,1
2023-06-01,395461,33,2,35,2,1,2
2023-06-01,400447,2,0,2,2,0,2
2023-06-01,394413,2,0,2,2,0,2
2023-06-01,399596,1,0,1,1,0,1
2023-06-01,29842,9,0,9,2,0,2
2023-06-01,395597,58,0,58,4,0,4
2023-06-01,400347,1,0,1,1,0,1
2023-06-01,400386,1,0,1,1,0,1
2023-06-01,400695,1,0,1,3,0,3
2023-06-01,393824,1,0,1,1,0,1
2023-06-01,14351,3,0,3,1,0,1
2023-06-01,400613,1,0,1,1,0,1
2023-06-01,32876,1,0,1,3,0,3
2023-06-01,399886,3,0,3,3,0,3
2023-06-01,14325,13,2,15,21,4,22
2023-06-01,53333,1,0,1,3,0,3
2023-06-01,47846,3,1,4,3,2,3
2023-06-01,395301,13,0,13,2,0,2
2023-06-01,398818,1,0,1,1,0,1
2023-06-01,395978,1,0,1,1,0,1
2023-06-01,40459,17,0,17,7,0,7
2023-06-01,26776,1,0,1,1,0,1
2023-06-01,11183,9,0,9,2,0,2
2023-06-01,2707,6,7,13,6,3,6
2023-06-01,62774,2,0,2,3,0,3
2023-06-01,399541,7,0,7,7,0,7
2023-06-01,394201,4,0,4,6,0,6
2023-06-01,30322,2,0,2,2,0,2
2023-06-01,398434,3,0,3,1,0,1
2023-06-01,398487,3,0,3,1,0,1
2023-06-01,27163,4,0,4,3,0,3
2023-06-01,398841,1,0,1,1,0,1
2023-06-01,398988,1,0,1,1,0,1
2023-06-01,64238,2,2,4,2,1,2
2023-06-01,20298,3,1,4,3,1,3
2023-06-01,54661,6,0,6,6,0,6
2023-06-01,64255,2,0,2,4,2,6
2023-06-01,395406,1,0,1,1,0,1
2023-06-01,394749,10,15,25,12,14,15
2023-06-01,14609,24,0,24,13,0,13
2023-06-01,46916,2,0,2,1,0,1
2023-06-01,266849,1,1,2,4,2,4
2023-06-01,7856,8,0,8,1,0,1
2023-06-01,395944,8,0,8,3,0,3
2023-06-01,27526,4,0,4,2,0,2
2023-06-01,62723,3,0,3,4,0,4
2023-06-01,17099,8,0,8,1,0,1
2023-06-01,33606,21,1,22,6,3,6
2023-06-01,21541,21,0,21,2,0,2
2023-06-01,14195,3,0,3,2,0,2
2023-06-01,36555,4,0,4,2,0,2
2023-06-01,10425,5,0,5,4,0,4
2023-06-01,30354,3,0,3,2,0,2
2023-06-01,25660,24,1,25,7,2,7
2023-06-01,32877,2,0,2,2,0,2
2023-06-01,12021,9,0,9,1,0,1
2023-06-01,53486,7,2,9,12,7,12
2023-06-01,393994,10,1,11,3,1,3
2023-06-01,19652,2,0,2,3,0,3
2023-06-01,26449,2,0,2,1,0,1
2023-06-01,21555,6,0,6,2,0,2
2023-06-01,399772,0,1,1,6,6,7
2023-06-01,16543,4,0,4,2,0,2
2023-06-01,33675,4,0,4,6,0,6
2023-06-01,22807,16,0,16,1,0,1
2023-06-01,29867,3,0,3,1,0,1
2023-06-01,10625,5,0,5,1,0,1
2023-06-01,25657,3,0,3,3,0,3
2023-06-01,40304,2,0,2,1,0,1
2023-06-01,398274,1,0,1,2,0,2
2023-06-01,397058,1,0,1,2,0,2
2023-06-01,54511,1,0,1,2,0,2
2023-06-01,26674,1,0,1,1,0,1
2023-06-01,1043,2,0,2,2,0,2
2023-06-01,25817,14,0,14,3,0,3
2023-06-01,64584,1,0,1,1,0,1
2023-06-01,32726,9,6,15,4,4,4
2023-06-01,54966,1,0,1,1,0,1
2023-06-01,11598,6,1,7,4,2,4
2023-06-01,14977,15,1,16,5,3,5
2023-06-01,14041,11,2,13,31,12,31
2023-06-01,398110,23,0,23,1,0,1
2023-06-01,26329,4,0,4,2,0,2
2023-06-01,18433,3,0,3,3,0,3
2023-06-01,40108,23,0,23,3,0,3
2023-06-01,45178,26,0,26,9,0,9
2023-06-01,62856,21,1,22,9,2,9
2023-06-01,394385,1,0,1,1,0,1
2023-06-01,16526,36,0,36,3,0,3
2023-06-01,16781,1,0,1,1,0,1
2023-06-01,22581,29,1,30,4,1,4
2023-06-01,36471,11,0,11,3,0,3
2023-06-01,393441,8,0,8,2,0,2
2023-06-01,22958,25,7,32,5,1,5
2023-06-01,202213,6,0,6,2,0,2
2023-06-01,6404,10,0,10,13,0,13
2023-06-01,397691,2,0,2,1,0,1
2023-06-01,7991,40,0,40,2,0,2
2023-06-01,14246,1,0,1,2,0,2
2023-06-01,598,1,0,1,1,0,1
2023-06-01,393747,1,0,1,1,0,1
2023-06-01,32977,8,0,8,2,0,2
2023-06-01,16659,3,0,3,2,0,2
2023-06-01,16789,20,0,20,13,0,13
2023-06-01,16948,6,0,6,3,0,3
2023-06-01,3512,5,0,5,5,0,5
2023-06-01,30560,9,0,9,3,0,3
2023-06-01,22433,1,0,1,1,0,1
2023-06-01,400218,6,0,6,3,0,3
2023-06-01,53322,1,0,1,3,0,3
2023-06-01,53327,1,0,1,3,0,3
2023-06-01,53963,1,0,1,1,0,1
2023-06-01,22270,2,0,2,2,0,2
2023-06-01,400058,1,0,1,1,0,1
2023-06-01,400338,2,1,3,2,1,2
2023-06-01,692,3,1,4,1,1,1
2023-06-01,133066,11,0,11,1,0,1
2023-06-01,399493,17,1,18,1,1,1
2023-06-01,397504,4,1,5,1,2,2
2023-06-01,398391,19,0,19,4,0,4
2023-06-01,30107,1,1,2,1,1,1
2023-06-01,393677,1,0,1,1,0,1
2023-06-01,393899,1,0,1,2,0,2
2023-06-01,36078,1,0,1,1,0,1
2023-06-01,23328,2,2,4,2,2,2
2023-06-01,40266,29,0,29,4,0,4
2023-06-01,40586,2,0,2,2,0,2
2023-06-01,22275,1,0,1,1,0,1
2023-06-01,11059,5,1,6,2,1,2
2023-06-01,26277,57,0,57,7,0,7
2023-06-01,36374,17,1,18,9,6,10
2023-06-01,25769,7,1,8,2,1,2
2023-06-01,22879,4,0,4,1,0,1
2023-06-01,15324,10,0,10,6,0,6
2023-06-01,33494,28,1,29,2,1,2
2023-06-01,19920,5,0,5,4,0,4
2023-06-01,53582,2,1,3,3,2,3
2023-06-01,22654,2,0,2,3,0,3
2023-06-01,12012,3,0,3,3,0,3
2023-06-01,36590,8,0,8,3,0,3
2023-06-01,26016,2,0,2,2,0,2
2023-06-01,36607,1,0,1,1,0,1
2023-06-01,40447,5,0,5,2,0,2
2023-06-01,395035,3,0,3,2,0,2
2023-06-01,11509,18,2,20,3,2,3
2023-06-01,33701,3,0,3,1,0,1
2023-06-01,32592,95,2,97,3,1,3
2023-06-01,18891,4,0,4,3,0,3
2023-06-01,16809,1,0,1,1,0,1
2023-06-01,8132,4,0,4,1,0,1
2023-06-01,25694,7,1,8,8,1,8
2023-06-01,55043,15,0,15,3,0,3
2023-06-01,32442,4,0,4,4,0,4
2023-06-01,46361,2,0,2,2,0,2
2023-06-01,17219,1,0,1,1,0,1
2023-06-01,22774,1,0,1,2,0,2
2023-06-01,36825,2,0,2,3,0,3
2023-06-01,19514,1,0,1,1,0,1
2023-06-01,32402,5,0,5,7,0,7
2023-06-01,29803,2,0,2,2,0,2
2023-06-01,396861,2,0,2,2,0,2
2023-06-01,397455,2,0,2,2,0,2
2023-06-01,6295,15,2,17,9,7,10
2023-06-01,11899,1,0,1,2,0,2
2023-06-01,35856,1,0,1,1,0,1
2023-06-01,399220,7,0,7,4,0,4
2023-06-01,395685,9,0,9,1,0,1
2023-06-01,32746,10,1,11,2,1,2
2023-06-01,17135,4,0,4,1,0,1
2023-06-01,22684,5,2,7,1,1,1
2023-06-01,12206,2,0,2,1,0,1
2023-06-01,18725,5,0,5,2,0,2
2023-06-01,61018,3,0,3,3,0,3
2023-06-01,16788,34,0,34,2,0,2
2023-06-01,12138,1,0,1,1,0,1
2023-06-01,11650,8,1,9,4,4,4
2023-06-01,11584,16,0,16,3,0,3
2023-06-01,32102,1,0,1,3,0,3
2023-06-01,6580,10,1,11,4,1,4
2023-06-01,26284,14,0,14,1,0,1
2023-06-01,400800,2,0,2,1,0,1
2023-06-01,393408,17,0,17,2,0,2
2023-06-01,20442,30,0,30,3,0,3
2023-06-01,32262,2,0,2,2,0,2
2023-06-01,40861,91,0,91,11,0,11
2023-06-01,4364,2,0,2,2,0,2
2023-06-01,19171,11,4,15,8,5,9
2023-06-01,15263,3,0,3,3,0,3
2023-06-01,32784,1,0,1,1,0,1
2023-06-01,12261,14,1,15,4,1,4
2023-06-01,20428,10,0,10,2,0,2
2023-06-01,16524,194,23,217,14,3,14
2023-06-01,395165,3,0,3,2,0,2
2023-06-01,6531,2,0,2,1,0,1
2023-06-01,398700,17,1,18,4,4,5
2023-06-01,17307,11,0,11,2,0,2
2023-06-01,18484,6,0,6,2,0,2
2023-06-01,18485,6,0,6,2,0,2
2023-06-01,18489,3,0,3,2,0,2
2023-06-01,19803,11,0,11,2,0,2
2023-06-01,19804,7,0,7,2,0,2
2023-06-01,18486,6,0,6,2,0,2
2023-06-01,18490,4,0,4,2,0,2
2023-06-01,18491,8,0,8,2,0,2
2023-06-01,19808,3,0,3,2,0,2
2023-06-01,18488,4,0,4,1,0,1
2023-06-01,19807,7,0,7,7,0,7
2023-06-01,19809,6,0,6,1,0,1
2023-06-01,16941,19,0,19,4,0,4
2023-06-01,1968,33,5,38,9,2,9
2023-06-01,1256,5,0,5,6,0,6
2023-06-01,396086,3,0,3,1,0,1
2023-06-01,30003,1,0,1,1,0,1
2023-06-01,46720,3,1,4,4,1,4
2023-06-01,19570,24,0,24,3,0,3
2023-06-01,394998,6,0,6,2,0,2
2023-06-01,22631,23,0,23,3,0,3
2023-06-01,2044,15,1,16,7,1,7
2023-06-01,30087,1,0,1,1,0,1
2023-06-01,6384,7,0,7,1,0,1
2023-06-01,22276,4,0,4,5,0,5
2023-06-01,397827,2,0,2,2,0,2
2023-06-01,11473,2,0,2,1,0,1
2023-06-01,19323,7,2,9,3,2,4
2023-06-01,63448,19,0,19,4,0,4
2023-06-01,12282,4,1,5,2,2,2
2023-06-01,399123,3,0,3,1,0,1
2023-06-01,3833,231,2,233,2,4,4
2023-06-01,395251,1,0,1,4,0,4
2023-06-01,12041,226,224,450,27,15,29
2023-06-01,207266,77,77,154,3,3,3
2023-06-01,33280,1,1,2,3,2,3
2023-06-01,13810,1,1,2,1,1,1
2023-06-01,55195,9,17,26,14,10,15
2023-06-01,394354,8,15,23,20,15,23
2023-06-01,132064,3,1,4,2,2,2
2023-06-01,21775,10,7,17,6,4,6
2023-06-01,26510,1,0,1,1,0,1
2023-06-01,400266,1,0,1,1,0,1
2023-06-01,22800,1,0,1,3,0,3
2023-06-01,4576,2,0,2,2,0,2
2023-06-01,589,3,1,4,4,1,4
2023-06-01,54222,1,0,1,3,0,3
2023-06-01,397021,1,0,1,1,0,1
2023-06-01,11133,15,0,15,3,0,3
2023-06-01,63323,4,0,4,2,0,2
2023-06-01,19662,48,1,49,7,4,9
2023-06-01,12009,3,1,4,1,1,1
2023-06-01,50075,2,0,2,2,0,2
2023-06-01,32189,3,0,3,1,0,1
2023-06-01,26071,1,0,1,1,0,1
2023-06-01,27005,5,0,5,3,0,3
2023-06-01,14905,29,0,29,1,0,1
2023-06-01,4282,12,0,12,1,0,1
2023-06-01,18847,1,0,1,1,0,1
2023-06-01,17402,27,0,27,1,0,1
2023-06-01,12275,4,0,4,2,0,2
2023-06-01,21854,16,0,16,2,0,2
2023-06-01,40911,5,0,5,3,0,3
2023-06-01,398021,2,0,2,1,0,1
2023-06-01,46408,48,0,48,1,0,1
2023-06-01,36707,2,0,2,2,0,2
2023-06-01,60154,2,1,3,3,2,3
2023-06-01,398390,1,0,1,1,0,1
2023-06-01,14397,17,0,17,3,0,3
2023-06-01,32519,1,3,4,1,1,2
2023-06-01,398976,2,0,2,2,0,2
2023-06-01,25914,7,1,8,4,4,4
2023-06-01,399007,43,1,44,4,1,4
2023-06-01,22379,69,65,134,17,13,17
2023-06-01,11759,1,0,1,1,0,1
2023-06-01,30367,3,0,3,5,0,5
2023-06-01,19720,12,0,12,1,0,1
2023-06-01,35880,1,0,1,1,0,1
2023-06-01,46152,1,0,1,4,0,4
2023-06-01,1632,2,0,2,2,0,2
2023-06-01,16979,1,0,1,1,0,1
2023-06-01,399208,1,0,1,3,0,3
2023-06-01,398116,5,0,5,3,0,3
2023-06-01,46673,1,0,1,3,0,3
2023-06-01,22405,1,0,1,1,0,1
2023-06-01,46766,2,0,2,3,0,3
2023-06-01,12216,1,0,1,1,0,1
2023-06-01,46835,1,0,1,1,0,1
2023-06-01,14699,1,0,1,1,0,1
2023-06-01,46904,1,0,1,3,0,3
2023-06-01,399684,1,0,1,3,0,3
2023-06-01,19862,1,0,1,1,0,1
2023-06-01,40137,1,0,1,1,0,1
2023-06-01,22345,1,0,1,3,0,3
2023-06-01,3598,22,5,27,5,3,5
2023-06-01,40443,18,4,22,6,5,6
2023-06-01,11135,11,0,11,3,0,3
2023-06-01,11357,2,0,2,2,0,2
2023-06-01,397296,1,0,1,3,0,3
2023-06-01,54893,2,0,2,1,0,1
2023-06-01,396912,1,1,2,2,2,2
2023-06-01,399609,1,0,1,1,0,1
2023-06-01,21730,3,0,3,2,0,2
2023-06-01,15026,10,0,10,1,0,1
2023-06-01,16872,1,0,1,1,0,1
2023-06-01,19934,2,0,2,2,0,2
2023-06-01,22703,17,0,17,4,0,4
2023-06-01,21648,11,0,11,3,0,3
2023-06-01,393359,5,0,5,3,0,3
2023-06-01,210781,2,0,2,1,0,1
2023-06-01,10494,2,0,2,1,0,1
2023-06-01,11623,2,0,2,1,0,1
2023-06-01,32464,1,0,1,3,0,3
2023-06-01,11067,20,1,21,4,1,4
2023-06-01,14369,17,1,18,3,1,3
2023-06-01,6382,3,0,3,1,0,1
2023-06-01,19658,3,0,3,4,0,4
2023-06-01,36711,3,1,4,2,1,2
2023-06-01,6197,6,0,6,1,0,1
2023-06-01,54322,1,0,1,1,0,1
2023-06-01,23155,4,0,4,6,0,6
2023-06-01,398413,16,0,16,1,0,1
2023-06-01,35999,3,0,3,3,0,3
2023-06-01,22022,2,0,2,3,0,3
2023-06-01,32342,6,0,6,3,0,3
2023-06-01,400425,2,0,2,1,0,1
2023-06-01,25653,18,0,18,3,0,3
2023-06-01,17358,22,0,22,3,0,3
2023-06-01,19864,50,0,50,4,0,4
2023-06-01,20134,9,0,9,1,0,1
2023-06-01,22658,34,0,34,1,0,1
2023-06-01,23509,7,0,7,5,0,5
2023-06-01,36748,6,0,6,2,0,2
2023-06-01,396933,4,0,4,2,0,2
2023-06-01,14689,8,0,8,9,0,9
2023-06-01,20392,1,0,1,2,0,2
2023-06-01,36031,18,1,19,2,2,2
2023-06-01,40341,6,1,7,3,1,3
2023-06-01,36030,7,1,8,2,1,2
2023-06-01,27272,12,1,13,5,2,5
2023-06-01,31934,1,0,1,1,0,1
2023-06-01,30715,2,0,2,1,0,1
2023-06-01,393892,7,0,7,5,0,5
2023-06-01,22138,1,0,1,3,0,3
2023-06-01,18990,13,0,13,2,0,2
2023-06-01,572,6,0,6,2,0,2
2023-06-01,7876,0,0,0,4,0,4
2023-06-01,398959,4,0,4,2,0,2
2023-06-01,19872,1,1,2,1,1,1
2023-06-01,4307,2,1,3,1,1,1
2023-06-01,30691,10,0,10,3,0,3
2023-06-01,399948,1,0,1,3,0,3
2023-06-01,396482,2,0,2,3,0,3
2023-06-01,394680,0,0,0,3,0,3
2023-06-01,14434,101,0,101,5,0,5
2023-06-01,32231,4,0,4,3,0,3
2023-06-01,22965,4,0,4,3,0,3
2023-06-01,33327,10,0,10,4,0,4
2023-06-01,399254,2,0,2,1,0,1
2023-06-01,394046,3,0,3,1,0,1
2023-06-01,46551,1,0,1,2,0,2
2023-06-01,11076,1,0,1,3,0,3
2023-06-01,22349,3,0,3,3,0,3
2023-06-01,22618,1,0,1,1,0,1
2023-06-01,32175,1,0,1,2,0,2
2023-06-01,20230,2,0,2,3,0,3
2023-06-01,62791,2,0,2,3,0,3
2023-06-01,21881,4,0,4,1,0,1
2023-06-01,32460,2,0,2,4,0,4
2023-06-01,21702,1,0,1,3,0,3
2023-06-01,32124,1,0,1,1,0,1
2023-06-01,25655,11,0,11,6,0,6
2023-06-01,26761,2,0,2,1,0,1
2023-06-01,14937,1,0,1,3,0,3
2023-06-01,31942,1,0,1,1,0,1
2023-06-01,25758,2,0,2,3,0,3
2023-06-01,15238,4,0,4,5,0,5
2023-06-01,23032,1,0,1,1,0,1
2023-06-01,29969,1,0,1,1,0,1
2023-06-01,30293,1,0,1,2,0,2
2023-06-01,54695,5,0,5,3,0,3
2023-06-01,14057,2,0,2,3,0,3
2023-06-01,46348,1,0,1,1,0,1
2023-06-01,32099,2,0,2,3,0,3
2023-06-01,22776,1,0,1,2,0,2
2023-06-01,25934,65,1,66,13,1,13
2023-06-01,11255,16,0,16,6,0,6
2023-06-01,11937,1,0,1,1,0,1
2023-06-01,393776,2,0,2,3,0,3
2023-06-01,21843,2,0,2,3,0,3
2023-06-01,36602,1,0,1,3,0,3
2023-06-01,32118,1,0,1,2,0,2
2023-06-01,26955,7,4,11,3,3,3
2023-06-01,53885,2,0,2,2,0,2
2023-06-01,54259,2,0,2,3,0,3
2023-06-01,13762,1,0,1,1,0,1
2023-06-01,395773,2,0,2,2,0,2
2023-06-01,2768,4,0,4,3,0,3
2023-06-01,19800,4,0,4,3,0,3
2023-06-01,12005,4,0,4,4,0,4
2023-06-01,33644,1,0,1,1,0,1
2023-06-01,36071,7,0,7,3,0,3
2023-06-01,32824,7,0,7,2,0,2
2023-06-01,16648,2,0,2,1,0,1
2023-06-01,26308,1,0,1,3,0,3
2023-06-01,11842,3,0,3,2,0,2
2023-06-01,14862,4,0,4,6,0,6
2023-06-01,395030,3,1,4,3,1,3
2023-06-01,25729,1,0,1,1,0,1
2023-06-01,40451,1,0,1,1,0,1
2023-06-01,40010,5,0,5,1,0,1
2023-06-01,394307,1,0,1,2,0,2
2023-06-01,19629,2,0,2,3,0,3
2023-06-01,19208,2,0,2,1,0,1
2023-06-01,46206,5,0,5,3,0,3
2023-06-01,33232,2,0,2,2,0,2
2023-06-01,63215,1,0,1,1,0,1
2023-06-01,54781,7,0,7,4,0,4
2023-06-01,40952,1,0,1,1,0,1
2023-06-01,62801,1,0,1,3,0,3
2023-06-01,55217,1,0,1,1,0,1
2023-06-01,14844,1,0,1,2,0,2
2023-06-01,400430,3,0,3,1,0,1
2023-06-01,36515,3,0,3,2,0,2
2023-06-01,22035,2,0,2,2,0,2
2023-06-01,54111,3,2,5,2,2,2
2023-06-01,6122,14,3,17,20,5,20
2023-06-01,54150,1,0,1,1,0,1
2023-06-01,15257,7,1,8,2,1,2
2023-06-01,12165,6,0,6,2,0,2
2023-06-01,22621,3,0,3,2,0,2
2023-06-01,55261,2,0,2,2,0,2
2023-06-01,394704,1,0,1,1,0,1
2023-06-01,400663,1,0,1,1,0,1
2023-06-01,46387,1,0,1,3,0,3
2023-06-01,395308,1,0,1,2,0,2
2023-06-01,395617,2,0,2,3,0,3
2023-06-01,394528,2,0,2,2,0,2
2023-06-01,397392,1,0,1,3,0,3
2023-06-01,47010,2,0,2,1,0,1
2023-06-01,26341,1,0,1,1,0,1
2023-06-01,397524,1,0,1,1,0,1
2023-06-01,6223,3,2,5,13,7,13
2023-06-01,10945,1,0,1,2,0,2
2023-06-01,395562,4,0,4,1,0,1
2023-06-01,394515,1,0,1,1,0,1
2023-06-01,395531,1,0,1,1,0,1
2023-06-01,395736,1,0,1,3,0,3
2023-06-01,399221,2,0,2,4,0,4
2023-06-01,394853,2,0,2,1,0,1
2023-06-01,394929,1,0,1,3,0,3
2023-06-01,11651,2,0,2,3,0,3
2023-06-01,36652,1,0,1,2,0,2
2023-06-01,63415,4,1,5,3,1,3
2023-06-01,62478,2,1,3,3,1,3
2023-06-01,395702,2,0,2,4,0,4
2023-06-01,35840,1,0,1,1,0,1
2023-06-01,395918,3,1,4,2,1,2
2023-06-01,19357,2,0,2,2,0,2
2023-06-01,54538,16,2,18,9,2,9
2023-06-01,64280,12,0,12,3,0,3
2023-06-01,393917,2,0,2,3,0,3
2023-06-01,393658,1,0,1,2,0,2
2023-06-01,13607,17,5,22,5,3,5
2023-06-01,25909,4,0,4,6,0,6
2023-06-01,20411,1,0,1,1,0,1
2023-06-01,18529,1,0,1,2,0,2
2023-06-01,40370,3,0,3,3,0,3
2023-06-01,397099,2,0,2,2,0,2
2023-06-01,25633,1,0,1,2,0,2
2023-06-01,29717,2,0,2,1,0,1
2023-06-01,32833,2,0,2,4,0,4
2023-06-01,20282,3,0,3,3,0,3
2023-06-01,11708,4,1,5,5,3,6
2023-06-01,30111,1,0,1,1,0,1
2023-06-01,397924,3,0,3,1,0,1
2023-06-01,397461,1,0,1,3,0,3
2023-06-01,20396,1,0,1,1,0,1
2023-06-01,10507,211,12,223,2,1,2
2023-06-01,40432,2,0,2,1,0,1
2023-06-01,32091,5,0,5,3,0,3
2023-06-01,18435,23,0,23,2,0,2
2023-06-01,40489,1,0,1,1,0,1
2023-06-01,22083,2,0,2,3,0,3
2023-06-01,33198,5,0,5,3,0,3
2023-06-01,25678,2,0,2,3,0,3
2023-06-01,29756,1,0,1,1,0,1
2023-06-01,14574,3,1,4,2,1,2
2023-06-01,16705,3,0,3,1,0,1
2023-06-01,1647,4,0,4,4,0,4
2023-06-01,36517,2,0,2,2,0,2
2023-06-01,6157,33,0,33,2,0,2
2023-06-01,21582,4,0,4,2,0,2
2023-06-01,12217,51,0,51,3,0,3
2023-06-01,26861,1,0,1,1,0,1
2023-06-01,23029,9,0,9,3,0,3
2023-06-01,17352,4,0,4,1,0,1
2023-06-01,36853,3,0,3,3,0,3
2023-06-01,40505,4,0,4,1,0,1
2023-06-01,36454,35,4,39,5,3,5
2023-06-01,20299,94,0,94,5,0,5
2023-06-01,27773,585,1,586,2,1,2
2023-06-01,33055,13,0,13,4,0,4
2023-06-01,20238,3,0,3,4,0,4
2023-06-01,33067,11,0,11,3,0,3
2023-06-01,14859,6,0,6,1,0,1
2023-06-01,19623,3,0,3,1,0,1
2023-06-01,19668,1,0,1,1,0,1
2023-06-01,11942,7,1,8,3,1,3
2023-06-01,31904,1,0,1,1,0,1
2023-06-01,32126,1,0,1,1,0,1
2023-06-01,398045,1,2,3,1,2,3
2023-06-01,12107,1,0,1,3,0,3
2023-06-01,33418,1,0,1,1,0,1
2023-06-01,399836,1,0,1,1,0,1
2023-06-01,14065,9,0,9,1,0,1
2023-06-01,12098,3,0,3,3,0,3
2023-06-01,33699,1,0,1,1,0,1
2023-06-01,36357,1,0,1,3,0,3
2023-06-01,53530,1,0,1,1,0,1
2023-06-01,54754,1,0,1,1,0,1
2023-06-01,393988,3,0,3,1,0,1
2023-06-01,46493,1,0,1,2,0,2
2023-06-01,54705,1,0,1,2,0,2
2023-06-01,14556,5,0,5,3,0,3
2023-06-01,396941,1,1,2,1,2,2
2023-06-01,399222,2,0,2,1,0,1
2023-06-01,21689,1,0,1,2,0,2
2023-06-01,12016,2,0,2,2,0,2
2023-06-01,46591,1,0,1,3,0,3
2023-06-01,32790,1,0,1,2,0,2
2023-06-01,27468,2,0,2,2,0,2
2023-06-01,40321,3,0,3,3,0,3
2023-06-01,14297,48,0,48,12,0,12
2023-06-01,4451,4,0,4,3,0,3
2023-06-01,393370,1,0,1,2,0,2
2023-06-01,27781,30,3,33,7,2,7
2023-06-01,19434,1,0,1,3,0,3
2023-06-01,32982,27,4,31,4,1,4
2023-06-01,40397,1,0,1,2,0,2
2023-06-01,32973,1,0,1,1,0,1
2023-06-01,27021,16,0,16,4,0,4
2023-06-01,20389,1,0,1,1,0,1
2023-06-01,33242,1,0,1,1,0,1
2023-06-01,63433,1,0,1,1,0,1
2023-06-01,54986,7,0,7,3,0,3
2023-06-01,19353,9,0,9,4,0,4
2023-06-01,16829,1,0,1,1,0,1
2023-06-01,14424,3,0,3,1,0,1
2023-06-01,15174,1,0,1,1,0,1
2023-06-01,14279,3,0,3,1,0,1
2023-06-01,7045,7,0,7,3,0,3
2023-06-01,30563,1,0,1,2,0,2
2023-06-01,32894,2,0,2,1,0,1
2023-06-01,46524,3,2,5,2,2,2
2023-06-01,54678,1,0,1,1,0,1
2023-06-01,394839,1,0,1,3,0,3
2023-06-01,33278,1,0,1,3,0,3
2023-06-01,39960,31,0,31,3,0,3
2023-06-01,393827,3,0,3,2,0,2
2023-06-01,17014,2,0,2,5,0,5
2023-06-01,11347,2,0,2,3,0,3
2023-06-01,15297,8,7,15,4,2,4
2023-06-01,21809,1,0,1,1,0,1
2023-06-01,23139,2,0,2,2,0,2
2023-06-01,396322,1,1,2,2,1,2
2023-06-01,46578,1,0,1,1,0,1
2023-06-01,14130,1,0,1,1,0,1
2023-06-01,33476,5,0,5,3,0,3
2023-06-01,395090,1,0,1,1,0,1
2023-06-01,32551,1,0,1,1,0,1
2023-06-01,395331,1,0,1,2,0,2
2023-06-01,22124,1,0,1,3,0,3
2023-06-01,54268,2,0,2,2,0,2
2023-06-01,22334,9,0,9,3,0,3
2023-06-01,22470,1,0,1,2,0,2
2023-06-01,22288,1,0,1,3,0,3
2023-06-01,29822,2,0,2,3,0,3
2023-06-01,1294,41,0,41,11,0,11
2023-06-01,18459,2,0,2,2,0,2
2023-06-01,11609,34,0,34,8,0,8
2023-06-01,33121,1,0,1,3,0,3
2023-06-01,11081,45,1,46,11,2,11
2023-06-01,22527,47,0,47,3,0,3
2023-06-01,11217,1,0,1,1,0,1
2023-06-01,11860,1,0,1,2,0,2
2023-06-01,23097,3,0,3,3,0,3
2023-06-01,22502,2,0,2,2,0,2
2023-06-01,1615,1,0,1,3,0,3
2023-06-01,10440,4,0,4,3,0,3
2023-06-01,40802,1,0,1,2,0,2
2023-06-01,22674,5,0,5,6,0,6
2023-06-01,20027,1,0,1,2,0,2
2023-06-01,53936,1,0,1,2,0,2
2023-06-01,11331,1,0,1,1,0,1
2023-06-01,22119,1,0,1,1,0,1
2023-06-01,26355,1,0,1,3,0,3
2023-06-01,32915,9,0,9,2,0,2
2023-06-01,40909,1,0,1,3,0,3
2023-06-01,36107,2,0,2,3,0,3
2023-06-01,14015,2,0,2,2,0,2
2023-06-01,54892,1,0,1,3,0,3
2023-06-01,22755,2,0,2,3,0,3
2023-06-01,6947,4,0,4,2,0,2
2023-06-01,23008,3,2,5,3,2,3
2023-06-01,36380,1,0,1,1,0,1
2023-06-01,13388,6,0,6,2,0,2
2023-06-01,7407,1,0,1,1,0,1
2023-06-01,6143,2,0,2,3,0,3
2023-06-01,54292,1,0,1,1,0,1
2023-06-01,22130,2,0,2,1,0,1
2023-06-01,40901,1,0,1,1,0,1
2023-06-01,13690,4,0,4,2,0,2
2023-06-01,397556,5,1,6,3,1,3
2023-06-01,396442,3,0,3,3,0,3
2023-06-01,22274,1,0,1,2,0,2
2023-06-01,19407,1,0,1,1,0,1
2023-06-01,22815,1,0,1,3,0,3
2023-06-01,30149,5,0,5,5,0,5
2023-06-01,23168,1,0,1,1,0,1
2023-06-01,10453,1,0,1,2,0,2
2023-06-01,15079,1,0,1,1,0,1
2023-06-01,32295,1,0,1,1,0,1
2023-06-01,32289,8,0,8,2,0,2
2023-06-01,22361,3,1,4,2,1,2
2023-06-01,30053,1,0,1,2,0,2
2023-06-01,394150,4,0,4,4,0,4
2023-06-01,394096,1,0,1,2,0,2
2023-06-01,393432,1,0,1,3,0,3
2023-06-01,46187,1,0,1,1,0,1
2023-06-01,46622,1,0,1,2,0,2
2023-06-01,26645,1,0,1,1,0,1
2023-06-01,40323,1,0,1,1,0,1
2023-06-01,25603,1,0,1,2,0,2
2023-06-01,40532,2,0,2,3,0,3
2023-06-01,32730,1,0,1,1,0,1
2023-06-01,395078,2,0,2,3,0,3
2023-06-01,14251,2,0,2,3,0,3
2023-06-01,6256,124,0,124,6,0,6
2023-06-01,2634,0,0,0,3,0,3
2023-06-01,12238,1,0,1,1,0,1
2023-06-01,400369,1,0,1,1,0,1
2023-06-01,30280,1,0,1,1,0,1
2023-06-01,25692,4,0,4,2,0,2
2023-06-01,25795,5,2,7,8,6,11
2023-06-01,13834,2,0,2,3,0,3
2023-06-01,25896,9,0,9,6,0,6
2023-06-01,29729,7,0,7,2,0,2
2023-06-01,36553,1,0,1,3,0,3
2023-06-01,393555,2,0,2,2,0,2
2023-06-01,22580,4,0,4,5,0,5
2023-06-01,396452,1,0,1,2,0,2
2023-06-01,46643,1,0,1,2,0,2
2023-06-01,54019,1,0,1,1,0,1
2023-06-01,395650,8,0,8,2,0,2
2023-06-01,396222,1,0,1,3,0,3
2023-06-01,400255,2,0,2,3,0,3
2023-06-01,46104,1,0,1,1,0,1
2023-06-01,395116,1,0,1,1,0,1
2023-06-01,21511,1,0,1,3,0,3
2023-06-01,27247,1,0,1,1,0,1
2023-06-01,22633,2,0,2,1,0,1
2023-06-01,29956,1,0,1,1,0,1
2023-06-01,27573,2,0,2,2,0,2
2023-06-01,2552,6,2,8,5,3,5
2023-06-01,393591,7,0,7,3,0,3
2023-06-01,22451,2,0,2,3,0,3
2023-06-01,47036,2,0,2,1,0,1
2023-06-01,25970,3,0,3,1,0,1
2023-06-01,22933,35,4,39,1,1,1
2023-06-01,30257,4,0,4,5,0,5
2023-06-01,13986,3,0,3,3,0,3
2023-06-01,54579,5,1,6,4,2,4
2023-06-01,40480,1,0,1,3,0,3
2023-06-01,394609,5,0,5,6,0,6
2023-06-01,3651,32,0,32,1,0,1
2023-06-01,14048,4,0,4,9,0,9
2023-06-01,16473,0,0,0,2,0,2
2023-06-01,20019,7,0,7,1,0,1
2023-06-01,17237,2,0,2,1,0,1
2023-06-01,13433,12,1,13,2,1,2
2023-06-01,22663,21,2,23,8,2,8
2023-06-01,40073,5,0,5,2,0,2
2023-06-01,3657,2,0,2,1,0,1
2023-06-01,35988,3,0,3,2,0,2
2023-06-01,25233,48,1,49,17,1,17
2023-06-01,209342,14,0,14,4,0,4
2023-06-01,397673,2,0,2,2,0,2
2023-06-01,397651,25,1,26,3,1,3
2023-06-01,55229,4,0,4,2,0,2
2023-06-01,11817,12,0,12,6,0,6
2023-06-01,23227,2,0,2,2,0,2
2023-06-01,19234,3,0,3,1,0,1
2023-06-01,18649,16,0,16,2,0,2
2023-06-01,36252,10,0,10,1,0,1
2023-06-01,32160,23,1,24,5,2,5
2023-06-01,36545,3,1,4,2,1,2
2023-06-01,33256,3,0,3,2,0,2
2023-06-01,6547,1,0,1,2,0,2
2023-06-01,22572,5,1,6,3,2,3
2023-06-01,328748,6,1,7,21,10,22
2023-06-01,11711,5,1,6,4,1,4
2023-06-01,26546,7,1,8,3,2,3
2023-06-01,29902,11,0,11,3,0,3
2023-06-01,25003,50,2,52,16,3,16
2023-06-01,399950,2,0,2,1,0,1
2023-06-01,206570,3,1,4,2,1,2
2023-06-01,397778,1,0,1,2,0,2
2023-06-01,394862,5,0,5,1,0,1
2023-06-01,22500,2,0,2,1,0,1
2023-06-01,23336,22,0,22,2,0,2
2023-06-01,6494,3,0,3,1,0,1
2023-06-01,32554,4,0,4,4,0,4
2023-06-01,26541,6,0,6,4,0,4
2023-06-01,26819,6,0,6,3,0,3
2023-06-01,32808,11,1,12,4,2,4
2023-06-01,394056,2,1,3,1,1,1
2023-06-01,54447,2,0,2,3,0,3
2023-06-01,7270,130,0,130,8,0,8
2023-06-01,26935,4,1,5,2,1,2
2023-06-01,26250,1,0,1,2,0,2
2023-06-01,62669,2,0,2,2,0,2
2023-06-01,394788,1,0,1,3,0,3
2023-06-01,14495,41,0,41,4,0,4
2023-06-01,46328,8,0,8,4,0,4
2023-06-01,33635,18,0,18,4,0,4
2023-06-01,397713,1,0,1,3,0,3
2023-06-01,35966,1,0,1,3,0,3
2023-06-01,46124,1,0,1,1,0,1
2023-06-01,62641,3,0,3,1,0,1
2023-06-01,33435,1,0,1,2,0,2
2023-06-01,20260,6,0,6,2,0,2
2023-06-01,16992,1,0,1,2,0,2
2023-06-01,16433,36,1,37,2,1,2
2023-06-01,40282,1,0,1,2,0,2
2023-06-01,1421,54,3,57,10,2,10
2023-06-01,30359,9,0,9,2,0,2
2023-06-01,30059,12,1,13,4,1,4
2023-06-01,14233,10,0,10,2,0,2
2023-06-01,36175,4,0,4,2,0,2
2023-06-01,19170,2,1,3,4,2,4
2023-06-01,400045,2,1,3,1,1,1
2023-06-01,53347,93,40,133,2,2,2
2023-06-01,30325,73,2,75,2,2,3
2023-06-01,396878,26,0,26,1,0,1
2023-06-01,14477,52,1,53,6,1,6
2023-06-01,11055,3,16,19,1,1,1
2023-06-01,394457,1,0,1,1,0,1
2023-06-01,393698,6,0,6,3,0,3
2023-06-01,393924,9,1,10,3,2,3
2023-06-01,396919,7,5,12,1,1,1
2023-06-01,398351,1,4,5,1,2,2
2023-06-01,18986,45,0,45,3,0,3
2023-06-01,19058,48,0,48,3,0,3
2023-06-01,33293,11,0,11,2,0,2
2023-06-01,400439,10,0,10,1,0,1
2023-06-01,46478,1,0,1,1,0,1
2023-06-01,5714,87,0,87,2,0,2
2023-06-01,2158,33,1,34,2,2,2
2023-06-01,1248,12,2,14,16,6,17
2023-06-01,14803,1,2,3,1,1,1
2023-06-01,397333,1,0,1,1,0,1
2023-06-01,397917,1,0,1,1,0,1
2023-06-01,398229,2,0,2,1,0,1
2023-06-01,46093,18,0,18,7,0,7
2023-06-01,11035,1,0,1,3,0,3
2023-06-01,13771,9,1,10,2,1,2
2023-06-01,46401,19,0,19,5,0,5
2023-06-01,31917,8,0,8,2,0,2
2023-06-01,14707,2,0,2,3,0,3
2023-06-01,5760,23,1,24,7,4,7
2023-06-01,19710,6,0,6,2,0,2
2023-06-01,203999,658,0,658,4,0,4
2023-06-01,396324,1,0,1,1,0,1
2023-06-01,394062,1,0,1,3,0,3
2023-06-01,396059,1,0,1,1,0,1
2023-06-01,11590,25,1,26,2,1,2
2023-06-01,20413,3,1,4,10,1,10
2023-06-01,14020,3,0,3,4,0,4
2023-06-01,6372,8,0,8,7,0,7
2023-06-01,23223,2,0,2,4,0,4
2023-06-01,62594,3,0,3,3,0,3
2023-06-01,13687,1,1,2,1,1,2
2023-06-01,400077,1,0,1,1,0,1
2023-06-01,400364,1,0,1,1,0,1
2023-06-01,400448,1,0,1,2,0,2
2023-06-01,397283,2,0,2,1,0,1
2023-06-01,11766,18,0,18,4,0,4
2023-06-01,10947,6,1,7,6,4,7
2023-06-01,53607,2,0,2,3,0,3
2023-06-01,21632,12,1,13,5,4,6
2023-06-01,32203,3,0,3,2,0,2
2023-06-01,23492,15,0,15,3,0,3
2023-06-01,23308,15,1,16,7,2,7
2023-06-01,22847,3,1,4,4,3,4
2023-06-01,64270,68,0,68,1,0,1
2023-06-01,11215,192,0,192,3,0,3
2023-06-01,22163,2,0,2,1,0,1
2023-06-01,45187,7,1,8,12,8,12
2023-06-01,24043,6,1,7,2,1,2
2023-06-01,3999,12,1,13,9,5,11
2023-06-01,14438,36,0,36,2,0,2
2023-06-01,22093,9,0,9,4,0,4
2023-06-01,4200010276,2,0,2,1,0,1
2023-06-01,33415,2,0,2,7,0,7
2023-06-01,21670,1,0,1,2,0,2
2023-06-01,393738,2,0,2,2,0,2
2023-06-01,32341,1,0,1,3,0,3
2023-06-01,53791,2,0,2,3,0,3
2023-06-01,11192,5,0,5,1,0,1
2023-06-01,23277,3,0,3,1,0,1
2023-06-01,32778,3,0,3,2,0,2
2023-06-01,11666,16,1,17,16,5,17
2023-06-01,6267,4,0,4,2,0,2
2023-06-01,133144,4,0,4,6,0,6
2023-06-01,44965,4,0,4,7,0,7
2023-06-01,40627,34,1,35,25,1,25
2023-06-01,63062,35,0,35,7,0,7
2023-06-01,19517,4,1,5,1,1,1
2023-06-01,400151,1,0,1,1,0,1
2023-06-01,35997,2,0,2,2,0,2
2023-06-01,394316,3,0,3,3,0,3
2023-06-01,396481,2,1,3,2,1,2
2023-06-01,40875,2,0,2,1,0,1
2023-06-01,394292,1,0,1,1,0,1
2023-06-01,32751,7,1,8,6,5,7
2023-06-01,396133,1,0,1,1,0,1
2023-06-01,393985,1,0,1,1,0,1
2023-06-01,2725,1,0,1,1,0,1
2023-06-01,4324,10,0,10,1,0,1
2023-06-01,55053,10,0,10,2,0,2
2023-06-01,32424,2,0,2,1,0,1
2023-06-01,53357,1,0,1,1,0,1
2023-06-01,393960,8,0,8,2,0,2
2023-06-01,62537,6,0,6,8,0,8
2023-06-01,394257,1,0,1,3,0,3
2023-06-01,394309,1,0,1,2,0,2
2023-06-01,394032,1,0,1,1,0,1
2023-06-01,40501,17,0,17,5,0,5
2023-06-01,400815,1,0,1,1,0,1
2023-06-01,394347,1,0,1,2,0,2
2023-06-01,21960,13,0,13,2,0,2
2023-06-01,400042,4,1,5,3,2,5
2023-06-01,36217,2,1,3,2,1,2
2023-06-01,63318,3,5,8,2,4,4
2023-06-01,54839,4,3,7,4,4,4
2023-06-01,7191,3,0,3,1,0,1
2023-06-01,32923,1,0,1,2,0,2
2023-06-01,21908,22,0,22,2,0,2
2023-06-01,13337,17,0,17,2,0,2
2023-06-01,30528,3,1,4,2,2,2
2023-06-01,63859,193,1,194,10,1,10
2023-06-01,133798,29,24,53,3,2,3
2023-06-01,10848,8,0,8,3,0,3
2023-06-01,25826,8,0,8,3,0,3
2023-06-01,27823,82,1,83,2,1,2
2023-06-01,33125,15,1,16,4,3,4
2023-06-01,395731,5,0,5,3,0,3
2023-06-01,63302,1,0,1,2,0,2
2023-06-01,17092,1,0,1,1,0,1
2023-06-01,396455,2,0,2,2,0,2
2023-06-01,396458,2,0,2,2,0,2
2023-06-01,29711,2,0,2,1,0,1
2023-06-01,23303,1,0,1,1,0,1
2023-06-01,55087,1,0,1,2,0,2
2023-06-01,399378,9,0,9,2,0,2
2023-06-01,21607,1,0,1,2,0,2
2023-06-01,395746,2,1,3,1,1,1
2023-06-01,36237,1,0,1,1,0,1
2023-06-01,394444,3,0,3,3,0,3
2023-06-01,397692,1,0,1,3,0,3
2023-06-01,396403,2,0,2,1,0,1
2023-06-01,207355,6,1,7,1,1,1
2023-06-01,18780,22,1,23,2,1,2
2023-06-01,394321,3,0,3,3,0,3
2023-06-01,40569,3,0,3,3,0,3
2023-06-01,19941,1,0,1,1,0,1
2023-06-01,46854,2,0,2,2,0,2
2023-06-01,27328,1,0,1,1,0,1
2023-06-01,11187,10,0,10,2,0,2
2023-06-01,36538,7,0,7,1,0,1
2023-06-01,13651,1,0,1,1,0,1
2023-06-01,15121,16,0,16,1,0,1
2023-06-01,11061,1,0,1,1,0,1
2023-06-01,26703,1,0,1,1,0,1
2023-06-01,36678,9,1,10,6,3,6
2023-06-01,23027,4,0,4,4,0,4
2023-06-01,32841,1,0,1,1,0,1
2023-06-01,12191,3,0,3,1,0,1
2023-06-01,40217,4,1,5,3,2,4
2023-06-01,400321,1,0,1,2,0,2
2023-06-01,395813,2,0,2,3,0,3
2023-06-01,40715,10,1,11,1,1,1
2023-06-01,21752,3,0,3,2,0,2
2023-06-01,31814,3,0,3,1,0,1
2023-06-01,397927,1,0,1,1,0,1
2023-06-01,63010,11,1,12,4,1,4
2023-06-01,11656,6,0,6,2,0,2
2023-06-01,20371,25,0,25,2,0,2
2023-06-01,11917,5,5,10,1,1,1
2023-06-01,29775,1,0,1,1,0,1
2023-06-01,393476,1,0,1,1,0,1
2023-06-01,36728,8,1,9,4,1,4
2023-06-01,18784,2,0,2,2,0,2
2023-06-01,398556,1,0,1,1,0,1
2023-06-01,398548,1,0,1,1,0,1
2023-06-01,4200010192,1,0,1,1,0,1
2023-06-01,394564,10,0,10,2,0,2
2023-06-01,15221,3,1,4,4,1,4
2023-06-01,399079,6,0,6,1,0,1
2023-06-01,393387,2,0,2,2,0,2
2023-06-01,26894,1,0,1,4,0,4
2023-06-01,13831,3,0,3,1,0,1
2023-06-01,19940,7,1,8,3,1,3
2023-06-01,64225,6,0,6,2,0,2
2023-06-01,395037,1,0,1,1,0,1
2023-06-01,393417,3,1,4,2,2,2
2023-06-01,399651,2,0,2,1,0,1
2023-06-01,393972,4,0,4,1,0,1
2023-06-01,17403,6,0,6,2,0,2
2023-06-01,3851,5,2,7,7,5,7
2023-06-01,395468,1,1,2,1,1,1
2023-06-01,17211,2,0,2,1,0,1
2023-06-01,8029,5,0,5,1,0,1
2023-06-01,7235,3,0,3,5,0,5
2023-06-01,10692,9,0,9,5,0,5
2023-06-01,26937,3,0,3,1,0,1
2023-06-01,20040,3,0,3,3,0,3
2023-06-01,40765,1,0,1,2,0,2
2023-06-01,139648,40,2,42,7,2,7
2023-06-01,400351,2,0,2,2,0,2
2023-06-01,397732,2,1,3,2,2,2
2023-06-01,399992,1,1,2,2,2,2
2023-06-01,399944,1,0,1,1,0,1
2023-06-01,397928,1,1,2,1,1,1
2023-06-01,955,5,21,26,3,17,17
2023-06-01,26930,2,3,5,2,4,4
2023-06-01,400061,2,0,2,1,0,1
2023-06-01,22364,27,2,29,4,2,4
2023-06-01,263783,76,1,77,4,1,4
2023-06-01,12127,23,0,23,1,0,1
2023-06-01,54665,15,3,18,5,4,5
2023-06-01,13565,2,0,2,1,0,1
2023-06-01,396488,1,0,1,2,0,2
2023-06-01,30336,52,0,52,5,0,5
2023-06-01,16955,7,0,7,1,0,1
2023-06-01,36184,25,0,25,11,0,11
2023-06-01,25801,1,0,1,3,0,3
2023-06-01,22624,2,0,2,3,0,3
2023-06-01,11188,49,0,49,6,0,6
2023-06-01,22956,1,0,1,1,0,1
2023-06-01,10322,5,0,5,4,0,4
2023-06-01,263236,13,4,17,1,1,1
2023-06-01,15072,1,0,1,1,0,1
2023-06-01,398176,1,0,1,1,0,1
2023-06-01,398112,1,0,1,1,0,1
2023-06-01,46566,2,0,2,3,0,3
2023-06-01,14675,1,0,1,1,0,1
2023-06-01,32022,8,0,8,3,0,3
2023-06-01,26981,12,0,12,2,0,2
2023-06-01,16532,10,2,12,9,5,9
2023-06-01,10865,3,0,3,2,0,2
2023-06-01,14957,1,0,1,1,0,1
2023-06-01,55264,4,0,4,6,0,6
2023-06-01,398536,5,0,5,1,0,1
2023-06-01,395800,1,0,1,1,0,1
2023-06-01,20419,7,0,7,3,0,3
2023-06-01,18897,12,2,14,7,4,7
2023-06-01,395786,1,0,1,1,0,1
2023-06-01,14453,47,4,51,11,5,11
2023-06-01,18674,4,0,4,4,0,4
2023-06-01,19784,1,0,1,1,0,1
2023-06-01,395238,2,0,2,1,0,1
2023-06-01,10421,4,0,4,4,0,4
2023-06-01,29790,1,0,1,1,0,1
2023-06-01,19902,6,0,6,1,0,1
2023-06-01,1635,2,0,2,3,0,3
2023-06-01,396226,11,0,11,3,0,3
2023-06-01,29900,2,0,2,4,0,4
2023-06-01,14001,7,0,7,2,0,2
2023-06-01,26224,5,0,5,2,0,2
2023-06-01,398453,2,0,2,5,0,5
2023-06-01,23535,7,1,8,3,3,3
2023-06-01,395177,5,0,5,3,0,3
2023-06-01,36556,5,1,6,1,1,1
2023-06-01,397293,5,0,5,1,0,1
2023-06-01,396173,3,0,3,1,0,1
2023-06-01,22771,1,0,1,3,0,3
2023-06-01,54021,2,0,2,2,0,2
2023-06-01,15220,1,0,1,3,0,3
2023-06-01,23516,2,0,2,2,0,2
2023-06-01,19909,1,0,1,1,0,1
2023-06-01,62794,1,0,1,1,0,1
2023-06-01,397291,1,0,1,2,0,2
2023-06-01,12235,3,0,3,3,0,3
2023-06-01,400475,12,1,13,2,2,2
2023-06-01,26328,30,1,31,6,1,6
2023-06-01,17144,4,3,7,3,1,3
2023-06-01,26093,1,0,1,2,0,2
2023-06-01,16919,2,0,2,2,0,2
2023-06-01,40889,4,0,4,2,0,2
2023-06-01,4898,5,0,5,5,0,5
2023-06-01,32699,1,0,1,3,0,3
2023-06-01,14720,7,0,7,1,0,1
2023-06-01,23525,2,0,2,3,0,3
2023-06-01,63307,1,0,1,1,0,1
2023-06-01,36117,1,0,1,1,0,1
2023-06-01,141518,6,1,7,3,1,3
2023-06-01,32522,16,1,17,7,3,7
2023-06-01,32344,2,0,2,1,0,1
2023-06-01,32083,38,0,38,4,0,4
2023-06-01,12028,3,0,3,6,0,6
2023-06-01,53962,1,0,1,1,0,1
2023-06-01,54664,3,0,3,4,0,4
2023-06-01,13916,6,3,9,3,1,3
2023-06-01,26211,41,3,44,8,4,8
2023-06-01,22843,35,3,38,3,2,3
2023-06-01,52129,26,2,28,4,3,5
2023-06-01,54466,2,0,2,2,0,2
2023-06-01,54408,1,0,1,3,0,3
2023-06-01,10823,12,1,13,3,1,3
2023-06-01,23115,4,0,4,1,0,1
2023-06-01,27608,3,0,3,1,0,1
2023-06-01,21771,1,0,1,2,0,2
2023-06-01,27383,4,0,4,1,0,1
2023-06-01,394599,2,0,2,3,0,3
2023-06-01,40154,12,0,12,5,0,5
2023-06-01,11120,1,0,1,2,0,2
2023-06-01,10843,7,1,8,3,1,3
2023-06-01,23204,4,0,4,2,0,2
2023-06-01,30472,1,0,1,1,0,1
2023-06-01,19074,2,0,2,1,0,1
2023-06-01,62688,5,1,6,2,2,2
2023-06-01,36646,42,6,48,1,1,1
2023-06-01,3853,3,1,4,4,5,5
2023-06-01,53467,1,0,1,3,0,3
2023-06-01,21627,13,0,13,1,0,1
2023-06-01,26669,6,0,6,2,0,2
2023-06-01,29959,1,0,1,2,0,2
2023-06-01,13819,8,1,9,3,1,3
2023-06-01,14805,15,4,19,3,1,3
2023-06-01,33186,4,2,6,2,2,2
2023-06-01,40816,6,2,8,3,2,3
2023-06-01,53512,1,1,2,2,1,2
2023-06-01,395632,1,1,2,3,2,3
2023-06-01,22918,1,2,3,3,2,3
2023-06-01,62542,1,0,1,2,0,2
2023-06-01,397404,1,0,1,2,0,2
2023-06-01,30121,1,0,1,5,0,5
2023-06-01,8121,0,0,0,2,2,3
2023-06-01,30142,1,0,1,4,0,4
2023-06-01,14384,1,0,1,2,0,2
2023-06-01,35,12,0,12,2,0,2
2023-06-01,5691,2,0,2,1,0,1
2023-06-01,13996,12,0,12,3,0,3
2023-06-01,27618,1,1,2,5,5,6
2023-06-01,16582,14,0,14,5,0,5
2023-06-01,11478,7,2,9,1,1,1
2023-06-01,31861,2,0,2,3,0,3
2023-06-01,32544,2,0,2,1,0,1
2023-06-01,21713,5,1,6,1,1,1
2023-06-01,32760,22,0,22,2,0,2
2023-06-01,30220,26,0,26,2,0,2
2023-06-01,32376,1,0,1,1,0,1
2023-06-01,55107,1,0,1,1,0,1
2023-06-01,26785,6,1,7,3,1,3
2023-06-01,11900,1,1,2,1,1,1
2023-06-01,397151,4,0,4,4,0,4
2023-06-01,20128,10,3,13,1,1,1
2023-06-01,54720,3,0,3,2,0,2
2023-06-01,33346,11,1,12,1,1,1
2023-06-01,62961,2,0,2,2,0,2
2023-06-01,395311,1,0,1,2,0,2
2023-06-01,398117,1,0,1,2,0,2
2023-06-01,395145,1,0,1,2,0,2
2023-06-01,396015,1,0,1,1,0,1
2023-06-01,54381,10,0,10,4,0,4
2023-06-01,36421,5,1,6,3,2,3
2023-06-01,394044,1,0,1,2,0,2
2023-06-01,11595,2,0,2,1,0,1
2023-06-01,21976,98,2,100,18,5,18
2023-06-01,88,10,2,12,4,2,4
2023-06-01,400065,4,0,4,2,0,2
2023-06-01,36463,5,0,5,2,0,2
2023-06-01,400120,1,0,1,1,0,1
2023-06-01,53298,2,0,2,1,0,1
2023-06-01,6954,8,0,8,3,0,3
2023-06-01,7961,3,0,3,2,0,2
2023-06-01,32940,2,1,3,5,2,5
2023-06-01,11850,1,0,1,1,0,1
2023-06-01,398113,35,1,36,3,1,3
2023-06-01,22632,3,0,3,2,0,2
2023-06-01,6082,15,1,16,5,3,5
2023-06-01,22247,3,0,3,1,0,1
2023-06-01,15175,5,0,5,3,0,3
2023-06-01,32429,1,0,1,1,0,1
2023-06-01,2559,58,0,58,7,0,7
2023-06-01,7352,11,1,12,2,2,2
2023-06-01,19162,1,0,1,2,0,2
2023-06-01,40891,2,0,2,1,0,1
2023-06-01,13797,3,0,3,2,0,2
2023-06-01,11951,6,0,6,3,0,3
2023-06-01,32043,2,0,2,1,0,1
2023-06-01,399425,1,0,1,1,0,1
2023-06-01,22639,119,3,122,7,4,7
2023-06-01,30071,1,0,1,2,0,2
2023-06-01,16436,2,1,3,1,1,1
2023-06-01,63133,2,0,2,2,0,2
2023-06-01,14703,6,0,6,1,0,1
2023-06-01,397360,3,0,3,1,0,1
2023-06-01,35955,5,0,5,3,0,3
2023-06-01,396905,7,1,8,4,4,4
2023-06-01,11402,29,0,29,2,0,2
2023-06-01,46860,9,0,9,2,0,2
2023-06-01,22753,9,2,11,3,2,3
2023-06-01,22360,5,3,8,2,2,2
2023-06-01,31976,2,0,2,2,0,2
2023-06-01,201286,1,0,1,1,0,1
2023-06-01,22046,2,0,2,2,0,2
2023-06-01,27490,1,0,1,1,0,1
2023-06-01,32268,4,0,4,5,0,5
2023-06-01,29707,1,0,1,1,0,1
2023-06-01,26922,1,0,1,2,0,2
2023-06-01,14467,4,0,4,3,0,3
2023-06-01,25898,5,0,5,3,0,3
2023-06-01,54236,2,0,2,2,0,2
2023-06-01,11218,1,0,1,3,0,3
2023-06-01,22475,2,0,2,1,0,1
2023-06-01,18524,1,0,1,1,0,1
2023-06-01,396424,1,0,1,1,0,1
2023-06-01,39985,1,0,1,2,0,2
2023-06-01,400057,1,0,1,1,0,1
2023-06-01,16940,6,0,6,1,0,1
2023-06-01,29942,1,0,1,2,0,2
2023-06-01,1401,2,0,2,2,0,2
2023-06-01,393291,1,0,1,1,0,1
2023-06-01,15033,2,0,2,3,0,3
2023-06-01,22509,2,0,2,2,0,2
2023-06-01,46192,4,0,4,3,0,3
2023-06-01,46413,6,0,6,2,0,2
2023-06-01,63298,9,0,9,5,0,5
2023-06-01,393838,1,0,1,3,0,3
2023-06-01,29985,2,0,2,3,0,3
2023-06-01,33630,1,0,1,2,0,2
2023-06-01,27590,1,0,1,1,0,1
2023-06-01,33710,1,0,1,1,0,1
2023-06-01,46381,2,0,2,3,0,3
2023-06-01,395533,2,0,2,3,0,3
2023-06-01,18504,1,0,1,3,0,3
2023-06-01,397718,1,0,1,1,0,1
2023-06-01,22655,1,0,1,1,0,1
2023-06-01,35863,2,0,2,1,0,1
2023-06-01,14942,1,0,1,1,0,1
2023-06-01,396258,11,0,11,2,0,2
2023-06-01,54666,2,0,2,3,0,3
2023-06-01,19659,1,0,1,1,0,1
2023-06-01,13755,1,0,1,2,0,2
2023-06-01,394750,1,0,1,1,0,1
2023-06-01,32566,1,0,1,1,0,1
2023-06-01,16897,1,0,1,2,0,2
2023-06-01,46379,3,0,3,4,0,4
2023-06-01,21985,2,0,2,4,0,4
2023-06-01,395884,1,0,1,2,0,2
2023-06-01,33202,1,0,1,2,0,2
2023-06-01,55156,3,0,3,3,0,3
2023-06-01,394293,1,0,1,1,0,1
2023-06-01,29921,2,3,5,4,2,4
2023-06-01,394171,1,0,1,1,0,1
2023-06-01,19119,1,0,1,1,0,1
2023-06-01,393413,1,0,1,2,0,2
2023-06-01,40823,1,0,1,3,0,3
2023-06-01,17320,3,0,3,2,0,2
2023-06-01,30158,2,0,2,1,0,1
2023-06-01,13765,4,1,5,10,4,11
2023-06-01,26085,1,2,3,2,2,2
2023-06-01,24494,1,0,1,1,0,1
2023-06-01,40405,7,1,8,3,1,3
2023-06-01,21719,13,1,14,7,1,7
2023-06-01,54023,2,0,2,1,0,1
2023-06-01,15128,176,10,186,9,6,9
2023-06-01,21873,26,0,26,2,0,2
2023-06-01,394513,1,0,1,1,0,1
2023-06-01,26803,8,1,9,3,1,3
2023-06-01,14676,5,0,5,1,0,1
2023-06-01,30154,2,1,3,2,1,2
2023-06-01,14532,4,1,5,1,1,1
2023-06-01,22320,5,0,5,3,0,3
2023-06-01,12247,9,0,9,2,0,2
2023-06-01,22743,9,0,9,2,0,2
2023-06-01,396417,5,3,8,7,3,8
2023-06-01,11922,6,1,7,5,1,5
2023-06-01,205809,8,9,17,6,6,6
2023-06-01,36063,1,0,1,4,2,4
2023-06-01,21852,12,0,12,3,0,3
2023-06-01,693,4,1,5,3,2,3
2023-06-01,13614,29,1,30,2,2,2
2023-06-01,396035,2,0,2,1,0,1
2023-06-01,16745,1,0,1,1,0,1
2023-06-01,30301,3,0,3,2,0,2
2023-06-01,62935,2,0,2,3,0,3
2023-06-01,397570,2,0,2,1,0,1
2023-06-01,394280,2,0,2,3,0,3
2023-06-01,62509,19,0,19,1,0,1
2023-06-01,394492,19,0,19,5,0,5
2023-06-01,398814,1,1,2,3,2,3
2023-06-01,46722,3,0,3,1,0,1
2023-06-01,13917,2,1,3,1,1,2
2023-06-01,23102,5,0,5,1,0,1
2023-06-01,20210,1,0,1,2,0,2
2023-06-01,33734,40,0,40,2,0,2
2023-06-01,36057,17,1,18,4,1,4
2023-06-01,53365,3,1,4,3,3,3
2023-06-01,396528,6,0,6,3,0,3
2023-06-01,399947,1,0,1,1,0,1
2023-06-01,19261,3,0,3,3,0,3
2023-06-01,46619,2,0,2,2,0,2
2023-06-01,14408,13,0,13,1,0,1
2023-06-01,63306,5,0,5,5,0,5
2023-06-01,30147,5,0,5,2,0,2
2023-06-01,64212,4,0,4,2,0,2
2023-06-01,47094,2,0,2,2,0,2
2023-06-01,19393,4,0,4,4,0,4
2023-06-01,394708,27,0,27,3,0,3
2023-06-01,3714,7,2,9,5,4,5
2023-06-01,10437,0,0,0,10,3,10
2023-06-01,40438,1,0,1,2,0,2
2023-06-01,5015,11,0,11,3,0,3
2023-06-01,46694,17,0,17,3,0,3
2023-06-01,19403,4,0,4,2,0,2
2023-06-01,32616,1,0,1,1,0,1
2023-06-01,14885,1,0,1,1,0,1
2023-06-01,399706,2,0,2,1,0,1
2023-06-01,30465,1,0,1,1,0,1
2023-06-01,46787,2,0,2,3,0,3
2023-06-01,30264,44,0,44,4,0,4
2023-06-01,23447,2,0,2,2,0,2
2023-06-01,14374,77,0,77,4,0,4
2023-06-01,53726,2,0,2,2,0,2
2023-06-01,10367,29,0,29,5,0,5
2023-06-01,53784,2,0,2,1,0,1
2023-06-01,17125,1,0,1,2,0,2
2023-06-01,29761,3,1,4,2,1,2
2023-06-01,393706,5,1,6,3,1,3
2023-06-01,62913,14,0,14,3,0,3
2023-06-01,21525,1,1,2,4,2,4
2023-06-01,17281,2,0,2,1,0,1
2023-06-01,14152,1,0,1,1,0,1
2023-06-01,26923,2,0,2,1,0,1
2023-06-01,22969,3,0,3,1,0,1
2023-06-01,22875,1,0,1,2,0,2
2023-06-01,4997,29,0,29,1,0,1
2023-06-01,4208,11,0,11,2,0,2
2023-06-01,33003,19,0,19,2,0,2
2023-06-01,11693,18,0,18,1,0,1
2023-06-01,22727,10,0,10,4,0,4
2023-06-01,17192,3,0,3,1,0,1
2023-06-01,36695,1,0,1,2,0,2
2023-06-01,395299,1,0,1,3,0,3
2023-06-01,394074,3,0,3,2,0,2
2023-06-01,10984,6,0,6,2,0,2
2023-06-01,398053,1,0,1,1,0,1
2023-06-01,400610,14,0,14,3,0,3
2023-06-01,23141,3,0,3,3,0,3
2023-06-01,62605,3,0,3,1,0,1
2023-06-01,393816,1,0,1,2,0,2
2023-06-01,22837,12,0,12,1,0,1
2023-06-01,400516,2,0,2,3,0,3
2023-06-01,394623,2,0,2,1,0,1
2023-06-01,64296,2,0,2,3,0,3
2023-06-01,400437,1,1,2,3,1,3
2023-06-01,396956,4,0,4,2,0,2
2023-06-01,395965,63,0,63,3,0,3
2023-06-01,65099,1,0,1,1,0,1
2023-06-01,400627,1,0,1,1,0,1
2023-06-01,33430,3,0,3,2,0,2
2023-06-01,27557,7,0,7,1,0,1
2023-06-01,14116,9,3,12,5,4,5
2023-06-01,19128,3,0,3,3,0,3
2023-06-01,27508,2,0,2,2,0,2
2023-06-01,11233,2,0,2,7,0,7
2023-06-01,19775,1,0,1,2,0,2
2023-06-01,14046,1,0,1,1,0,1
2023-06-01,19337,1,0,1,3,0,3
2023-06-01,7336,5,0,5,2,0,2
2023-06-01,46476,3,1,4,2,1,2
2023-06-01,30217,5,4,9,2,2,2
2023-06-01,46825,1,0,1,1,0,1
2023-06-01,23246,5,1,6,5,1,5
2023-06-01,3273,8,0,8,2,0,2
2023-06-01,270049,10,3,13,5,2,5
2023-06-01,271936,2,1,3,2,1,2
2023-06-01,271975,1,3,4,1,1,2
2023-06-01,14511,4,1,5,1,1,1
2023-06-01,29744,31,1,32,1,1,1
2023-06-01,29713,12,3,15,3,1,3
2023-06-01,46188,14,0,14,1,0,1
2023-06-01,19156,1,1,2,2,2,2
2023-06-01,201471,9,1,10,4,1,4
2023-06-01,40839,12,0,12,3,0,3
2023-06-01,27262,10,0,10,2,0,2
2023-06-01,11495,11,1,12,2,1,2
2023-06-01,14022,10,0,10,2,0,2
2023-06-01,4844,3,1,4,11,6,12
2023-06-01,55348,7,0,7,2,0,2
2023-06-01,14909,10,0,10,1,0,1
2023-06-01,46940,1,0,1,1,0,1
2023-06-01,26978,5,1,6,7,4,7
2023-06-01,29819,7,0,7,1,0,1
2023-06-01,33355,1,0,1,2,0,2
2023-06-01,31835,8,0,8,2,0,2
2023-06-01,22027,9,0,9,3,0,3
2023-06-01,10439,6,1,7,3,4,4
2023-06-01,25766,3,0,3,3,0,3
2023-06-01,25923,4,2,6,2,4,4
2023-06-01,14188,3,0,3,2,0,2
2023-06-01,36221,4,3,7,3,3,3
2023-06-01,14861,9,0,9,2,0,2
2023-06-01,36720,1,0,1,1,0,1
2023-06-01,25649,25,1,26,5,6,7
2023-06-01,25941,1,0,1,1,0,1
2023-06-01,18596,2,1,3,4,1,4
2023-06-01,32645,31,0,31,1,0,1
2023-06-01,12175,17,0,17,1,0,1
2023-06-01,17093,5,0,5,1,0,1
2023-06-01,22647,31,0,31,2,0,2
2023-06-01,23483,2,2,4,1,1,1
2023-06-01,62945,1,0,1,3,0,3
2023-06-01,22615,2,0,2,1,0,1
2023-06-01,32524,53,0,53,7,0,7
2023-06-01,16583,14,1,15,5,3,5
2023-06-01,54296,1,0,1,1,0,1
2023-06-01,400384,12,0,12,1,0,1
2023-06-01,15036,3,0,3,1,0,1
2023-06-01,397731,8,0,8,2,0,2
2023-06-01,63290,3,1,4,7,6,7
2023-06-01,33218,14,0,14,3,0,3
2023-06-01,208308,14,0,14,1,0,1
2023-06-01,7456,5,0,5,1,0,1
2023-06-01,26407,4,0,4,2,0,2
2023-06-01,30148,15,14,29,6,4,6
2023-06-01,397969,4,0,4,1,0,1
2023-06-01,968,1,1,2,6,5,8
2023-06-01,398435,1,0,1,1,0,1
2023-06-01,397995,1,0,1,1,0,1
2023-06-01,21639,3,0,3,5,0,5
2023-06-01,27228,1,1,2,2,1,2
2023-06-01,395900,1,0,1,1,0,1
2023-06-01,14889,1,0,1,1,0,1
2023-06-01,29829,1,0,1,3,0,3
2023-06-01,33582,6,6,12,2,1,2
2023-06-01,63328,3,0,3,4,0,4
2023-06-01,16741,1,0,1,1,0,1
2023-06-01,36675,2,0,2,2,0,2
2023-06-01,23522,8,0,8,1,0,1
2023-06-01,12223,4,0,4,1,0,1
2023-06-01,19578,3,1,4,3,3,3
2023-06-01,36487,18,0,18,2,0,2
2023-06-01,32408,7,0,7,3,0,3
2023-06-01,26788,4,2,6,1,1,1
2023-06-01,25606,3,0,3,1,0,1
2023-06-01,29843,2,0,2,1,0,1
2023-06-01,36097,7,1,8,2,1,3
2023-06-01,26480,3,1,4,1,1,1
2023-06-01,7024,1,0,1,2,0,2
2023-06-01,25712,9,0,9,4,0,4
2023-06-01,13828,9,0,9,2,0,2
2023-06-01,393789,14,0,14,1,0,1
2023-06-01,6528,35,10,45,2,1,2
2023-06-01,44976,4,0,4,3,0,3
2023-06-01,26359,1,0,1,1,0,1
2023-06-01,11381,1,0,1,1,0,1
2023-06-01,40819,11,1,12,3,1,3
2023-06-01,32806,24,0,24,5,0,5
2023-06-01,53231,33,12,45,7,2,7
2023-06-01,25,12,1,13,1,1,1
2023-06-01,11084,16,1,17,5,3,5
2023-06-01,35998,6,0,6,3,0,3
2023-06-01,1082,2,0,2,2,0,2
2023-06-01,400595,2,0,2,2,0,2
2023-06-01,5758,16,0,16,3,0,3
2023-06-01,40473,12,1,13,3,1,3
2023-06-01,36731,11,2,13,5,2,5
2023-06-01,14634,10,0,10,2,0,2
2023-06-01,63178,21,0,21,1,0,1
2023-06-01,26374,1,0,1,1,0,1
2023-06-01,33742,1,0,1,5,0,5
2023-06-01,53682,1,0,1,2,0,2
2023-06-01,25922,2,0,2,2,0,2
2023-06-01,20009,5,0,5,2,0,2
2023-06-01,36687,10,1,11,3,2,3
2023-06-01,398719,24,1,25,5,2,5
2023-06-01,33359,12,0,12,7,0,7
2023-06-01,16385,2,0,2,1,0,1
2023-06-01,29948,1,1,2,2,2,2
2023-06-01,3456,10,9,19,2,4,5
2023-06-01,19717,4,0,4,2,0,2
2023-06-01,39949,1,0,1,2,0,2
2023-06-01,32397,3,0,3,2,0,2
2023-06-01,14252,2,0,2,2,0,2
2023-06-01,11964,2,0,2,2,0,2
2023-06-01,398428,1,0,1,1,0,1
2023-06-01,23297,1,0,1,3,0,3
2023-06-01,17032,4,0,4,2,0,2
2023-06-01,19914,1,0,1,1,0,1
2023-06-01,393774,1,0,1,2,0,2
2023-06-01,20273,26,0,26,1,0,1
2023-06-01,54374,12,0,12,3,0,3
2023-06-01,19628,35,0,35,3,0,3
2023-06-01,62825,22,0,22,2,0,2
2023-06-01,65778,1,0,1,1,0,1
2023-06-01,397475,11,0,11,1,0,1
2023-06-01,63436,6,1,7,2,2,3
2023-06-01,46892,59,0,59,2,0,2
2023-06-01,396461,14,0,14,2,0,2
2023-06-01,397305,14,0,14,3,0,3
2023-06-01,26397,3,1,4,2,1,2
2023-06-01,22408,8,0,8,4,0,4
2023-06-01,27221,11,0,11,2,0,2
2023-06-01,6250,44,1,45,5,1,5
2023-06-01,22504,11,0,11,2,0,2
2023-06-01,395072,3,0,3,1,0,1
2023-06-01,395594,2,0,2,1,0,1
2023-06-01,21561,1,0,1,2,0,2
2023-06-01,54523,7,0,7,2,0,2
2023-06-01,33356,1,0,1,1,0,1
2023-06-01,32086,3,0,3,4,0,4
2023-06-01,62990,1,0,1,2,0,2
2023-06-01,31778,1,0,1,2,0,2
2023-06-01,13312,1,0,1,2,0,2
2023-06-01,10538,5,1,6,3,1,3
2023-06-01,40760,3,0,3,1,0,1
2023-06-01,26298,6,0,6,3,0,3
2023-06-01,36312,1,0,1,2,0,2
2023-06-01,22667,16,1,17,5,1,5
2023-06-01,32228,14,0,14,2,0,2
2023-06-01,22293,2,0,2,2,0,2
2023-06-01,398380,1,0,1,1,0,1
2023-06-01,11211,2,0,2,3,0,3
2023-06-01,53629,3,0,3,3,0,3
2023-06-01,26305,8,1,9,3,2,3
2023-06-01,16903,2,0,2,3,0,3
2023-06-01,23302,3,0,3,4,0,4
2023-06-01,36522,177,11,188,1,1,1
2023-06-01,394453,17,0,17,7,0,7
2023-06-01,27650,19,1,20,3,1,3
2023-06-01,18645,1,0,1,3,0,3
2023-06-01,35943,2,0,2,2,0,2
2023-06-01,17359,20,0,20,4,0,4
2023-06-01,54417,17,0,17,3,0,3
2023-06-01,31767,1,0,1,1,0,1
2023-06-01,26036,2,0,2,4,0,4
2023-06-01,40492,1,0,1,2,0,2
2023-06-01,63405,3,0,3,6,0,6
2023-06-01,36660,1,0,1,1,0,1
2023-06-01,30550,2,0,2,2,0,2
2023-06-01,32831,3,0,3,3,0,3
2023-06-01,40892,3,0,3,3,0,3
2023-06-01,29989,1,0,1,1,0,1
2023-06-01,25878,5,0,5,8,0,8
2023-06-01,29766,9,0,9,2,0,2
2023-06-01,28959,5,0,5,6,0,6
2023-06-01,30172,4,0,4,4,0,4
2023-06-01,30384,1,0,1,3,0,3
2023-06-01,62511,3,0,3,1,0,1
2023-06-01,11945,1,0,1,3,0,3
2023-06-01,22811,3,0,3,1,0,1
2023-06-01,4200010036,1,0,1,1,0,1
2023-06-01,55277,2,0,2,2,0,2
2023-06-01,14321,1,0,1,2,0,2
2023-06-01,54778,8,0,8,9,0,9
2023-06-01,19831,1,0,1,2,0,2
2023-06-01,393980,1,0,1,2,0,2
2023-06-01,53262,2,0,2,3,0,3
2023-06-01,32153,2,0,2,1,0,1
2023-06-01,22153,14,0,14,1,0,1
2023-06-01,17053,1,0,1,3,0,3
2023-06-01,11710,2,0,2,3,0,3
2023-06-01,22167,1,0,1,1,0,1
2023-06-01,33581,1,0,1,1,0,1
2023-06-01,19216,4,0,4,4,0,4
2023-06-01,395994,1,0,1,3,0,3
2023-06-01,36207,16,0,16,4,0,4
2023-06-01,4200010203,1,0,1,1,0,1
2023-06-01,1410,18,0,18,4,0,4
2023-06-01,40804,2,0,2,2,0,2
2023-06-01,32754,1,0,1,2,0,2
2023-06-01,46732,2,0,2,1,0,1
2023-06-01,32812,1,0,1,1,0,1
2023-06-01,30519,1,0,1,1,0,1
2023-06-01,394196,2,0,2,2,0,2
2023-06-01,18980,3,0,3,4,0,4
2023-06-01,14487,6,1,7,4,1,4
2023-06-01,62968,2,0,2,4,0,4
2023-06-01,268,1,0,1,1,0,1
2023-06-01,395391,5,0,5,2,0,2
2023-06-01,36819,5,0,5,8,0,8
2023-06-01,398444,2,0,2,3,0,3
2023-06-01,27188,1,0,1,1,0,1
2023-06-01,23409,3,0,3,3,0,3
2023-06-01,395634,2,0,2,2,0,2
2023-06-01,13596,1,0,1,1,0,1
2023-06-01,62733,2,0,2,3,0,3
2023-06-01,25884,2,0,2,2,0,2
2023-06-01,46726,1,0,1,1,0,1
2023-06-01,22944,4,0,4,3,0,3
2023-06-01,19901,39,0,39,1,0,1
2023-06-01,30673,10,0,10,3,0,3
2023-06-01,393672,0,0,0,3,0,3
2023-06-01,398828,1,0,1,3,0,3
2023-06-01,25748,2,0,2,2,0,2
2023-06-01,397346,2,0,2,2,0,2
2023-06-01,22842,2,0,2,1,0,1
2023-06-01,14617,1,0,1,2,0,2
2023-06-01,53843,1,0,1,3,0,3
2023-06-01,46311,1,0,1,1,0,1
2023-06-01,397861,1,0,1,3,0,3
2023-06-01,27277,6,0,6,4,0,4
2023-06-01,63400,3,0,3,1,0,1
2023-06-01,14671,26,0,26,3,0,3
2023-06-01,46175,4,0,4,2,0,2
2023-06-01,13371,5,1,6,1,1,1
2023-06-01,397625,2,0,2,1,0,1
2023-06-01,13983,1,0,1,1,0,1
2023-06-01,30272,1,0,1,1,0,1
2023-06-01,397933,3,2,5,1,1,1
2023-06-01,397060,1,0,1,3,0,3
2023-06-01,397898,1,0,1,1,0,1
2023-06-01,39971,2,1,3,2,1,2
2023-06-01,46293,7,0,7,2,0,2
2023-06-01,395038,1,0,1,1,0,1
2023-06-01,395182,1,1,2,2,1,2
2023-06-01,40907,2,2,4,3,1,3
2023-06-01,15047,5,0,5,2,0,2
2023-06-01,39950,1,0,1,1,0,1
2023-06-01,395188,2,0,2,3,0,3
2023-06-01,394781,1,1,2,2,2,2
2023-06-01,395344,9,0,9,2,0,2
2023-06-01,45217,1,0,1,2,0,2
2023-06-01,23507,1,0,1,3,0,3
2023-06-01,210250,2,0,2,7,0,7
2023-06-01,46440,1,1,2,3,1,3
2023-06-01,19554,10,1,11,5,1,5
2023-06-01,17252,11,1,12,1,1,1
2023-06-01,395557,1,0,1,3,0,3
2023-06-01,394963,1,0,1,3,0,3
2023-06-01,14974,4,0,4,3,0,3
2023-06-01,396895,1,0,1,1,0,1
2023-06-01,15255,1,0,1,2,0,2
2023-06-01,27564,2,1,3,2,3,4
2023-06-01,46815,1,0,1,2,0,2
2023-06-01,14189,1,0,1,1,0,1
2023-06-01,46242,1,0,1,1,0,1
2023-06-01,39958,1,0,1,1,0,1
2023-06-01,14939,2,2,4,5,4,5
2023-06-01,397000,3,0,3,2,0,2
2023-06-01,22489,85,6,91,9,4,9
2023-06-01,14993,2,0,2,2,0,2
2023-06-01,64266,8,0,8,4,0,4
2023-06-01,396377,1,0,1,1,0,1
2023-06-01,63240,3,0,3,1,0,1
2023-06-01,399126,1,0,1,1,0,1
2023-06-01,30294,1,0,1,1,0,1
2023-06-01,40880,1,0,1,1,0,1
2023-06-01,11481,15,1,16,3,1,3
2023-06-01,14314,3,0,3,1,0,1
2023-06-01,11676,44,0,44,4,0,4
2023-06-01,22353,7,0,7,2,0,2
2023-06-01,12048,1,0,1,2,0,2
2023-06-01,15302,1,0,1,1,0,1
2023-06-01,36367,4,0,4,3,0,3
2023-06-01,396205,2,0,2,3,0,3
2023-06-01,13592,1,0,1,1,0,1
2023-06-01,21755,3,0,3,2,0,2
2023-06-01,21889,70,15,85,1,1,1
2023-06-01,33749,47,0,47,4,0,4
2023-06-01,33024,2,3,5,2,1,2
2023-06-01,400000,1,0,1,2,0,2
2023-06-01,20356,10,0,10,2,0,2
2023-06-01,32415,35,0,35,8,0,8
2023-06-01,26742,2,0,2,2,0,2
2023-06-01,11606,4,0,4,3,0,3
2023-06-01,394541,8,0,8,3,0,3
2023-06-01,33596,4,0,4,3,0,3
2023-06-01,611,45,0,45,4,0,4
2023-06-01,5638,1,0,1,2,0,2
2023-06-01,54818,2,0,2,2,0,2
2023-06-01,26161,2,0,2,2,0,2
2023-06-01,46331,1,0,1,1,0,1
2023-06-01,19526,3,0,3,3,0,3
2023-06-01,32880,32,4,36,9,3,9
2023-06-01,22598,32,0,32,8,0,8
2023-06-01,20058,14,0,14,5,0,5
2023-06-01,26864,24,0,24,2,0,2
2023-06-01,46309,8,1,9,8,2,8
2023-06-01,13537,1,0,1,1,0,1
2023-06-01,31849,5,1,6,1,1,1
2023-06-01,20340,14,0,14,18,0,18
2023-06-01,40336,2,0,2,2,0,2
2023-06-01,55269,1,0,1,1,0,1
2023-06-01,398233,1,0,1,2,0,2
2023-06-01,25605,2,0,2,3,2,3
2023-06-01,30607,0,0,0,3,3,3
2023-06-01,45459,22,3,25,1,1,1
2023-06-01,398212,1,0,1,1,0,1
2023-06-01,40579,2,1,3,2,2,2
2023-06-01,14559,2,0,2,1,0,1
2023-06-01,15960,19,2,21,12,9,14
2023-06-01,398636,6,0,6,2,0,2
2023-06-01,16815,87,0,87,8,0,8
2023-06-01,36316,3,1,4,2,1,2
2023-06-01,27172,2,0,2,1,0,1
2023-06-01,10765,9,0,9,1,0,1
2023-06-01,397127,1,1,2,2,1,2
2023-06-01,396024,1,1,2,2,2,2
2023-06-01,396866,1,0,1,1,0,1
2023-06-01,397531,1,0,1,2,0,2
2023-06-01,19712,1,1,2,2,2,2
2023-06-01,397900,2,0,2,2,0,2
2023-06-01,3365,1,0,1,1,0,1
2023-06-01,33011,8,0,8,4,0,4
2023-06-01,396145,3,0,3,3,0,3
2023-06-01,15123,7,0,7,2,0,2
2023-06-01,395857,3,0,3,1,0,1
2023-06-01,26984,2,0,2,4,0,4
2023-06-01,20194,9,0,9,2,0,2
2023-06-01,395844,1,0,1,2,0,2
2023-06-01,394660,3,0,3,1,0,1
2023-06-01,62788,1,0,1,1,0,1
2023-06-01,64233,8,1,9,3,1,3
2023-06-01,54455,12,2,14,3,3,3
2023-06-01,36591,2,0,2,3,0,3
2023-06-01,46092,1,0,1,1,0,1
2023-06-01,394840,5,1,6,4,1,4
2023-06-01,399494,6,1,7,3,2,3
2023-06-01,16715,5,0,5,3,0,3
2023-06-01,33333,4,4,8,6,5,6
2023-06-01,17048,19,5,24,5,4,5
2023-06-01,14740,2,0,2,3,0,3
2023-06-01,396103,1,0,1,1,0,1
2023-06-01,46996,2,0,2,2,0,2
2023-06-01,46882,3,0,3,1,0,1
2023-06-01,8038,16,9,25,15,10,18
2023-06-01,31864,1,0,1,2,0,2
2023-06-01,54119,98,0,98,37,0,37
2023-06-01,397309,1,0,1,3,0,3
2023-06-01,18820,3,0,3,4,0,4
2023-06-01,397068,14,9,23,1,1,1
2023-06-01,62715,18,0,18,16,0,16
2023-06-01,22051,74,0,74,1,0,1
2023-06-01,26155,1,0,1,1,0,1
2023-06-01,13347,17,1,18,3,2,3
2023-06-01,21803,65,0,65,5,0,5
2023-06-01,35894,30,1,31,5,1,5
2023-06-01,25977,44,0,44,4,0,4
2023-06-01,4557,7,5,12,20,11,20
2023-06-01,22339,1,0,1,1,0,1
2023-06-01,40751,1,0,1,1,0,1
2023-06-01,394102,7,1,8,5,4,6
2023-06-01,395725,2,0,2,3,0,3
2023-06-01,5,2,0,2,6,0,6
2023-06-01,26120,10,0,10,7,0,7
2023-06-01,399482,1,0,1,2,0,2
2023-06-01,396040,3,1,4,5,2,5
2023-06-01,396510,1,0,1,1,0,1
2023-06-01,15261,4,0,4,2,0,2
2023-06-01,13555,5,0,5,3,0,3
2023-06-01,395302,1,0,1,1,0,1
2023-06-01,12130,31,0,31,5,0,5
2023-06-01,30444,3,0,3,3,0,3
2023-06-01,13498,2,0,2,2,0,2
2023-06-01,40728,3,0,3,1,0,1
2023-06-01,32634,3,0,3,3,0,3
2023-06-01,20308,5,0,5,2,0,2
2023-06-01,13787,17,0,17,2,0,2
2023-06-01,1077,2,0,2,2,0,2
2023-06-01,20423,1,0,1,1,0,1
2023-06-01,13871,20,0,20,4,0,4
2023-06-01,4284,3,0,3,1,0,1
2023-06-01,4283,3,0,3,1,0,1
2023-06-01,30089,1,0,1,1,0,1
2023-06-01,53662,2,0,2,3,0,3
2023-06-01,395036,1,0,1,3,0,3
2023-06-01,25628,1,0,1,3,0,3
2023-06-01,22350,1,0,1,1,0,1
2023-06-01,26396,10,0,10,1,0,1
2023-06-01,26013,1,0,1,1,0,1
2023-06-01,13363,2,0,2,4,0,4
2023-06-01,53411,1,0,1,1,0,1
2023-06-01,30424,2,0,2,3,0,3
2023-06-01,46776,3,0,3,2,0,2
2023-06-01,53617,2,0,2,2,0,2
2023-06-01,26078,1,0,1,3,0,3
2023-06-01,35852,13,0,13,2,0,2
2023-06-01,19528,23,5,28,7,2,7
2023-06-01,46454,11,0,11,7,0,7
2023-06-01,21904,30,0,30,2,0,2
2023-06-01,1640,18,0,18,2,0,2
2023-06-01,26588,5,0,5,2,0,2
2023-06-01,36473,14,3,17,5,2,5
2023-06-01,46473,5,0,5,2,0,2
2023-06-01,21876,2,0,2,2,0,2
2023-06-01,46749,1,0,1,7,2,7
2023-06-01,29957,1,0,1,1,0,1
2023-06-01,46685,4,1,5,1,1,1
2023-06-01,33208,2,0,2,3,0,3
2023-06-01,54003,2,0,2,2,0,2
2023-06-01,17266,21,0,21,1,0,1
2023-06-01,393571,18,0,18,2,0,2
2023-06-01,33705,2,0,2,2,0,2
2023-06-01,54137,1,0,1,3,0,3
2023-06-01,2726,2,0,2,2,0,2
2023-06-01,40863,1,0,1,1,0,1
2023-06-01,11013,6,1,7,5,1,5
2023-06-01,46253,4,8,12,3,2,3
2023-06-01,22781,24,0,24,4,0,4
2023-06-01,21808,10,1,11,6,2,6
2023-06-01,14488,11,1,12,2,1,2
2023-06-01,399435,4,0,4,1,0,1
2023-06-01,55001,5,0,5,2,0,2
2023-06-01,399754,1,0,1,2,0,2
2023-06-01,399612,1,2,3,1,1,2
2023-06-01,11522,3,0,3,9,0,9
2023-06-01,397888,1,0,1,3,0,3
2023-06-01,399445,2,0,2,1,0,1
2023-06-01,398162,1,0,1,2,0,2
2023-06-01,780,1,0,1,1,0,1
2023-06-01,32986,2,0,2,1,0,1
2023-06-01,29974,118,37,155,7,4,7
2023-06-01,29940,1,0,1,1,0,1
2023-06-01,15049,1,0,1,2,0,2
2023-06-01,14964,4,0,4,3,0,3
2023-06-01,54300,10,0,10,2,0,2
2023-06-01,207563,1,2,3,2,2,2
2023-06-01,20388,2,0,2,3,0,3
2023-06-01,395428,1,0,1,3,0,3
2023-06-01,8134,3,1,4,3,2,3
2023-06-01,14500,11,0,11,6,0,6
2023-06-01,44239,16,32,48,7,6,7
2023-06-01,14651,5,0,5,1,0,1
2023-06-01,14701,37,0,37,6,0,6
2023-06-01,8137,6,0,6,2,0,2
2023-06-01,21663,1,0,1,1,0,1
2023-06-01,20093,6,1,7,1,1,1
2023-06-01,32003,16,0,16,4,0,4
2023-06-01,36832,1,0,1,1,0,1
2023-06-01,17235,1,0,1,1,0,1
2023-06-01,40615,6,0,6,2,0,2
2023-06-01,13324,1,0,1,2,0,2
2023-06-01,30108,3,0,3,3,0,3
2023-06-01,54855,6,0,6,6,0,6
2023-06-01,7287,316,164,480,1,1,1
2023-06-01,54845,3,0,3,3,0,3
2023-06-01,6302,1,0,1,1,0,1
2023-06-01,394505,1,0,1,1,0,1
2023-06-01,40772,17,0,17,3,0,3
2023-06-01,400455,1,0,1,2,0,2
2023-06-01,393695,1,0,1,1,0,1
2023-06-01,398246,1,0,1,1,0,1
2023-06-01,40754,1,0,1,1,0,1
2023-06-01,11777,4,0,4,3,0,3
2023-06-01,3369,7,2,9,1,1,1
2023-06-01,1326,5,0,5,1,0,1
2023-06-01,1339,12,2,14,5,3,5
2023-06-01,1383,1,0,1,2,0,2
2023-06-01,13671,2,0,2,2,0,2
2023-06-01,1323,1,0,1,1,0,1
2023-06-01,1325,4,0,4,1,0,1
2023-06-01,26849,1,0,1,3,0,3
2023-06-01,33527,2,0,2,2,0,2
2023-06-01,54697,6,0,6,2,0,2
2023-06-01,54774,1,0,1,2,0,2
2023-06-01,17123,6,0,6,2,0,2
2023-06-01,22438,10,1,11,4,3,6
2023-06-01,15178,3,0,3,2,0,2
2023-06-01,53291,1,0,1,1,0,1
2023-06-01,53309,3,0,3,2,0,2
2023-06-01,53306,7,0,7,2,0,2
2023-06-01,19210,5,3,8,3,2,3
2023-06-01,47870,7,11,18,5,4,5
2023-06-01,22765,23,0,23,4,0,4
2023-06-01,26722,3,4,7,3,2,4
2023-06-01,13654,33,0,33,2,0,2
2023-06-01,11601,2,0,2,1,0,1
2023-06-01,46986,2,0,2,1,0,1
2023-06-01,395582,32,0,32,1,0,1
2023-06-01,22878,5,0,5,1,0,1
2023-06-01,398289,1,0,1,3,0,3
2023-06-01,394912,2,0,2,2,0,2
2023-06-01,14038,35,2,37,3,2,3
2023-06-01,34440,1,1,2,5,2,5
2023-06-01,398791,2,3,5,1,1,1
2023-06-01,32710,12,0,12,3,0,3
2023-06-01,13853,7,0,7,1,0,1
2023-06-01,10880,6,6,12,2,2,2
2023-06-01,14780,3,1,4,1,1,1
2023-06-01,47,16,0,16,4,0,4
2023-06-01,14663,7,0,7,1,0,1
2023-06-01,40791,1,0,1,1,0,1
2023-06-01,13933,3,0,3,2,0,2
2023-06-01,26429,1,0,1,1,0,1
2023-06-01,33636,3,0,3,2,0,2
2023-06-01,54392,5,0,5,2,0,2
2023-06-01,6385,5,0,5,1,0,1
2023-06-01,6198,3,0,3,1,0,1
2023-06-01,18662,4,0,4,3,0,3
2023-06-01,46153,2,0,2,3,0,3
2023-06-01,23081,1,0,1,3,0,3
2023-06-01,46094,1,0,1,3,0,3
2023-06-01,46873,11,1,12,2,3,3
2023-06-01,394908,5,0,5,2,0,2
2023-06-01,14506,14,3,17,2,1,2
2023-06-01,7160,102,14,116,22,8,24
2023-06-01,4192,10,0,10,2,0,2
2023-06-01,792,25,6,31,4,3,4
2023-06-01,12154,17,0,17,4,0,4
2023-06-01,29973,4,0,4,1,0,1
2023-06-01,16934,2,0,2,3,0,3
2023-06-01,397729,1,0,1,2,0,2
2023-06-01,47044,1,0,1,1,0,1
2023-06-01,21707,1,0,1,1,0,1
2023-06-01,27187,1,0,1,2,0,2
2023-06-01,394921,1,0,1,2,0,2
2023-06-01,46902,4,0,4,2,0,2
2023-06-01,25830,2,0,2,1,0,1
2023-06-01,19107,35,0,35,2,0,2
2023-06-01,13993,7,1,8,2,1,2
2023-06-01,19749,7,0,7,3,0,3
2023-06-01,393635,4,1,5,1,1,1
2023-06-01,32625,4,1,5,10,4,10
2023-06-01,31759,2,0,2,1,0,1
2023-06-01,54283,1,0,1,1,0,1
2023-06-01,36528,2,0,2,1,0,1
2023-06-01,6473,12,3,15,4,2,4
2023-06-01,400540,1,0,1,1,0,1
2023-06-01,25961,17,1,18,4,2,4
2023-06-01,10488,3,0,3,3,0,3
2023-06-01,26091,5,0,5,2,0,2
2023-06-01,64228,3,0,3,3,0,3
2023-06-01,398025,5,0,5,3,0,3
2023-06-01,22883,9,0,9,5,0,5
2023-06-01,54304,5,0,5,3,0,3
2023-06-01,12011,1,0,1,1,0,1
2023-06-01,26241,12,1,13,4,2,5
2023-06-01,20436,2,0,2,2,0,2
2023-06-01,15055,1,0,1,1,0,1
2023-06-01,22915,1,1,2,3,3,3
2023-06-01,40606,2,1,3,2,2,2
2023-06-01,46742,2,1,3,6,3,6
2023-06-01,18516,3,0,3,5,0,5
2023-06-01,26793,24,20,44,7,11,11
2023-06-01,53423,15,0,15,6,0,6
2023-06-01,30663,1,0,1,2,0,2
2023-06-01,47030,5,0,5,2,0,2
2023-06-01,396181,5,0,5,3,0,3
2023-06-01,131926,4,0,4,3,0,3
2023-06-01,396485,2,0,2,3,0,3
2023-06-01,10271,16,1,17,4,1,4
2023-06-01,26792,1,4,5,5,5,6
2023-06-01,18950,1,0,1,1,0,1
2023-06-01,63121,3,0,3,3,0,3
2023-06-01,394790,4,0,4,2,0,2
2023-06-01,55035,2,0,2,1,0,1
2023-06-01,54326,11,0,11,1,0,1
2023-06-01,27437,4,0,4,4,0,4
2023-06-01,18972,5,0,5,2,0,2
2023-06-01,4986,8,1,9,2,2,2
2023-06-01,20394,7,2,9,9,6,10
2023-06-01,36325,1,0,1,1,0,1
2023-06-01,12211,11,0,11,8,0,8
2023-06-01,393967,2,0,2,2,0,2
2023-06-01,63450,6,0,6,2,0,2
2023-06-01,11742,3,0,3,7,0,7
2023-06-01,47087,2,0,2,1,0,1
2023-06-01,30028,11,0,11,3,0,3
2023-06-01,394315,1,0,1,3,0,3
2023-06-01,54375,3,0,3,1,0,1
2023-06-01,10634,3,0,3,2,0,2
2023-06-01,54706,33,0,33,3,0,3
2023-06-01,393813,2,0,2,5,0,5
2023-06-01,63179,11,0,11,1,0,1
2023-06-01,7257,2,0,2,3,0,3
2023-06-01,47042,1,0,1,1,0,1
2023-06-01,1929,3,0,3,1,0,1
2023-06-01,46872,9,0,9,5,0,5
2023-06-01,10996,4,1,5,3,2,3
2023-06-01,32101,19,0,19,2,0,2
2023-06-01,46081,1,0,1,2,0,2
2023-06-01,15285,2,0,2,1,0,1
2023-06-01,23420,5,1,6,1,1,1
2023-06-01,40475,6,1,7,1,1,1
2023-06-01,11524,4,0,4,2,0,2
2023-06-01,10809,1,0,1,1,0,1
2023-06-01,46592,9,0,9,1,0,1
2023-06-01,23497,32,0,32,3,0,3
2023-06-01,396536,2,0,2,1,0,1
2023-06-01,19600,2,0,2,2,0,2
2023-06-01,31841,8,1,9,3,1,3
2023-06-01,13924,16,0,16,1,0,1
2023-06-01,395880,0,1,1,8,3,8
2023-06-01,28110,25,1,26,4,1,4
2023-06-01,26555,1,0,1,1,0,1
2023-06-01,40651,1,0,1,1,0,1
2023-06-01,24245,1,1,2,6,1,6
2023-06-01,11854,2,1,3,9,3,9
2023-06-01,46852,3,0,3,3,0,3
2023-06-01,394647,1,0,1,1,0,1
2023-06-01,23053,1,0,1,3,0,3
2023-06-01,26897,6,0,6,3,0,3
2023-06-01,35953,6,0,6,3,0,3
2023-06-01,46108,2,0,2,2,0,2
2023-06-01,24118,2,0,2,1,0,1
2023-06-01,23918,10,1,11,8,2,8
2023-06-01,27181,1,0,1,1,0,1
2023-06-01,1440,1,0,1,2,0,2
2023-06-01,46433,61,0,61,1,0,1
2023-06-01,40389,1,1,2,1,1,1
2023-06-01,55017,40,1,41,3,1,3
2023-06-01,11798,3,2,5,3,2,3
2023-06-01,19306,5,0,5,1,0,1
2023-06-01,27478,1,0,1,1,0,1
2023-06-01,397562,4,0,4,2,0,2
2023-06-01,36605,1,0,1,1,0,1
2023-06-01,6423,10,3,13,5,1,5
2023-06-01,30478,1,0,1,1,0,1
2023-06-01,28920,7,0,7,1,0,1
2023-06-01,14383,24,0,24,2,0,2
2023-06-01,30295,14,2,16,5,1,5
2023-06-01,27365,30,0,30,2,0,2
2023-06-01,55444,2,0,2,2,0,2
2023-06-01,20433,1,0,1,2,0,2
2023-06-01,1358,7,0,7,2,0,2
2023-06-01,18462,16,0,16,1,0,1
2023-06-01,63003,1,1,2,2,1,3
2023-06-01,33353,78,47,125,39,20,44
2023-06-01,19836,10,9,19,2,2,2
2023-06-01,396559,5,15,20,2,2,2
2023-06-01,396579,8,4,12,2,2,2
2023-06-01,397198,4,8,12,2,2,2
2023-06-01,397206,15,0,15,2,0,2
2023-06-01,36625,16,0,16,2,0,2
2023-06-01,396540,10,9,19,2,2,2
2023-06-01,396605,9,8,17,2,2,2
2023-06-01,396568,10,1,11,2,2,2
2023-06-01,397197,16,16,32,2,2,2
2023-06-01,396555,15,4,19,2,2,2
2023-06-01,20362,9,0,9,2,0,2
2023-06-01,396556,4,0,4,2,0,2
2023-06-01,396544,15,15,30,2,2,2
2023-06-01,396569,15,0,15,2,0,2
2023-06-01,397207,13,14,27,2,2,2
2023-06-01,396610,16,15,31,2,2,2
2023-06-01,10515,15,15,30,2,2,2
2023-06-01,20431,16,15,31,2,2,2
2023-06-01,396546,5,1,6,2,2,2
2023-06-01,396549,15,6,21,2,2,2
2023-06-01,396563,17,0,17,2,0,2
2023-06-01,19917,5,0,5,3,0,3
2023-06-01,398028,1,0,1,3,0,3
2023-06-01,31780,1,0,1,1,0,1
2023-06-01,21879,3,0,3,1,0,1
2023-06-01,53693,1,0,1,2,0,2
2023-06-01,394262,1,0,1,3,0,3
2023-06-01,10249,3,0,3,1,0,1
2023-06-01,47018,2,0,2,6,0,6
2023-06-01,19927,11,0,11,2,0,2
2023-06-01,19197,17,0,17,16,0,16
2023-06-01,40174,11,0,11,2,0,2
2023-06-01,29871,1,0,1,1,0,1
2023-06-01,29953,21,1,22,5,2,5
2023-06-01,53706,4,0,4,7,0,7
2023-06-01,46323,6,1,7,4,1,4
2023-06-01,21992,9,0,9,2,0,2
2023-06-01,26404,3,0,3,2,0,2
2023-06-01,32721,1,0,1,3,0,3
2023-06-01,32432,29,0,29,4,0,4
2023-06-01,30362,18,1,19,5,1,6
2023-06-01,32393,3,1,4,4,1,4
2023-06-01,14934,2,0,2,1,0,1
2023-06-01,31803,2,0,2,2,0,2
2023-06-01,26209,7,0,7,4,0,4
2023-06-01,60311,8,3,11,1,1,1
2023-06-01,40241,1,0,1,2,0,2
2023-06-01,40286,1,0,1,2,0,2
2023-06-01,7138,15,1,16,6,1,6
2023-06-01,17189,2,0,2,3,0,3
2023-06-01,40903,1,0,1,2,0,2
2023-06-01,12214,13,0,13,3,0,3
2023-06-01,36304,1,0,1,1,0,1
2023-06-01,22691,12,0,12,3,0,3
2023-06-01,29706,4,0,4,2,0,2
2023-06-01,22738,3,0,3,3,0,3
2023-06-01,17362,3,0,3,5,0,5
2023-06-01,32123,6,0,6,4,0,4
2023-06-01,19473,2,1,3,1,1,1
2023-06-01,12100,2,0,2,3,0,3
2023-06-01,6921,46,0,46,3,0,3
2023-06-01,30436,26,0,26,5,0,5
2023-06-01,15331,1,1,2,1,1,1
2023-06-01,17,11,2,13,2,1,2
2023-06-01,31747,19,0,19,10,0,10
2023-06-01,11336,4,0,4,1,0,1
2023-06-01,39948,35,0,35,3,0,3
2023-06-01,55095,17,33,50,4,4,4
2023-06-01,21709,2,0,2,4,0,4
2023-06-01,19939,1,0,1,1,0,1
2023-06-01,26129,30,0,30,1,0,1
2023-06-01,55134,3,0,3,2,0,2
2023-06-01,23464,8,0,8,2,0,2
2023-06-01,33038,2,1,3,1,1,1
2023-06-01,46652,18,0,18,1,0,1
2023-06-01,11440,1,1,2,3,1,3
2023-06-01,40762,6,0,6,2,0,2
2023-06-01,23127,2,0,2,1,0,1
2023-06-01,30072,3,0,3,3,0,3
2023-06-01,393392,1,0,1,1,0,1
2023-06-01,397292,1,0,1,1,0,1
2023-06-01,46457,3,0,3,3,0,3
2023-06-01,394391,3,0,3,3,0,3
2023-06-01,29883,16,0,16,2,0,2
2023-06-01,15350,2,0,2,1,0,1
2023-06-01,23092,1,0,1,1,0,1
2023-06-01,1010,1,0,1,1,0,1
2023-06-01,11038,8,0,8,4,0,4
2023-06-01,19566,1,1,2,3,1,3
2023-06-01,40638,2,0,2,4,0,4
2023-06-01,35874,16,0,16,3,0,3
2023-06-01,22714,1,0,1,3,0,3
2023-06-01,399672,7,6,13,2,2,2
2023-06-01,397887,2,0,2,2,0,2
2023-06-01,396566,16,14,30,2,2,2
2023-06-01,396570,16,16,32,2,2,2
2023-06-01,396576,16,15,31,2,2,2
2023-06-01,36631,14,14,28,2,2,2
2023-06-01,396557,15,0,15,2,0,2
2023-06-01,3601,2,1,3,4,3,5
2023-06-01,399207,1,0,1,2,0,2
2023-06-01,397444,5,9,14,4,5,5
2023-06-01,54415,4,4,8,7,5,7
2023-06-01,398917,1,0,1,3,0,3
2023-06-01,398780,2,0,2,4,0,4
2023-06-01,397959,1,0,1,1,0,1
2023-06-01,15335,2,0,2,2,0,2
2023-06-01,397510,1,0,1,2,0,2
2023-06-01,397819,1,0,1,2,0,2
2023-06-01,7086,8,0,8,2,0,2
2023-06-01,40954,12,0,12,4,0,4
2023-06-01,399893,3,1,4,2,1,2
2023-06-01,395144,1,0,1,2,0,2
2023-06-01,31791,2,1,3,3,3,3
2023-06-01,17137,7,0,7,1,0,1
2023-06-01,394294,2,0,2,2,0,2
2023-06-01,393287,1,0,1,1,0,1
2023-06-01,396046,3,0,3,3,0,3
2023-06-01,395046,4,0,4,3,0,3
2023-06-01,22018,3,0,3,2,0,2
2023-06-01,398461,1,2,3,1,1,1
2023-06-01,399266,3,1,4,2,1,2
2023-06-01,35885,1,0,1,1,0,1
2023-06-01,12166,7,0,7,1,0,1
2023-06-01,22557,3,0,3,3,0,3
2023-06-01,3384,3,0,3,1,0,1
2023-06-01,54799,5,0,5,4,0,4
2023-06-01,13409,2,0,2,2,0,2
2023-06-01,40581,15,1,16,18,7,18
2023-06-01,5090,3,0,3,1,0,1
2023-06-01,14211,5,0,5,3,0,3
2023-06-01,13745,7,0,7,7,0,7
2023-06-01,26859,1,0,1,2,0,2
2023-06-01,14834,2,1,3,1,1,1
2023-06-01,15144,1,0,1,1,0,1
2023-06-01,14872,16,0,16,1,0,1
2023-06-01,25992,3,0,3,3,0,3
2023-06-01,32363,17,1,18,3,1,3
2023-06-01,14938,48,0,48,5,0,5
2023-06-01,11430,3,1,4,2,2,2
2023-06-01,32766,1,0,1,1,0,1
2023-06-01,62953,1,0,1,2,0,2
2023-06-01,25625,17,4,21,7,1,7
2023-06-01,46446,27,0,27,6,0,6
2023-06-01,32459,2,0,2,1,0,1
2023-06-01,7055,3,1,4,4,2,4
2023-06-01,14390,7,0,7,1,0,1
2023-06-01,63343,3,2,5,2,1,2
2023-06-01,36523,3,0,3,3,0,3
2023-06-01,32264,4,0,4,2,0,2
2023-06-01,393397,4,0,4,4,0,4
2023-06-01,26454,2,0,2,2,0,2
2023-06-01,39981,1,0,1,3,0,3
2023-06-01,16590,1,0,1,3,0,3
2023-06-01,19961,2,0,2,1,0,1
2023-06-01,29890,3,0,3,4,0,4
2023-06-01,26290,1,0,1,1,0,1
2023-06-01,40002,1,0,1,2,0,2
2023-06-01,18458,1,0,1,1,0,1
2023-06-01,40163,1,0,1,3,0,3
2023-06-01,17278,2,0,2,1,0,1
2023-06-01,30416,1,0,1,1,0,1
2023-06-01,395102,2,0,2,2,0,2
2023-06-01,8052,25,1,26,1,1,1
2023-06-01,2495,7,2,9,18,11,19
2023-06-01,393401,1,1,2,3,1,3
2023-06-01,395569,12,0,12,2,0,2
2023-06-01,20257,10,1,11,3,2,3
2023-06-01,30094,12,1,13,2,1,2
2023-06-01,399830,1,1,2,1,1,1
2023-06-01,36715,9,0,9,4,0,4
2023-06-01,397712,3,0,3,3,0,3
2023-06-01,398423,3,0,3,3,0,3
2023-06-01,33712,1,0,1,1,0,1
2023-06-01,393486,3,0,3,3,0,3
2023-06-01,398471,4,2,6,3,2,3
2023-06-01,30255,1,0,1,3,0,3
2023-06-01,14089,15,0,15,3,0,3
2023-06-01,398429,1,0,1,2,0,2
2023-06-01,46646,8,2,10,7,1,7
2023-06-01,6362,2,0,2,2,0,2
2023-06-01,30286,14,1,15,5,3,6
2023-06-01,29928,1,0,1,2,0,2
2023-06-01,14197,4,0,4,1,0,1
2023-06-01,11612,16,0,16,1,0,1
2023-06-01,18647,3,0,3,6,0,6
2023-06-01,30497,60,0,60,5,0,5
2023-06-01,27569,3,0,3,1,0,1
2023-06-01,31996,22,0,22,2,0,2
2023-06-01,398940,12,0,12,3,0,3
2023-06-01,14257,2,0,2,3,0,3
2023-06-01,26883,1,0,1,1,0,1
2023-06-01,395805,1,0,1,2,0,2
2023-06-01,395912,2,0,2,1,0,1
2023-06-01,21800,1,0,1,2,0,2
2023-06-01,14308,1,0,1,1,0,1
2023-06-01,14076,2,0,2,1,0,1
2023-06-01,21898,2,1,3,2,1,2
2023-06-01,17202,1,0,1,3,0,3
2023-06-01,11080,4,1,5,2,1,2
2023-06-01,27541,10,0,10,2,0,2
2023-06-01,27018,2,0,2,2,0,2
2023-06-01,22976,12,0,12,2,0,2
2023-06-01,26873,15,0,15,3,0,3
2023-06-01,13895,4,2,6,4,2,4
2023-06-01,22964,19,1,20,8,2,8
2023-06-01,196962,5,1,6,3,1,3
2023-06-01,395754,2,0,2,3,0,3
2023-06-01,4892,3,0,3,1,0,1
2023-06-01,73,10,1,11,1,1,1
2023-06-01,27170,2,0,2,1,0,1
2023-06-01,397667,1,0,1,2,0,2
2023-06-01,41697,19,0,19,3,0,3
2023-06-01,13392,1,0,1,1,0,1
2023-06-01,1606,2,0,2,2,0,2
2023-06-01,395171,1,0,1,1,0,1
2023-06-01,21989,4,0,4,4,0,4
2023-06-01,40559,1,0,1,2,0,2
2023-06-01,32146,1,0,1,1,0,1
2023-06-01,36037,5,0,5,1,0,1
2023-06-01,14196,3,1,4,1,1,1
2023-06-01,14776,3,1,4,1,1,1
2023-06-01,5779,3,1,4,1,1,1
2023-06-01,393245,3,1,4,1,1,1
2023-06-01,14779,3,1,4,1,1,1
2023-06-01,36088,5,1,6,1,1,1
2023-06-01,14777,5,1,6,1,1,1
2023-06-01,19209,2,0,2,4,0,4
2023-06-01,399346,2,0,2,2,0,2
2023-06-01,395169,3,0,3,3,0,3
2023-06-01,33046,3,0,3,1,0,1
2023-06-01,23228,6,0,6,1,0,1
2023-06-01,398262,1,0,1,2,0,2
2023-06-01,22725,3,0,3,2,0,2
2023-06-01,400093,1,0,1,1,0,1
2023-06-01,400019,1,0,1,3,0,3
2023-06-01,35871,3,0,3,3,0,3
2023-06-01,399491,4,0,4,2,0,2
2023-06-01,399457,3,0,3,3,0,3
2023-06-01,32331,4,0,4,1,0,1
2023-06-01,395172,8,2,10,2,3,3
2023-06-01,53500,2,0,2,2,0,2
2023-06-01,394951,2,0,2,2,0,2
2023-06-01,394948,2,0,2,3,0,3
2023-06-01,64230,1,1,2,2,1,2
2023-06-01,395159,1,0,1,1,0,1
2023-06-01,393575,1,0,1,2,0,2
2023-06-01,22359,2,0,2,1,0,1
2023-06-01,399743,5,0,5,2,0,2
2023-06-01,19245,1,0,1,1,0,1
2023-06-01,12118,5,0,5,3,0,3
2023-06-01,16667,10,0,10,3,0,3
2023-06-01,15100,11,1,12,2,1,2
2023-06-01,26388,33,3,36,2,1,2
2023-06-01,32016,8,0,8,1,0,1
2023-06-01,53346,1,0,1,1,0,1
2023-06-01,25875,19,0,19,9,0,9
2023-06-01,3856,1,1,2,19,13,23
2023-06-01,395962,2,0,2,1,0,1
2023-06-01,394345,1,0,1,5,0,5
2023-06-01,393564,2,0,2,2,0,2
2023-06-01,33427,3,0,3,2,0,2
2023-06-01,395633,2,0,2,2,0,2
2023-06-01,11827,6,1,7,2,1,2
2023-06-01,16527,9,1,10,3,2,3
2023-06-01,26527,13,2,15,1,2,2
2023-06-01,25981,1,0,1,1,0,1
2023-06-01,33416,3,0,3,2,0,2
2023-06-01,13857,13,1,14,7,2,7
2023-06-01,212374,3,0,3,5,0,5
2023-06-01,36344,4,0,4,2,0,2
2023-06-01,200288,3,1,4,3,1,3
2023-06-01,33597,1,0,1,3,0,3
2023-06-01,16987,5,0,5,3,0,3
2023-06-01,397441,3,0,3,1,0,1
2023-06-01,63033,6,1,7,1,1,1
2023-06-01,131524,3,0,3,1,0,1
2023-06-01,135373,39,19,58,9,4,9
2023-06-01,26627,1,0,1,1,0,1
2023-06-01,46964,6,1,7,6,1,6
2023-06-01,398563,1,0,1,6,0,6
2023-06-01,397710,4,0,4,1,0,1
2023-06-01,15015,2,0,2,1,0,1
2023-06-01,1611,2,0,2,1,0,1
2023-06-01,22280,4,1,5,3,3,3
2023-06-01,397689,4,0,4,3,0,3
2023-06-01,53321,2,0,2,2,0,2
2023-06-01,397686,4,0,4,3,0,3
2023-06-01,54373,2,0,2,2,0,2
2023-06-01,63330,3,0,3,1,0,1
2023-06-01,36610,8,1,9,6,2,6
2023-06-01,395024,1,0,1,3,0,3
2023-06-01,2723,3,0,3,3,0,3
2023-06-01,10423,2,1,3,8,3,8
2023-06-01,53551,1,0,1,3,0,3
2023-06-01,8188,2,0,2,3,0,3
2023-06-01,396236,1,0,1,1,0,1
2023-06-01,54414,1,0,1,1,0,1
2023-06-01,11235,3,0,3,4,0,4
2023-06-01,53804,7,1,8,2,2,2
2023-06-01,26759,18,0,18,2,0,2
2023-06-01,27389,1,0,1,1,0,1
2023-06-01,40725,3,0,3,2,0,2
2023-06-01,33239,2,0,2,1,0,1
2023-06-01,46985,6,0,6,3,0,3
2023-06-01,14027,4,0,4,1,0,1
2023-06-01,46737,1,0,1,2,0,2
2023-06-01,46772,1,0,1,2,0,2
2023-06-01,36503,1,0,1,3,0,3
2023-06-01,30676,5,0,5,6,0,6
2023-06-01,22556,2,0,2,1,0,1
2023-06-01,400818,1,1,2,2,4,5
2023-06-01,21956,3,0,3,3,0,3
2023-06-01,15300,1,0,1,1,0,1
2023-06-01,399293,2,0,2,3,0,3
2023-06-01,22236,1,0,1,1,0,1
2023-06-01,35941,1,0,1,1,0,1
2023-06-01,24004,1,0,1,1,0,1
2023-06-01,15200,1,0,1,1,0,1
2023-06-01,32381,2,3,5,2,1,2
2023-06-01,397679,4,0,4,4,0,4
2023-06-01,36441,3,0,3,2,0,2
2023-06-01,14605,4,0,4,3,0,3
2023-06-01,29934,3,0,3,1,0,1
2023-06-01,36518,6,0,6,3,0,3
2023-06-01,393845,11,0,11,2,0,2
2023-06-01,18598,3,1,4,4,1,4
2023-06-01,63112,5,0,5,4,0,4
2023-06-01,17361,5,0,5,2,0,2
2023-06-01,53399,1,0,1,1,0,1
2023-06-01,399669,1,0,1,1,0,1
2023-06-01,14471,1,0,1,1,0,1
2023-06-01,33690,6,0,6,1,0,1
2023-06-01,54175,1,0,1,3,0,3
2023-06-01,3695,18,0,18,1,0,1
2023-06-01,13742,2,0,2,3,0,3
2023-06-01,46238,32,0,32,1,0,1
2023-06-01,23546,18,0,18,3,0,3
2023-06-01,14106,3,1,4,2,1,2
2023-06-01,396443,24,1,25,1,1,1
2023-06-01,65777,1,0,1,1,0,1
2023-06-01,399277,8,0,8,1,0,1
2023-06-01,53483,2,0,2,2,0,2
2023-06-01,30366,4,0,4,2,0,2
2023-06-01,16647,2,0,2,3,0,3
2023-06-01,22419,2,0,2,1,0,1
2023-06-01,40306,72,0,72,3,0,3
2023-06-01,397743,7,0,7,5,0,5
2023-06-01,398827,2,0,2,3,0,3
2023-06-01,40620,5,0,5,6,0,6
2023-06-01,17142,1,0,1,1,0,1
2023-06-01,13362,1,0,1,1,0,1
2023-06-01,29788,3,0,3,2,0,2
2023-06-01,63027,3,2,5,3,1,4
2023-06-01,26993,1,0,1,1,0,1
2023-06-01,23435,2,0,2,2,0,2
2023-06-01,17068,1,0,1,3,0,3
2023-06-01,22495,4,0,4,1,0,1
2023-06-01,40488,1,0,1,3,0,3
2023-06-01,53493,2,0,2,3,0,3
2023-06-01,20084,1,0,1,3,0,3
2023-06-01,400241,1,0,1,2,0,2
2023-06-01,397904,1,0,1,1,0,1
2023-06-01,55226,2,0,2,2,0,2
2023-06-01,393840,1,0,1,1,0,1
2023-06-01,36709,3,0,3,2,0,2
2023-06-01,13833,2,0,2,2,0,2
2023-06-01,21584,1,0,1,2,0,2
2023-06-01,19047,30,4,34,13,1,13
2023-06-01,18595,1,0,1,2,0,2
2023-06-01,27028,1,0,1,1,0,1
2023-06-01,36418,1,0,1,1,0,1
2023-06-01,19593,1,0,1,3,0,3
2023-06-01,62954,2,0,2,1,0,1
2023-06-01,33420,2,0,2,1,0,1
2023-06-01,10921,5,0,5,1,0,1
2023-06-01,53897,4,0,4,2,0,2
2023-06-01,397149,1,0,1,1,0,1
2023-06-01,36801,17,0,17,2,0,2
2023-06-01,394519,1,0,1,1,0,1
2023-06-01,62559,2,0,2,2,0,2
2023-06-01,396034,1,0,1,2,0,2
2023-06-01,14666,1,0,1,1,0,1
2023-06-01,36531,1,0,1,2,0,2
2023-06-01,36446,2,2,4,1,1,2
2023-06-01,40358,4,0,4,3,0,3
2023-06-01,395675,1,0,1,2,0,2
2023-06-01,46695,2,0,2,3,0,3
2023-06-01,46613,1,0,1,1,0,1
2023-06-01,22895,2,0,2,3,0,3
2023-06-01,33270,1,0,1,1,0,1
2023-06-01,10981,1,0,1,1,0,1
2023-06-01,400258,8,0,8,1,0,1
2023-06-01,7954,4,2,6,3,2,3
2023-06-01,53595,5,0,5,4,0,4
2023-06-01,11044,2,0,2,1,0,1
2023-06-01,33484,1,0,1,2,0,2
2023-06-01,14631,1,0,1,1,0,1
2023-06-01,36112,2,0,2,2,0,2
2023-06-01,14832,5,0,5,2,0,2
2023-06-01,30537,1,0,1,3,0,3
2023-06-01,46458,2,0,2,2,0,2
2023-06-01,21631,2,0,2,1,0,1
2023-06-01,36755,1,0,1,1,0,1
2023-06-01,26992,2,0,2,2,0,2
2023-06-01,22393,1,0,1,2,0,2
2023-06-01,25863,1,0,1,1,0,1
2023-06-01,30242,2,0,2,2,0,2
2023-06-01,16767,1,0,1,1,0,1
2023-06-01,46774,1,0,1,1,0,1
2023-06-01,397889,3,0,3,3,0,3
2023-06-01,396986,70,35,105,42,23,47
2023-06-01,138699,8,2,10,15,8,17
2023-06-01,47066,18,2,20,1,1,1
2023-06-01,63442,9,3,12,4,2,4
2023-06-01,395464,2,0,2,3,0,3
2023-06-01,53293,2,0,2,2,0,2
2023-06-01,46549,3,0,3,1,0,1
2023-06-01,4887,1,0,1,3,0,3
2023-06-01,17291,1,0,1,1,0,1
2023-06-01,11298,2,0,2,1,0,1
2023-06-01,14657,2,0,2,3,0,3
2023-06-01,46801,1,0,1,2,0,2
2023-06-01,395124,1,0,1,2,0,2
2023-06-01,22291,1,0,1,1,0,1
2023-06-01,395143,2,0,2,1,0,1
2023-06-01,19643,7,0,7,4,0,4
2023-06-01,396070,1,0,1,2,0,2
2023-06-01,396193,1,0,1,3,0,3
2023-06-01,395888,1,0,1,1,0,1
2023-06-01,399705,1,0,1,2,0,2
2023-06-01,40640,1,0,1,2,0,2
2023-06-01,32579,1,0,1,1,0,1
2023-06-01,40547,3,0,3,2,0,2
2023-06-01,36002,4,0,4,1,0,1
2023-06-01,46416,12,1,13,7,6,10
2023-06-01,36673,6,0,6,3,0,3
2023-06-01,40023,1,0,1,1,0,1
2023-06-01,46820,1,0,1,2,0,2
2023-06-01,23173,17,0,17,3,0,3
2023-06-01,26503,2,0,2,3,0,3
2023-06-01,40845,19,3,22,3,1,3
2023-06-01,33322,10,0,10,1,0,1
2023-06-01,26140,1,0,1,3,0,3
2023-06-01,397569,5,0,5,1,0,1
2023-06-01,399512,2,0,2,1,0,1
2023-06-01,32162,2,0,2,5,0,5
2023-06-01,27246,1,0,1,2,0,2
2023-06-01,14635,2,0,2,2,0,2
2023-06-01,394832,4,0,4,4,0,4
2023-06-01,22136,3,0,3,3,0,3
2023-06-01,18851,7,0,7,1,0,1
2023-06-01,18893,2,0,2,3,0,3
2023-06-01,54370,1,0,1,2,0,2
2023-06-01,19158,4,0,4,1,0,1
2023-06-01,54360,1,0,1,1,0,1
2023-06-01,22931,4,1,5,2,2,2
2023-06-01,397809,3,0,3,1,0,1
2023-06-01,33255,3,0,3,2,0,2
2023-06-01,394147,28,0,28,3,0,3
2023-06-01,16838,4,2,6,5,2,5
2023-06-01,23183,11,0,11,1,0,1
2023-06-01,23185,4,0,4,2,0,2
2023-06-01,7832,40,0,40,3,0,3
2023-06-01,14954,2,0,2,1,0,1
2023-06-01,23260,8,1,9,2,2,2
2023-06-01,20460,9,0,9,3,0,3
2023-06-01,54331,1,0,1,2,0,2
2023-06-01,393636,2,0,2,1,0,1
2023-06-01,33441,2,0,2,2,0,2
2023-06-01,22346,3,1,4,1,1,1
2023-06-01,398079,6,0,6,3,0,3
2023-06-01,36658,11,0,11,3,0,3
2023-06-01,400227,2,0,2,3,0,3
2023-06-01,63013,1,0,1,1,0,1
2023-06-01,400376,1,0,1,1,0,1
2023-06-01,62765,1,0,1,2,0,2
2023-06-01,397280,4,0,4,1,0,1
2023-06-01,397374,4,0,4,2,0,2
2023-06-01,53536,2,0,2,3,0,3
2023-06-01,1249,4,0,4,2,0,2
2023-06-01,19463,6,0,6,2,0,2
2023-06-01,7151,5,1,6,3,2,3
2023-06-01,53846,2,0,2,1,0,1
2023-06-01,399501,1,0,1,1,0,1
2023-06-01,399065,14,3,17,3,2,3
2023-06-01,22805,1,0,1,1,0,1
2023-06-01,394151,3,2,5,4,4,4
2023-06-01,397287,1,0,1,1,0,1
2023-06-01,39921,8,2,10,2,1,2
2023-06-01,47064,3,0,3,2,0,2
2023-06-01,36395,3,0,3,1,0,1
2023-06-01,22716,1,0,1,1,0,1
2023-06-01,20200,1,0,1,1,0,1
2023-06-01,25669,1,0,1,3,0,3
2023-06-01,62648,11,0,11,2,0,2
2023-06-01,15082,2,1,3,1,1,1
2023-06-01,17380,12,0,12,3,0,3
2023-06-01,32736,32,0,32,2,0,2
2023-06-01,10292,61,0,61,2,0,2
2023-06-01,10278,4,0,4,5,0,5
2023-06-01,46959,4,3,7,2,2,2
2023-06-01,55085,4,0,4,2,0,2
2023-06-01,395107,3,0,3,1,0,1
2023-06-01,18805,1,0,1,2,0,2
2023-06-01,3128,14,1,15,13,6,14
2023-06-01,59,11,1,12,3,2,3
2023-06-01,11062,11,0,11,6,0,6
2023-06-01,10725,4,1,5,1,2,3
2023-06-01,63083,2,0,2,2,0,2
2023-06-01,394967,2,0,2,1,0,1
2023-06-01,31955,2,0,2,4,0,4
2023-06-01,36073,3,0,3,6,0,6
2023-06-01,38,14,2,16,2,2,2
2023-06-01,187,17,17,34,1,1,1
2023-06-01,395425,6,0,6,6,0,6
2023-06-01,14289,1,0,1,1,0,1
2023-06-01,54385,2,0,2,2,0,2
2023-06-01,21918,34,0,34,1,0,1
2023-06-01,398134,1,0,1,2,0,2
2023-06-01,398066,1,0,1,3,0,3
2023-06-01,40914,1,0,1,1,0,1
2023-06-01,266165,7,7,14,4,3,4
2023-06-01,266166,3,3,6,9,6,10
2023-06-01,266173,5,1,6,3,1,3
2023-06-01,266184,7,0,7,3,0,3
2023-06-01,62506,2,0,2,1,0,1
2023-06-01,6645,1,0,1,3,0,3
2023-06-01,393648,8,0,8,2,0,2
2023-06-01,55254,8,1,9,3,1,3
2023-06-01,397770,1,0,1,1,0,1
2023-06-01,395683,2,0,2,2,0,2
2023-06-01,36114,9,1,10,1,1,1
2023-06-01,393573,6,1,7,3,2,3
2023-06-01,46931,1,0,1,1,0,1
2023-06-01,32622,2,0,2,1,0,1
2023-06-01,54914,2,0,2,2,0,2
2023-06-01,14997,1,0,1,1,0,1
2023-06-01,396493,1,0,1,4,0,4
2023-06-01,393939,2,0,2,1,0,1
2023-06-01,393560,3,1,4,1,1,1
2023-06-01,30350,3,1,4,2,2,2
2023-06-01,398072,1,0,1,1,0,1
2023-06-01,40378,1,0,1,1,0,1
2023-06-01,7788,1,0,1,1,0,1
2023-06-01,11712,8,0,8,2,0,2
2023-06-01,6912,4,1,5,3,1,3
2023-06-01,25641,1,0,1,1,0,1
2023-06-01,2939,19,0,19,3,0,3
2023-06-01,3479,23,0,23,11,0,11
2023-06-01,19765,2,0,2,1,0,1
2023-06-01,36686,1,0,1,1,0,1
2023-06-01,400160,1,0,1,3,0,3
2023-06-01,20103,1,0,1,3,0,3
2023-06-01,26885,3,0,3,3,0,3
2023-06-01,54536,3,1,4,3,1,3
2023-06-01,393657,18,1,19,2,1,2
2023-06-01,62915,7,0,7,3,0,3
2023-06-01,18672,8,1,9,2,2,2
2023-06-01,32530,5,0,5,4,0,4
2023-06-01,19697,1,0,1,1,0,1
2023-06-01,395883,1,0,1,1,0,1
2023-06-01,26008,10,8,18,3,3,3
2023-06-01,54318,3,2,5,3,2,3
2023-06-01,393991,1,0,1,1,0,1
2023-06-01,396389,1,0,1,3,0,3
2023-06-01,40658,1,0,1,2,0,2
2023-06-01,64019,2,1,3,1,1,1
2023-06-01,63340,1,0,1,1,0,1
2023-06-01,19571,1,0,1,2,0,2
2023-06-01,19995,2,0,2,2,0,2
2023-06-01,32830,2,0,2,3,0,3
2023-06-01,54032,11,0,11,3,0,3
2023-06-01,25640,8,0,8,2,0,2
2023-06-01,62712,12,0,12,2,0,2
2023-06-01,10858,1,0,1,1,0,1
2023-06-01,23209,2,0,2,2,0,2
2023-06-01,26808,2,0,2,1,0,1
2023-06-01,19674,3,0,3,2,0,2
2023-06-01,26372,2,0,2,2,0,2
2023-06-01,25750,1,0,1,2,0,2
2023-06-01,40047,1,0,1,2,0,2
2023-06-01,62841,1,0,1,2,0,2
2023-06-01,55045,14,1,15,1,1,1
2023-06-01,36024,2,0,2,2,0,2
2023-06-01,39988,1,0,1,1,0,1
2023-06-01,54092,3,0,3,4,0,4
2023-06-01,395968,2,0,2,1,0,1
2023-06-01,54106,2,0,2,1,0,1
2023-06-01,33501,3,1,4,2,2,2
2023-06-01,22568,1,0,1,2,0,2
2023-06-01,398446,26,0,26,5,0,5
2023-06-01,16402,1,0,1,1,0,1
2023-06-01,396899,3,0,3,2,0,2
2023-06-01,11580,5,0,5,1,0,1
2023-06-01,10980,14,1,15,2,1,2
2023-06-01,65035,1,0,1,1,0,1
2023-06-01,16866,5,1,6,4,2,4
2023-06-01,63052,25,1,26,5,5,6
2023-06-01,54274,1,0,1,3,0,3
2023-06-01,16515,1,0,1,1,0,1
2023-06-01,397932,3,0,3,2,0,2
2023-06-01,54682,1,0,1,3,0,3
2023-06-01,17325,1,0,1,2,0,2
2023-06-01,397560,2,0,2,1,0,1
2023-06-01,54603,4,0,4,2,0,2
2023-06-01,46947,1,0,1,1,0,1
2023-06-01,46688,1,0,1,3,0,3
2023-06-01,40777,1,0,1,2,0,2
2023-06-01,13470,2,1,3,1,1,1
2023-06-01,395123,1,1,2,1,1,1
2023-06-01,13773,8,0,8,1,0,1
2023-06-01,32221,2,0,2,1,0,1
2023-06-01,4900,1,0,1,2,0,2
2023-06-01,11593,1,0,1,2,0,2
2023-06-01,33465,6,0,6,3,0,3
2023-06-01,26395,40,0,40,9,0,9
2023-06-01,13731,1,1,2,3,1,3
2023-06-01,17303,3,1,4,5,1,5
2023-06-01,36045,1,0,1,2,0,2
2023-06-01,46292,5,0,5,3,0,3
2023-06-01,30682,8,0,8,4,0,4
2023-06-01,394584,1,0,1,2,0,2
2023-06-01,400085,1,0,1,1,0,1
2023-06-01,400852,1,0,1,2,0,2
2023-06-01,11872,13,1,14,3,3,3
2023-06-01,1059,1,0,1,1,0,1
2023-06-01,396928,1,0,1,2,0,2
2023-06-01,394218,4,0,4,5,0,5
2023-06-01,31987,1,0,1,2,0,2
2023-06-01,400703,1,0,1,1,0,1
2023-06-01,397294,1,0,1,1,0,1
2023-06-01,397016,7,0,7,4,0,4
2023-06-01,398867,1,0,1,1,0,1
2023-06-01,399846,1,0,1,1,0,1
2023-06-01,16716,3,0,3,1,0,1
2023-06-01,40293,1,0,1,3,0,3
2023-06-01,394230,4,5,9,3,3,3
2023-06-01,19810,2,0,2,2,0,2
2023-06-01,19904,4,0,4,2,0,2
2023-06-01,30335,2,0,2,2,0,2
2023-06-01,20284,8,1,9,3,1,3
2023-06-01,395515,7,6,13,3,3,3
2023-06-01,395242,1,0,1,1,0,1
2023-06-01,395544,1,0,1,3,0,3
2023-06-01,396152,1,1,2,3,1,3
2023-06-01,19704,2,2,4,4,2,4
2023-06-01,32497,1,0,1,1,0,1
2023-06-01,55208,2,0,2,2,0,2
2023-06-01,40159,2,0,2,1,0,1
2023-06-01,36243,7,1,8,4,2,4
2023-06-01,19005,10,0,10,2,0,2
2023-06-01,32075,4,0,4,2,0,2
2023-06-01,26152,2,0,2,3,0,3
2023-06-01,23043,1,0,1,1,0,1
2023-06-01,46195,1,0,1,5,0,5
2023-06-01,22088,2,0,2,1,0,1
2023-06-01,22344,4,0,4,4,0,4
2023-06-01,25842,2,0,2,2,0,2
2023-06-01,14066,1,0,1,1,0,1
2023-06-01,394950,2,0,2,2,0,2
2023-06-01,16842,6,0,6,5,0,5
2023-06-01,35862,4,1,5,4,1,4
2023-06-01,10730,1,0,1,2,0,2
2023-06-01,14986,1,0,1,1,0,1
2023-06-01,33506,2,0,2,2,0,2
2023-06-01,33627,4,0,4,3,0,3
2023-06-01,46877,2,0,2,1,0,1
2023-06-01,26226,1,0,1,2,0,2
2023-06-01,14820,3,0,3,3,0,3
2023-06-01,11288,2,0,2,2,0,2
2023-06-01,46132,3,0,3,3,0,3
2023-06-01,399193,1,0,1,3,0,3
2023-06-01,33069,2,1,3,4,3,4
2023-06-01,22111,4,0,4,2,0,2
2023-06-01,36504,11,0,11,1,0,1
2023-06-01,22766,1,0,1,1,0,1
2023-06-01,46748,1,0,1,1,0,1
2023-06-01,33391,2,0,2,2,0,2
2023-06-01,26632,1,0,1,1,0,1
2023-06-01,25943,2,0,2,2,0,2
2023-06-01,11222,3,0,3,4,0,4
2023-06-01,46861,2,0,2,4,0,4
2023-06-01,19404,19,0,19,6,0,6
2023-06-01,18896,2,0,2,2,0,2
2023-06-01,22069,2,0,2,2,0,2
2023-06-01,30231,4,0,4,3,0,3
2023-06-01,398232,6,0,6,3,0,3
2023-06-01,19503,1,1,2,2,1,2
2023-06-01,36582,1,1,2,2,2,2
2023-06-01,46796,2,0,2,2,0,2
2023-06-01,53567,6,0,6,4,0,4
2023-06-01,46927,1,0,1,3,0,3
2023-06-01,17116,8,1,9,2,2,2
2023-06-01,26630,13,0,13,1,0,1
2023-06-01,395571,8,0,8,3,0,3
2023-06-01,14902,4,0,4,2,0,2
2023-06-01,13823,12,1,13,2,1,2
2023-06-01,36046,2,0,2,2,0,2
2023-06-01,46971,2,0,2,2,0,2
2023-06-01,54107,6,0,6,8,0,8
2023-06-01,395808,2,0,2,1,0,1
2023-06-01,22009,4,0,4,2,0,2
2023-06-01,6419,112,0,112,7,0,7
2023-06-01,47000,6,0,6,3,0,3
2023-06-01,40867,3,0,3,4,0,4
2023-06-01,46932,9,0,9,1,0,1
2023-06-01,47002,4,1,5,2,1,2
2023-06-01,27297,1,0,1,1,0,1
2023-06-01,10764,1,0,1,3,2,3
2023-06-01,40191,8,1,9,2,1,2
2023-06-01,22338,2,0,2,2,0,2
2023-06-01,23225,13,0,13,8,0,8
2023-06-01,19915,4,0,4,2,0,2
2023-06-01,13826,0,0,0,5,2,5
2023-06-01,32757,15,0,15,1,0,1
2023-06-01,36809,1,0,1,2,0,2
2023-06-01,32987,4,0,4,3,0,3
2023-06-01,394199,2,0,2,2,0,2
2023-06-01,142007,1,0,1,3,0,3
2023-06-01,47035,1,0,1,1,0,1
2023-06-01,19888,3,0,3,2,0,2
2023-06-01,199709,1,0,1,2,0,2
2023-06-01,33062,1,0,1,2,0,2
2023-06-01,27232,3,0,3,3,0,3
2023-06-01,39470,2,0,2,2,0,2
2023-06-01,14753,5,0,5,3,0,3
2023-06-01,46817,12,0,12,3,0,3
2023-06-01,47060,4,0,4,3,0,3
2023-06-01,14073,4,0,4,3,0,3
2023-06-01,47015,4,1,5,2,1,2
2023-06-01,47069,1,0,1,2,0,2
2023-06-01,19911,0,0,0,2,0,2
2023-06-01,46812,8,0,8,2,0,2
2023-06-01,27647,5,4,9,10,5,10
2023-06-01,11536,1,0,1,1,0,1
2023-06-01,21885,1,0,1,1,0,1
2023-06-01,398420,22,0,22,1,0,1
2023-06-01,47084,4,0,4,2,0,2
2023-06-01,32413,9,0,9,4,0,4
2023-06-01,40837,15,0,15,2,0,2
2023-06-01,29919,2,0,2,3,0,3
2023-06-01,4867,6,0,6,5,0,5
2023-06-01,26083,12,0,12,1,0,1
2023-06-01,47100,1,1,2,1,1,1
2023-06-01,26137,2,0,2,4,0,4
2023-06-01,15088,1,2,3,1,2,2
2023-06-01,20430,5,0,5,4,0,4
2023-06-01,53254,4,0,4,1,0,1
2023-06-01,36273,1,0,1,1,0,1
2023-06-01,20365,24,3,27,2,1,2
2023-06-01,53251,1,0,1,1,0,1
2023-06-01,36354,17,0,17,3,0,3
2023-06-01,29889,15,3,18,4,4,6
2023-06-01,47023,7,0,7,3,0,3
2023-06-01,16912,5,0,5,6,0,6
2023-06-01,36524,2,0,2,1,0,1
2023-06-01,397430,3,0,3,2,0,2
2023-06-01,15038,6,0,6,7,0,7
2023-06-01,15997,3,1,4,14,4,14
2023-06-01,1277,1,0,1,1,0,1
2023-06-01,394634,1,1,2,1,1,1
2023-06-01,394597,4,1,5,3,1,3
2023-06-01,36511,12,2,14,1,1,2
2023-06-01,53276,4,0,4,4,0,4
2023-06-01,1442,2,1,3,3,2,3
2023-06-01,53266,2,0,2,2,0,2
2023-06-01,53263,2,0,2,2,0,2
2023-06-01,27400,8,1,9,7,6,9
2023-06-01,47031,3,0,3,2,0,2
2023-06-01,1445,1,0,1,2,0,2
2023-06-01,42909,5,3,8,15,6,16
2023-06-01,49673,6,1,7,7,1,7
2023-06-01,51090,5,2,7,5,5,5
2023-06-01,1628,3,0,3,1,0,1
2023-06-01,23012,2,0,2,2,0,2
2023-06-01,1652,1,0,1,1,0,1
2023-06-01,15122,2,0,2,2,0,2
2023-06-01,53307,3,0,3,3,0,3
2023-06-01,6165,11,0,11,1,0,1
2023-06-01,21978,1,0,1,1,0,1
2023-06-01,1643,1,0,1,1,0,1
2023-06-01,1379,8,0,8,2,0,2
2023-06-01,1443,1,0,1,4,0,4
2023-06-01,12225,5,0,5,3,0,3
2023-06-01,20228,2,0,2,1,0,1
2023-06-01,15278,4,0,4,5,0,5
2023-06-01,1827,5,0,5,2,0,2
2023-06-01,1823,4,0,4,2,0,2
2023-06-01,23197,13,0,13,12,0,12
2023-06-01,53324,1,0,1,1,0,1
2023-06-01,46699,3,0,3,2,0,2
2023-06-01,399522,4,1,5,2,2,2
2023-06-01,12273,12,0,12,5,0,5
2023-06-01,3688,1,0,1,1,0,1
2023-06-01,32866,6,0,6,2,0,2
2023-06-01,1826,1,0,1,1,0,1
2023-06-01,46429,2,3,5,4,3,4
2023-06-01,31977,4,0,4,2,0,2
2023-06-01,4539,2,0,2,4,0,4
2023-06-01,2941,2,0,2,2,0,2
2023-06-01,30032,1,0,1,3,0,3
2023-06-01,32570,4,0,4,1,0,1
2023-06-01,26217,1,0,1,2,0,2
2023-06-01,13341,5,0,5,2,0,2
2023-06-01,4894,1,0,1,2,0,2
2023-06-01,13851,4,1,5,3,1,3
2023-06-01,1633,5,0,5,2,0,2
2023-06-01,4980,1,0,1,3,0,3
2023-06-01,3061,3,0,3,2,0,2
2023-06-01,4912,1,0,1,1,0,1
2023-06-01,63157,1,0,1,2,0,2
2023-06-01,46437,12,1,13,3,1,3
2023-06-01,4886,3,0,3,2,0,2
2023-06-01,395551,1,0,1,4,0,4
2023-06-01,4940,2,0,2,4,0,4
2023-06-01,11170,8,1,9,9,5,9
2023-06-01,22787,31,29,60,10,12,13
2023-06-01,22441,5,0,5,3,0,3
2023-06-01,7143,3,0,3,4,0,4
2023-06-01,36464,2,0,2,3,0,3
2023-06-01,35064,4,0,4,7,0,7
2023-06-01,21690,1,0,1,1,0,1
2023-06-01,14866,5,1,6,7,1,7
2023-06-01,14268,1,0,1,1,0,1
2023-06-01,30097,8,0,8,2,0,2
2023-06-01,4893,1,0,1,3,0,3
2023-06-01,46878,4,0,4,2,0,2
2023-06-01,29868,2,0,2,2,0,2
2023-06-01,35860,7,0,7,2,0,2
2023-06-01,27401,9,0,9,3,0,3
2023-06-01,29906,8,1,9,3,1,3
2023-06-01,19424,3,0,3,2,0,2
2023-06-01,11477,1,0,1,2,0,2
2023-06-01,21678,8,0,8,4,0,4
2023-06-01,19750,6,8,14,7,5,7
2023-06-01,1999,10,1,11,3,2,3
2023-06-01,27515,1,0,1,1,0,1
2023-06-01,39975,1,1,2,5,4,5
2023-06-01,200182,1,5,6,4,2,5
2023-06-01,922,1,0,1,1,0,1
2023-06-01,32683,1,0,1,1,0,1
2023-06-01,11297,1,0,1,1,0,1
2023-06-01,36815,5,3,8,1,1,1
2023-06-01,32584,7,0,7,1,0,1
2023-06-01,26950,2,0,2,4,0,4
2023-06-01,18938,8,0,8,3,0,3
2023-06-01,4878,1,0,1,1,0,1
2023-06-01,23284,4,0,4,2,0,2
2023-06-01,10661,1,0,1,3,0,3
2023-06-01,32560,3,0,3,1,0,1
2023-06-01,26032,1,0,1,1,0,1
2023-06-01,14480,6,0,6,4,0,4
2023-06-01,6951,4,0,4,4,0,4
2023-06-01,32773,3,0,3,2,0,2
2023-06-01,7366,2,0,2,3,0,3
2023-06-01,13722,2,1,3,2,1,2
2023-06-01,398969,4,0,4,6,0,6
2023-06-01,398990,1,0,1,2,0,2
2023-06-01,39963,8,1,9,2,1,2
2023-06-01,22496,1,0,1,2,0,2
2023-06-01,21818,2,1,3,2,1,2
2023-06-01,36758,32,0,32,3,0,3
2023-06-01,19595,1,0,1,2,0,2
2023-06-01,25889,2,0,2,3,0,3
2023-06-01,53294,3,0,3,3,0,3
2023-06-01,32671,4,0,4,5,0,5
2023-06-01,32141,3,0,3,2,0,2
2023-06-01,393449,1,0,1,2,0,2
2023-06-01,30188,3,0,3,5,0,5
2023-06-01,36823,2,0,2,3,0,3
2023-06-01,12102,1,0,1,3,0,3
2023-06-01,394991,20,1,21,4,3,4
2023-06-01,22300,4,4,8,5,4,6
2023-06-01,16848,4,0,4,2,0,2
2023-06-01,30063,2,0,2,1,0,1
2023-06-01,40790,2,0,2,1,0,1
2023-06-01,22937,4,3,7,2,2,2
2023-06-01,27441,2,0,2,1,0,1
2023-06-01,399281,1,0,1,1,0,1
2023-06-01,53313,2,0,2,2,0,2
2023-06-01,36324,9,2,11,4,3,4
2023-06-01,53361,4,0,4,1,0,1
2023-06-01,53289,8,0,8,1,0,1
2023-06-01,399800,2,0,2,1,0,1
2023-06-01,18776,2,0,2,4,0,4
2023-06-01,510,3,0,3,3,0,3
2023-06-01,53319,1,0,1,1,0,1
2023-06-01,53383,1,0,1,1,0,1
2023-06-01,26237,3,0,3,6,0,6
2023-06-01,14352,7,0,7,3,0,3
2023-06-01,46576,9,0,9,3,0,3
2023-06-01,26921,1,0,1,1,0,1
2023-06-01,11365,5,0,5,1,0,1
2023-06-01,14224,3,0,3,4,0,4
2023-06-01,17319,12,0,12,1,0,1
2023-06-01,20193,1,0,1,1,0,1
2023-06-01,53425,4,0,4,3,0,3
2023-06-01,18898,6,0,6,4,0,4
2023-06-01,23051,1,0,1,2,0,2
2023-06-01,10919,1,0,1,1,0,1
2023-06-01,30047,10,0,10,4,0,4
2023-06-01,26569,1,1,2,2,1,2
2023-06-01,46785,9,1,10,3,1,3
2023-06-01,1614,4,0,4,1,0,1
2023-06-01,394610,2,0,2,3,0,3
2023-06-01,62844,6,0,6,1,0,1
2023-06-01,394581,5,0,5,3,0,3
2023-06-01,14982,2,0,2,3,0,3
2023-06-01,53332,2,0,2,1,0,1
2023-06-01,15211,13,3,16,7,5,7
2023-06-01,36698,11,1,12,5,1,5
2023-06-01,19137,29,0,29,3,0,3
2023-06-01,53450,1,0,1,1,0,1
2023-06-01,398297,3,0,3,2,0,2
2023-06-01,400251,3,0,3,3,0,3
2023-06-01,35975,3,1,4,1,1,1
2023-06-01,200185,11,1,12,9,6,10
2023-06-01,400694,3,0,3,4,0,4
2023-06-01,40727,12,0,12,3,0,3
2023-06-01,5740,5,0,5,5,0,5
2023-06-01,27527,2,0,2,1,0,1
2023-06-01,14292,4,0,4,1,0,1
2023-06-01,36742,7,0,7,2,0,2
2023-06-01,16856,2,0,2,2,0,2
2023-06-01,53429,4,0,4,3,0,3
2023-06-01,53830,17,0,17,5,0,5
2023-06-01,53373,6,0,6,3,0,3
2023-06-01,26671,3,0,3,2,0,2
2023-06-01,30009,6,0,6,3,0,3
2023-06-01,27398,8,6,14,3,2,3
2023-06-01,400706,13,0,13,1,0,1
2023-06-01,16938,2,0,2,3,0,3
2023-06-01,394901,2,0,2,5,0,5
2023-06-01,18911,3,0,3,3,0,3
2023-06-01,46182,4,0,4,4,0,4
2023-06-01,62776,5,0,5,2,0,2
2023-06-01,46834,1,0,1,1,0,1
2023-06-01,29722,1,0,1,1,0,1
2023-06-01,23354,3,0,3,2,0,2
2023-06-01,25885,5,2,7,8,4,8
2023-06-01,25787,3,1,4,6,1,6
2023-06-01,40496,4,0,4,1,0,1
2023-06-01,11560,16,0,16,2,0,2
2023-06-01,18865,4,3,7,4,4,4
2023-06-01,53469,1,0,1,1,0,1
2023-06-01,29854,3,3,6,3,2,3
2023-06-01,11554,2,0,2,1,0,1
2023-06-01,400782,1,0,1,3,0,3
2023-06-01,55291,8,0,8,3,0,3
2023-06-01,15313,11,0,11,1,0,1
2023-06-01,54178,5,0,5,3,0,3
2023-06-01,14064,1,0,1,3,0,3
2023-06-01,36788,6,0,6,2,0,2
2023-06-01,33629,2,0,2,4,0,4
2023-06-01,36542,1,0,1,1,0,1
2023-06-01,393574,1,0,1,1,0,1
2023-06-01,30568,8,0,8,2,0,2
2023-06-01,46271,1,0,1,3,0,3
2023-06-01,46250,2,0,2,2,0,2
2023-06-01,25854,5,0,5,4,0,4
2023-06-01,393803,1,0,1,2,0,2
2023-06-01,21867,1,0,1,3,0,3
2023-06-01,400552,1,0,1,1,0,1
2023-06-01,393530,1,0,1,1,0,1
2023-06-01,62912,1,0,1,1,0,1
2023-06-01,30674,24,1,25,2,1,2
2023-06-01,18791,2,0,2,3,0,3
2023-06-01,18777,8,0,8,4,0,4
2023-06-01,397289,1,0,1,3,0,3
2023-06-01,400233,1,0,1,1,0,1
2023-06-01,32440,110,1,111,25,8,25
2023-06-01,54700,4,0,4,1,0,1
2023-06-01,14085,3,2,5,2,1,2
2023-06-01,11810,3,1,4,2,2,2
2023-06-01,26945,1,0,1,1,0,1
2023-06-01,21817,11,2,13,1,1,1
2023-06-01,18597,2,0,2,3,0,3
2023-06-01,54711,4,0,4,2,0,2
2023-06-01,21742,1,0,1,2,0,2
2023-06-01,393880,3,0,3,2,0,2
2023-06-01,397581,1,0,1,1,0,1
2023-06-01,26254,4,0,4,5,0,5
2023-06-01,18669,2,0,2,3,0,3
2023-06-01,14637,1,0,1,2,0,2
2023-06-01,11057,1,0,1,1,0,1
2023-06-01,395313,1,0,1,2,0,2
2023-06-01,23157,2,0,2,2,0,2
2023-06-01,36656,4,0,4,1,0,1
2023-06-01,26957,2,0,2,3,0,3
2023-06-01,11276,1,0,1,3,0,3
2023-06-01,14002,1,0,1,1,0,1
2023-06-01,62737,1,0,1,1,0,1
2023-06-01,25683,3,0,3,3,0,3
2023-06-01,46245,1,0,1,1,0,1
2023-06-01,29720,1,0,1,1,0,1
2023-06-01,395554,1,0,1,2,0,2
2023-06-01,26122,1,0,1,1,0,1
2023-06-01,394502,1,0,1,1,0,1
2023-06-01,14842,1,0,1,1,0,1
2023-06-01,36102,2,0,2,1,0,1
2023-06-01,14209,7,1,8,2,3,3
2023-06-01,26520,1,0,1,1,0,1
2023-06-01,14214,11,0,11,7,0,7
2023-06-01,4323,0,0,0,3,0,3
2023-06-01,53618,8,0,8,4,0,4
2023-06-01,395341,13,0,13,3,0,3
2023-06-01,7271,1,0,1,2,0,2
2023-06-01,22404,2,0,2,2,0,2
2023-06-01,20477,24,0,24,2,0,2
2023-06-01,53543,16,0,16,1,0,1
2023-06-01,40328,37,3,40,5,1,5
2023-06-01,394099,2,0,2,4,0,4
2023-06-01,46115,35,0,35,1,0,1
2023-06-01,11317,3,1,4,6,7,9
2023-06-01,16489,4,0,4,3,0,3
2023-06-01,54548,13,4,17,3,2,3
2023-06-01,34305,8,5,13,3,3,3
2023-06-01,31990,1,1,2,1,1,1
2023-06-01,21628,1,0,1,1,0,1
2023-06-01,10723,3,0,3,3,0,3
2023-06-01,19982,4,1,5,1,2,2
2023-06-01,18923,1,1,2,1,1,1
2023-06-01,397976,6,0,6,3,0,3
2023-06-01,22739,2,0,2,1,0,1
2023-06-01,18794,12,0,12,2,0,2
2023-06-01,19189,5,0,5,6,0,6
2023-06-01,6401,5,0,5,2,0,2
2023-06-01,36119,2,0,2,1,0,1
2023-06-01,26200,2,0,2,4,0,4
2023-06-01,19602,8,0,8,6,0,6
2023-06-01,11781,1,0,1,1,0,1
2023-06-01,36199,1,0,1,2,0,2
2023-06-01,27175,1,0,1,3,0,3
2023-06-01,26500,1,0,1,1,0,1
2023-06-01,5787,8,1,9,2,2,2
2023-06-01,26472,4,0,4,1,0,1
2023-06-01,55189,6,0,6,3,0,3
2023-06-01,14729,1,0,1,2,0,2
2023-06-01,53742,1,0,1,2,0,2
2023-06-01,54324,3,0,3,4,0,4
2023-06-01,18552,6,0,6,1,0,1
2023-06-01,20450,1,0,1,2,0,2
2023-06-01,26712,1,0,1,1,0,1
2023-06-01,19483,11,0,11,1,0,1
2023-06-01,13378,2,0,2,1,0,1
2023-06-01,32032,2,0,2,2,0,2
2023-06-01,27622,1,0,1,1,0,1
2023-06-01,36465,1,0,1,3,0,3
2023-06-01,40057,3,0,3,3,0,3
2023-06-01,395733,1,0,1,2,0,2
2023-06-01,16778,2,0,2,1,0,1
2023-06-01,54526,1,0,1,4,0,4
2023-06-01,40054,1,0,1,2,0,2
2023-06-01,397314,4,0,4,2,0,2
2023-06-01,26296,7,0,7,2,0,2
2023-06-01,40852,1,0,1,1,0,1
2023-06-01,6498,27,1,28,8,2,9
2023-06-01,11429,5,0,5,2,0,2
2023-06-01,32957,3,0,3,3,0,3
2023-06-01,16719,2,0,2,5,0,5
2023-06-01,33206,3,0,3,3,0,3
2023-06-01,17241,1,0,1,1,0,1
2023-06-01,14841,1,0,1,1,0,1
2023-06-01,7453,12,0,12,6,0,6
2023-06-01,7000,1,0,1,4,0,4
2023-06-01,20130,3,3,6,4,4,4
2023-06-01,26767,1,0,1,1,0,1
2023-06-01,65126,2,0,2,1,0,1
2023-06-01,53979,5,0,5,1,0,1
2023-06-01,393993,1,0,1,3,0,3
2023-06-01,18696,1,1,2,1,1,1
2023-06-01,393447,3,0,3,3,0,3
2023-06-01,393962,3,0,3,2,0,2
2023-06-01,11624,20,0,20,1,0,1
2023-06-01,54124,1,0,1,1,0,1
2023-06-01,16386,2,0,2,1,0,1
2023-06-01,23493,1,0,1,2,0,2
2023-06-01,16854,3,0,3,4,0,4
2023-06-01,53729,1,0,1,1,0,1
2023-06-01,62691,2,0,2,3,0,3
2023-06-01,54445,2,0,2,1,0,1
2023-06-01,54619,2,0,2,2,0,2
2023-06-01,36402,1,0,1,3,0,3
2023-06-01,27556,3,0,3,2,0,2
2023-06-01,23070,1,0,1,3,0,3
2023-06-01,395376,1,0,1,1,0,1
2023-06-01,53697,2,0,2,2,0,2
2023-06-01,55065,1,0,1,2,0,2
2023-06-01,32853,1,0,1,1,0,1
2023-06-01,46496,2,0,2,2,0,2
2023-06-01,55236,3,0,3,5,0,5
2023-06-01,19219,1,0,1,1,0,1
2023-06-01,32104,6,0,6,3,0,3
2023-06-01,63198,1,0,1,1,0,1
2023-06-01,394443,1,0,1,1,0,1
2023-06-01,7349,2,0,2,2,0,2
2023-06-01,396384,1,0,1,1,0,1
2023-06-01,398261,2,0,2,1,0,1
2023-06-01,394537,1,0,1,2,0,2
2023-06-01,55042,1,0,1,1,0,1
2023-06-01,14656,1,0,1,1,0,1
2023-06-01,53369,3,0,3,3,0,3
2023-06-01,26160,3,0,3,2,0,2
2023-06-01,25629,5,0,5,3,0,3
2023-06-01,36739,1,0,1,1,0,1
2023-06-01,46949,1,0,1,1,0,1
2023-06-01,40513,12,0,12,11,0,11
2023-06-01,11074,1,0,1,3,0,3
2023-06-01,607,1,0,1,1,0,1
2023-06-01,27250,6,1,7,3,1,3
2023-06-01,13963,1,0,1,1,0,1
2023-06-01,40091,27,0,27,2,0,2
2023-06-01,11195,2,1,3,5,1,5
2023-06-01,393628,2,0,2,4,0,4
2023-06-01,14659,3,0,3,3,0,3
2023-06-01,26278,2,0,2,2,0,2
2023-06-01,19223,3,1,4,2,1,2
2023-06-01,395292,1,0,1,1,0,1
2023-06-01,22677,2,3,5,1,1,1
2023-06-01,23132,2,3,5,1,1,1
2023-06-01,22710,2,10,12,1,1,1
2023-06-01,22974,2,2,4,2,1,2
2023-06-01,22513,2,2,4,1,1,1
2023-06-01,22516,2,2,4,2,1,2
2023-06-01,20231,2,2,4,1,1,1
2023-06-01,17090,4,1,5,1,1,1
2023-06-01,23232,1,0,1,1,0,1
2023-06-01,22620,1,0,1,2,0,2
2023-06-01,397003,2,0,2,2,0,2
2023-06-01,41458,6,0,6,4,0,4
2023-06-01,15197,1,0,1,1,0,1
2023-06-01,53525,7,1,8,3,3,4
2023-06-01,32364,6,0,6,1,0,1
2023-06-01,205157,7,5,12,5,1,5
2023-06-01,26123,4,1,5,2,1,2
2023-06-01,62624,1,0,1,1,0,1
2023-06-01,393958,2,0,2,1,0,1
2023-06-01,398839,9,0,9,2,0,2
2023-06-01,397919,1,1,2,2,1,2
2023-06-01,40786,0,0,0,3,3,4
2023-06-01,398831,1,0,1,1,0,1
2023-06-01,47037,1,0,1,1,0,1
2023-06-01,62693,2,0,2,4,0,4
2023-06-01,398783,1,0,1,1,0,1
2023-06-01,395423,2,1,3,2,2,2
2023-06-01,394672,3,0,3,2,0,2
2023-06-01,55394,5,2,7,3,2,3
2023-06-01,400114,1,0,1,1,0,1
2023-06-01,21767,15,0,15,3,0,3
2023-06-01,29840,4,0,4,3,0,3
2023-06-01,19999,3,0,3,3,0,3
2023-06-01,400102,1,0,1,3,0,3
2023-06-01,399999,2,0,2,2,0,2
2023-06-01,22980,1,0,1,1,0,1
2023-06-01,399922,1,0,1,1,0,1
2023-06-01,399983,1,0,1,1,0,1
2023-06-01,399325,1,0,1,3,0,3
2023-06-01,400047,2,0,2,1,0,1
2023-06-01,400313,1,0,1,1,0,1
2023-06-01,27242,1,0,1,1,0,1
2023-06-01,25910,1,0,1,1,0,1
2023-06-01,40417,3,1,4,5,2,5
2023-06-01,398381,2,0,2,1,0,1
2023-06-01,30117,1,0,1,2,0,2
2023-06-01,400416,4,0,4,3,0,3
2023-06-01,21779,3,0,3,2,0,2
2023-06-01,10349,10,2,12,4,2,4
2023-06-01,26002,8,0,8,1,0,1
2023-06-01,23294,7,1,8,1,1,1
2023-06-01,23207,6,0,6,1,0,1
2023-06-01,396992,1,0,1,1,0,1
2023-06-01,26333,6,0,6,1,0,1
2023-06-01,22985,13,0,13,3,0,3
2023-06-01,54529,2,0,2,3,0,3
2023-06-01,30564,2,0,2,3,0,3
2023-06-01,26303,4,0,4,1,0,1
2023-06-01,2055,11,3,14,1,1,1
2023-06-01,394891,1,0,1,1,0,1
2023-06-01,40944,3,0,3,2,0,2
2023-06-01,53472,1,0,1,4,0,4
2023-06-01,395442,1,0,1,1,0,1
2023-06-01,29718,1,0,1,1,0,1
2023-06-01,200484,105,0,105,1,0,1
2023-06-01,33849,3,0,3,5,0,5
2023-06-01,35030,5,0,5,4,0,4
2023-06-01,48424,35,1,36,12,4,12
2023-06-01,211306,12,0,12,1,0,1
2023-06-01,202183,1,0,1,1,0,1
2023-06-01,206070,6,0,6,3,0,3
2023-06-01,42586,15,0,15,1,0,1
2023-06-01,204471,3,2,5,3,4,4
2023-06-01,213202,2,0,2,3,0,3
2023-06-01,211007,4,1,5,2,2,2
2023-06-01,201127,4,2,6,1,1,1
2023-06-01,8615,9,0,9,16,0,16
2023-06-01,34747,9,0,9,1,0,1
2023-06-01,1030,2,2,4,1,1,2
2023-06-01,42003,76,8,84,1,1,1
2023-06-01,35191,4,1,5,4,1,4
2023-06-01,21017,11,0,11,2,0,2
2023-06-01,41676,9,0,9,5,0,5
2023-06-01,41931,9,0,9,5,0,5
2023-06-01,25500,3,1,4,5,2,5
2023-06-01,50225,15,0,15,1,0,1
2023-06-01,21437,11,0,11,5,0,5
2023-06-01,204197,1,0,1,1,0,1
2023-06-01,25515,16,1,17,6,1,6
2023-06-01,44237,6,2,8,1,1,1
2023-06-01,201769,9,0,9,1,0,1
2023-06-01,16202,13,7,20,3,2,3
2023-06-01,199896,1,0,1,2,0,2
2023-06-01,42402,5,0,5,4,0,4
2023-06-01,204063,1,0,1,2,0,2
2023-06-01,205708,5,0,5,2,0,2
2023-06-01,202050,14,0,14,5,0,5
2023-06-01,207329,1,0,1,1,0,1
2023-06-01,213147,1,0,1,1,0,1
2023-06-01,210910,1,0,1,1,0,1
2023-06-01,28732,2,0,2,3,0,3
2023-06-01,213144,2,0,2,2,0,2
2023-06-01,212163,1,0,1,1,0,1
2023-06-01,51337,2,0,2,4,0,4
2023-06-01,213174,2,0,2,1,0,1
2023-06-01,212915,1,0,1,1,0,1
2023-06-01,207033,3,0,3,3,0,3
2023-06-01,210220,5,1,6,5,4,6
2023-06-01,198408,2,5,7,6,4,10
2023-06-01,51769,2,0,2,3,0,3
2023-06-01,213310,1,0,1,1,0,1
2023-06-01,210407,1,0,1,2,0,2
2023-06-01,42877,7,0,7,6,0,6
2023-06-01,210959,2,1,3,1,2,2
2023-06-01,210866,1,0,1,3,0,3
2023-06-01,210379,1,0,1,2,0,2
2023-06-01,210406,1,0,1,2,0,2
2023-06-01,211516,1,0,1,2,0,2
2023-06-01,209066,1,0,1,3,0,3
2023-06-01,60496,25,0,25,1,0,1
2023-06-01,204890,4,0,4,6,0,6
2023-06-01,44933,5,1,6,2,1,2
2023-06-01,29687,165,0,165,8,0,8
2023-06-01,2111,1,0,1,1,0,1
2023-06-01,60092,4,4,8,3,3,4
2023-06-01,57619,7,0,7,5,0,5
2023-06-01,42215,1,0,1,1,0,1
2023-06-01,44062,1,0,1,2,0,2
2023-06-01,34606,11,1,12,6,3,6
2023-06-01,2259,5,0,5,1,0,1
2023-06-01,42236,6,1,7,2,1,2
2023-06-01,1835,5,3,8,11,7,11
2023-06-01,42252,3,1,4,1,1,1
2023-06-01,42310,6,3,9,4,4,5
2023-06-01,51479,1,1,2,1,1,1
2023-06-01,42325,3,0,3,3,0,3
2023-06-01,197252,3,0,3,3,0,3
2023-06-01,42416,16,2,18,2,2,2
2023-06-01,42421,6,1,7,3,1,3
2023-06-01,42435,1,0,1,1,0,1
2023-06-01,209917,1,0,1,2,0,2
2023-06-01,200801,1,0,1,2,0,2
2023-06-01,8674,18,10,28,41,20,43
2023-06-01,20650,18,0,18,2,0,2
2023-06-01,41190,8,0,8,1,0,1
2023-06-01,41508,20,0,20,9,0,9
2023-06-01,56628,2,1,3,6,3,8
2023-06-01,42484,3,1,4,3,1,3
2023-06-01,205045,1,0,1,1,0,1
2023-06-01,202247,1,1,2,1,1,1
2023-06-01,42515,2,0,2,2,0,2
2023-06-01,43317,6,2,8,5,4,5
2023-06-01,42532,12,2,14,3,3,3
2023-06-01,197876,9,1,10,2,1,2
2023-06-01,202046,4,1,5,7,1,7
2023-06-01,28789,5,0,5,4,0,4
2023-06-01,42584,5,0,5,2,0,2
2023-06-01,50386,2,0,2,2,0,2
2023-06-01,42579,6,2,8,4,2,4
2023-06-01,30468,1,0,1,1,0,1
2023-06-01,29726,1,0,1,2,0,2
2023-06-01,30467,1,0,1,2,0,2
2023-06-01,50656,2,0,2,1,0,1
2023-06-01,41471,3,0,3,1,0,1
2023-06-01,42684,1,0,1,2,0,2
2023-06-01,41215,1,0,1,2,0,2
2023-06-01,6412,182,0,182,10,3,10
2023-06-01,42781,111,1,112,16,1,16
2023-06-01,42028,2,0,2,3,0,3
2023-06-01,20905,4,4,8,2,2,2
2023-06-01,42716,1,0,1,1,0,1
2023-06-01,43284,6,2,8,4,4,4
2023-06-01,42840,2,0,2,2,0,2
2023-06-01,42748,2,0,2,1,0,1
2023-06-01,35768,2,0,2,2,0,2
2023-06-01,42753,1,0,1,1,0,1
2023-06-01,8312,10,1,11,1,1,1
2023-06-01,42770,7,0,7,2,0,2
2023-06-01,206850,2,0,2,3,0,3
2023-06-01,42851,3,0,3,2,0,2
2023-06-01,21429,1,0,1,2,0,2
2023-06-01,43127,2,1,3,2,2,2
2023-06-01,43382,1,1,2,2,2,3
2023-06-01,200107,19,19,38,14,15,18
2023-06-01,41983,4,1,5,2,1,2
2023-06-01,42988,1,0,1,4,0,4
2023-06-01,202243,3,0,3,1,0,1
2023-06-01,56538,3,0,3,2,0,2
2023-06-01,48335,1,0,1,1,0,1
2023-06-01,43179,3,0,3,1,0,1
2023-06-01,33811,3,1,4,5,1,5
2023-06-01,42860,3,0,3,2,0,2
2023-06-01,42882,8,1,9,1,1,1
2023-06-01,12447,2,0,2,5,0,5
2023-06-01,42887,1,0,1,1,0,1
2023-06-01,43460,1,1,2,1,1,1
2023-06-01,43037,6,6,12,8,9,11
2023-06-01,42903,4,1,5,3,2,3
2023-06-01,43019,15,1,16,2,1,2
2023-06-01,42917,1,0,1,1,0,1
2023-06-01,42919,3,0,3,2,0,2
2023-06-01,42944,7,0,7,2,0,2
2023-06-01,43247,23,1,24,6,2,6
2023-06-01,42972,2,0,2,2,0,2
2023-06-01,35703,3,1,4,2,2,2
2023-06-01,43716,1,0,1,1,0,1
2023-06-01,206577,1,0,1,2,0,2
2023-06-01,211122,2,0,2,4,0,4
2023-06-01,31029,20,0,20,11,0,11
2023-06-01,20750,4,0,4,3,0,3
2023-06-01,13306,22,1,23,2,1,2
2023-06-01,49849,32,0,32,7,0,7
2023-06-01,34074,1,0,1,3,0,3
2023-06-01,47874,1,0,1,2,0,2
2023-06-01,47771,18,0,18,1,0,1
2023-06-01,8190,37,2,39,5,1,5
2023-06-01,34569,31,0,31,15,0,15
2023-06-01,61071,13,0,13,4,0,4
2023-06-01,15685,64,1,65,11,7,13
2023-06-01,209369,2,1,3,5,4,5
2023-06-01,62323,1,0,1,1,0,1
2023-06-01,39013,12,0,12,1,0,1
2023-06-01,208617,3,0,3,1,0,1
2023-06-01,24748,2,0,2,1,0,1
2023-06-01,209409,1,0,1,3,0,3
2023-06-01,205308,3,0,3,4,0,4
2023-06-01,201615,1,0,1,3,0,3
2023-06-01,41097,4,0,4,4,0,4
2023-06-01,202904,1,0,1,3,0,3
2023-06-01,28893,2,0,2,2,0,2
2023-06-01,197474,2,0,2,3,0,3
2023-06-01,44175,2,0,2,4,0,4
2023-06-01,207206,1,0,1,2,0,2
2023-06-01,202081,3,0,3,5,0,5
2023-06-01,760,7,0,7,2,2,2
2023-06-01,59835,4,1,5,5,3,5
2023-06-01,56430,12,6,18,6,5,8
2023-06-01,48592,5,0,5,1,0,1
2023-06-01,61077,1,0,1,1,0,1
2023-06-01,60403,1,0,1,1,0,1
2023-06-01,204157,3,0,3,2,0,2
2023-06-01,60408,1,0,1,2,0,2
2023-06-01,39312,3,0,3,2,0,2
2023-06-01,59854,8,0,8,1,0,1
2023-06-01,51162,7,0,7,9,0,9
2023-06-01,210459,1,0,1,1,0,1
2023-06-01,33911,8,0,8,3,0,3
2023-06-01,13209,2,0,2,2,0,2
2023-06-01,39815,6,0,6,2,0,2
2023-06-01,34974,14,0,14,3,0,3
2023-06-01,34584,17,0,17,2,0,2
2023-06-01,61324,1,0,1,4,0,4
2023-06-01,201133,14,0,14,9,0,9
2023-06-01,35042,1,0,1,1,0,1
2023-06-01,209739,2,0,2,3,0,3
2023-06-01,16003,2,0,2,2,0,2
2023-06-01,204776,7,0,7,1,0,1
2023-06-01,201684,4,1,5,3,3,4
2023-06-01,209726,5,0,5,2,0,2
2023-06-01,44345,1,0,1,2,0,2
2023-06-01,35119,1,0,1,2,0,2
2023-06-01,50024,1,0,1,2,0,2
2023-06-01,52086,1,0,1,3,0,3
2023-06-01,200409,11,1,12,5,5,6
2023-06-01,213363,2,0,2,1,0,1
2023-06-01,209731,1,0,1,2,0,2
2023-06-01,205718,9,9,18,4,1,4
2023-06-01,209561,6,1,7,2,2,2
2023-06-01,43341,9,4,13,9,6,10
2023-06-01,48696,11,0,11,1,0,1
2023-06-01,38946,1,5,6,7,5,9
2023-06-01,202015,11,5,16,2,2,2
2023-06-01,199837,8,2,10,7,4,7
2023-06-01,42081,7,2,9,2,2,2
2023-06-01,50495,10,1,11,1,1,1
2023-06-01,53107,18,0,18,5,0,5
2023-06-01,35632,3,0,3,2,0,2
2023-06-01,207371,1,0,1,1,0,1
2023-06-01,8795,6,0,6,2,0,2
2023-06-01,208579,1,0,1,2,0,2
2023-06-01,212561,1,0,1,1,0,1
2023-06-01,203390,1,0,1,2,0,2
2023-06-01,42763,3,0,3,4,0,4
2023-06-01,198424,7,0,7,5,0,5
2023-06-01,42838,1,0,1,2,0,2
2023-06-01,210115,1,0,1,1,0,1
2023-06-01,44194,4,13,17,5,3,5
2023-06-01,51373,19,2,21,7,2,7
2023-06-01,203210,14,0,14,1,0,1
2023-06-01,34530,7,1,8,4,3,4
2023-06-01,42154,2,0,2,1,0,1
2023-06-01,41771,3,0,3,1,0,1
2023-06-01,49719,1,0,1,4,0,4
2023-06-01,43376,14,5,19,9,3,9
2023-06-01,42423,3,0,3,6,0,6
2023-06-01,43182,10,1,11,3,2,3
2023-06-01,29069,6,0,6,1,0,1
2023-06-01,200150,2,0,2,2,0,2
2023-06-01,210913,1,1,2,1,1,1
2023-06-01,49071,5,0,5,2,0,2
2023-06-01,43338,12,0,12,8,0,8
2023-06-01,203085,1,1,2,1,1,1
2023-06-01,203829,1,1,2,1,1,1
2023-06-01,20792,3,1,4,7,1,7
2023-06-01,25393,6,2,8,7,3,7
2023-06-01,43404,2,1,3,13,7,15
2023-06-01,43420,6,1,7,3,1,3
2023-06-01,49234,6,0,6,1,0,1
2023-06-01,51400,1,1,2,4,3,4
2023-06-01,51800,1,1,2,7,3,7
2023-06-01,31445,14,0,14,9,0,9
2023-06-01,3252,2,0,2,12,0,12
2023-06-01,29534,8,0,8,2,0,2
2023-06-01,31423,6,0,6,3,0,3
2023-06-01,202725,2,0,2,2,0,2
2023-06-01,210175,1,0,1,7,0,7
2023-06-01,42821,17,2,19,1,1,1
2023-06-01,208911,4,1,5,1,1,1
2023-06-01,199417,2,0,2,1,0,1
2023-06-01,50260,1,0,1,1,0,1
2023-06-01,205983,2,0,2,1,0,1
2023-06-01,207168,4,0,4,4,0,4
2023-06-01,64419,11,0,11,4,0,4
2023-06-01,43012,2,1,3,3,2,3
2023-06-01,199420,3,1,4,2,1,2
2023-06-01,47233,1,0,1,1,0,1
2023-06-01,35825,9,0,9,3,0,3
2023-06-01,30975,3,1,4,10,1,10
2023-06-01,42216,4,0,4,2,0,2
2023-06-01,206558,1,0,1,1,0,1
2023-06-01,44620,2,1,3,2,1,2
2023-06-01,43293,1,0,1,7,0,7
2023-06-01,48322,4,0,4,1,0,1
2023-06-01,50983,1,0,1,3,0,3
2023-06-01,41411,1,0,1,1,0,1
2023-06-01,51259,2,1,3,3,3,3
2023-06-01,30721,5,2,7,4,4,4
2023-06-01,21166,2,0,2,2,0,2
2023-06-01,21062,5,0,5,1,0,1
2023-06-01,60772,10,1,11,5,3,5
2023-06-01,8528,18,2,20,3,1,3
2023-06-01,43030,2,0,2,1,0,1
2023-06-01,43020,1,0,1,1,0,1
2023-06-01,43024,1,0,1,2,0,2
2023-06-01,199422,3,3,6,4,5,6
2023-06-01,43087,1,0,1,1,0,1
2023-06-01,50078,2,0,2,7,0,7
2023-06-01,51713,2,0,2,1,0,1
2023-06-01,16303,1,0,1,5,0,5
2023-06-01,209318,2,2,4,1,1,1
2023-06-01,29282,3,1,4,2,2,2
2023-06-01,44762,1,0,1,2,0,2
2023-06-01,39449,4,0,4,4,0,4
2023-06-01,44898,11,0,11,1,0,1
2023-06-01,41965,10,0,10,2,0,2
2023-06-01,205368,6,0,6,4,0,4
2023-06-01,39235,3,1,4,1,1,1
2023-06-01,43152,18,0,18,4,0,4
2023-06-01,43185,1,0,1,2,0,2
2023-06-01,25332,3,0,3,2,0,2
2023-06-01,3222,5,0,5,1,0,1
2023-06-01,43190,3,1,4,9,5,10
2023-06-01,205207,5,0,5,1,0,1
2023-06-01,204812,1,0,1,1,0,1
2023-06-01,208798,1,0,1,1,0,1
2023-06-01,52116,41,0,41,2,0,2
2023-06-01,42621,3,0,3,1,0,1
2023-06-01,42031,10,0,10,7,0,7
2023-06-01,38984,11,0,11,3,0,3
2023-06-01,58024,7,0,7,2,0,2
2023-06-01,56862,6,0,6,3,0,3
2023-06-01,39709,2,0,2,5,0,5
2023-06-01,210443,1,0,1,2,0,2
2023-06-01,25446,1,1,2,1,1,1
2023-06-01,42110,19,0,19,2,0,2
2023-06-01,42561,2,0,2,1,0,1
2023-06-01,43199,1,0,1,2,0,2
2023-06-01,39252,1,0,1,2,0,2
2023-06-01,202674,1,0,1,1,0,1
2023-06-01,35728,148,0,148,1,0,1
2023-06-01,42396,37,0,37,11,0,11
2023-06-01,34610,23,0,23,2,0,2
2023-06-01,35629,23,0,23,2,0,2
2023-06-01,206814,4,1,5,5,1,5
2023-06-01,201450,1,1,2,1,1,1
2023-06-01,206625,1,0,1,1,0,1
2023-06-01,200077,4,0,4,4,0,4
2023-06-01,198736,9,0,9,8,0,8
2023-06-01,205016,4,3,7,5,4,5
2023-06-01,205515,14,0,14,3,0,3
2023-06-01,42632,37,5,42,6,6,8
2023-06-01,45007,10,0,10,1,0,1
2023-06-01,51898,1,0,1,1,0,1
2023-06-01,207446,1,1,2,3,1,3
2023-06-01,204827,1,0,1,2,0,2
2023-06-01,207353,10,0,10,10,0,10
2023-06-01,42699,2,1,3,4,4,5
2023-06-01,62310,2,1,3,3,4,4
2023-06-01,200964,11,1,12,2,3,3
2023-06-01,42769,1,0,1,1,0,1
2023-06-01,30968,8,0,8,2,0,2
2023-06-01,42876,4,0,4,1,0,1
2023-06-01,42751,1,0,1,1,0,1
2023-06-01,44112,16,1,17,5,2,5
2023-06-01,35295,6,1,7,1,1,1
2023-06-01,206557,7,1,8,3,3,3
2023-06-01,28919,19,2,21,4,3,4
2023-06-01,198272,4,0,4,4,0,4
2023-06-01,34169,7,0,7,5,0,5
2023-06-01,207694,3,0,3,3,0,3
2023-06-01,47110,5,1,6,6,1,6
2023-06-01,205191,4,0,4,2,0,2
2023-06-01,200165,11,2,13,4,1,4
2023-06-01,204337,1,0,1,2,0,2
2023-06-01,212441,25,2,27,2,2,2
2023-06-01,57120,1,0,1,4,0,4
2023-06-01,50126,9,0,9,3,0,3
2023-06-01,198406,7,0,7,3,0,3
2023-06-01,59440,1,0,1,2,0,2
2023-06-01,49910,2,8,10,6,4,7
2023-06-01,42478,20,0,20,3,0,3
2023-06-01,42117,3,0,3,1,0,1
2023-06-01,201291,5,0,5,2,0,2
2023-06-01,49113,4,1,5,2,2,2
2023-06-01,42885,2,0,2,2,0,2
2023-06-01,34482,3,0,3,1,0,1
2023-06-01,42289,9,0,9,3,0,3
2023-06-01,42539,5,0,5,2,0,2
2023-06-01,210750,1,0,1,2,0,2
2023-06-01,210380,1,0,1,1,0,1
2023-06-01,12384,2,0,2,1,0,1
2023-06-01,9113,3,1,4,2,1,2
2023-06-01,13296,9,0,9,2,0,2
2023-06-01,198774,4,0,4,1,0,1
2023-06-01,29037,21,3,24,14,9,16
2023-06-01,51431,14,0,14,4,0,4
2023-06-01,209836,12,1,13,2,1,2
2023-06-01,60627,8,1,9,4,1,4
2023-06-01,47493,1,1,2,4,3,4
2023-06-01,201536,9,9,18,3,1,3
2023-06-01,39135,4,0,4,1,0,1
2023-06-01,34550,11,0,11,7,0,7
2023-06-01,14778,3,4,7,4,1,4
2023-06-01,203070,3,1,4,1,1,1
2023-06-01,42429,8,0,8,2,0,2
2023-06-01,39799,8,0,8,2,0,2
2023-06-01,44257,26,0,26,4,0,4
2023-06-01,34066,12,0,12,8,0,8
2023-06-01,47234,7,0,7,2,0,2
2023-06-01,42943,29,2,31,3,1,3
2023-06-01,56865,6,0,6,2,0,2
2023-06-01,43316,3,0,3,2,0,2
2023-06-01,42245,1,0,1,2,0,2
2023-06-01,42309,1,0,1,1,0,1
2023-06-01,42300,11,0,11,3,0,3
2023-06-01,34326,5,0,5,3,0,3
2023-06-01,50196,1,0,1,2,0,2
2023-06-01,44011,1,0,1,1,0,1
2023-06-01,34033,1,0,1,3,0,3
2023-06-01,206419,1,0,1,3,0,3
2023-06-01,42516,4,0,4,5,0,5
2023-06-01,48673,1,0,1,1,0,1
2023-06-01,210130,3,0,3,1,0,1
2023-06-01,44858,13,1,14,10,6,10
2023-06-01,28747,4,1,5,1,1,1
2023-06-01,42386,4,0,4,1,0,1
2023-06-01,2848,3,1,4,2,2,3
2023-06-01,42364,1,0,1,1,0,1
2023-06-01,13070,2,0,2,1,0,1
2023-06-01,200030,12,1,13,4,3,5
2023-06-01,42517,5,1,6,5,4,5
2023-06-01,42451,9,1,10,5,1,6
2023-06-01,39266,2,0,2,4,0,4
2023-06-01,42463,1,1,2,4,3,4
2023-06-01,41046,8,2,10,1,1,1
2023-06-01,42669,1,1,2,2,2,2
2023-06-01,204782,2,0,2,1,0,1
2023-06-01,208800,19,1,20,5,1,5
2023-06-01,44266,5,0,5,5,0,5
2023-06-01,42697,6,5,11,3,3,3
2023-06-01,60549,1,0,1,1,0,1
2023-06-01,20969,4,0,4,10,0,10
2023-06-01,200701,2,0,2,1,0,1
2023-06-01,42818,1,0,1,2,0,2
2023-06-01,42779,3,0,3,1,0,1
2023-06-01,42713,4,0,4,1,0,1
2023-06-01,31424,17,7,24,15,8,17
2023-06-01,42777,1,1,2,1,1,1
2023-06-01,60281,2,0,2,3,0,3
2023-06-01,209006,1,0,1,3,0,3
2023-06-01,39931,3,1,4,4,3,4
2023-06-01,42868,20,0,20,1,0,1
2023-06-01,41622,4,1,5,2,1,2
2023-06-01,13257,9,0,9,1,0,1
2023-06-01,39264,32,1,33,6,1,6
2023-06-01,42907,14,0,14,2,0,2
2023-06-01,42968,3,0,3,4,0,4
2023-06-01,56696,15,0,15,1,0,1
2023-06-01,42965,7,1,8,8,8,10
2023-06-01,21254,6,0,6,1,0,1
2023-06-01,49072,1,0,1,1,0,1
2023-06-01,208397,15,0,15,3,0,3
2023-06-01,42808,7,0,7,3,0,3
2023-06-01,39115,1,0,1,2,0,2
2023-06-01,31590,12,1,13,3,2,3
2023-06-01,199276,8,1,9,2,1,2
2023-06-01,39724,4,1,5,2,1,2
2023-06-01,62217,18,19,37,8,7,9
2023-06-01,43568,4,1,5,4,2,4
2023-06-01,20807,28,0,28,1,0,1
2023-06-01,43275,9,0,9,1,0,1
2023-06-01,43248,1,0,1,6,0,6
2023-06-01,61237,1,0,1,2,0,2
2023-06-01,43272,11,0,11,1,0,1
2023-06-01,197790,11,1,12,14,5,15
2023-06-01,43537,1,0,1,1,0,1
2023-06-01,35189,2,2,4,1,1,1
2023-06-01,43937,76,2,78,10,2,10
2023-06-01,43749,1,0,1,1,0,1
2023-06-01,43586,6,10,16,3,2,3
2023-06-01,3266,3,2,5,1,1,1
2023-06-01,50475,1,1,2,3,2,3
2023-06-01,43611,1,0,1,1,0,1
2023-06-01,44971,1,2,3,1,1,1
2023-06-01,203918,3,1,4,2,1,2
2023-06-01,43655,5,1,6,2,1,2
2023-06-01,21446,3,1,4,8,2,8
2023-06-01,34409,12,1,13,7,4,7
2023-06-01,35377,4,0,4,3,0,3
2023-06-01,43682,1,0,1,2,0,2
2023-06-01,200410,3,0,3,5,0,5
2023-06-01,201218,1,0,1,1,0,1
2023-06-01,209350,1,1,2,1,1,1
2023-06-01,208906,1,1,2,1,1,1
2023-06-01,43734,2,0,2,3,0,3
2023-06-01,28994,6,1,7,12,1,13
2023-06-01,208558,1,0,1,3,0,3
2023-06-01,41685,2,0,2,5,0,5
2023-06-01,42489,2,0,2,2,0,2
2023-06-01,210716,1,0,1,1,0,1
2023-06-01,202204,9,2,11,2,1,2
2023-06-01,202896,4,0,4,5,0,5
2023-06-01,49709,2,1,3,8,3,8
2023-06-01,39479,4,2,6,7,6,8
2023-06-01,15683,7,1,8,1,1,1
2023-06-01,44914,7,1,8,9,2,9
2023-06-01,13092,7,1,8,6,2,6
2023-06-01,43752,1,0,1,1,0,1
2023-06-01,204380,1,0,1,2,0,2
2023-06-01,207124,1,0,1,2,0,2
2023-06-01,3239,0,0,0,7,0,7
2023-06-01,42580,4,1,5,1,1,1
2023-06-01,8771,9,1,10,1,1,1
2023-06-01,43728,1,0,1,3,0,3
2023-06-01,43670,5,0,5,3,0,3
2023-06-01,43757,2,1,3,3,1,3
2023-06-01,15703,21,5,26,14,7,14
2023-06-01,44046,1,0,1,3,0,3
2023-06-01,57476,3,0,3,4,0,4
2023-06-01,8423,11,3,14,6,5,6
2023-06-01,44124,10,1,11,7,5,7
2023-06-01,44692,19,0,19,2,0,2
2023-06-01,199136,3,0,3,4,0,4
2023-06-01,199138,1,0,1,2,0,2
2023-06-01,35292,3,1,4,1,1,1
2023-06-01,197287,10,0,10,1,0,1
2023-06-01,62360,1,0,1,2,0,2
2023-06-01,197643,9,0,9,3,0,3
2023-06-01,202296,33,0,33,2,0,2
2023-06-01,209620,5,6,11,2,2,2
2023-06-01,56467,9,8,17,1,1,1
2023-06-01,199093,1,0,1,1,0,1
2023-06-01,200807,5,1,6,3,1,3
2023-06-01,59572,0,0,0,2,0,2
2023-06-01,212657,1,0,1,3,0,3
2023-06-01,197225,2,0,2,2,0,2
2023-06-01,9147,48,0,48,4,0,4
2023-06-01,49986,1,0,1,1,0,1
2023-06-01,43494,8,0,8,1,0,1
2023-06-01,50807,9,0,9,1,0,1
2023-06-01,211956,2,1,3,2,1,2
2023-06-01,57487,9,4,13,9,3,10
2023-06-01,12976,5,1,6,2,1,2
2023-06-01,49503,7,2,9,1,1,1
2023-06-01,43318,1,0,1,1,0,1
2023-06-01,51664,8,0,8,3,0,3
2023-06-01,39605,8,2,10,6,7,9
2023-06-01,20697,2,0,2,3,0,3
2023-06-01,209631,1,0,1,5,0,5
2023-06-01,41364,24,1,25,12,3,12
2023-06-01,62015,3,0,3,2,0,2
2023-06-01,206383,2,0,2,4,0,4
2023-06-01,45839,37,1,38,9,1,9
2023-06-01,35110,3,0,3,2,0,2
2023-06-01,43824,16,3,19,1,1,1
2023-06-01,20751,9,0,9,9,0,9
2023-06-01,12971,1,0,1,3,0,3
2023-06-01,31239,4,0,4,1,0,1
2023-06-01,57174,4,0,4,10,0,10
2023-06-01,209759,6,0,6,2,0,2
2023-06-01,210989,1,0,1,1,0,1
2023-06-01,29038,1,0,1,3,0,3
2023-06-01,29626,2,0,2,1,0,1
2023-06-01,44070,2,1,3,1,1,1
2023-06-01,43413,2,0,2,4,0,4
2023-06-01,48022,1,0,1,2,0,2
2023-06-01,24787,2,0,2,2,0,2
2023-06-01,208086,2,2,4,2,2,2
2023-06-01,209966,5,0,5,2,0,2
2023-06-01,31383,2,1,3,9,5,10
2023-06-01,202205,11,0,11,1,0,1
2023-06-01,42187,6,1,7,6,1,6
2023-06-01,208407,2,1,3,4,3,4
2023-06-01,35492,3,1,4,3,3,3
2023-06-01,31367,16,0,16,3,0,3
2023-06-01,42685,3,2,5,1,1,1
2023-06-01,47515,7,1,8,3,1,3
2023-06-01,43521,5,0,5,3,0,3
2023-06-01,43527,5,0,5,3,0,3
2023-06-01,209352,5,0,5,3,0,3
2023-06-01,209351,1,0,1,1,0,1
2023-06-01,198390,1,0,1,1,0,1
2023-06-01,50800,1,0,1,2,0,2
2023-06-01,8879,8,1,9,11,5,12
2023-06-01,29217,21,3,24,4,3,4
2023-06-01,13001,2,0,2,2,0,2
2023-06-01,16301,5,0,5,1,0,1
2023-06-01,209736,1,0,1,3,0,3
2023-06-01,60966,7,0,7,2,0,2
2023-06-01,206410,2,0,2,2,0,2
2023-06-01,51581,3,1,4,3,3,3
2023-06-01,198280,2,0,2,3,0,3
2023-06-01,203312,3,0,3,3,0,3
2023-06-01,201326,2,0,2,2,0,2
2023-06-01,202357,1,0,1,3,0,3
2023-06-01,200458,1,0,1,2,0,2
2023-06-01,56539,1,0,1,2,0,2
2023-06-01,49421,1,1,2,2,1,2
2023-06-01,1120,2,2,4,6,3,7
2023-06-01,49172,3,0,3,1,0,1
2023-06-01,44945,2,0,2,2,0,2
2023-06-01,43362,15,0,15,3,0,3
2023-06-01,62160,4,1,5,5,4,5
2023-06-01,210300,5,0,5,2,0,2
2023-06-01,206502,2,1,3,3,1,3
2023-06-01,204995,3,1,4,8,6,10
2023-06-01,12502,4,2,6,12,4,12
2023-06-01,59775,4,1,5,2,2,3
2023-06-01,34306,3,0,3,1,0,1
2023-06-01,49040,26,0,26,5,0,5
2023-06-01,59484,9,0,9,2,0,2
2023-06-01,203917,2,0,2,6,0,6
2023-06-01,51855,3,0,3,3,0,3
2023-06-01,39251,90,1,91,13,6,16
2023-06-01,49188,11,0,11,5,0,5
2023-06-01,44967,5,0,5,3,0,3
2023-06-01,41665,8,0,8,4,0,4
2023-06-01,34948,2,0,2,1,0,1
2023-06-01,43277,4,0,4,2,0,2
2023-06-01,34552,4,0,4,3,0,3
2023-06-01,201749,13,2,15,6,1,6
2023-06-01,198169,6,0,6,4,0,4
2023-06-01,207811,0,0,0,12,3,12
2023-06-01,50880,20,0,20,3,0,3
2023-06-01,198776,3,1,4,2,2,2
2023-06-01,31507,4,1,5,2,1,2
2023-06-01,34513,43,0,43,3,0,3
2023-06-01,43566,9,0,9,10,0,10
2023-06-01,43687,1,0,1,2,0,2
2023-06-01,49801,8,2,10,5,1,5
2023-06-01,41227,9,0,9,2,0,2
2023-06-01,30902,7,0,7,1,0,1
2023-06-01,44410,1,0,1,1,0,1
2023-06-01,20649,15,0,15,1,0,1
2023-06-01,34351,8,0,8,1,0,1
2023-06-01,31343,3,1,4,3,1,3
2023-06-01,8877,2,0,2,1,0,1
2023-06-01,60656,22,0,22,1,0,1
2023-06-01,202968,1,0,1,1,0,1
2023-06-01,207172,1,0,1,1,0,1
2023-06-01,203380,19,3,22,10,3,10
2023-06-01,205085,8,0,8,1,0,1
2023-06-01,202325,1,1,2,1,1,1
2023-06-01,209160,1,0,1,1,0,1
2023-06-01,48900,3,0,3,1,0,1
2023-06-01,47647,1,0,1,1,0,1
2023-06-01,15362,1,0,1,3,0,3
2023-06-01,20960,5,1,6,5,2,6
2023-06-01,5532,23,0,23,5,0,5
2023-06-01,2590,6,1,7,5,3,5
2023-06-01,211746,1,0,1,2,0,2
2023-06-01,39816,12,1,13,7,2,7
2023-06-01,41464,2,0,2,2,0,2
2023-06-01,198289,1,0,1,2,0,2
2023-06-01,206957,18,0,18,4,0,4
2023-06-01,197848,2,0,2,3,0,3
2023-06-01,198591,2,0,2,4,0,4
2023-06-01,200673,1,0,1,1,0,1
2023-06-01,210410,1,0,1,1,0,1
2023-06-01,211711,2,0,2,1,0,1
2023-06-01,51801,2,0,2,2,0,2
2023-06-01,210943,1,0,1,1,0,1
2023-06-01,47721,8,0,8,2,0,2
2023-06-01,57922,2,0,2,1,0,1
2023-06-01,213083,2,0,2,1,0,1
2023-06-01,8685,54,1,55,4,1,4
2023-06-01,210388,6,0,6,1,0,1
2023-06-01,205192,4,0,4,6,0,6
2023-06-01,211859,2,0,2,2,0,2
2023-06-01,44717,3,0,3,3,0,3
2023-06-01,210791,18,0,18,3,0,3
2023-06-01,49980,4,0,4,1,0,1
2023-06-01,33892,7,0,7,3,0,3
2023-06-01,25520,2,1,3,4,2,4
2023-06-01,57731,0,0,0,2,0,2
2023-06-01,25228,12,0,12,1,0,1
2023-06-01,200220,2,1,3,1,1,1
2023-06-01,138607,24,0,24,5,0,5
2023-06-01,54913,8,1,9,2,2,2
2023-06-01,204410,9,2,11,3,2,3
2023-06-01,48951,30,17,47,8,8,8
2023-06-01,200362,3,0,3,4,0,4
2023-06-01,50258,4,0,4,3,0,3
2023-06-01,204077,4,0,4,2,0,2
2023-06-01,200643,1,1,2,2,2,2
2023-06-01,50230,1,0,1,1,0,1
2023-06-01,205717,5,1,6,3,2,3
2023-06-01,212675,3,1,4,1,1,1
2023-06-01,210552,2,0,2,3,0,3
2023-06-01,211542,1,0,1,2,0,2
2023-06-01,200459,1,0,1,1,0,1
2023-06-01,44476,5,0,5,1,0,1
2023-06-01,34754,79,0,79,2,0,2
2023-06-01,42805,1,0,1,1,0,1
2023-06-01,48452,48,0,48,10,0,10
2023-06-01,35579,8,1,9,4,3,4
2023-06-01,209887,4,0,4,2,0,2
2023-06-01,60362,3,4,7,7,4,7
2023-06-01,47737,2,0,2,5,0,5
2023-06-01,209892,3,0,3,2,0,2
2023-06-01,212107,1,0,1,1,0,1
2023-06-01,35226,10,0,10,1,0,1
2023-06-01,397065,2,0,2,2,0,2
2023-06-01,399578,1,0,1,2,0,2
2023-06-01,35370,29,9,38,4,4,4
2023-06-01,49944,1,0,1,1,0,1
2023-06-01,29319,6,0,6,14,0,14
2023-06-01,28738,8,0,8,3,0,3
2023-06-01,44116,2,0,2,1,0,1
2023-06-01,62067,4,0,4,6,0,6
2023-06-01,49469,7,0,7,1,0,1
2023-06-01,34173,6,1,7,3,3,3
2023-06-01,62057,1,0,1,3,0,3
2023-06-01,8352,4,0,4,1,0,1
2023-06-01,24620,7,1,8,1,1,1
2023-06-01,43435,1,0,1,2,0,2
2023-06-01,35239,2,0,2,2,0,2
2023-06-01,61976,4,1,5,3,2,3
2023-06-01,203668,1,0,1,2,0,2
2023-06-01,31376,19,1,20,25,6,26
2023-06-01,43507,2,0,2,5,0,5
2023-06-01,43542,2,1,3,12,6,12
2023-06-01,207945,3,1,4,1,1,1
2023-06-01,43574,3,0,3,1,0,1
2023-06-01,60637,1,0,1,3,0,3
2023-06-01,43709,7,7,14,7,1,7
2023-06-01,42742,8,0,8,4,0,4
2023-06-01,39767,5,1,6,2,1,2
2023-06-01,43984,2,0,2,4,0,4
2023-06-01,210583,4,0,4,1,0,1
2023-06-01,211791,3,0,3,1,0,1
2023-06-01,43698,3,0,3,1,0,1
2023-06-01,212908,2,0,2,2,0,2
2023-06-01,211254,1,0,1,1,0,1
2023-06-01,43093,1,0,1,4,0,4
2023-06-01,5582,2,1,3,8,2,8
2023-06-01,203408,3,0,3,3,0,3
2023-06-01,203287,2,0,2,1,0,1
2023-06-01,24577,5,0,5,6,0,6
2023-06-01,203828,7,1,8,7,2,7
2023-06-01,204392,1,0,1,3,0,3
2023-06-01,210911,6,0,6,3,0,3
2023-06-01,208737,3,0,3,6,0,6
2023-06-01,9008,10,2,12,5,3,6
2023-06-01,198128,3,0,3,4,0,4
2023-06-01,34894,2,0,2,1,0,1
2023-06-01,47331,103,29,132,1,1,1
2023-06-01,20926,20,20,40,4,2,4
2023-06-01,43989,5,1,6,7,3,7
2023-06-01,206047,1,0,1,2,0,2
2023-06-01,21305,25,1,26,4,1,4
2023-06-01,44288,1,0,1,1,0,1
2023-06-01,39781,6,2,8,8,6,8
2023-06-01,198153,2,0,2,3,0,3
2023-06-01,44002,11,1,12,6,1,6
2023-06-01,29238,9,0,9,3,0,3
2023-06-01,47201,4,4,8,1,2,2
2023-06-01,30833,9,1,10,4,1,4
2023-06-01,39310,2,0,2,9,0,9
2023-06-01,44065,2,1,3,3,2,3
2023-06-01,12902,3,1,4,12,7,12
2023-06-01,211251,10,0,10,3,0,3
2023-06-01,202240,1,0,1,2,0,2
2023-06-01,200759,3,0,3,8,0,8
2023-06-01,42408,3,0,3,2,0,2
2023-06-01,12853,3,1,4,4,2,4
2023-06-01,197342,2,0,2,1,0,1
2023-06-01,21101,3,0,3,6,0,6
2023-06-01,44091,5,0,5,3,0,3
2023-06-01,44096,2,1,3,3,1,3
2023-06-01,47212,1,1,2,3,2,4
2023-06-01,44225,22,1,23,4,1,4
2023-06-01,9144,5,10,15,4,3,4
2023-06-01,44156,1,0,1,3,0,3
2023-06-01,44215,1,0,1,2,0,2
2023-06-01,44140,1,0,1,1,0,1
2023-06-01,44510,1,0,1,2,0,2
2023-06-01,44261,1,0,1,1,0,1
2023-06-01,44312,3,0,3,1,0,1
2023-06-01,25418,5,0,5,1,0,1
2023-06-01,21483,21,0,21,1,0,1
2023-06-01,34137,4,0,4,1,0,1
2023-06-01,35624,9,0,9,1,0,1
2023-06-01,203135,2,0,2,3,0,3
2023-06-01,57287,1,1,2,1,1,1
2023-06-01,16089,2,1,3,1,1,1
2023-06-01,47195,16,1,17,10,6,12
2023-06-01,47182,1,0,1,1,0,1
2023-06-01,21249,1,0,1,3,0,3
2023-06-01,41435,6,8,14,14,4,15
2023-06-01,213226,1,0,1,1,0,1
2023-06-01,200304,1,0,1,1,0,1
2023-06-01,213113,1,2,3,5,4,5
2023-06-01,57782,2,13,15,3,8,8
2023-06-01,210089,1,2,3,1,1,1
2023-06-01,208590,1,1,2,1,2,2
2023-06-01,47334,1,0,1,1,0,1
2023-06-01,57269,10,1,11,2,1,2
2023-06-01,60619,2,0,2,2,0,2
2023-06-01,8456,22,0,22,2,0,2
2023-06-01,25374,148,1,149,5,7,8
2023-06-01,212677,2,0,2,1,0,1
2023-06-01,207812,1,1,2,1,1,1
2023-06-01,205872,2,0,2,1,0,1
2023-06-01,59763,4,0,4,2,0,2
2023-06-01,43415,11,1,12,4,1,4
2023-06-01,9080,5,1,6,5,3,6
2023-06-01,43763,3,0,3,1,0,1
2023-06-01,43782,4,2,6,1,1,1
2023-06-01,39378,16,3,19,11,8,13
2023-06-01,24852,33,2,35,5,3,5
2023-06-01,31476,2,0,2,1,0,1
2023-06-01,60853,3,0,3,2,0,2
2023-06-01,3238,25,1,26,8,3,8
2023-06-01,211716,1,0,1,3,0,3
2023-06-01,201247,2,0,2,3,0,3
2023-06-01,210342,1,0,1,1,0,1
2023-06-01,61052,1,0,1,2,0,2
2023-06-01,60006,1,0,1,1,0,1
2023-06-01,59793,11,1,12,5,1,5
2023-06-01,43882,4,0,4,2,0,2
2023-06-01,199901,1,0,1,2,0,2
2023-06-01,42459,8,1,9,8,4,9
2023-06-01,25076,1,0,1,1,0,1
2023-06-01,50670,41,1,42,9,1,9
2023-06-01,12829,110,0,110,1,0,1
2023-06-01,49815,4,0,4,4,0,4
2023-06-01,44432,2,0,2,1,0,1
2023-06-01,199259,1,0,1,3,0,3
2023-06-01,29676,21,0,21,2,0,2
2023-06-01,196728,1,0,1,2,0,2
2023-06-01,45013,3,0,3,2,0,2
2023-06-01,206926,1,0,1,5,0,5
2023-06-01,56957,5,0,5,1,0,1
2023-06-01,56631,8,0,8,5,0,5
2023-06-01,205130,1,0,1,1,0,1
2023-06-01,61178,5,1,6,1,1,1
2023-06-01,204525,1,0,1,3,0,3
2023-06-01,207581,2,0,2,2,0,2
2023-06-01,199622,1,0,1,1,0,1
2023-06-01,199623,1,0,1,2,0,2
2023-06-01,211506,1,0,1,2,0,2
2023-06-01,47541,16,2,18,9,6,10
2023-06-01,211963,1,0,1,2,0,2
2023-06-01,57085,2,0,2,4,0,4
2023-06-01,49797,1,0,1,1,0,1
2023-06-01,205830,2,0,2,1,0,1
2023-06-01,21051,16,1,17,6,1,6
2023-06-01,199647,1,0,1,1,0,1
2023-06-01,29572,1,0,1,1,0,1
2023-06-01,56857,2,0,2,1,0,1
2023-06-01,201974,2,0,2,2,0,2
2023-06-01,44555,4,0,4,1,0,1
2023-06-01,211173,1,0,1,2,0,2
2023-06-01,196730,6,0,6,2,0,2
2023-06-01,47329,15,0,15,8,0,8
2023-06-01,60782,6,0,6,6,0,6
2023-06-01,43970,1,0,1,1,0,1
2023-06-01,43870,12,1,13,1,1,1
2023-06-01,209640,4,0,4,1,0,1
2023-06-01,43908,7,0,7,1,0,1
2023-06-01,41589,6,3,9,2,2,2
2023-06-01,62021,2,0,2,4,0,4
2023-06-01,44166,2,11,13,2,1,2
2023-06-01,44021,2,0,2,1,0,1
2023-06-01,34263,10,1,11,4,2,4
2023-06-01,43954,1,0,1,2,0,2
2023-06-01,43973,19,0,19,10,0,10
2023-06-01,47347,1,1,2,3,2,3
2023-06-01,205137,3,2,5,1,1,1
2023-06-01,203412,3,1,4,2,2,2
2023-06-01,44670,3,0,3,2,0,2
2023-06-01,47323,2,0,2,6,0,6
2023-06-01,197307,3,1,4,5,3,5
2023-06-01,210324,1,0,1,1,0,1
2023-06-01,44291,12,1,13,7,3,7
2023-06-01,44134,2,1,3,4,3,4
2023-06-01,197756,3,0,3,4,0,4
2023-06-01,197140,1,0,1,4,0,4
2023-06-01,29053,1,0,1,1,0,1
2023-06-01,60178,3,0,3,1,0,1
2023-06-01,15397,1,2,3,6,1,6
2023-06-01,207050,13,1,14,3,1,3
2023-06-01,31558,6,0,6,1,0,1
2023-06-01,43706,1,0,1,1,0,1
2023-06-01,43707,3,0,3,1,0,1
2023-06-01,25252,30,4,34,3,3,3
2023-06-01,43761,2,0,2,3,0,3
2023-06-01,25215,31,0,31,5,0,5
2023-06-01,25627,15,0,15,7,0,7
2023-06-01,204558,4,1,5,3,3,3
2023-06-01,43777,2,0,2,1,0,1
2023-06-01,21274,1,1,2,9,4,9
2023-06-01,57331,4,0,4,1,0,1
2023-06-01,43191,8,3,11,5,3,5
2023-06-01,16095,31,2,33,4,3,4
2023-06-01,21480,7,0,7,1,0,1
2023-06-01,201910,2,0,2,1,0,1
2023-06-01,196963,4,0,4,2,0,2
2023-06-01,43801,2,0,2,2,0,2
2023-06-01,44314,2,1,3,6,4,6
2023-06-01,43845,8,1,9,3,1,4
2023-06-01,43829,1,0,1,2,0,2
2023-06-01,20723,7,1,8,5,3,6
2023-06-01,41004,2,0,2,1,0,1
2023-06-01,41476,3,0,3,1,0,1
2023-06-01,44565,48,0,48,4,0,4
2023-06-01,44588,2,0,2,1,0,1
2023-06-01,8903,111,5,116,26,5,28
2023-06-01,43919,2,1,3,4,2,4
2023-06-01,12541,111,5,116,24,4,25
2023-06-01,50533,6,1,7,16,10,18
2023-06-01,33808,7,1,8,1,1,1
2023-06-01,43892,6,2,8,2,3,4
2023-06-01,15919,6,1,7,5,4,5
2023-06-01,12946,8,5,13,6,1,6
2023-06-01,43874,2,0,2,1,0,1
2023-06-01,200926,1,0,1,3,0,3
2023-06-01,64432,6,1,7,4,1,4
2023-06-01,51477,5,0,5,2,0,2
2023-06-01,43876,1,0,1,1,0,1
2023-06-01,43928,4,1,5,2,3,3
2023-06-01,59701,12,1,13,5,2,6
2023-06-01,31641,4,1,5,6,5,8
2023-06-01,43884,1,0,1,1,0,1
2023-06-01,38986,1,0,1,1,0,1
2023-06-01,43437,1,0,1,1,0,1
2023-06-01,34031,2,1,3,1,1,1
2023-06-01,30882,8,0,8,2,0,2
2023-06-01,206387,8,0,8,1,0,1
2023-06-01,207103,4,0,4,1,0,1
2023-06-01,30784,2,0,2,1,0,1
2023-06-01,62292,16,0,16,4,0,4
2023-06-01,30723,3,0,3,1,0,1
2023-06-01,33947,33,1,34,1,1,1
2023-06-01,42964,9,1,10,1,1,1
2023-06-01,60071,12,0,12,1,0,1
2023-06-01,201237,10,0,10,1,0,1
2023-06-01,43359,8,2,10,3,2,3
2023-06-01,62449,2,1,3,1,2,2
2023-06-01,39834,1,1,2,1,1,1
2023-06-01,43966,19,0,19,8,0,8
2023-06-01,196726,2,0,2,1,0,1
2023-06-01,43951,1,0,1,1,0,1
2023-06-01,50741,1,0,1,3,0,3
2023-06-01,48234,3,0,3,1,0,1
2023-06-01,41058,1,0,1,1,0,1
2023-06-01,212586,4,0,4,3,0,3
2023-06-01,200042,1,0,1,1,0,1
2023-06-01,209240,4,0,4,4,0,4
2023-06-01,210125,5,0,5,2,0,2
2023-06-01,47119,42,0,42,1,0,1
2023-06-01,47385,2,0,2,1,0,1
2023-06-01,59565,3,1,4,3,3,3
2023-06-01,202650,2,0,2,1,0,1
2023-06-01,212897,2,0,2,3,0,3
2023-06-01,28708,28,17,45,1,1,1
2023-06-01,199140,9,3,12,1,2,2
2023-06-01,8891,6,14,20,1,1,1
2023-06-01,328126,13,3,16,13,1,13
2023-06-01,6813,18,0,18,1,0,1
2023-06-01,30910,2,0,2,1,0,1
2023-06-01,201844,1,0,1,3,0,3
2023-06-01,62143,1,0,1,3,0,3
2023-06-01,20815,9,0,9,3,0,3
2023-06-01,41165,5,1,6,6,3,6
2023-06-01,35006,5,0,5,1,0,1
2023-06-01,200295,1,0,1,3,0,3
2023-06-01,202803,10,1,11,3,1,4
2023-06-01,208549,3,0,3,2,0,2
2023-06-01,31697,11,0,11,2,0,2
2023-06-01,20710,4,0,4,3,0,3
2023-06-01,31241,5,1,6,3,2,3
2023-06-01,8911,2,0,2,2,0,2
2023-06-01,21196,4,0,4,1,0,1
2023-06-01,31461,1,0,1,1,0,1
2023-06-01,25417,3,2,5,1,1,1
2023-06-01,50231,18,1,19,11,1,11
2023-06-01,28889,12,1,13,15,2,16
2023-06-01,204577,1,0,1,7,0,7
2023-06-01,206873,8,8,16,5,4,5
2023-06-01,212461,5,1,6,1,1,1
2023-06-01,207883,6,0,6,1,0,1
2023-06-01,207711,1,0,1,3,0,3
2023-06-01,206980,6,0,6,5,0,5
2023-06-01,212713,6,0,6,2,0,2
2023-06-01,211849,2,0,2,1,0,1
2023-06-01,208091,12,2,14,1,2,2
2023-06-01,62247,2,1,3,3,2,3
2023-06-01,208541,1,0,1,3,0,3
2023-06-01,201270,1,0,1,2,0,2
2023-06-01,50115,7,0,7,5,0,5
2023-06-01,41205,3,0,3,1,0,1
2023-06-01,209559,1,0,1,1,0,1
2023-06-01,31479,2,0,2,1,0,1
2023-06-01,24699,5,0,5,1,0,1
2023-06-01,51728,6,2,8,3,2,4
2023-06-01,29068,29,0,29,3,0,3
2023-06-01,204595,4,0,4,1,0,1
2023-06-01,57629,9,33,42,8,14,15
2023-06-01,31695,15,0,15,3,0,3
2023-06-01,37722,6,1,7,5,3,6
2023-06-01,37455,4,0,4,1,0,1
2023-06-01,207816,1,1,2,1,1,1
2023-06-01,204059,2,1,3,3,3,4
2023-06-01,204708,1,1,2,4,3,4
2023-06-01,209090,3,3,6,4,4,4
2023-06-01,60197,1,1,2,1,1,1
2023-06-01,20861,4,1,5,2,2,2
2023-06-01,33871,10,0,10,6,0,6
2023-06-01,20791,2,0,2,3,0,3
2023-06-01,31720,8,0,8,2,0,2
2023-06-01,7243,11,0,11,5,0,5
2023-06-01,20784,1,0,1,3,0,3
2023-06-01,208846,3,4,7,1,1,1
2023-06-01,209108,1,1,2,2,2,2
2023-06-01,16197,5,0,5,1,0,1
2023-06-01,210422,3,1,4,1,1,1
2023-06-01,30937,5,0,5,3,0,3
2023-06-01,20918,1,0,1,2,0,2
2023-06-01,20794,2,0,2,3,0,3
2023-06-01,12533,3,0,3,2,0,2
2023-06-01,50173,5,1,6,5,2,6
2023-06-01,49242,7,1,8,2,1,2
2023-06-01,20848,16,0,16,6,0,6
2023-06-01,8804,6,1,7,12,8,14
2023-06-01,20755,4,1,5,3,2,3
2023-06-01,34287,5,0,5,1,0,1
2023-06-01,42437,3,0,3,6,0,6
2023-06-01,48854,26,5,31,5,3,5
2023-06-01,9120,6,1,7,3,2,3
2023-06-01,29600,9,1,10,4,3,4
2023-06-01,34350,5,0,5,3,0,3
2023-06-01,201872,3,0,3,5,0,5
2023-06-01,45043,5,0,5,3,0,3
2023-06-01,34613,1,0,1,1,0,1
2023-06-01,20800,4,0,4,2,0,2
2023-06-01,57084,4,1,5,3,1,3
2023-06-01,34372,6,3,9,7,4,7
2023-06-01,16080,2,1,3,8,3,8
2023-06-01,34913,7,1,8,1,1,1
2023-06-01,34404,1,0,1,3,0,3
2023-06-01,34410,11,1,12,2,1,2
2023-06-01,197301,2,1,3,5,4,6
2023-06-01,48259,1,0,1,1,0,1
2023-06-01,48107,1,0,1,1,0,1
2023-06-01,48715,58,1,59,1,2,2
2023-06-01,20798,1,0,1,1,0,1
2023-06-01,49217,4,0,4,1,0,1
2023-06-01,42622,2,0,2,2,0,2
2023-06-01,207490,2,1,3,2,2,2
2023-06-01,49037,43,35,78,4,3,4
2023-06-01,211282,1,1,2,1,1,1
2023-06-01,206680,1,1,2,1,1,1
2023-06-01,35654,8,0,8,1,0,1
2023-06-01,34467,7,0,7,2,0,2
2023-06-01,20849,4,1,5,8,5,9
2023-06-01,20819,2,0,2,2,0,2
2023-06-01,21068,1,0,1,1,0,1
2023-06-01,57822,10,0,10,1,0,1
2023-06-01,62382,11,0,11,11,0,11
2023-06-01,20870,38,1,39,7,1,7
2023-06-01,34500,3,0,3,3,0,3
2023-06-01,30733,17,0,17,13,0,13
2023-06-01,20899,8,0,8,1,0,1
2023-06-01,61207,15,2,17,1,1,1
2023-06-01,34511,5,4,9,3,1,3
2023-06-01,202935,1,0,1,3,0,3
2023-06-01,204649,3,0,3,1,0,1
2023-06-01,210841,6,0,6,1,0,1
2023-06-01,202613,10,2,12,1,1,1
2023-06-01,210053,1,0,1,1,0,1
2023-06-01,34554,2,1,3,5,3,6
2023-06-01,49476,3,1,4,11,5,12
2023-06-01,197076,3,0,3,1,0,1
2023-06-01,39915,3,0,3,2,0,2
2023-06-01,5385,74,4,78,12,7,14
2023-06-01,20882,2,0,2,1,0,1
2023-06-01,34767,2,1,3,1,1,1
2023-06-01,20914,1,1,2,2,1,3
2023-06-01,34731,2,0,2,1,0,1
2023-06-01,24626,4,0,4,7,0,7
2023-06-01,57045,3,0,3,5,0,5
2023-06-01,211437,1,1,2,1,2,2
2023-06-01,47726,3,0,3,2,0,2
2023-06-01,12739,5,1,6,9,4,9
2023-06-01,51427,1,0,1,2,0,2
2023-06-01,20924,4,1,5,6,2,6
2023-06-01,51547,18,0,18,1,0,1
2023-06-01,30960,8,0,8,6,0,6
2023-06-01,8523,5,1,6,3,2,3
2023-06-01,29527,12,1,13,9,3,9
2023-06-01,34623,1,1,2,1,1,1
2023-06-01,39156,2,0,2,12,0,12
2023-06-01,199287,1,0,1,1,0,1
2023-06-01,205597,1,3,4,1,1,1
2023-06-01,400513,8,1,9,2,2,2
2023-06-01,50045,2,1,3,4,1,4
2023-06-01,51369,1,0,1,1,0,1
2023-06-01,42244,16,3,19,5,2,5
2023-06-01,29387,1,0,1,1,0,1
2023-06-01,8549,12,0,12,3,0,3
2023-06-01,34536,3,0,3,2,0,2
2023-06-01,21000,18,0,18,5,0,5
2023-06-01,12788,2,0,2,6,0,6
2023-06-01,60359,1,0,1,4,0,4
2023-06-01,25372,1,1,2,11,3,11
2023-06-01,39083,2,4,6,3,6,6
2023-06-01,209241,1,0,1,1,0,1
2023-06-01,21032,9,2,11,1,1,1
2023-06-01,21143,2,0,2,2,0,2
2023-06-01,40993,7,2,9,3,1,3
2023-06-01,34686,3,3,6,3,1,3
2023-06-01,34695,2,0,2,1,0,1
2023-06-01,3276,1,0,1,2,0,2
2023-06-01,42653,1,0,1,2,0,2
2023-06-01,34697,1,0,1,2,0,2
2023-06-01,21286,25,5,30,1,1,1
2023-06-01,20953,2,1,3,2,2,2
2023-06-01,196778,3,0,3,1,0,1
2023-06-01,199262,1,0,1,1,0,1
2023-06-01,24978,4,2,6,4,3,4
2023-06-01,202082,1,0,1,3,0,3
2023-06-01,30952,3,0,3,5,0,5
2023-06-01,211185,1,0,1,2,0,2
2023-06-01,57631,1,0,1,2,0,2
2023-06-01,60679,5,2,7,11,8,12
2023-06-01,203751,7,0,7,2,0,2
2023-06-01,34760,1,0,1,1,0,1
2023-06-01,28757,8,1,9,10,1,10
2023-06-01,34785,7,1,8,3,3,3
2023-06-01,48798,5,0,5,2,0,2
2023-06-01,16206,6,0,6,1,0,1
2023-06-01,34784,2,1,3,2,2,2
2023-06-01,21019,1,0,1,2,0,2
2023-06-01,15657,5,1,6,2,2,2
2023-06-01,25569,1,0,1,2,0,2
2023-06-01,51353,1,0,1,1,0,1
2023-06-01,56611,7,1,8,2,1,2
2023-06-01,21060,14,1,15,2,2,2
2023-06-01,47608,4,1,5,8,3,8
2023-06-01,28792,11,1,12,7,6,8
2023-06-01,29243,3,1,4,3,2,3
2023-06-01,35197,22,0,22,2,0,2
2023-06-01,44885,4,1,5,1,1,1
2023-06-01,21045,1,0,1,2,0,2
2023-06-01,43096,3,0,3,2,0,2
2023-06-01,21214,18,1,19,3,1,3
2023-06-01,21058,13,0,13,2,0,2
2023-06-01,59716,3,1,4,1,1,1
2023-06-01,44123,4,1,5,4,2,4
2023-06-01,12428,4,0,4,1,0,1
2023-06-01,51007,7,1,8,4,2,4
2023-06-01,21155,18,4,22,4,3,4
2023-06-01,13136,1,1,2,1,1,1
2023-06-01,30720,1,1,2,2,1,2
2023-06-01,16043,3,0,3,1,0,1
2023-06-01,16378,17,3,20,4,3,5
2023-06-01,50910,17,0,17,3,0,3
2023-06-01,60806,18,0,18,9,0,9
2023-06-01,24993,1,1,2,3,3,3
2023-06-01,13246,8,1,9,2,1,2
2023-06-01,21077,12,0,12,3,0,3
2023-06-01,56472,2,1,3,6,3,6
2023-06-01,28954,3,1,4,1,1,1
2023-06-01,198710,12,2,14,3,2,3
2023-06-01,24640,4,0,4,2,0,2
2023-06-01,60380,8,2,10,1,1,1
2023-06-01,21104,16,0,16,1,0,1
2023-06-01,199620,1,0,1,1,0,1
2023-06-01,57475,3,1,4,1,1,1
2023-06-01,6859,1,0,1,2,0,2
2023-06-01,25146,1,1,2,3,2,3
2023-06-01,35062,2,1,3,2,2,2
2023-06-01,21260,18,0,18,3,0,3
2023-06-01,62429,8,1,9,4,3,5
2023-06-01,35214,3,0,3,1,0,1
2023-06-01,49542,13,5,18,6,1,6
2023-06-01,35238,2,0,2,2,0,2
2023-06-01,20994,2,0,2,2,0,2
2023-06-01,16145,5,0,5,3,0,3
2023-06-01,328156,1,0,1,4,0,4
2023-06-01,327733,9,1,10,6,3,6
2023-06-01,328233,1,0,1,3,0,3
2023-06-01,328194,1,0,1,1,0,1
2023-06-01,328132,2,0,2,3,0,3
2023-06-01,328226,1,0,1,1,0,1
2023-06-01,328160,2,1,3,8,1,8
2023-06-01,328131,1,0,1,2,0,2
2023-06-01,327891,4,0,4,3,0,3
2023-06-01,328175,1,0,1,1,0,1
2023-06-01,328211,1,0,1,1,0,1
2023-06-01,328240,1,0,1,1,0,1
2023-06-01,328174,2,1,3,2,2,3
2023-06-01,33779,36,1,37,2,1,2
2023-06-01,44365,5,0,5,2,0,2
2023-06-01,25176,23,3,26,3,3,3
2023-06-01,210465,2,0,2,1,0,1
2023-06-01,35313,13,0,13,16,0,16
2023-06-01,21105,2,0,2,5,0,5
2023-06-01,203865,5,3,8,3,3,3
2023-06-01,15434,1,0,1,1,0,1
2023-06-01,12847,4,1,5,7,3,7
2023-06-01,24921,38,4,42,2,2,2
2023-06-01,12793,9,0,9,1,0,1
2023-06-01,35074,4,0,4,1,0,1
2023-06-01,21266,1,0,1,2,0,2
2023-06-01,10991,41,0,41,8,0,8
2023-06-01,20886,5,1,6,8,6,10
2023-06-01,3285,4,1,5,2,1,2
2023-06-01,16294,12,0,12,4,0,4
2023-06-01,43103,11,0,11,9,0,9
2023-06-01,207802,8,0,8,2,0,2
2023-06-01,50038,1,0,1,4,0,4
2023-06-01,42901,1,0,1,2,0,2
2023-06-01,60944,1,0,1,1,0,1
2023-06-01,21171,2,1,3,1,1,1
2023-06-01,35130,5,2,7,2,1,2
2023-06-01,63017,3,2,5,1,1,1
2023-06-01,211348,2,0,2,1,0,1
2023-06-01,210423,10,0,10,3,0,3
2023-06-01,210395,4,0,4,3,0,3
2023-06-01,209858,6,0,6,1,0,1
2023-06-01,21173,3,0,3,3,0,3
2023-06-01,3331,1,1,2,8,4,10
2023-06-01,196755,12,1,13,7,3,7
2023-06-01,50857,2,0,2,3,0,3
2023-06-01,21226,4,0,4,5,0,5
2023-06-01,34858,7,0,7,10,0,10
2023-06-01,204919,1,0,1,2,0,2
2023-06-01,21231,4,0,4,5,0,5
2023-06-01,35207,7,2,9,2,1,2
2023-06-01,65350,1,0,1,1,0,1
2023-06-01,24611,14,1,15,9,4,9
2023-06-01,5500,12,3,15,6,6,7
2023-06-01,21184,5,0,5,3,0,3
2023-06-01,8393,70,0,70,4,0,4
2023-06-01,204006,1,0,1,6,4,6
2023-06-01,212734,3,1,4,1,1,2
2023-06-01,48586,1,0,1,1,0,1
2023-06-01,199440,3,0,3,3,0,3
2023-06-01,21390,1,1,2,1,1,1
2023-06-01,206112,1,0,1,3,0,3
2023-06-01,34265,12,0,12,11,0,11
2023-06-01,44390,1,0,1,3,0,3
2023-06-01,197029,2,1,3,5,4,6
2023-06-01,35569,1,0,1,1,0,1
2023-06-01,8660,14,0,14,5,0,5
2023-06-01,35356,10,0,10,2,0,2
2023-06-01,33854,1,0,1,2,0,2
2023-06-01,39263,4,0,4,2,0,2
2023-06-01,199296,5,1,6,5,1,5
2023-06-01,204444,7,1,8,3,3,5
2023-06-01,21218,1,0,1,1,0,1
2023-06-01,38949,1,1,2,11,4,11
2023-06-01,200187,2,1,3,10,5,11
2023-06-01,211609,14,0,14,12,0,12
2023-06-01,204428,3,0,3,2,0,2
2023-06-01,199335,15,0,15,7,0,7
2023-06-01,327754,27,4,31,4,2,4
2023-06-01,206105,2,1,3,2,1,2
2023-06-01,204448,2,0,2,5,0,5
2023-06-01,16154,29,2,31,3,4,5
2023-06-01,43044,1,1,2,1,1,1
2023-06-01,35551,3,1,4,9,6,9
2023-06-01,29668,43,3,46,11,6,11
2023-06-01,21348,2,1,3,2,1,2
2023-06-01,12767,6,2,8,1,1,1
2023-06-01,209157,1,0,1,2,0,2
2023-06-01,31313,33,1,34,30,3,30
2023-06-01,61002,8,0,8,3,0,3
2023-06-01,211313,1,0,1,2,0,2
2023-06-01,206510,1,0,1,2,0,2
2023-06-01,6693,3,0,3,2,0,2
2023-06-01,204972,1,0,1,3,0,3
2023-06-01,62350,2,1,3,2,2,2
2023-06-01,25536,2,0,2,1,0,1
2023-06-01,39531,3,0,3,1,0,1
2023-06-01,203305,1,0,1,1,0,1
2023-06-01,49852,3,1,4,4,4,5
2023-06-01,211294,1,0,1,1,0,1
2023-06-01,205001,1,0,1,2,0,2
2023-06-01,60657,1,0,1,3,0,3
2023-06-01,49023,9,0,9,3,0,3
2023-06-01,48931,2,0,2,2,0,2
2023-06-01,49052,3,0,3,3,0,3
2023-06-01,15856,2,0,2,1,0,1
2023-06-01,20497,4,0,4,1,0,1
2023-06-01,205861,2,0,2,2,0,2
2023-06-01,34283,2,0,2,1,0,1
2023-06-01,25116,1,0,1,1,0,1
2023-06-01,28727,3,1,4,2,1,3
2023-06-01,29171,3,0,3,2,0,2
2023-06-01,16120,2,0,2,1,0,1
2023-06-01,20820,1,0,1,2,0,2
2023-06-01,47427,4,0,4,4,0,4
2023-06-01,51461,5,0,5,4,0,4
2023-06-01,31017,9,1,10,8,2,8
2023-06-01,34723,3,0,3,8,0,8
2023-06-01,49507,2,0,2,2,0,2
2023-06-01,12446,3,0,3,4,0,4
2023-06-01,25103,2,0,2,2,0,2
2023-06-01,24704,2,0,2,2,0,2
2023-06-01,21294,11,0,11,3,0,3
2023-06-01,15471,95,1,96,5,3,6
2023-06-01,44277,13,0,13,1,0,1
2023-06-01,34416,2,0,2,1,0,1
2023-06-01,209644,1,0,1,2,0,2
2023-06-01,29628,1,0,1,1,0,1
2023-06-01,39279,5,1,6,13,6,15
2023-06-01,25319,0,0,0,1,0,1
2023-06-01,200247,1,0,1,1,0,1
2023-06-01,207868,1,0,1,2,0,2
2023-06-01,202453,1,0,1,3,0,3
2023-06-01,35369,10,1,11,18,10,19
2023-06-01,200970,2,1,3,10,2,10
2023-06-01,51187,1,0,1,1,0,1
2023-06-01,34905,1,0,1,1,0,1
2023-06-01,201728,1,0,1,1,0,1
2023-06-01,61022,1,0,1,1,0,1
2023-06-01,39285,1,1,2,3,1,3
2023-06-01,49135,1,0,1,1,0,1
2023-06-01,2792,14,0,14,1,0,1
2023-06-01,201378,4,0,4,2,0,2
2023-06-01,7514,19,1,20,4,3,5
2023-06-01,9022,13,2,15,8,4,9
2023-06-01,397964,2,1,3,2,2,2
2023-06-01,41151,2,1,3,8,3,8
2023-06-01,13059,1,0,1,2,0,2
2023-06-01,209820,3,0,3,1,0,1
2023-06-01,200062,7,1,8,7,6,8
2023-06-01,204196,9,0,9,1,0,1
2023-06-01,203953,10,1,11,1,1,1
2023-06-01,200611,1,0,1,1,0,1
2023-06-01,24806,12,1,13,7,1,7
2023-06-01,205727,4,1,5,6,1,6
2023-06-01,14516,5,0,5,2,0,2
2023-06-01,27173,5,0,5,3,0,3
2023-06-01,47570,11,0,11,1,0,1
2023-06-01,62436,1,0,1,2,0,2
2023-06-01,57318,1,0,1,1,0,1
2023-06-01,25107,1,0,1,1,0,1
2023-06-01,199300,1,0,1,1,0,1
2023-06-01,35108,3,0,3,3,0,3
2023-06-01,47499,3,0,3,1,0,1
2023-06-01,44441,2,0,2,1,0,1
2023-06-01,35809,1,0,1,1,0,1
2023-06-01,211424,1,0,1,1,0,1
2023-06-01,199577,2,0,2,2,0,2
2023-06-01,197616,2,0,2,2,0,2
2023-06-01,43956,1,0,1,1,0,1
2023-06-01,35407,3,2,5,7,3,7
2023-06-01,39627,1,0,1,1,0,1
2023-06-01,20895,12,1,13,6,3,6
2023-06-01,41810,19,0,19,1,0,1
2023-06-01,199809,13,0,13,3,0,3
2023-06-01,205362,11,0,11,3,0,3
2023-06-01,60427,7,1,8,7,6,7
2023-06-01,41507,7,0,7,4,0,4
2023-06-01,35516,1,0,1,1,0,1
2023-06-01,21282,4,1,5,4,3,6
2023-06-01,199118,6,1,7,3,2,3
2023-06-01,35535,2,0,2,3,0,3
2023-06-01,16296,1,0,1,2,0,2
2023-06-01,202132,5,0,5,1,0,1
2023-06-01,35546,3,0,3,1,0,1
2023-06-01,12964,2,0,2,3,0,3
2023-06-01,44234,4,0,4,4,0,4
2023-06-01,212473,1,0,1,1,0,1
2023-06-01,196900,1,0,1,1,0,1
2023-06-01,44811,10,0,10,3,0,3
2023-06-01,44627,3,0,3,2,0,2
2023-06-01,35564,7,0,7,1,0,1
2023-06-01,43478,58,3,61,1,1,1
2023-06-01,48722,1,0,1,4,0,4
2023-06-01,31253,0,0,0,1,0,1
2023-06-01,24680,4,0,4,5,0,5
2023-06-01,29321,5,1,6,1,1,1
2023-06-01,51482,2,0,2,1,0,1
2023-06-01,198903,1,1,2,2,2,2
2023-06-01,201455,5,0,5,2,0,2
2023-06-01,198631,5,0,5,2,0,2
2023-06-01,21336,2,0,2,7,0,7
2023-06-01,35635,2,0,2,4,0,4
2023-06-01,20776,107,0,107,5,0,5
2023-06-01,21502,2,0,2,3,0,3
2023-06-01,61964,5,1,6,4,2,4
2023-06-01,65003,4,0,4,1,0,1
2023-06-01,208186,1,0,1,1,0,1
2023-06-01,206011,5,1,6,3,2,3
2023-06-01,21350,20,0,20,4,0,4
2023-06-01,5585,0,0,0,2,0,2
2023-06-01,34946,6,1,7,4,4,5
2023-06-01,21364,1,0,1,2,0,2
2023-06-01,44494,3,0,3,3,0,3
2023-06-01,198239,6,2,8,8,2,8
2023-06-01,211531,2,0,2,2,0,2
2023-06-01,43783,4,0,4,2,0,2
2023-06-01,202931,4,0,4,2,0,2
2023-06-01,35704,9,3,12,2,1,2
2023-06-01,21360,1,1,2,6,2,6
2023-06-01,28847,3,2,5,1,1,1
2023-06-01,35738,2,0,2,3,0,3
2023-06-01,21391,1,0,1,1,0,1
2023-06-01,34434,17,0,17,3,0,3
2023-06-01,21197,3,2,5,2,1,2
2023-06-01,34683,4,1,5,5,2,6
2023-06-01,201973,1,1,2,1,1,2
2023-06-01,16228,1,0,1,1,0,1
2023-06-01,35755,1,0,1,2,0,2
2023-06-01,31484,7,1,8,3,1,3
2023-06-01,39875,2,0,2,7,0,7
2023-06-01,25292,7,0,7,3,0,3
2023-06-01,202161,15,0,15,1,0,1
2023-06-01,200751,4,0,4,2,0,2
2023-06-01,20576,2,0,2,2,0,2
2023-06-01,15826,2,1,3,3,3,3
2023-06-01,49826,4,1,5,2,1,2
2023-06-01,29689,4,0,4,1,0,1
2023-06-01,39612,14,0,14,3,0,3
2023-06-01,328842,1,0,1,5,0,5
2023-06-01,30982,32,0,32,3,0,3
2023-06-01,12380,3,0,3,2,0,2
2023-06-01,24713,3,1,4,4,1,4
2023-06-01,35832,7,0,7,1,0,1
2023-06-01,209638,7,1,8,1,1,1
2023-06-01,212216,3,0,3,2,0,2
2023-06-01,212426,1,0,1,1,0,1
2023-06-01,211668,1,1,2,1,1,1
2023-06-01,57918,12,0,12,2,0,2
2023-06-01,15555,2,0,2,1,0,1
2023-06-01,209096,1,0,1,3,0,3
2023-06-01,25061,2,1,3,9,5,10
2023-06-01,39038,3,0,3,1,0,1
2023-06-01,209798,1,0,1,1,0,1
2023-06-01,16001,2,1,3,1,1,1
2023-06-01,43797,27,0,27,12,0,12
2023-06-01,60643,2,0,2,2,0,2
2023-06-01,3343,7,0,7,3,0,3
2023-06-01,41212,1,0,1,2,0,2
2023-06-01,57994,14,0,14,1,0,1
2023-06-01,38948,1,1,2,2,1,2
2023-06-01,8535,3,1,4,4,1,4
2023-06-01,39042,4,0,4,4,0,4
2023-06-01,8282,7,2,9,11,6,13
2023-06-01,13180,8,0,8,5,0,5
2023-06-01,21469,2,0,2,1,0,1
2023-06-01,197603,6,1,7,3,1,3
2023-06-01,21454,9,0,9,8,0,8
2023-06-01,8441,1,0,1,3,0,3
2023-06-01,24624,1,0,1,2,0,2
2023-06-01,30933,7,0,7,2,0,2
2023-06-01,59708,6,0,6,3,0,3
2023-06-01,61239,3,0,3,1,0,1
2023-06-01,206575,5,0,5,5,0,5
2023-06-01,203964,11,2,13,5,2,5
2023-06-01,28837,2,0,2,1,0,1
2023-06-01,207429,22,0,22,2,0,2
2023-06-01,39101,10,1,11,5,1,5
2023-06-01,207056,4,1,5,7,5,7
2023-06-01,39046,8,1,9,5,3,6
2023-06-01,24585,1,1,2,4,1,4
2023-06-01,41397,4,0,4,3,0,3
2023-06-01,39144,6,0,6,2,0,2
2023-06-01,8311,20,1,21,4,1,4
2023-06-01,212578,16,0,16,1,0,1
2023-06-01,203591,13,0,13,5,0,5
2023-06-01,204316,3,1,4,1,1,1
2023-06-01,203789,1,0,1,1,0,1
2023-06-01,209784,1,0,1,3,0,3
2023-06-01,205520,1,0,1,8,0,8
2023-06-01,201465,1,0,1,1,0,1
2023-06-01,198203,16,3,19,6,3,7
2023-06-01,48623,1,0,1,1,0,1
2023-06-01,49338,1,0,1,1,0,1
2023-06-01,24655,2,0,2,1,0,1
2023-06-01,5486,2,0,2,4,0,4
2023-06-01,30778,4,1,5,6,4,6
2023-06-01,208930,1,1,2,1,1,1
2023-06-01,43386,2,0,2,2,0,2
2023-06-01,24848,5,1,6,5,3,5
2023-06-01,48227,1,0,1,1,0,1
2023-06-01,35366,18,1,19,2,3,3
2023-06-01,49602,2,0,2,2,0,2
2023-06-01,202444,2,0,2,1,0,1
2023-06-01,20597,10,1,11,1,1,1
2023-06-01,34211,2,0,2,1,0,1
2023-06-01,24873,3,0,3,1,0,1
2023-06-01,207859,1,0,1,1,0,1
2023-06-01,51777,1,0,1,1,0,1
2023-06-01,204393,5,0,5,1,0,1
2023-06-01,5523,4,0,4,7,0,7
2023-06-01,208314,3,0,3,3,0,3
2023-06-01,197275,9,0,9,7,0,7
2023-06-01,42811,3,0,3,1,0,1
2023-06-01,199715,31,0,31,5,0,5
2023-06-01,212479,1,0,1,2,0,2
2023-06-01,201519,1,0,1,2,0,2
2023-06-01,205034,1,0,1,1,0,1
2023-06-01,211388,1,0,1,1,0,1
2023-06-01,50551,1,0,1,1,0,1
2023-06-01,60106,1,0,1,3,0,3
2023-06-01,43769,9,0,9,2,0,2
2023-06-01,61256,2,0,2,2,0,2
2023-06-01,204301,3,0,3,3,0,3
2023-06-01,60378,2,0,2,1,0,1
2023-06-01,60468,6,0,6,3,0,3
2023-06-01,62258,1,0,1,1,0,1
2023-06-01,205990,1,0,1,1,0,1
2023-06-01,205813,6,0,6,4,0,4
2023-06-01,50830,2,0,2,2,0,2
2023-06-01,13022,3,0,3,1,0,1
2023-06-01,24789,2,0,2,1,0,1
2023-06-01,51184,9,5,14,10,7,11
2023-06-01,24992,1,1,2,3,2,3
2023-06-01,200284,4,0,4,3,0,3
2023-06-01,197458,3,0,3,3,0,3
2023-06-01,42378,1,2,3,2,1,2
2023-06-01,197623,15,1,16,3,2,3
2023-06-01,209981,5,0,5,3,0,3
2023-06-01,40339,12,0,12,12,0,12
2023-06-01,16083,4,1,5,1,1,1
2023-06-01,39103,3,0,3,3,0,3
2023-06-01,201201,5,1,6,12,2,13
2023-06-01,24607,6,0,6,3,0,3
2023-06-01,212102,1,0,1,1,0,1
2023-06-01,34666,17,0,17,3,0,3
2023-06-01,21470,2,0,2,3,0,3
2023-06-01,24618,1,0,1,1,0,1
2023-06-01,20709,2,0,2,3,0,3
2023-06-01,196957,2,1,3,3,2,3
2023-06-01,60918,1,0,1,1,0,1
2023-06-01,25534,11,1,12,4,1,5
2023-06-01,62062,1,0,1,3,0,3
2023-06-01,35833,3,4,7,3,5,5
2023-06-01,29046,34,2,36,5,3,6
2023-06-01,203879,1,0,1,1,0,1
2023-06-01,24657,1,0,1,3,0,3
2023-06-01,41330,5,0,5,6,0,6
2023-06-01,15389,8,1,9,3,3,3
2023-06-01,35283,6,1,7,4,4,5
2023-06-01,24638,3,1,4,13,6,14
2023-06-01,49607,2,0,2,4,0,4
2023-06-01,39242,3,1,4,1,2,2
2023-06-01,24658,2,1,3,2,1,3
2023-06-01,209588,8,3,11,6,3,6
2023-06-01,38955,8,2,10,5,2,5
2023-06-01,24830,8,0,8,1,0,1
2023-06-01,26415,6,6,12,24,24,32
2023-06-01,396699,1,1,2,2,2,2
2023-06-01,397203,5,9,14,2,2,2
2023-06-01,39214,5,0,5,3,0,3
2023-06-01,29033,2,4,6,5,5,5
2023-06-01,39202,1,1,2,7,5,8
2023-06-01,13208,22,0,22,13,0,13
2023-06-01,20866,1,0,1,1,0,1
2023-06-01,60833,2,0,2,3,0,3
2023-06-01,51188,5,1,6,3,3,5
2023-06-01,3274,1,1,2,1,1,1
2023-06-01,30916,10,0,10,1,0,1
2023-06-01,39228,16,0,16,3,0,3
2023-06-01,44462,2,1,3,1,1,1
2023-06-01,12505,1,0,1,1,0,1
2023-06-01,39244,6,0,6,3,0,3
2023-06-01,200094,2,0,2,4,0,4
2023-06-01,8726,3,0,3,1,0,1
2023-06-01,58350,1,0,1,2,0,2
2023-06-01,209041,4,2,6,3,3,3
2023-06-01,212136,4,0,4,2,0,2
2023-06-01,59869,2,0,2,1,0,1
2023-06-01,41691,15,2,17,2,2,2
2023-06-01,24810,45,0,45,1,0,1
2023-06-01,210238,2,0,2,2,0,2
2023-06-01,51472,1,0,1,2,0,2
2023-06-01,12350,25,2,27,8,2,8
2023-06-01,48796,2,0,2,1,0,1
2023-06-01,16256,7,0,7,3,0,3
2023-06-01,30729,2,0,2,5,0,5
2023-06-01,24730,5,1,6,9,7,11
2023-06-01,42433,2,1,3,2,2,2
2023-06-01,24764,1,1,2,3,1,3
2023-06-01,39434,8,0,8,1,0,1
2023-06-01,57227,7,0,7,4,0,4
2023-06-01,20973,1,0,1,3,0,3
2023-06-01,24799,1,0,1,1,0,1
2023-06-01,25592,7,1,8,5,4,6
2023-06-01,9086,10,0,10,3,0,3
2023-06-01,39512,1,1,2,2,1,2
2023-06-01,24817,4,1,5,3,1,3
2023-06-01,199346,2,0,2,2,0,2
2023-06-01,57728,5,3,8,1,1,1
2023-06-01,60273,11,0,11,4,0,4
2023-06-01,202104,1,0,1,1,0,1
2023-06-01,208496,1,0,1,1,0,1
2023-06-01,39078,5,2,7,2,2,2
2023-06-01,60409,1,0,1,1,0,1
2023-06-01,41541,20,0,20,1,0,1
2023-06-01,39478,1,0,1,2,0,2
2023-06-01,43200,4,0,4,1,0,1
2023-06-01,201482,6,0,6,5,0,5
2023-06-01,13018,6,0,6,2,0,2
2023-06-01,39509,1,1,2,2,1,2
2023-06-01,24880,1,0,1,5,0,5
2023-06-01,28860,18,0,18,1,0,1
2023-06-01,200599,9,1,10,3,2,3
2023-06-01,35508,2,0,2,7,0,7
2023-06-01,199732,2,0,2,4,0,4
2023-06-01,24832,4,0,4,6,0,6
2023-06-01,25306,33,0,33,2,0,2
2023-06-01,41770,1,1,2,1,1,1
2023-06-01,47887,114,1,115,9,2,9
2023-06-01,51538,8,0,8,4,0,4
2023-06-01,51904,2,0,2,10,0,10
2023-06-01,44622,9,0,9,8,0,8
2023-06-01,202955,2,0,2,1,0,1
2023-06-01,39620,1,0,1,1,0,1
2023-06-01,25364,11,0,11,4,0,4
2023-06-01,39740,3,0,3,2,0,2
2023-06-01,207648,1,0,1,2,0,2
2023-06-01,211503,1,0,1,1,0,1
2023-06-01,34978,5,1,6,1,1,1
2023-06-01,39657,19,0,19,4,0,4
2023-06-01,196797,56,0,56,2,0,2
2023-06-01,48129,6,0,6,7,0,7
2023-06-01,64515,2,0,2,1,0,1
2023-06-01,39718,3,0,3,1,0,1
2023-06-01,41242,2,0,2,3,0,3
2023-06-01,12519,4,1,5,6,2,6
2023-06-01,47242,9,0,9,7,0,7
2023-06-01,211216,1,0,1,1,0,1
2023-06-01,197383,4,0,4,1,0,1
2023-06-01,57235,23,0,23,3,0,3
2023-06-01,31418,6,0,6,1,0,1
2023-06-01,2300,1,0,1,1,0,1
2023-06-01,29664,7,0,7,4,0,4
2023-06-01,16028,6,5,11,1,1,1
2023-06-01,5378,19,81,100,4,2,5
2023-06-01,12826,5,1,6,3,3,4
2023-06-01,38056,12,0,12,6,0,6
2023-06-01,393439,5,0,5,1,0,1
2023-06-01,15782,7,1,8,5,2,5
2023-06-01,39729,12,1,13,6,3,6
2023-06-01,29300,4,0,4,1,0,1
2023-06-01,39684,10,0,10,11,0,11
2023-06-01,15436,11,5,16,11,4,11
2023-06-01,34002,4,0,4,5,1,6
2023-06-01,31651,1,0,1,1,0,1
2023-06-01,34279,15,1,16,8,3,9
2023-06-01,25285,1,0,1,2,0,2
2023-06-01,39789,2,0,2,3,0,3
2023-06-01,41925,3,0,3,4,0,4
2023-06-01,34205,3,0,3,1,0,1
2023-06-01,25022,3,0,3,2,0,2
2023-06-01,5495,24,1,25,4,1,5
2023-06-01,25081,1,1,2,10,6,12
2023-06-01,39863,17,0,17,2,0,2
2023-06-01,48407,5,1,6,3,1,3
2023-06-01,212573,0,1,1,7,3,7
2023-06-01,56484,14,5,19,13,3,13
2023-06-01,25058,1,1,2,3,3,3
2023-06-01,29003,3,1,4,10,4,10
2023-06-01,29646,5,0,5,6,0,6
2023-06-01,25048,2,1,3,2,1,3
2023-06-01,48901,5,2,7,1,1,1
2023-06-01,25054,4,1,5,1,1,1
2023-06-01,39790,5,3,8,7,2,7
2023-06-01,25124,16,0,16,2,0,2
2023-06-01,44705,3,0,3,2,0,2
2023-06-01,202090,7,1,8,3,1,3
2023-06-01,42390,7,0,7,4,0,4
2023-06-01,20830,2,1,3,4,1,4
2023-06-01,39905,11,1,12,3,3,4
2023-06-01,209190,3,0,3,2,0,2
2023-06-01,201999,11,0,11,3,0,3
2023-06-01,24786,2,1,3,2,1,2
2023-06-01,43486,2,0,2,3,0,3
2023-06-01,24991,5,2,7,2,2,3
2023-06-01,198461,1,0,1,2,0,2
2023-06-01,44371,5,0,5,3,0,3
2023-06-01,34943,1,0,1,2,0,2
2023-06-01,25251,9,0,9,3,0,3
2023-06-01,59653,2,0,2,1,0,1
2023-06-01,51929,10,1,11,5,2,5
2023-06-01,60507,3,0,3,2,0,2
2023-06-01,202863,1,0,1,1,0,1
2023-06-01,49036,5,0,5,4,0,4
2023-06-01,34042,1,0,1,4,0,4
2023-06-01,8491,9,1,10,9,5,9
2023-06-01,199746,1,0,1,2,0,2
2023-06-01,200264,2,0,2,3,0,3
2023-06-01,207479,2,0,2,1,0,1
2023-06-01,8553,3,1,4,1,1,1
2023-06-01,25247,1,0,1,2,0,2
2023-06-01,197673,1,0,1,1,0,1
2023-06-01,62308,2,0,2,3,0,3
2023-06-01,12365,14,7,21,3,1,3
2023-06-01,1955,10,1,11,13,6,14
2023-06-01,30904,1,0,1,1,0,1
2023-06-01,48226,9,0,9,1,0,1
2023-06-01,44418,5,1,6,3,1,3
2023-06-01,59477,1,0,1,1,0,1
2023-06-01,35613,1,1,2,3,1,3
2023-06-01,59479,2,0,2,1,0,1
2023-06-01,198944,5,2,7,2,2,2
2023-06-01,197177,9,0,9,4,0,4
2023-06-01,199028,1,0,1,1,0,1
2023-06-01,59603,1,0,1,1,0,1
2023-06-01,211763,2,1,3,3,1,3
2023-06-01,59516,1,1,2,3,2,3
2023-06-01,47492,5,1,6,1,1,1
2023-06-01,43131,1,1,2,2,1,2
2023-06-01,207146,3,1,4,2,1,2
2023-06-01,28949,15,0,15,2,0,2
2023-06-01,49136,5,0,5,3,0,3
2023-06-01,57614,1,0,1,1,0,1
2023-06-01,61106,3,0,3,1,0,1
2023-06-01,42238,13,0,13,1,0,1
2023-06-01,198293,1,0,1,1,0,1
2023-06-01,57606,1,0,1,1,0,1
2023-06-01,57093,14,0,14,3,0,3
2023-06-01,34955,12,0,12,5,0,5
2023-06-01,57612,1,0,1,1,0,1
2023-06-01,44032,33,0,33,2,0,2
2023-06-01,201725,3,0,3,4,0,4
2023-06-01,57223,4,0,4,1,0,1
2023-06-01,41616,16,0,16,6,0,6
2023-06-01,50649,2,0,2,1,0,1
2023-06-01,42530,5,0,5,3,0,3
2023-06-01,42589,10,0,10,4,0,4
2023-06-01,198297,7,1,8,14,2,14
2023-06-01,200638,1,1,2,2,2,2
2023-06-01,213273,1,1,2,1,1,1
2023-06-01,31662,10,4,14,6,4,7
2023-06-01,59782,1,0,1,6,0,6
2023-06-01,57242,1,0,1,1,0,1
2023-06-01,213039,1,0,1,2,0,2
2023-06-01,51273,6,1,7,9,1,9
2023-06-01,48320,9,0,9,3,0,3
2023-06-01,31165,2,0,2,3,0,3
2023-06-01,34343,19,11,30,5,5,7
2023-06-01,205467,3,1,4,2,2,2
2023-06-01,199391,43,9,52,10,5,10
2023-06-01,200583,7,0,7,4,0,4
2023-06-01,201822,2,1,3,2,1,2
2023-06-01,201419,2,1,3,2,2,2
2023-06-01,51942,8,4,12,6,3,7
2023-06-01,199791,5,1,6,1,1,1
2023-06-01,199745,1,0,1,1,0,1
2023-06-01,200953,4,0,4,2,0,2
2023-06-01,199833,3,0,3,2,0,2
2023-06-01,201123,5,0,5,5,0,5
2023-06-01,200982,3,0,3,4,0,4
2023-06-01,16220,5,0,5,2,0,2
2023-06-01,33875,4,0,4,1,0,1
2023-06-01,3233,30,1,31,3,1,3
2023-06-01,58022,4,0,4,2,0,2
2023-06-01,56746,1,0,1,1,0,1
2023-06-01,44679,27,1,28,6,4,6
2023-06-01,56335,2,0,2,1,0,1
2023-06-01,39205,3,0,3,4,0,4
2023-06-01,59590,3,0,3,2,0,2
2023-06-01,199071,1,0,1,1,0,1
2023-06-01,34353,4,0,4,2,0,2
2023-06-01,205275,60,0,60,5,0,5
2023-06-01,60104,1,0,1,3,0,3
2023-06-01,39629,1,0,1,1,0,1
2023-06-01,41028,7,0,7,3,0,3
2023-06-01,42508,1,0,1,1,0,1
2023-06-01,61353,2,0,2,3,0,3
2023-06-01,12439,3,0,3,2,0,2
2023-06-01,207737,3,0,3,3,0,3
2023-06-01,35505,6,0,6,4,0,4
2023-06-01,33961,2,0,2,3,0,3
2023-06-01,201148,1,1,2,1,1,2
2023-06-01,200298,1,0,1,2,0,2
2023-06-01,57992,1,0,1,3,0,3
2023-06-01,28925,2,0,2,3,0,3
2023-06-01,8248,10,3,13,2,1,2
2023-06-01,35174,4,0,4,4,0,4
2023-06-01,12525,4,1,5,1,1,1
2023-06-01,60506,1,0,1,1,0,1
2023-06-01,400380,1,0,1,1,0,1
2023-06-01,211695,3,0,3,2,0,2
2023-06-01,139719,11,0,11,8,0,8
2023-06-01,29165,5,0,5,1,0,1
2023-06-01,28768,3,2,5,4,3,5
2023-06-01,41109,1,0,1,2,0,2
2023-06-01,205460,8,0,8,13,0,13
2023-06-01,52060,4,0,4,5,0,5
2023-06-01,202173,6,1,7,3,2,3
2023-06-01,202552,4,0,4,2,0,2
2023-06-01,212234,2,0,2,3,0,3
2023-06-01,31275,1,1,2,6,5,6
2023-06-01,49251,1,3,4,1,1,1
2023-06-01,50664,17,0,17,3,0,3
2023-06-01,25350,1,0,1,1,0,1
2023-06-01,41148,4,0,4,3,0,3
2023-06-01,25305,1,0,1,1,0,1
2023-06-01,210457,7,0,7,2,0,2
2023-06-01,41135,20,8,28,6,3,6
2023-06-01,29575,7,0,7,4,0,4
2023-06-01,41157,1,2,3,4,3,4
2023-06-01,12923,2,0,2,5,0,5
2023-06-01,25343,1,0,1,1,0,1
2023-06-01,1218,23,18,41,3,3,3
2023-06-01,14544,9,9,18,2,2,2
2023-06-01,31197,9,0,9,3,0,3
2023-06-01,30924,1,0,1,3,0,3
2023-06-01,31368,20,0,20,3,0,3
2023-06-01,34381,2,0,2,3,0,3
2023-06-01,4241496521,6,0,6,2,0,2
2023-06-01,1729,33,0,33,1,0,1
2023-06-01,21272,5,0,5,2,0,2
2023-06-01,212709,5,0,5,3,0,3
2023-06-01,31629,3,0,3,3,0,3
2023-06-01,31660,1,0,1,2,0,2
2023-06-01,16236,12,1,13,5,2,5
2023-06-01,20580,2,0,2,1,0,1
2023-06-01,39738,2,0,2,3,0,3
2023-06-01,8554,9,1,10,5,3,5
2023-06-01,30774,1,0,1,2,0,2
2023-06-01,52209,16,2,18,1,1,2
2023-06-01,30801,7,1,8,1,1,1
2023-06-01,206564,2,1,3,1,1,1
2023-06-01,205766,6,8,14,2,2,2
2023-06-01,44152,2,0,2,3,0,3
2023-06-01,60799,1,1,2,1,1,1
2023-06-01,6782,30,2,32,6,3,6
2023-06-01,31568,1,0,1,1,0,1
2023-06-01,205550,2,0,2,2,0,2
2023-06-01,139729,3,0,3,2,0,2
2023-06-01,29122,2,0,2,1,0,1
2023-06-01,200719,25,2,27,1,3,3
2023-06-01,212328,2,0,2,1,0,1
2023-06-01,199206,1,0,1,4,0,4
2023-06-01,15975,29,0,29,2,0,2
2023-06-01,44179,1,0,1,4,0,4
2023-06-01,24964,8,0,8,7,0,7
2023-06-01,35464,2,0,2,3,0,3
2023-06-01,198003,1,0,1,2,0,2
2023-06-01,30736,1,1,2,1,1,1
2023-06-01,212035,2,0,2,1,0,1
2023-06-01,4589,25,0,25,3,0,3
2023-06-01,29304,15,0,15,5,0,5
2023-06-01,60002,0,0,0,1,0,1
2023-06-01,31236,7,0,7,2,0,2
2023-06-01,28819,4,0,4,3,0,3
2023-06-01,15773,5,0,5,4,0,4
2023-06-01,30827,14,2,16,13,7,14
2023-06-01,31273,9,1,10,1,2,2
2023-06-01,30835,1,1,2,3,2,3
2023-06-01,15757,9,0,9,6,0,6
2023-06-01,44552,4,0,4,2,0,2
2023-06-01,208273,3,0,3,2,0,2
2023-06-01,15736,13,0,13,1,0,1
2023-06-01,30795,3,1,4,2,2,2
2023-06-01,209705,4,0,4,3,0,3
2023-06-01,207435,1,0,1,2,0,2
2023-06-01,62075,1,7,8,1,6,6
2023-06-01,212936,1,0,1,1,0,1
2023-06-01,206735,3,1,4,6,2,6
2023-06-01,211949,1,0,1,3,0,3
2023-06-01,208392,6,0,6,1,0,1
2023-06-01,31425,11,0,11,2,0,2
2023-06-01,30936,3,0,3,8,0,8
2023-06-01,21375,1,0,1,3,0,3
2023-06-01,15594,6,7,13,8,7,10
2023-06-01,12319,1,0,1,2,0,2
2023-06-01,3268,2,1,3,4,2,4
2023-06-01,35223,2,1,3,3,2,3
2023-06-01,48758,4,0,4,1,0,1
2023-06-01,34248,15,0,15,2,0,2
2023-06-01,57238,1,1,2,1,1,1
2023-06-01,13105,24,1,25,14,1,15
2023-06-01,34875,2,0,2,4,0,4
2023-06-01,34426,27,0,27,1,0,1
2023-06-01,212588,1,1,2,1,1,1
2023-06-01,59851,3,0,3,4,0,4
2023-06-01,200533,2,1,3,6,1,6
2023-06-01,31067,1,0,1,3,0,3
2023-06-01,61082,1,0,1,1,0,1
2023-06-01,211545,6,0,6,1,0,1
2023-06-01,50866,1,0,1,3,0,3
2023-06-01,43723,1,0,1,2,0,2
2023-06-01,43732,2,0,2,2,0,2
2023-06-01,197741,2,0,2,4,0,4
2023-06-01,207249,7,3,10,7,5,8
2023-06-01,39483,1,0,1,2,0,2
2023-06-01,57912,5,0,5,4,0,4
2023-06-01,197184,6,0,6,2,0,2
2023-06-01,49704,1,1,2,2,2,2
2023-06-01,34462,1,0,1,1,0,1
2023-06-01,201105,5,0,5,1,0,1
2023-06-01,209193,6,2,8,1,1,1
2023-06-01,41625,6,6,12,9,9,10
2023-06-01,29180,23,0,23,1,0,1
2023-06-01,206920,4,1,5,1,1,1
2023-06-01,43463,9,1,10,2,1,2
2023-06-01,39007,16,0,16,4,0,4
2023-06-01,50065,2,1,3,1,1,1
2023-06-01,9153,6,1,7,6,3,6
2023-06-01,202416,1,1,2,2,2,2
2023-06-01,29147,2,1,3,2,2,3
2023-06-01,60722,2,0,2,1,0,1
2023-06-01,196796,1,0,1,2,0,2
2023-06-01,57452,5,0,5,5,0,5
2023-06-01,199862,1,0,1,2,0,2
2023-06-01,197097,1,0,1,2,0,2
2023-06-01,33908,5,0,5,3,0,3
2023-06-01,210906,168,0,168,2,0,2
2023-06-01,15419,21,2,23,6,2,6
2023-06-01,212046,90,0,90,1,0,1
2023-06-01,34262,1,0,1,2,0,2
2023-06-01,25355,33,0,33,3,0,3
2023-06-01,16168,3,0,3,5,0,5
2023-06-01,49090,1,0,1,1,0,1
2023-06-01,203331,1,0,1,1,0,1
2023-06-01,61270,1,0,1,1,0,1
2023-06-01,29297,5,0,5,1,0,1
2023-06-01,41340,2,0,2,1,0,1
2023-06-01,9127,24,0,24,2,0,2
2023-06-01,50359,3,0,3,3,0,3
2023-06-01,31435,8,0,8,1,0,1
2023-06-01,209564,8,0,8,1,0,1
2023-06-01,16185,3,0,3,3,0,3
2023-06-01,29446,1,0,1,4,0,4
2023-06-01,211082,5,0,5,2,0,2
2023-06-01,204738,1,0,1,2,0,2
2023-06-01,31112,4,0,4,1,0,1
2023-06-01,197392,5,0,5,5,0,5
2023-06-01,198755,5,1,6,4,3,4
2023-06-01,208774,1,0,1,3,0,3
2023-06-01,204298,1,0,1,3,0,3
2023-06-01,41469,12,0,12,2,0,2
2023-06-01,206820,2,0,2,1,0,1
2023-06-01,43651,1,0,1,2,0,2
2023-06-01,29255,8,0,8,1,0,1
2023-06-01,43647,7,0,7,2,0,2
2023-06-01,39539,2,0,2,2,0,2
2023-06-01,15474,2,1,3,3,1,3
2023-06-01,29348,1,0,1,1,0,1
2023-06-01,25376,4,5,9,8,4,8
2023-06-01,198319,7,0,7,2,0,2
2023-06-01,31654,8,0,8,2,0,2
2023-06-01,198692,3,2,5,5,3,5
2023-06-01,8596,2,1,3,6,3,6
2023-06-01,12888,22,0,22,15,0,15
2023-06-01,44986,1,0,1,2,0,2
2023-06-01,211167,2,0,2,2,0,2
2023-06-01,60713,7,2,9,2,3,3
2023-06-01,204086,2,0,2,4,0,4
2023-06-01,199842,1,0,1,3,0,3
2023-06-01,199910,2,0,2,2,0,2
2023-06-01,201695,2,0,2,3,0,3
2023-06-01,203261,2,0,2,4,0,4
2023-06-01,199891,1,0,1,1,0,1
2023-06-01,199568,3,1,4,2,1,2
2023-06-01,199944,17,0,17,1,0,1
2023-06-01,201503,5,4,9,3,2,3
2023-06-01,50079,6,0,6,5,0,5
2023-06-01,201078,4,0,4,2,0,2
2023-06-01,200876,10,0,10,1,0,1
2023-06-01,208112,1,0,1,3,0,3
2023-06-01,62025,2,0,2,1,0,1
2023-06-01,199260,5,0,5,2,0,2
2023-06-01,208227,1,0,1,3,0,3
2023-06-01,205017,1,0,1,4,0,4
2023-06-01,212251,2,0,2,4,0,4
2023-06-01,209388,3,0,3,2,0,2
2023-06-01,197704,8,0,8,6,0,6
2023-06-01,206093,1,0,1,1,0,1
2023-06-01,196928,5,0,5,4,0,4
2023-06-01,203389,6,0,6,4,0,4
2023-06-01,197903,1,0,1,1,0,1
2023-06-01,197142,1,0,1,1,0,1
2023-06-01,42246,2,0,2,3,0,3
2023-06-01,206442,2,0,2,2,0,2
2023-06-01,35463,2,0,2,2,0,2
2023-06-01,25552,4,0,4,4,0,4
2023-06-01,39112,2,0,2,2,0,2
2023-06-01,34707,5,0,5,1,0,1
2023-06-01,29581,1,0,1,2,0,2
2023-06-01,197467,3,2,5,3,3,4
2023-06-01,43975,0,0,0,4,0,4
2023-06-01,12724,2,0,2,2,0,2
2023-06-01,6874,2,0,2,2,0,2
2023-06-01,8398,4,0,4,1,0,1
2023-06-01,9162,1,1,2,1,1,1
2023-06-01,31575,1,0,1,3,0,3
2023-06-01,202689,1,0,1,1,0,1
2023-06-01,29100,2,0,2,3,0,3
2023-06-01,29510,1,0,1,1,0,1
2023-06-01,51338,3,0,3,2,0,2
2023-06-01,28886,1,1,2,13,2,13
2023-06-01,208938,1,0,1,3,0,3
2023-06-01,25528,2,0,2,1,0,1
2023-06-01,207503,2,0,2,1,0,1
2023-06-01,29584,17,1,18,2,1,2
2023-06-01,60258,17,0,17,2,0,2
2023-06-01,8920,28,0,28,3,0,3
2023-06-01,35423,1,0,1,2,0,2
2023-06-01,204492,1,0,1,2,0,2
2023-06-01,8677,196,0,196,2,0,2
2023-06-01,41233,0,0,0,2,0,2
2023-06-01,16177,22,0,22,1,0,1
2023-06-01,204819,3,1,4,2,1,2
2023-06-01,199485,2,0,2,3,0,3
2023-06-01,199579,2,0,2,2,0,2
2023-06-01,43673,2,0,2,3,0,3
2023-06-01,29651,3,0,3,4,0,4
2023-06-01,25473,1,1,2,3,1,3
2023-06-01,29452,5,1,6,8,7,9
2023-06-01,30737,1,0,1,1,0,1
2023-06-01,209287,2,0,2,3,0,3
2023-06-01,211970,7,1,8,3,1,3
2023-06-01,30978,1,0,1,1,0,1
2023-06-01,51190,5,0,5,4,0,4
2023-06-01,6740,4,0,4,1,0,1
2023-06-01,30745,11,8,19,3,2,3
2023-06-01,62200,1,1,2,1,1,1
2023-06-01,56864,8,1,9,7,3,8
2023-06-01,29212,1,0,1,1,0,1
2023-06-01,196744,5,0,5,2,0,2
2023-06-01,34508,6,0,6,1,0,1
2023-06-01,30981,4,0,4,3,0,3
2023-06-01,20640,3,1,4,7,5,8
2023-06-01,13091,9,0,9,4,0,4
2023-06-01,204141,2,1,3,1,1,1
2023-06-01,13289,2,1,3,4,5,5
2023-06-01,29624,1,1,2,8,6,9
2023-06-01,33942,15,0,15,2,0,2
2023-06-01,201058,14,0,14,1,0,1
2023-06-01,50249,1,0,1,1,0,1
2023-06-01,209769,1,0,1,1,0,1
2023-06-01,209296,1,0,1,1,0,1
2023-06-01,20507,2,1,3,1,1,1
2023-06-01,208545,4,0,4,3,0,3
2023-06-01,44515,14,2,16,1,1,1
2023-06-01,202924,1,0,1,1,0,1
2023-06-01,51174,1,0,1,2,0,2
2023-06-01,203634,1,0,1,1,0,1
2023-06-01,24891,1,0,1,2,0,2
2023-06-01,31444,8,0,8,10,0,10
2023-06-01,34809,1,0,1,2,0,2
2023-06-01,207011,3,0,3,1,0,1
2023-06-01,28839,2,1,3,2,1,2
2023-06-01,28848,2,1,3,2,1,2
2023-06-01,206159,1,1,2,2,2,2
2023-06-01,206148,1,0,1,1,0,1
2023-06-01,28771,8,3,11,2,2,2
2023-06-01,205554,11,0,11,4,0,4
2023-06-01,31492,2,0,2,2,0,2
2023-06-01,35770,1,0,1,2,0,2
2023-06-01,42767,1,0,1,1,0,1
2023-06-01,198643,1,0,1,2,0,2
2023-06-01,50182,3,0,3,5,0,5
2023-06-01,47968,1,0,1,3,0,3
2023-06-01,60992,1,0,1,1,0,1
2023-06-01,60661,1,0,1,1,0,1
2023-06-01,30879,2,1,3,3,3,4
2023-06-01,212498,1,0,1,1,0,1
2023-06-01,51320,22,0,22,1,0,1
2023-06-01,8391,3,1,4,11,10,13
2023-06-01,31056,2,1,3,2,2,2
2023-06-01,8561,17,17,34,6,5,6
2023-06-01,34000,6,0,6,1,0,1
2023-06-01,210891,1,0,1,1,0,1
2023-06-01,41003,2,0,2,1,0,1
2023-06-01,42096,0,0,0,2,0,2
2023-06-01,30914,6,0,6,1,0,1
2023-06-01,30870,28,4,32,6,4,6
2023-06-01,199522,4,1,5,7,2,7
2023-06-01,30925,11,1,12,10,7,13
2023-06-01,29690,33,1,34,5,1,5
2023-06-01,135381,13,4,17,2,3,3
2023-06-01,142609,2,0,2,3,0,3
2023-06-01,149036,2,0,2,3,0,3
2023-06-01,23154,61,0,61,40,0,40
2023-06-01,137489,2,0,2,2,0,2
2023-06-01,150686,2,0,2,2,0,2
2023-06-01,138427,2,0,2,3,0,3
2023-06-01,151040,2,0,2,3,0,3
2023-06-01,133328,2,0,2,2,0,2
2023-06-01,55538,2,0,2,1,0,1
2023-06-01,49206,6,2,8,8,2,9
2023-06-01,5390,6,1,7,12,7,14
2023-06-01,40999,2,2,4,8,3,10
2023-06-01,200093,4,0,4,3,0,3
2023-06-01,3457,4,0,4,3,0,3
2023-06-01,47518,2,0,2,2,0,2
2023-06-01,28997,3,1,4,1,1,1
2023-06-01,30971,4,2,6,7,6,7
2023-06-01,42605,4,2,6,9,6,11
2023-06-01,33941,15,2,17,7,5,8
2023-06-01,202130,4,0,4,1,0,1
2023-06-01,31411,1,0,1,3,0,3
2023-06-01,209581,6,0,6,1,0,1
2023-06-01,213048,1,0,1,3,0,3
2023-06-01,207280,5,0,5,1,0,1
2023-06-01,25557,2,0,2,9,0,9
2023-06-01,31306,7,0,7,1,0,1
2023-06-01,47156,9,1,10,1,2,2
2023-06-01,49157,8,0,8,3,0,3
2023-06-01,31404,16,0,16,5,0,5
2023-06-01,41848,1,1,2,1,1,1
2023-06-01,33873,28,2,30,4,2,4
2023-06-01,51401,9,1,10,1,1,1
2023-06-01,31394,2,0,2,2,0,2
2023-06-01,31415,12,1,13,11,6,11
2023-06-01,31438,2,1,3,3,1,3
2023-06-01,39132,1,0,1,1,0,1
2023-06-01,31489,1,0,1,1,0,1
2023-06-01,31467,1,0,1,1,0,1
2023-06-01,31521,1,0,1,1,0,1
2023-06-01,34967,14,0,14,3,0,3
2023-06-01,35117,3,0,3,1,0,1
2023-06-01,43186,1,0,1,2,0,2
2023-06-01,34233,1,1,2,3,3,5
2023-06-01,15681,5,0,5,2,0,2
2023-06-01,48702,4,0,4,4,0,4
2023-06-01,29063,13,1,14,7,3,7
2023-06-01,30900,4,2,6,4,3,4
2023-06-01,208623,1,0,1,1,0,1
2023-06-01,207664,2,0,2,3,0,3
2023-06-01,213162,2,1,3,3,1,3
2023-06-01,207642,1,1,2,1,1,1
2023-06-01,207665,1,0,1,2,0,2
2023-06-01,34895,2,1,3,8,7,10
2023-06-01,209176,1,0,1,2,0,2
2023-06-01,200332,1,0,1,2,0,2
2023-06-01,212505,1,0,1,1,0,1
2023-06-01,211793,1,0,1,2,0,2
2023-06-01,204620,1,0,1,1,0,1
2023-06-01,200205,1,0,1,1,0,1
2023-06-01,197497,5,0,5,1,0,1
2023-06-01,59586,4,2,6,2,1,2
2023-06-01,44941,18,0,18,7,4,7
2023-06-01,49718,25,1,26,6,1,6
2023-06-01,31712,4,0,4,1,0,1
2023-06-01,28978,6,1,7,9,3,9
2023-06-01,39168,1,0,1,1,0,1
2023-06-01,34310,3,0,3,2,0,2
2023-06-01,50229,2,0,2,1,0,1
2023-06-01,15713,5,0,5,1,0,1
2023-06-01,41809,11,1,12,1,1,1
2023-06-01,52153,1,0,1,10,0,10
2023-06-01,38923,4,0,4,1,0,1
2023-06-01,21132,0,0,0,3,0,3
2023-06-01,33838,4,0,4,6,0,6
2023-06-01,30851,27,1,28,19,2,19
2023-06-01,34254,4,1,5,8,3,9
2023-06-01,199494,7,0,7,3,0,3
2023-06-01,20516,8,0,8,8,0,8
2023-06-01,48957,13,0,13,10,0,10
2023-06-01,34520,1,1,2,2,2,2
2023-06-01,196812,1,0,1,3,0,3
2023-06-01,8350,53,0,53,3,0,3
2023-06-01,208281,1,1,2,1,1,1
2023-06-01,62133,2,0,2,2,0,2
2023-06-01,60486,8,10,18,19,16,23
2023-06-01,34989,9,0,9,1,0,1
2023-06-01,44655,1,1,2,12,4,12
2023-06-01,35229,1,0,1,1,0,1
2023-06-01,34485,4,0,4,2,0,2
2023-06-01,29554,4,0,4,1,0,1
2023-06-01,3264,2,1,3,1,1,1
2023-06-01,196773,7,0,7,3,0,3
2023-06-01,25310,4,0,4,1,0,1
2023-06-01,31222,3,1,4,2,1,2
2023-06-01,202492,22,0,22,3,0,3
2023-06-01,150345,2,0,2,7,0,7
2023-06-01,13075,4,1,5,1,1,1
2023-06-01,31319,8,2,10,9,7,11
2023-06-01,3058,6,1,7,1,1,1
2023-06-01,208560,3,1,4,2,1,2
2023-06-01,60920,5,0,5,4,0,4
2023-06-01,50494,2,0,2,1,0,1
2023-06-01,52073,4,1,5,1,1,2
2023-06-01,50599,22,3,25,7,3,7
2023-06-01,209201,1,0,1,2,0,2
2023-06-01,197205,5,2,7,6,2,6
2023-06-01,31505,4,0,4,6,0,6
2023-06-01,49484,6,0,6,6,0,6
2023-06-01,31634,2,0,2,1,0,1
2023-06-01,31562,1,1,2,3,3,4
2023-06-01,51009,1,1,2,3,1,3
2023-06-01,24936,12,0,12,8,0,8
2023-06-01,39435,71,1,72,1,1,1
2023-06-01,31595,2,1,3,7,6,9
2023-06-01,31304,5,1,6,4,1,4
2023-06-01,202520,2,0,2,1,0,1
2023-06-01,8784,29,0,29,4,0,4
2023-06-01,29259,4,1,5,8,5,9
2023-06-01,2847,9,1,10,10,10,11
2023-06-01,208244,1,0,1,2,0,2
2023-06-01,41273,1,0,1,1,0,1
2023-06-01,208910,1,0,1,1,0,1
2023-06-01,43809,6,3,9,6,1,6
2023-06-01,201206,16,1,17,2,1,2
2023-06-01,35411,3,0,3,2,0,2
2023-06-01,12651,2,1,3,3,1,3
2023-06-01,31441,1,0,1,1,0,1
2023-06-01,34572,7,1,8,12,3,12
2023-06-01,39830,4,0,4,2,0,2
2023-06-01,42308,1,0,1,3,0,3
2023-06-01,31510,6,1,7,10,7,11
2023-06-01,35778,1,0,1,1,0,1
2023-06-01,34525,8,1,9,11,6,13
2023-06-01,12580,8,1,9,9,1,9
2023-06-01,35169,1,0,1,1,0,1
2023-06-01,39694,1,0,1,2,0,2
2023-06-01,196,17,2,19,1,1,1
2023-06-01,12402,4,1,5,1,1,1
2023-06-01,9069,3,1,4,1,1,1
2023-06-01,12364,2,1,3,1,1,1
2023-06-01,8253,3,1,4,1,1,1
2023-06-01,8581,9,1,10,1,1,1
2023-06-01,8611,3,0,3,1,0,1
2023-06-01,8991,3,0,3,2,0,2
2023-06-01,51473,1,0,1,1,0,1
2023-06-01,12355,9,10,19,10,6,12
2023-06-01,286,0,0,0,3,2,5
2023-06-01,31138,1,1,2,2,2,2
2023-06-01,60651,11,1,12,6,2,6
2023-06-01,51446,1,0,1,2,0,2
2023-06-01,29129,2,0,2,2,0,2
2023-06-01,210398,5,2,7,2,2,2
2023-06-01,132006,2,1,3,3,2,3
2023-06-01,31186,1,0,1,3,0,3
2023-06-01,196927,1,0,1,2,0,2
2023-06-01,48331,0,0,0,2,0,2
2023-06-01,31204,5,0,5,3,0,3
2023-06-01,49971,3,0,3,2,0,2
2023-06-01,204256,2,0,2,6,0,6
2023-06-01,34694,2,1,3,2,2,2
2023-06-01,31225,16,0,16,6,0,6
2023-06-01,49215,4,0,4,3,0,3
2023-06-01,31294,1,1,2,6,1,6
2023-06-01,61980,1,0,1,3,0,3
2023-06-01,50608,1,0,1,3,0,3
2023-06-01,12388,1,0,1,1,0,1
2023-06-01,31596,1,0,1,3,0,3
2023-06-01,25532,69,4,73,4,2,4
2023-06-01,47328,8,0,8,4,0,4
2023-06-01,41280,5,0,5,1,0,1
2023-06-01,9999,10,1,11,3,1,3
2023-06-01,48921,2,1,3,2,3,3
2023-06-01,15457,9,1,10,1,1,1
2023-06-01,44718,4,0,4,4,0,4
2023-06-01,44586,3,0,3,1,0,1
2023-06-01,60886,5,0,5,1,0,1
2023-06-01,206815,1,1,2,1,1,1
2023-06-01,209500,4,0,4,1,0,1
2023-06-01,210275,8,1,9,3,1,3
2023-06-01,8513,3,0,3,1,0,1
2023-06-01,35434,14,1,15,9,6,10
2023-06-01,202220,4,0,4,2,0,2
2023-06-01,8508,15,4,19,6,4,6
2023-06-01,199279,1,0,1,1,0,1
2023-06-01,394808,8,0,8,3,0,3
2023-06-01,44467,2,0,2,1,0,1
2023-06-01,33934,62,0,62,1,0,1
2023-06-01,42362,10,0,10,1,0,1
2023-06-01,39913,2,1,3,2,1,2
2023-06-01,50955,2,1,3,1,1,1
2023-06-01,197015,5,0,5,1,0,1
2023-06-01,201498,1,0,1,2,0,2
2023-06-01,207133,2,2,4,7,4,7
2023-06-01,212620,1,0,1,2,0,2
2023-06-01,58136,23,0,23,3,0,3
2023-06-01,211928,1,0,1,2,0,2
2023-06-01,212288,1,0,1,2,0,2
2023-06-01,211497,1,0,1,2,0,2
2023-06-01,198579,1,0,1,3,0,3
2023-06-01,56533,6,0,6,6,0,6
2023-06-01,42065,49,0,49,2,0,2
2023-06-01,35831,6,0,6,3,0,3
2023-06-01,31364,53,0,53,5,0,5
2023-06-01,39551,67,1,68,5,2,5
2023-06-01,203583,3,0,3,3,0,3
2023-06-01,211595,6,1,7,2,1,2
2023-06-01,15545,5,0,5,1,0,1
2023-06-01,204494,1,0,1,3,0,3
2023-06-01,30942,2,0,2,1,0,1
2023-06-01,199397,4,0,4,3,0,3
2023-06-01,21208,4,0,4,1,0,1
2023-06-01,31679,11,0,11,1,0,1
2023-06-01,12444,8,0,8,5,0,5
2023-06-01,51321,4,0,4,5,0,5
2023-06-01,213245,9,0,9,1,0,1
2023-06-01,41933,2,0,2,1,0,1
2023-06-01,33940,1,1,2,3,2,3
2023-06-01,9208,5,2,7,10,5,10
2023-06-01,33864,5,1,6,1,1,1
2023-06-01,62461,1,0,1,3,0,3
2023-06-01,33831,6,0,6,3,0,3
2023-06-01,21088,2,0,2,1,0,1
2023-06-01,29636,1,1,2,1,4,4
2023-06-01,35433,3,0,3,1,0,1
2023-06-01,42611,7,1,8,4,4,5
2023-06-01,33943,1,1,2,1,2,2
2023-06-01,202206,7,0,7,3,0,3
2023-06-01,51905,1,0,1,1,0,1
2023-06-01,49419,7,3,10,3,3,3
2023-06-01,5414,1,0,1,2,0,2
2023-06-01,8562,9,1,10,5,1,5
2023-06-01,16096,16,0,16,3,0,3
2023-06-01,197387,1,0,1,1,0,1
2023-06-01,41091,1,0,1,1,0,1
2023-06-01,33848,11,3,14,7,6,9
2023-06-01,15930,10,1,11,5,1,5
2023-06-01,209061,4,0,4,1,0,1
2023-06-01,33987,3,0,3,2,0,2
2023-06-01,34444,13,0,13,6,0,6
2023-06-01,34925,1,0,1,1,0,1
2023-06-01,49825,8,3,11,7,4,7
2023-06-01,16290,3,0,3,6,0,6
2023-06-01,34171,6,1,7,6,4,7
2023-06-01,60099,4,0,4,1,0,1
2023-06-01,204770,5,1,6,3,1,3
2023-06-01,201579,4,1,5,1,1,1
2023-06-01,205570,7,0,7,1,0,1
2023-06-01,198345,4,2,6,1,1,1
2023-06-01,211192,3,0,3,3,0,3
2023-06-01,59642,5,1,6,2,1,2
2023-06-01,142561,2,2,4,1,1,2
2023-06-01,142275,2,2,4,1,1,1
2023-06-01,196691,3,0,3,6,0,6
2023-06-01,203673,2,1,3,2,2,2
2023-06-01,41325,1,0,1,2,0,2
2023-06-01,204119,3,1,4,1,1,1
2023-06-01,203339,4,2,6,1,1,1
2023-06-01,203557,4,1,5,1,1,1
2023-06-01,202920,1,0,1,1,0,1
2023-06-01,206902,2,0,2,5,0,5
2023-06-01,205370,1,0,1,2,0,2
2023-06-01,35199,4,0,4,10,0,10
2023-06-01,8834,1,0,1,2,0,2
2023-06-01,41167,3,0,3,1,0,1
2023-06-01,34937,6,0,6,2,0,2
2023-06-01,35383,3,1,4,1,1,1
2023-06-01,54058,10,4,14,3,3,3
2023-06-01,59657,3,0,3,1,0,1
2023-06-01,61234,2,0,2,3,0,3
2023-06-01,25084,2,1,3,14,5,14
2023-06-01,200272,2,1,3,5,1,5
2023-06-01,2107,16,2,18,12,8,12
2023-06-01,58046,5,1,6,1,1,1
2023-06-01,196738,2,0,2,3,0,3
2023-06-01,201583,1,0,1,1,0,1
2023-06-01,200899,13,8,21,12,4,12
2023-06-01,61992,2,0,2,1,0,1
2023-06-01,12708,12,0,12,1,0,1
2023-06-01,49887,1,0,1,1,0,1
2023-06-01,56990,6,1,7,10,7,11
2023-06-01,200778,1,0,1,3,0,3
2023-06-01,201387,5,0,5,4,0,4
2023-06-01,200955,1,0,1,3,0,3
2023-06-01,8241,2,0,2,4,0,4
2023-06-01,196914,2,0,2,4,0,4
2023-06-01,201388,2,0,2,1,0,1
2023-06-01,207433,1,0,1,2,0,2
2023-06-01,199145,1,0,1,1,0,1
2023-06-01,201383,2,0,2,1,0,1
2023-06-01,201382,7,0,7,3,0,3
2023-06-01,51557,11,0,11,1,0,1
2023-06-01,34168,1,1,2,1,1,1
2023-06-01,48991,1,0,1,1,0,1
2023-06-01,209228,1,0,1,1,0,1
2023-06-01,61084,4,0,4,1,0,1
2023-06-01,210030,2,0,2,2,0,2
2023-06-01,42899,1,0,1,1,0,1
2023-06-01,202175,4,3,7,1,1,1
2023-06-01,201767,5,0,5,2,0,2
2023-06-01,35773,4,0,4,2,0,2
2023-06-01,42855,1,0,1,1,0,1
2023-06-01,59463,11,0,11,4,0,4
2023-06-01,29244,14,0,14,9,0,9
2023-06-01,24877,18,1,19,2,1,2
2023-06-01,13041,8,2,10,6,6,8
2023-06-01,57837,1,1,2,1,1,1
2023-06-01,34390,1,0,1,2,0,2
2023-06-01,35274,1,0,1,2,0,2
2023-06-01,50222,1,1,2,4,1,4
2023-06-01,8997,0,0,0,2,0,2
2023-06-01,31608,10,0,10,9,0,9
2023-06-01,12654,20,24,44,60,46,67
2023-06-01,59105,5,1,6,17,16,19
2023-06-01,31619,13,0,13,5,0,5
2023-06-01,34509,1,0,1,1,0,1
2023-06-01,205395,1,0,1,3,0,3
2023-06-01,207325,1,0,1,2,0,2
2023-06-01,207742,1,0,1,2,0,2
2023-06-01,209384,1,0,1,1,0,1
2023-06-01,206417,9,0,9,3,0,3
2023-06-01,57608,9,0,9,9,0,9
2023-06-01,206679,1,0,1,3,0,3
2023-06-01,212909,1,0,1,1,0,1
2023-06-01,201753,1,0,1,1,0,1
2023-06-01,35506,58,1,59,8,3,8
2023-06-01,31581,1,0,1,4,0,4
2023-06-01,22005,2,0,2,3,0,3
2023-06-01,200946,5,0,5,2,0,2
2023-06-01,59769,1,0,1,1,0,1
2023-06-01,200682,2,0,2,2,0,2
2023-06-01,212949,14,0,14,1,0,1
2023-06-01,49560,6,1,7,2,1,2
2023-06-01,207839,3,0,3,3,0,3
2023-06-01,206907,1,0,1,6,0,6
2023-06-01,39848,1,0,1,3,0,3
2023-06-01,34969,6,0,6,2,0,2
2023-06-01,205679,18,1,19,8,5,8
2023-06-01,209579,1,1,2,2,1,2
2023-06-01,207998,2,0,2,2,0,2
2023-06-01,208141,1,0,1,2,0,2
2023-06-01,60807,6,0,6,1,0,1
2023-06-01,60508,9,0,9,3,0,3
2023-06-01,34479,2,0,2,2,0,2
2023-06-01,8506,1,0,1,1,0,1
2023-06-01,5387,15,1,16,4,1,4
2023-06-01,3335,2,0,2,1,0,1
2023-06-01,44698,1,0,1,1,0,1
2023-06-01,33796,4,0,4,1,0,1
2023-06-01,47402,8,0,8,2,0,2
2023-06-01,5541,3,0,3,3,2,3
2023-06-01,35638,1,0,1,2,0,2
2023-06-01,201308,1,3,4,1,1,1
2023-06-01,60199,4,1,5,1,1,1
2023-06-01,2594,23,1,24,6,3,7
2023-06-01,31615,4,0,4,1,0,1
2023-06-01,31703,3,0,3,1,0,1
2023-06-01,198868,1,0,1,1,0,1
2023-06-01,198576,2,0,2,3,0,3
2023-06-01,8345,21,0,21,1,0,1
2023-06-01,206198,2,0,2,3,0,3
2023-06-01,202819,3,0,3,1,0,1
2023-06-01,50128,2,1,3,3,3,3
2023-06-01,57801,5,5,10,3,3,3
2023-06-01,34001,4,1,5,1,1,1
2023-06-01,39504,4,0,4,1,0,1
2023-06-01,20590,20,0,20,6,0,6
2023-06-01,210986,3,0,3,1,0,1
2023-06-01,33921,4,0,4,2,0,2
2023-06-01,41943,1,0,1,2,0,2
2023-06-01,34236,7,0,7,1,0,1
2023-06-01,31402,6,0,6,2,0,2
2023-06-01,33953,3,0,3,1,0,1
2023-06-01,15450,20,1,21,3,3,3
2023-06-01,42880,1,0,1,2,0,2
2023-06-01,47113,1,0,1,2,0,2
2023-06-01,49137,5,0,5,2,0,2
2023-06-01,12511,4,3,7,1,1,1
2023-06-01,34165,4,0,4,1,0,1
2023-06-01,34308,2,0,2,4,0,4
2023-06-01,202617,4,1,5,9,6,11
2023-06-01,51970,2,0,2,1,0,1
2023-06-01,33839,3,0,3,1,0,1
2023-06-01,60509,3,0,3,2,0,2
2023-06-01,202043,1,0,1,2,0,2
2023-06-01,49010,10,3,13,1,1,1
2023-06-01,207517,1,0,1,2,0,2
2023-06-01,138005,13,6,19,6,4,7
2023-06-01,209871,6,6,12,3,4,4
2023-06-01,35237,11,0,11,8,0,8
2023-06-01,33844,3,0,3,1,0,1
2023-06-01,8629,2,0,2,5,0,5
2023-06-01,6834,4,1,5,8,4,8
2023-06-01,39563,5,0,5,5,0,5
2023-06-01,211554,2,0,2,3,0,3
2023-06-01,59862,41,1,42,6,2,6
2023-06-01,57186,12,0,12,1,0,1
2023-06-01,35644,1,0,1,2,0,2
2023-06-01,39113,1,0,1,4,0,4
2023-06-01,34557,16,0,16,1,0,1
2023-06-01,29485,2,1,3,1,1,1
2023-06-01,200248,1,0,1,1,0,1
2023-06-01,60189,1,0,1,3,0,3
2023-06-01,199965,2,0,2,2,0,2
2023-06-01,199615,1,0,1,1,0,1
2023-06-01,51931,2,1,3,3,2,5
2023-06-01,207144,43,0,43,1,0,1
2023-06-01,25147,12,0,12,2,0,2
2023-06-01,48747,12,0,12,1,0,1
2023-06-01,34788,78,0,78,10,0,10
2023-06-01,51486,1,0,1,3,0,3
2023-06-01,198388,1,0,1,2,0,2
2023-06-01,206645,1,0,1,3,0,3
2023-06-01,41017,1,0,1,1,0,1
2023-06-01,206796,2,0,2,2,0,2
2023-06-01,34896,1,0,1,2,0,2
2023-06-01,34705,1,0,1,1,0,1
2023-06-01,31643,9,0,9,3,0,3
2023-06-01,210393,2,0,2,3,0,3
2023-06-01,210095,4,0,4,2,0,2
2023-06-01,39151,14,0,14,6,0,6
2023-06-01,39678,8,0,8,7,0,7
2023-06-01,41999,1,0,1,2,0,2
2023-06-01,35299,1,0,1,1,0,1
2023-06-01,35300,1,0,1,1,0,1
2023-06-01,42162,2,0,2,8,0,8
2023-06-01,198225,6,1,7,3,3,4
2023-06-01,35334,4,1,5,1,2,2
2023-06-01,50779,5,2,7,3,2,3
2023-06-01,202385,1,0,1,1,0,1
2023-06-01,204885,1,0,1,1,0,1
2023-06-01,200670,1,0,1,1,0,1
2023-06-01,200289,1,0,1,2,0,2
2023-06-01,41966,4,1,5,8,4,8
2023-06-01,208807,1,0,1,2,0,2
2023-06-01,197887,1,0,1,3,0,3
2023-06-01,30793,8,0,8,2,0,2
2023-06-01,60816,1,0,1,3,0,3
2023-06-01,202399,1,0,1,3,0,3
2023-06-01,209292,1,0,1,1,0,1
2023-06-01,34144,4,1,5,2,1,2
2023-06-01,211106,4,0,4,1,0,1
2023-06-01,34100,1,1,2,1,1,1
2023-06-01,198632,3,0,3,1,0,1
2023-06-01,34133,2,0,2,2,0,2
2023-06-01,29233,1,0,1,1,0,1
2023-06-01,25156,2,2,4,2,1,3
2023-06-01,25384,12,1,13,4,1,4
2023-06-01,24822,3,1,4,4,4,5
2023-06-01,51553,7,0,7,7,0,7
2023-06-01,201334,1,0,1,2,0,2
2023-06-01,16326,2,1,3,2,2,2
2023-06-01,149457,8,0,8,1,0,1
2023-06-01,210671,1,0,1,1,0,1
2023-06-01,197549,3,0,3,1,0,1
2023-06-01,59580,3,0,3,2,0,2
2023-06-01,197013,5,1,6,4,1,4
2023-06-01,34362,23,0,23,11,0,11
2023-06-01,34769,1,0,1,1,0,1
2023-06-01,34589,1,0,1,2,0,2
2023-06-01,24693,2,1,3,2,1,2
2023-06-01,34470,6,0,6,8,0,8
2023-06-01,206991,12,0,12,2,0,2
2023-06-01,39918,6,0,6,5,0,5
2023-06-01,39868,1,0,1,1,0,1
2023-06-01,41211,1,0,1,1,0,1
2023-06-01,211631,1,0,1,1,0,1
2023-06-01,13005,12,1,13,5,2,5
2023-06-01,21233,6,1,7,2,1,2
2023-06-01,142005,13,0,13,5,0,5
2023-06-01,271689,12,7,19,6,6,7
2023-06-01,60636,33,1,34,7,2,7
2023-06-01,42314,41,2,43,3,2,4
2023-06-01,44444,188,3,191,28,13,33
2023-06-01,7598,18,0,18,1,0,1
2023-06-01,44703,8,0,8,3,0,3
2023-06-01,34803,9,1,10,6,3,6
2023-06-01,48427,38,0,38,4,0,4
2023-06-01,210102,5,0,5,1,0,1
2023-06-01,34644,1,0,1,1,0,1
2023-06-01,39055,2,0,2,1,0,1
2023-06-01,34752,3,0,3,1,0,1
2023-06-01,25509,1,0,1,8,0,8
2023-06-01,34678,1,0,1,1,0,1
2023-06-01,202975,4,1,5,6,3,6
2023-06-01,58088,2,0,2,3,0,3
2023-06-01,208642,2,0,2,1,0,1
2023-06-01,34699,1,0,1,1,0,1
2023-06-01,42985,1,0,1,2,0,2
2023-06-01,42087,18,4,22,2,1,2
2023-06-01,29555,47,7,54,1,1,1
2023-06-01,34383,4,1,5,1,1,1
2023-06-01,202891,5,0,5,1,0,1
2023-06-01,206924,1,7,8,8,9,11
2023-06-01,210101,1,1,2,2,1,2
2023-06-01,212045,1,0,1,1,0,1
2023-06-01,56877,1,0,1,2,0,2
2023-06-01,210099,7,0,7,2,0,2
2023-06-01,210618,1,0,1,1,0,1
2023-06-01,3348,11,0,11,1,0,1
2023-06-01,210086,4,0,4,1,0,1
2023-06-01,203924,8,3,11,2,3,3
2023-06-01,51335,5,0,5,1,0,1
2023-06-01,44583,2,0,2,1,0,1
2023-06-01,197050,4,0,4,2,0,2
2023-06-01,47453,6,1,7,3,2,3
2023-06-01,17477,156,10,166,20,6,21
2023-06-01,35045,1,0,1,1,0,1
2023-06-01,35021,2,0,2,5,0,5
2023-06-01,48009,3,0,3,1,0,1
2023-06-01,34941,4,1,5,3,2,3
2023-06-01,197039,22,0,22,2,0,2
2023-06-01,35079,1,0,1,2,0,2
2023-06-01,35359,8,0,8,2,0,2
2023-06-01,21388,2,0,2,7,0,7
2023-06-01,35180,6,2,8,9,3,9
2023-06-01,35080,1,0,1,1,0,1
2023-06-01,35087,2,1,3,3,1,3
2023-06-01,35361,2,1,3,5,4,5
2023-06-01,2589,13,1,14,2,2,2
2023-06-01,209754,4,1,5,5,4,8
2023-06-01,200805,6,0,6,1,0,1
2023-06-01,35157,5,1,6,3,1,3
2023-06-01,12645,6,0,6,2,0,2
2023-06-01,35593,5,0,5,3,0,3
2023-06-01,43697,8,0,8,4,0,4
2023-06-01,35227,2,0,2,3,0,3
2023-06-01,49247,1,0,1,1,0,1
2023-06-01,35240,1,0,1,1,0,1
2023-06-01,35259,1,0,1,1,0,1
2023-06-01,47458,1,0,1,2,0,2
2023-06-01,210840,1,0,1,1,0,1
2023-06-01,56951,2,1,3,4,3,4
2023-06-01,203809,1,0,1,2,0,2
2023-06-01,39081,3,0,3,2,0,2
2023-06-01,205095,1,0,1,1,0,1
2023-06-01,35725,17,0,17,2,0,2
2023-06-01,60909,2,0,2,1,0,1
2023-06-01,35348,7,0,7,3,0,3
2023-06-01,41087,1,0,1,1,0,1
2023-06-01,199513,2,0,2,1,0,1
2023-06-01,41461,3,0,3,4,0,4
2023-06-01,48141,4,0,4,5,0,5
2023-06-01,49674,1,0,1,2,0,2
2023-06-01,60615,2,0,2,2,0,2
2023-06-01,48948,9,0,9,10,0,10
2023-06-01,59677,1,0,1,2,0,2
2023-06-01,57444,2,0,2,2,0,2
2023-06-01,44106,2,0,2,2,0,2
2023-06-01,43315,1,0,1,1,0,1
2023-06-01,48929,1,0,1,1,0,1
2023-06-01,44271,1,0,1,2,0,2
2023-06-01,44148,1,0,1,2,0,2
2023-06-01,44081,3,0,3,1,0,1
2023-06-01,59532,5,0,5,1,0,1
2023-06-01,12675,7,0,7,1,0,1
2023-06-01,48453,3,0,3,6,0,6
2023-06-01,60531,1,1,2,1,1,1
2023-06-01,35371,1,0,1,1,0,1
2023-06-01,49295,1,0,1,1,0,1
2023-06-01,47345,1,0,1,1,0,1
2023-06-01,50886,1,0,1,4,0,4
2023-06-01,39397,6,2,8,2,1,2
2023-06-01,48830,14,0,14,1,0,1
2023-06-01,199731,10,0,10,3,0,3
2023-06-01,196821,66,0,66,1,0,1
2023-06-01,210293,2,0,2,2,0,2
2023-06-01,203018,2,1,3,1,1,1
2023-06-01,205400,2,1,3,2,1,2
2023-06-01,57142,24,0,24,7,0,7
2023-06-01,8257,15,0,15,1,0,1
2023-06-01,48124,4,0,4,3,0,3
2023-06-01,8510,2,1,3,4,1,4
2023-06-01,198685,4,1,5,2,1,2
2023-06-01,51352,3,1,4,2,1,2
2023-06-01,8630,2,0,2,2,0,2
2023-06-01,28800,2,1,3,3,1,3
2023-06-01,202537,1,0,1,3,0,3
2023-06-01,207256,2,0,2,2,0,2
2023-06-01,209698,1,0,1,3,0,3
2023-06-01,8941,5,0,5,3,0,3
2023-06-01,207373,1,0,1,1,0,1
2023-06-01,8480,3,0,3,2,0,2
2023-06-01,49929,3,0,3,2,0,2
2023-06-01,61040,7,0,7,4,0,4
2023-06-01,51783,4,1,5,2,1,2
2023-06-01,201848,4,2,6,2,1,2
2023-06-01,51562,1,0,1,2,0,2
2023-06-01,9206,8,0,8,1,0,1
2023-06-01,210276,2,0,2,2,0,2
2023-06-01,202633,1,0,1,1,0,1
2023-06-01,202989,1,0,1,2,0,2
2023-06-01,202974,1,0,1,1,0,1
2023-06-01,207184,1,0,1,1,0,1
2023-06-01,31365,8,0,8,1,0,1
2023-06-01,201128,8,1,9,1,1,1
2023-06-01,51703,3,0,3,2,0,2
2023-06-01,211996,2,0,2,1,0,1
2023-06-01,212805,2,3,5,3,3,3
2023-06-01,34418,5,0,5,1,0,1
2023-06-01,202139,3,3,6,1,1,1
2023-06-01,44776,3,1,4,3,2,3
2023-06-01,16071,2,0,2,1,0,1
2023-06-01,3213,13,2,15,12,9,13
2023-06-01,44232,5,0,5,2,0,2
2023-06-01,34403,9,0,9,3,0,3
2023-06-01,205681,1,0,1,1,0,1
2023-06-01,35019,12,0,12,6,0,6
2023-06-01,28971,1,0,1,1,0,1
2023-06-01,207518,1,1,2,4,3,4
2023-06-01,39154,5,0,5,1,0,1
2023-06-01,34439,1,1,2,1,1,1
2023-06-01,57495,5,0,5,6,0,6
2023-06-01,34469,1,0,1,1,0,1
2023-06-01,8692,4,1,5,4,4,4
2023-06-01,48235,2,0,2,2,0,2
2023-06-01,49609,9,0,9,2,0,2
2023-06-01,44651,3,0,3,1,0,1
2023-06-01,34684,7,0,7,1,0,1
2023-06-01,34654,1,0,1,1,0,1
2023-06-01,34663,1,1,2,4,3,4
2023-06-01,24595,1,0,1,1,0,1
2023-06-01,12917,1,0,1,1,0,1
2023-06-01,49936,1,1,2,1,1,1
2023-06-01,51230,4,0,4,2,0,2
2023-06-01,49006,1,0,1,1,0,1
2023-06-01,207623,2,0,2,1,0,1
2023-06-01,208245,2,2,4,1,1,1
2023-06-01,34810,4,0,4,3,0,3
2023-06-01,39825,9,0,9,1,0,1
2023-06-01,34746,1,0,1,6,0,6
2023-06-01,34737,1,0,1,1,0,1
2023-06-01,34759,1,0,1,2,0,2
2023-06-01,28977,7,0,7,2,0,2
2023-06-01,34804,1,0,1,1,0,1
2023-06-01,197347,1,0,1,1,0,1
2023-06-01,34931,8,0,8,5,0,5
2023-06-01,29283,8,1,9,5,4,6
2023-06-01,47171,11,0,11,4,0,4
2023-06-01,204274,6,1,7,2,1,2
2023-06-01,29606,5,0,5,14,0,14
2023-06-01,200584,1,3,4,2,2,2
2023-06-01,49147,3,0,3,1,0,1
2023-06-01,47745,4,0,4,1,0,1
2023-06-01,209518,1,0,1,1,0,1
2023-06-01,56606,2,0,2,1,0,1
2023-06-01,206045,1,0,1,1,0,1
2023-06-01,202160,2,0,2,1,0,1
2023-06-01,203182,2,0,2,4,0,4
2023-06-01,203633,1,0,1,1,0,1
2023-06-01,208322,1,0,1,1,0,1
2023-06-01,210746,2,0,2,1,0,1
2023-06-01,205129,1,0,1,1,0,1
2023-06-01,205465,1,0,1,1,0,1
2023-06-01,49740,2,0,2,2,0,2
2023-06-01,61370,1,0,1,1,0,1
2023-06-01,48233,3,5,8,1,1,2
2023-06-01,49387,4,0,4,1,0,1
2023-06-01,198482,9,0,9,1,0,1
2023-06-01,39396,11,1,12,6,1,6
2023-06-01,199173,2,0,2,1,0,1
2023-06-01,199048,5,0,5,1,0,1
2023-06-01,60182,5,0,5,2,0,2
2023-06-01,197769,4,0,4,2,0,2
2023-06-01,35445,4,1,5,2,2,2
2023-06-01,41455,1,0,1,1,0,1
2023-06-01,196954,14,1,15,8,6,9
2023-06-01,204217,1,0,1,1,0,1
2023-06-01,47711,4,0,4,1,0,1
2023-06-01,210868,2,0,2,1,0,1
2023-06-01,21193,22,0,22,1,0,1
2023-06-01,203561,11,1,12,4,3,4
2023-06-01,34327,2,0,2,5,0,5
2023-06-01,211510,3,1,4,4,2,4
2023-06-01,34384,3,0,3,1,0,1
2023-06-01,61189,2,5,7,5,5,5
2023-06-01,35175,4,1,5,1,1,1
2023-06-01,201587,2,1,3,1,3,3
2023-06-01,60414,3,1,4,2,2,2
2023-06-01,201642,6,1,7,3,1,3
2023-06-01,41782,6,0,6,5,0,5
2023-06-01,34622,2,1,3,2,2,2
2023-06-01,34580,2,0,2,3,0,3
2023-06-01,43903,3,0,3,1,0,1
2023-06-01,57073,13,4,17,13,7,13
2023-06-01,41515,1,0,1,2,0,2
2023-06-01,41861,2,0,2,1,0,1
2023-06-01,57008,7,0,7,3,0,3
2023-06-01,42940,1,0,1,1,0,1
2023-06-01,43429,3,0,3,1,0,1
2023-06-01,43901,3,0,3,1,0,1
2023-06-01,44844,1,0,1,2,0,2
2023-06-01,44333,1,0,1,3,0,3
2023-06-01,56639,2,0,2,3,0,3
2023-06-01,211744,1,0,1,4,0,4
2023-06-01,60455,3,0,3,3,0,3
2023-06-01,44383,1,0,1,9,0,9
2023-06-01,43837,4,0,4,1,0,1
2023-06-01,208556,3,0,3,2,0,2
2023-06-01,201451,1,0,1,1,0,1
2023-06-01,34502,1,0,1,1,0,1
2023-06-01,48570,4,0,4,3,0,3
2023-06-01,29196,1,0,1,7,0,7
2023-06-01,43031,1,0,1,2,0,2
2023-06-01,15851,2,1,3,4,1,4
2023-06-01,8970,1,1,2,5,1,5
2023-06-01,206632,2,0,2,1,0,1
2023-06-01,57321,2,0,2,1,0,1
2023-06-01,209563,1,0,1,3,0,3
2023-06-01,9085,5,2,7,15,2,15
2023-06-01,208384,1,0,1,3,0,3
2023-06-01,208817,1,0,1,4,0,4
2023-06-01,57541,1,0,1,1,0,1
2023-06-01,47312,1,0,1,1,0,1
2023-06-01,198930,4,2,6,12,7,14
2023-06-01,208669,4,8,12,2,1,2
2023-06-01,30877,3,1,4,4,2,4
2023-06-01,44454,3,1,4,5,2,5
2023-06-01,13627,4,4,8,2,2,2
2023-06-01,43526,1,0,1,3,0,3
2023-06-01,43909,1,0,1,3,0,3
2023-06-01,208035,9,0,9,4,0,4
2023-06-01,206860,1,0,1,3,0,3
2023-06-01,207389,1,0,1,1,0,1
2023-06-01,44696,1,0,1,1,0,1
2023-06-01,31251,7,2,9,1,1,1
2023-06-01,60750,4,1,5,3,1,3
2023-06-01,50515,5,0,5,3,0,3
2023-06-01,50840,10,1,11,3,2,3
2023-06-01,49252,3,0,3,1,0,1
2023-06-01,35617,7,1,8,7,5,8
2023-06-01,62162,2,0,2,2,0,2
2023-06-01,20722,15,0,15,11,0,11
2023-06-01,45035,4,0,4,2,0,2
2023-06-01,56795,1,0,1,2,0,2
2023-06-01,57316,1,0,1,1,0,1
2023-06-01,50023,4,0,4,9,0,9
2023-06-01,201213,7,2,9,12,6,13
2023-06-01,41219,1,0,1,2,0,2
2023-06-01,58174,2,0,2,2,0,2
2023-06-01,52039,6,0,6,6,0,6
2023-06-01,34621,1,0,1,1,0,1
2023-06-01,48874,5,1,6,1,1,1
2023-06-01,47915,3,0,3,1,0,1
2023-06-01,44120,1,0,1,2,0,2
2023-06-01,35268,2,0,2,4,0,4
2023-06-01,39346,1,0,1,1,0,1
2023-06-01,34916,10,0,10,7,0,7
2023-06-01,34951,1,0,1,2,0,2
2023-06-01,12442,3,0,3,2,0,2
2023-06-01,60078,2,0,2,2,0,2
2023-06-01,204390,8,0,8,4,0,4
2023-06-01,5522,2,1,3,2,1,2
2023-06-01,201096,2,0,2,1,0,1
2023-06-01,12816,9,2,11,2,2,2
2023-06-01,209335,2,1,3,1,1,1
2023-06-01,209252,1,0,1,2,0,2
2023-06-01,35427,4,0,4,1,0,1
2023-06-01,56650,3,0,3,1,0,1
2023-06-01,42275,5,5,10,4,4,4
2023-06-01,209368,5,9,14,4,3,5
2023-06-01,57773,11,2,13,3,2,3
2023-06-01,8145,3,2,5,2,2,2
2023-06-01,8236,5,0,5,4,2,4
2023-06-01,209366,5,0,5,3,0,3
2023-06-01,208769,1,0,1,1,0,1
2023-06-01,203496,1,4,5,4,4,5
2023-06-01,200400,1,0,1,1,0,1
2023-06-01,202047,8,0,8,1,0,1
2023-06-01,35426,1,1,2,4,4,4
2023-06-01,396006,32,1,33,2,1,2
2023-06-01,212131,1,1,2,4,2,4
2023-06-01,197690,5,3,8,1,2,2
2023-06-01,209354,1,0,1,1,0,1
2023-06-01,209349,2,0,2,4,0,4
2023-06-01,51012,4,1,5,2,1,2
2023-06-01,200485,4,1,5,8,1,8
2023-06-01,209348,4,0,4,1,0,1
2023-06-01,210247,3,0,3,3,2,3
2023-06-01,200735,9,7,16,2,2,2
2023-06-01,209345,1,0,1,1,0,1
2023-06-01,209019,2,0,2,2,0,2
2023-06-01,201826,20,0,20,7,0,7
2023-06-01,199425,1,0,1,1,0,1
2023-06-01,41336,5,0,5,7,0,7
2023-06-01,57684,2,2,4,3,3,3
2023-06-01,35388,1,1,2,1,1,1
2023-06-01,207167,5,2,7,4,6,7
2023-06-01,209226,4,0,4,3,0,3
2023-06-01,213333,3,0,3,2,0,2
2023-06-01,209825,4,0,4,3,0,3
2023-06-01,209824,5,3,8,1,2,2
2023-06-01,209337,1,0,1,1,0,1
2023-06-01,197833,12,0,12,5,0,5
2023-06-01,21030,9,1,10,13,2,13
2023-06-01,209332,5,0,5,3,0,3
2023-06-01,10557,16,0,16,1,0,1
2023-06-01,8670,11,1,12,4,3,4
2023-06-01,209098,1,1,2,1,1,1
2023-06-01,47939,24,0,24,2,0,2
2023-06-01,198721,17,1,18,8,2,8
2023-06-01,209327,1,1,2,1,1,1
2023-06-01,210773,12,0,12,2,0,2
2023-06-01,60328,1,1,2,2,2,2
2023-06-01,25486,10,2,12,3,3,5
2023-06-01,209148,1,1,2,2,4,4
2023-06-01,49377,13,0,13,2,0,2
2023-06-01,199334,1,1,2,1,1,1
2023-06-01,205581,8,4,12,6,5,6
2023-06-01,34935,1,0,1,1,0,1
2023-06-01,57070,2,0,2,4,0,4
2023-06-01,209302,1,0,1,1,0,1
2023-06-01,59546,2,0,2,3,0,3
2023-06-01,52055,1,0,1,1,0,1
2023-06-01,61098,34,35,69,12,10,13
2023-06-01,31490,4,2,6,4,2,4
2023-06-01,210624,1,0,1,3,0,3
2023-06-01,34368,18,1,19,2,1,2
2023-06-01,197600,3,1,4,2,2,2
2023-06-01,201549,2,0,2,1,0,1
2023-06-01,200115,1,0,1,3,0,3
2023-06-01,59958,8,0,8,3,0,3
2023-06-01,60448,5,0,5,3,0,3
2023-06-01,43153,5,0,5,10,0,10
2023-06-01,210831,1,0,1,3,0,3
2023-06-01,205738,1,0,1,1,0,1
2023-06-01,204009,1,0,1,2,0,2
2023-06-01,203585,2,0,2,1,0,1
2023-06-01,49604,6,3,9,6,4,7
2023-06-01,41350,1,0,1,2,0,2
2023-06-01,31125,2,0,2,1,0,1
2023-06-01,197431,4,1,5,4,1,4
2023-06-01,198262,1,0,1,1,0,1
2023-06-01,201845,1,0,1,2,0,2
2023-06-01,202162,1,0,1,4,0,4
2023-06-01,30725,2,0,2,1,0,1
2023-06-01,34342,4,0,4,2,0,2
2023-06-01,29505,4,1,5,9,6,10
2023-06-01,34887,22,0,22,3,0,3
2023-06-01,8622,7,0,7,1,0,1
2023-06-01,51149,6,0,6,5,0,5
2023-06-01,35158,4,0,4,1,0,1
2023-06-01,208291,1,0,1,1,0,1
2023-06-01,25381,4,0,4,3,0,3
2023-06-01,202806,1,0,1,3,0,3
2023-06-01,202011,3,0,3,1,0,1
2023-06-01,21315,5,1,6,4,3,4
2023-06-01,34965,1,0,1,1,0,1
2023-06-01,210096,1,0,1,1,0,1
2023-06-01,209886,3,3,6,3,3,3
2023-06-01,213224,2,0,2,1,0,1
2023-06-01,35033,1,0,1,2,0,2
2023-06-01,53589,20,0,20,6,0,6
2023-06-01,35032,10,12,22,9,5,10
2023-06-01,34318,2,0,2,3,0,3
2023-06-01,35053,6,0,6,1,0,1
2023-06-01,31416,0,1,1,2,1,3
2023-06-01,41132,3,0,3,1,0,1
2023-06-01,56540,2,0,2,7,0,7
2023-06-01,21321,1,0,1,3,0,3
2023-06-01,35375,1,0,1,1,0,1
2023-06-01,41721,33,0,33,3,0,3
2023-06-01,35076,3,0,3,3,0,3
2023-06-01,13167,2,1,3,2,2,2
2023-06-01,35181,12,0,12,2,0,2
2023-06-01,35178,1,0,1,1,0,1
2023-06-01,197648,6,2,8,1,3,4
2023-06-01,208329,4,0,4,2,0,2
2023-06-01,24750,8,1,9,4,1,4
2023-06-01,41989,2,0,2,1,0,1
2023-06-01,212974,3,0,3,4,0,4
2023-06-01,64488,3,1,4,4,3,4
2023-06-01,50242,2,1,3,3,3,3
2023-06-01,48473,6,1,7,3,1,3
2023-06-01,34443,1,0,1,3,0,3
2023-06-01,200055,1,0,1,3,0,3
2023-06-01,42979,2,0,2,4,0,4
2023-06-01,212717,1,1,2,1,2,2
2023-06-01,202221,5,0,5,4,0,4
2023-06-01,43615,2,1,3,3,1,3
2023-06-01,201315,1,0,1,1,0,1
2023-06-01,199558,3,0,3,2,0,2
2023-06-01,201673,1,0,1,1,0,1
2023-06-01,35484,1,0,1,3,0,3
2023-06-01,43188,3,0,3,1,0,1
2023-06-01,56938,1,0,1,1,0,1
2023-06-01,29345,3,1,4,1,2,2
2023-06-01,13242,4,0,4,1,0,1
2023-06-01,62225,3,0,3,2,0,2
2023-06-01,25190,5,0,5,3,0,3
2023-06-01,34620,1,0,1,1,0,1
2023-06-01,43848,6,0,6,4,0,4
2023-06-01,208350,3,0,3,1,0,1
2023-06-01,57272,1,0,1,1,0,1
2023-06-01,42018,17,4,21,1,1,1
2023-06-01,25135,18,0,18,1,0,1
2023-06-01,50333,1,0,1,5,0,5
2023-06-01,29384,16,5,21,4,4,5
2023-06-01,34945,1,0,1,2,0,2
2023-06-01,198499,6,4,10,2,1,2
2023-06-01,39614,10,11,21,5,7,9
2023-06-01,396535,4,1,5,3,3,3
2023-06-01,201505,3,1,4,1,1,1
2023-06-01,49243,4,0,4,1,0,1
2023-06-01,57325,7,1,8,1,1,1
2023-06-01,50427,21,0,21,6,0,6
2023-06-01,39785,33,0,33,10,0,10
2023-06-01,209867,1,0,1,3,0,3
2023-06-01,209866,2,0,2,1,0,1
2023-06-01,209281,11,0,11,5,0,5
2023-06-01,59723,3,0,3,2,0,2
2023-06-01,206863,2,0,2,1,0,1
2023-06-01,31556,14,1,15,3,2,3
2023-06-01,3316,31,2,33,9,5,11
2023-06-01,60426,3,2,5,6,5,8
2023-06-01,49496,1,0,1,1,0,1
2023-06-01,205506,7,0,7,4,0,4
2023-06-01,56871,10,0,10,3,0,3
2023-06-01,34560,4,0,4,1,0,1
2023-06-01,62281,4,0,4,3,0,3
2023-06-01,206068,3,0,3,2,0,2
2023-06-01,51541,1,0,1,1,0,1
2023-06-01,45021,1,1,2,1,1,1
2023-06-01,49948,1,0,1,1,0,1
2023-06-01,15692,9,5,14,3,2,3
2023-06-01,6796,1,0,1,3,0,3
2023-06-01,202203,2,1,3,5,2,5
2023-06-01,49302,3,0,3,1,0,1
2023-06-01,57060,1,0,1,1,0,1
2023-06-01,201337,12,0,12,3,0,3
2023-06-01,49169,2,0,2,4,0,4
2023-06-01,35653,1,0,1,1,0,1
2023-06-01,42225,1,0,1,1,0,1
2023-06-01,44853,4,1,5,1,1,1
2023-06-01,30885,3,0,3,3,0,3
2023-06-01,198417,34,1,35,3,1,4
2023-06-01,43459,1,0,1,2,0,2
2023-06-01,39519,4,1,5,1,1,1
2023-06-01,49410,2,0,2,2,0,2
2023-06-01,59784,1,0,1,1,0,1
2023-06-01,34450,17,1,18,5,3,6
2023-06-01,39569,7,0,7,1,0,1
2023-06-01,39277,4,0,4,4,0,4
2023-06-01,61139,4,0,4,2,0,2
2023-06-01,42637,1,0,1,1,0,1
2023-06-01,41749,6,0,6,1,0,1
2023-06-01,204213,20,0,20,5,0,5
2023-06-01,61225,1,0,1,1,0,1
2023-06-01,31609,7,0,7,1,0,1
2023-06-01,57446,7,0,7,2,0,2
2023-06-01,24749,2,1,3,3,1,3
2023-06-01,31102,11,0,11,1,0,1
2023-06-01,207333,25,1,26,3,1,3
2023-06-01,60149,2,2,4,2,2,2
2023-06-01,34847,2,0,2,4,0,4
2023-06-01,59923,1,0,1,1,0,1
2023-06-01,61115,1,0,1,1,0,1
2023-06-01,59910,1,0,1,1,0,1
2023-06-01,52057,1,0,1,2,0,2
2023-06-01,57646,2,0,2,1,0,1
2023-06-01,202958,20,1,21,3,1,3
2023-06-01,35397,1,0,1,2,0,2
2023-06-01,39345,7,1,8,1,1,1
2023-06-01,35263,1,0,1,2,0,2
2023-06-01,6882,3,0,3,4,0,4
2023-06-01,196713,16,0,16,2,0,2
2023-06-01,12655,3,2,5,3,3,3
2023-06-01,202635,10,0,10,1,0,1
2023-06-01,35374,6,0,6,2,0,2
2023-06-01,204952,1,0,1,1,0,1
2023-06-01,29545,20,2,22,3,2,3
2023-06-01,44472,3,0,3,1,0,1
2023-06-01,43120,3,0,3,1,0,1
2023-06-01,30923,3,1,4,3,2,3
2023-06-01,30857,9,2,11,5,2,5
2023-06-01,213269,1,0,1,2,0,2
2023-06-01,212859,1,1,2,1,1,1
2023-06-01,213214,1,0,1,1,0,1
2023-06-01,42465,1,0,1,1,0,1
2023-06-01,41626,2,0,2,1,0,1
2023-06-01,35679,1,0,1,2,0,2
2023-06-01,9142,16,0,16,3,0,3
2023-06-01,49043,1,0,1,2,0,2
2023-06-01,26478,6,0,6,6,0,6
2023-06-01,47444,3,0,3,4,0,4
2023-06-01,15585,7,1,8,1,1,2
2023-06-01,12632,1,0,1,1,0,1
2023-06-01,202950,21,0,21,1,0,1
2023-06-01,50716,5,1,6,4,1,4
2023-06-01,202521,4,1,5,3,2,4
2023-06-01,9205,4,0,4,5,0,5
2023-06-01,198966,3,0,3,1,0,1
2023-06-01,51249,4,0,4,3,0,3
2023-06-01,43877,2,0,2,1,0,1
2023-06-01,35760,3,0,3,5,0,5
2023-06-01,42266,4,0,4,4,0,4
2023-06-01,210161,1,0,1,2,0,2
2023-06-01,59102,7,0,7,2,0,2
2023-06-01,16287,1,0,1,1,0,1
2023-06-01,39407,5,0,5,1,0,1
2023-06-01,48288,3,2,5,1,1,1
2023-06-01,209079,1,0,1,1,0,1
2023-06-01,49207,1,0,1,1,0,1
2023-06-01,212036,2,0,2,1,0,1
2023-06-01,62367,3,0,3,3,0,3
2023-06-01,204544,11,0,11,2,0,2
2023-06-01,211990,1,0,1,1,0,1
2023-06-01,212063,3,0,3,1,0,1
2023-06-01,201634,1,1,2,1,1,1
2023-06-01,48546,1,0,1,1,0,1
2023-06-01,48113,3,0,3,1,0,1
2023-06-01,43482,1,0,1,1,0,1
2023-06-01,34417,1,0,1,1,0,1
2023-06-01,201134,4,0,4,1,0,1
2023-06-01,42815,1,0,1,2,0,2
2023-06-01,47697,5,2,7,6,5,6
2023-06-01,207772,2,0,2,3,0,3
2023-06-01,141180,4,1,5,2,1,3
2023-06-01,33802,5,0,5,5,0,5
2023-06-01,51925,3,0,3,6,0,6
2023-06-01,25224,1,0,1,1,0,1
2023-06-01,205115,8,1,9,2,2,2
2023-06-01,44017,7,1,8,4,1,4
2023-06-01,209274,1,0,1,1,0,1
2023-06-01,198890,2,0,2,1,0,1
2023-06-01,209524,1,0,1,2,0,2
2023-06-01,60859,2,0,2,3,0,3
2023-06-01,8734,2,0,2,2,0,2
2023-06-01,49882,6,0,6,4,0,4
2023-06-01,199759,1,0,1,2,0,2
2023-06-01,41624,2,0,2,5,0,5
2023-06-01,199939,8,4,12,10,6,12
2023-06-01,209653,2,0,2,1,0,1
2023-06-01,42446,2,1,3,4,1,4
2023-06-01,59437,10,3,13,10,7,11
2023-06-01,35448,4,0,4,3,0,3
2023-06-01,42942,1,0,1,2,0,2
2023-06-01,60202,7,0,7,5,0,5
2023-06-01,199818,1,0,1,2,0,2
2023-06-01,209628,1,0,1,3,0,3
2023-06-01,213200,3,0,3,1,0,1
2023-06-01,15504,4,0,4,5,0,5
2023-06-01,140599,4,1,5,1,1,1
2023-06-01,50368,1,0,1,1,0,1
2023-06-01,44564,1,0,1,3,0,3
2023-06-01,203864,1,0,1,2,0,2
2023-06-01,31420,21,0,21,4,0,4
2023-06-01,200811,15,0,15,2,0,2
2023-06-01,41201,254,0,254,5,0,5
2023-06-01,44716,9,0,9,1,0,1
2023-06-01,12962,2,0,2,4,0,4
2023-06-01,44029,3,0,3,1,0,1
2023-06-01,60291,1,0,1,2,0,2
2023-06-01,57095,3,0,3,1,0,1
2023-06-01,204497,1,0,1,1,0,1
2023-06-01,49857,4,1,5,1,1,1
2023-06-01,57273,1,0,1,1,0,1
2023-06-01,42428,28,2,30,2,1,2
2023-06-01,24599,2,0,2,4,0,4
2023-06-01,213241,6,2,8,2,2,2
2023-06-01,35399,11,1,12,2,1,2
2023-06-01,35405,4,0,4,3,0,3
2023-06-01,35571,2,0,2,2,0,2
2023-06-01,35501,1,1,2,3,1,3
2023-06-01,41549,9,2,11,5,7,8
2023-06-01,41576,2,0,2,1,0,1
2023-06-01,35568,12,0,12,2,0,2
2023-06-01,62212,6,1,7,1,1,1
2023-06-01,210875,1,0,1,1,0,1
2023-06-01,52219,1,0,1,1,0,1
2023-06-01,211344,2,1,3,1,1,2
2023-06-01,50377,2,0,2,5,0,5
2023-06-01,49059,1,0,1,1,0,1
2023-06-01,211298,2,1,3,2,2,2
2023-06-01,29529,1,0,1,3,0,3
2023-06-01,15886,10,0,10,7,0,7
2023-06-01,57230,1,0,1,1,0,1
2023-06-01,35656,4,0,4,2,0,2
2023-06-01,42804,1,1,2,2,1,2
2023-06-01,35834,9,0,9,11,0,11
2023-06-01,201930,1,0,1,1,0,1
2023-06-01,38936,1,0,1,1,0,1
2023-06-01,38981,2,0,2,4,0,4
2023-06-01,16212,15,0,15,1,0,1
2023-06-01,8464,3,1,4,2,1,3
2023-06-01,206141,3,2,5,6,7,9
2023-06-01,49967,1,0,1,1,0,1
2023-06-01,54896,4,0,4,3,0,3
2023-06-01,42810,1,0,1,2,0,2
2023-06-01,38988,1,0,1,3,0,3
2023-06-01,51859,27,1,28,4,2,4
2023-06-01,39311,1,0,1,1,0,1
2023-06-01,39032,5,0,5,1,0,1
2023-06-01,39029,4,2,6,3,3,3
2023-06-01,31084,6,1,7,6,4,7
2023-06-01,51776,10,2,12,6,4,8
2023-06-01,60385,4,0,4,3,0,3
2023-06-01,15742,12,0,12,2,0,2
2023-06-01,39241,1,0,1,1,0,1
2023-06-01,42730,11,1,12,3,3,3
2023-06-01,43408,8,3,11,4,3,4
2023-06-01,61023,1,0,1,3,0,3
2023-06-01,212430,3,1,4,1,1,1
2023-06-01,198614,7,0,7,2,0,2
2023-06-01,207647,7,2,9,1,1,1
2023-06-01,51520,1,0,1,6,0,6
2023-06-01,49828,5,0,5,4,0,4
2023-06-01,47822,1,0,1,3,0,3
2023-06-01,38942,4,0,4,5,0,5
2023-06-01,198214,3,0,3,6,0,6
2023-06-01,29148,13,2,15,1,1,1
2023-06-01,203646,2,1,3,1,1,1
2023-06-01,5526,0,0,0,5,3,5
2023-06-01,29596,43,1,44,6,2,6
2023-06-01,39662,2,1,3,3,3,4
2023-06-01,43558,1,1,2,2,2,2
2023-06-01,56564,3,0,3,2,0,2
2023-06-01,31298,14,0,14,6,0,6
2023-06-01,50994,2,1,3,1,2,2
2023-06-01,39489,1,1,2,3,3,4
2023-06-01,49190,1,0,1,1,0,1
2023-06-01,39932,2,1,3,2,2,2
2023-06-01,8643,4,1,5,1,1,1
2023-06-01,47542,6,1,7,2,2,3
2023-06-01,35311,12,2,14,8,8,11
2023-06-01,33972,1,0,1,3,0,3
2023-06-01,197214,11,0,11,1,0,1
2023-06-01,202463,5,0,5,1,0,1
2023-06-01,35401,17,1,18,6,1,6
2023-06-01,200743,1,0,1,3,0,3
2023-06-01,50853,1,0,1,1,0,1
2023-06-01,57304,2,1,3,1,1,1
2023-06-01,25462,2,0,2,1,0,1
2023-06-01,200024,2,0,2,1,0,1
2023-06-01,29622,5,0,5,2,0,2
2023-06-01,205352,7,0,7,1,0,1
2023-06-01,41376,1,0,1,1,0,1
2023-06-01,59967,1,0,1,1,0,1
2023-06-01,21325,1,0,1,1,0,1
2023-06-01,35107,4,0,4,1,0,1
2023-06-01,59935,1,1,2,1,1,1
2023-06-01,137989,14,1,15,4,1,4
2023-06-01,204533,0,0,0,2,0,2
2023-06-01,35765,6,0,6,2,0,2
2023-06-01,203220,3,1,4,1,1,1
2023-06-01,43428,3,1,4,1,1,1
2023-06-01,203219,3,1,4,1,1,1
2023-06-01,47843,2,0,2,1,0,1
2023-06-01,57511,9,0,9,1,0,1
2023-06-01,48029,3,0,3,1,0,1
2023-06-01,211291,2,0,2,3,0,3
2023-06-01,15641,16,0,16,4,0,4
2023-06-01,35558,7,0,7,3,0,3
2023-06-01,3226,9,1,10,10,5,11
2023-06-01,25488,1,0,1,2,0,2
2023-06-01,35567,112,0,112,5,0,5
2023-06-01,208573,1,0,1,2,0,2
2023-06-01,16300,5,1,6,5,1,5
2023-06-01,200838,11,0,11,1,0,1
2023-06-01,201970,1,0,1,1,0,1
2023-06-01,207978,1,0,1,4,0,4
2023-06-01,48080,2,0,2,1,0,1
2023-06-01,41187,3,0,3,4,0,4
2023-06-01,8443,10,0,10,1,0,1
2023-06-01,35729,15,0,15,9,0,9
2023-06-01,48340,1,0,1,2,0,2
2023-06-01,31143,11,1,12,3,3,4
2023-06-01,208217,1,0,1,1,0,1
2023-06-01,35668,1,0,1,2,0,2
2023-06-01,44272,2,1,3,1,1,1
2023-06-01,202925,1,0,1,3,0,3
2023-06-01,62170,1,0,1,2,0,2
2023-06-01,28849,14,0,14,6,0,6
2023-06-01,211976,1,0,1,1,0,1
2023-06-01,51936,1,0,1,1,0,1
2023-06-01,33973,6,0,6,5,0,5
2023-06-01,60611,1,0,1,1,0,1
2023-06-01,50155,8,0,8,1,0,1
2023-06-01,206813,5,18,23,11,16,18
2023-06-01,30749,8,0,8,1,0,1
2023-06-01,48846,24,1,25,7,3,9
2023-06-01,20915,3,1,4,7,2,7
2023-06-01,35754,2,1,3,1,1,1
2023-06-01,8983,33,6,39,2,2,2
2023-06-01,200656,15,4,19,4,3,4
2023-06-01,18666,5,5,10,2,2,2
2023-06-01,28723,41,7,48,3,2,3
2023-06-01,9801,6,0,6,1,0,1
2023-06-01,206114,1,1,2,2,1,2
2023-06-01,43065,4,2,6,5,4,6
2023-06-01,39188,2,0,2,1,0,1
2023-06-01,38917,15,8,23,8,2,9
2023-06-01,50989,4,1,5,4,3,5
2023-06-01,33837,2,1,3,1,1,1
2023-06-01,48579,10,1,11,2,3,4
2023-06-01,20657,16,0,16,7,0,7
2023-06-01,59900,0,0,0,6,0,6
2023-06-01,47226,1,0,1,3,0,3
2023-06-01,35011,1,0,1,1,0,1
2023-06-01,43063,1,0,1,2,0,2
2023-06-01,210672,1,0,1,1,0,1
2023-06-01,31127,4,1,5,4,1,4
2023-06-01,42071,4,0,4,1,0,1
2023-06-01,39145,1,0,1,2,0,2
2023-06-01,15955,2,0,2,6,0,6
2023-06-01,39178,10,0,10,1,0,1
2023-06-01,200994,44,1,45,5,2,5
2023-06-01,39447,3,0,3,5,0,5
2023-06-01,12386,12,0,12,1,0,1
2023-06-01,200076,2,1,3,1,1,1
2023-06-01,202147,6,0,6,1,0,1
2023-06-01,204967,1,0,1,1,0,1
2023-06-01,41307,4,1,5,7,3,7
2023-06-01,35129,1,0,1,3,0,3
2023-06-01,47379,3,0,3,8,0,8
2023-06-01,50177,1,0,1,1,0,1
2023-06-01,210392,18,0,18,1,0,1
2023-06-01,57240,1,0,1,1,0,1
2023-06-01,47118,6,0,6,3,0,3
2023-06-01,212296,1,0,1,1,0,1
2023-06-01,212926,1,1,2,1,1,2
2023-06-01,213148,1,0,1,1,0,1
2023-06-01,210319,1,0,1,1,0,1
2023-06-01,12403,13,0,13,3,0,3
2023-06-01,50188,5,0,5,3,0,3
2023-06-01,59460,12,2,14,5,1,5
2023-06-01,200668,1,0,1,4,0,4
2023-06-01,205392,1,0,1,2,0,2
2023-06-01,51101,5,0,5,7,0,7
2023-06-01,30779,4,0,4,8,0,8
2023-06-01,8839,4,1,5,10,5,11
2023-06-01,39353,5,0,5,3,0,3
2023-06-01,41608,6,1,7,1,1,1
2023-06-01,210062,5,1,6,8,5,8
2023-06-01,59410,1,1,2,1,1,1
2023-06-01,39472,3,0,3,4,0,4
2023-06-01,207236,2,0,2,1,0,1
2023-06-01,210088,1,1,2,2,1,2
2023-06-01,34907,3,34,37,7,12,15
2023-06-01,60741,1,1,2,1,1,2
2023-06-01,198352,6,2,8,5,2,6
2023-06-01,49751,2,0,2,3,0,3
2023-06-01,50321,6,3,9,3,1,3
2023-06-01,41118,1,0,1,4,0,4
2023-06-01,197107,16,0,16,3,0,3
2023-06-01,210314,5,0,5,6,0,6
2023-06-01,12527,3,0,3,1,0,1
2023-06-01,203685,2,0,2,1,0,1
2023-06-01,200176,3,0,3,5,0,5
2023-06-01,200574,4,0,4,3,0,3
2023-06-01,42923,3,0,3,3,0,3
2023-06-01,201122,4,0,4,7,0,7
2023-06-01,210853,1,0,1,1,0,1
2023-06-01,51374,4,0,4,2,0,2
2023-06-01,208318,1,0,1,2,0,2
2023-06-01,33825,1,0,1,2,0,2
2023-06-01,41889,1,0,1,1,0,1
2023-06-01,41566,2,0,2,6,0,6
2023-06-01,12676,15,5,20,10,6,12
2023-06-01,205734,4,0,4,1,0,1
2023-06-01,16316,2,1,3,9,5,10
2023-06-01,30815,20,0,20,4,0,4
2023-06-01,206361,1,0,1,2,0,2
2023-06-01,198427,1,0,1,1,0,1
2023-06-01,212702,13,0,13,1,0,1
2023-06-01,205784,2,0,2,3,0,3
2023-06-01,25308,16,0,16,4,0,4
2023-06-01,208219,1,0,1,1,0,1
2023-06-01,204076,2,0,2,1,0,1
2023-06-01,39633,6,0,6,4,0,4
2023-06-01,42841,8,1,9,9,5,10
2023-06-01,212652,1,0,1,1,0,1
2023-06-01,209277,8,0,8,5,0,5
2023-06-01,39611,14,4,18,10,3,10
2023-06-01,209132,3,1,4,3,1,3
2023-06-01,38913,1,1,2,1,1,1
2023-06-01,47838,3,0,3,1,0,1
2023-06-01,200344,1,0,1,1,0,1
2023-06-01,47341,1,1,2,2,2,2
2023-06-01,59403,1,0,1,1,0,1
2023-06-01,209521,1,0,1,1,0,1
2023-06-01,51546,4,4,8,3,3,3
2023-06-01,211751,8,0,8,3,0,3
2023-06-01,212319,1,1,2,3,3,4
2023-06-01,51601,5,0,5,7,0,7
2023-06-01,212345,3,1,4,3,3,3
2023-06-01,58001,1,0,1,3,0,3
2023-06-01,39391,13,0,13,5,0,5
2023-06-01,209725,2,0,2,1,0,1
2023-06-01,60733,3,1,4,5,2,5
2023-06-01,209685,1,0,1,1,0,1
2023-06-01,213193,4,0,4,1,0,1
2023-06-01,210025,4,8,12,3,4,4
2023-06-01,207253,8,0,8,1,0,1
2023-06-01,209472,1,0,1,1,0,1
2023-06-01,211802,1,0,1,1,0,1
2023-06-01,39005,2,0,2,1,0,1
2023-06-01,207156,6,0,6,6,0,6
2023-06-01,199823,1,0,1,1,0,1
2023-06-01,197136,4,0,4,1,0,1
2023-06-01,201904,1,0,1,1,0,1
2023-06-01,212305,1,0,1,1,0,1
2023-06-01,205355,1,0,1,3,0,3
2023-06-01,49664,1,0,1,1,0,1
2023-06-01,39599,7,0,7,8,0,8
2023-06-01,210587,1,1,2,2,2,2
2023-06-01,201113,3,0,3,3,0,3
2023-06-01,62147,1,0,1,2,0,2
2023-06-01,31108,3,2,5,5,5,5
2023-06-01,39354,6,0,6,1,0,1
2023-06-01,47798,5,0,5,2,0,2
2023-06-01,50226,32,1,33,6,2,7
2023-06-01,25531,13,0,13,1,0,1
2023-06-01,207473,2,0,2,1,0,1
2023-06-01,41651,2,0,2,3,0,3
2023-06-01,2593,3,1,4,8,3,8
2023-06-01,43923,1,0,1,1,0,1
2023-06-01,41454,1,0,1,5,0,5
2023-06-01,61094,17,1,18,10,2,10
2023-06-01,49406,1,0,1,1,0,1
2023-06-01,41401,2,0,2,2,0,2
2023-06-01,205839,1,0,1,1,0,1
2023-06-01,56496,4,0,4,3,0,3
2023-06-01,25505,11,0,11,5,0,5
2023-06-01,41465,2,0,2,1,0,1
2023-06-01,41475,1,0,1,5,0,5
2023-06-01,204804,5,0,5,1,0,1
2023-06-01,211842,2,0,2,3,0,3
2023-06-01,41480,9,2,11,6,4,6
2023-06-01,30803,3,0,3,3,0,3
2023-06-01,205771,4,1,5,3,1,3
2023-06-01,41695,2,1,3,8,3,8
2023-06-01,57031,4,1,5,4,2,5
2023-06-01,57055,2,0,2,6,0,6
2023-06-01,29382,2,0,2,4,0,4
2023-06-01,57285,1,0,1,4,0,4
2023-06-01,199220,2,1,3,1,1,1
2023-06-01,199189,1,0,1,1,0,1
2023-06-01,59660,1,0,1,1,0,1
2023-06-01,59693,1,0,1,2,0,2
2023-06-01,44362,2,0,2,2,0,2
2023-06-01,57069,9,0,9,2,0,2
2023-06-01,212325,2,0,2,3,0,3
2023-06-01,51744,1,1,2,8,4,8
2023-06-01,212113,1,1,2,3,3,3
2023-06-01,47959,6,1,7,1,1,1
2023-06-01,57076,1,0,1,1,0,1
2023-06-01,57101,4,0,4,3,0,3
2023-06-01,51041,1,0,1,1,0,1
2023-06-01,199545,1,1,2,1,5,5
2023-06-01,207590,3,1,4,2,1,3
2023-06-01,200196,1,0,1,1,0,1
2023-06-01,50868,1,1,2,1,1,1
2023-06-01,61223,5,0,5,4,0,4
2023-06-01,60548,1,0,1,1,0,1
2023-06-01,47550,3,0,3,1,0,1
2023-06-01,51042,2,0,2,1,0,1
2023-06-01,49737,2,0,2,2,0,2
2023-06-01,49226,2,0,2,1,0,1
2023-06-01,5626,15,0,15,2,0,2
2023-06-01,41284,9,0,9,3,0,3
2023-06-01,41302,15,0,15,3,0,3
2023-06-01,41596,1,0,1,2,0,2
2023-06-01,199675,6,0,6,2,0,2
2023-06-01,38968,3,0,3,3,0,3
2023-06-01,13065,3,0,3,5,0,5
2023-06-01,206240,2,0,2,3,0,3
2023-06-01,15454,3,0,3,2,0,2
2023-06-01,41368,26,0,26,3,0,3
2023-06-01,3339,27,1,28,1,1,1
2023-06-01,41343,24,0,24,2,0,2
2023-06-01,60267,12,0,12,1,0,1
2023-06-01,208229,3,0,3,1,0,1
2023-06-01,60737,3,0,3,5,0,5
2023-06-01,60331,5,1,6,3,1,3
2023-06-01,202187,1,0,1,4,0,4
2023-06-01,201313,1,0,1,1,0,1
2023-06-01,16278,1,1,2,2,3,3
2023-06-01,204621,1,0,1,1,0,1
2023-06-01,41443,1,0,1,3,0,3
2023-06-01,205677,1,0,1,1,0,1
2023-06-01,204987,1,0,1,3,0,3
2023-06-01,198131,2,0,2,3,0,3
2023-06-01,208404,1,0,1,2,0,2
2023-06-01,24994,7,0,7,2,0,2
2023-06-01,41639,6,1,7,2,1,2
2023-06-01,51416,3,0,3,1,0,1
2023-06-01,202108,2,3,5,1,1,1
2023-06-01,41579,1,0,1,1,0,1
2023-06-01,48109,5,0,5,1,0,1
2023-06-01,47202,5,0,5,4,0,4
2023-06-01,41819,1,0,1,2,0,2
2023-06-01,51223,13,0,13,1,0,1
2023-06-01,34538,2,0,2,1,0,1
2023-06-01,44154,2,0,2,2,0,2
2023-06-01,206089,8,0,8,2,0,2
2023-06-01,200532,4,1,5,1,1,1
2023-06-01,39347,5,0,5,1,0,1
2023-06-01,35584,2,0,2,4,0,4
2023-06-01,42616,1,0,1,1,0,1
2023-06-01,61096,1,0,1,1,0,1
2023-06-01,203929,6,0,6,11,0,11
2023-06-01,60453,6,0,6,2,0,2
2023-06-01,62322,1,0,1,2,0,2
2023-06-01,209375,2,0,2,2,0,2
2023-06-01,199887,1,0,1,1,0,1
2023-06-01,199369,1,0,1,1,0,1
2023-06-01,59999,2,0,2,3,0,3
2023-06-01,210485,1,0,1,3,0,3
2023-06-01,201682,4,1,5,1,1,1
2023-06-01,57673,3,0,3,1,0,1
2023-06-01,60676,1,0,1,1,0,1
2023-06-01,39511,1,1,2,1,1,1
2023-06-01,212311,1,1,2,1,1,1
2023-06-01,51722,27,0,27,1,0,1
2023-06-01,50884,4,0,4,2,0,2
2023-06-01,59934,2,0,2,1,0,1
2023-06-01,197212,4,1,5,4,2,4
2023-06-01,210856,1,0,1,1,0,1
2023-06-01,12842,16,1,17,4,1,4
2023-06-01,212944,2,1,3,2,1,2
2023-06-01,60125,1,0,1,2,0,2
2023-06-01,61954,1,0,1,1,0,1
2023-06-01,60604,1,0,1,1,0,1
2023-06-01,201565,12,5,17,3,2,3
2023-06-01,35450,4,0,4,1,0,1
2023-06-01,212014,1,1,2,1,1,1
2023-06-01,39464,5,0,5,6,0,6
2023-06-01,47505,3,0,3,2,0,2
2023-06-01,203039,2,0,2,2,0,2
2023-06-01,56570,2,0,2,1,0,1
2023-06-01,43938,3,0,3,2,0,2
2023-06-01,57034,2,0,2,2,0,2
2023-06-01,60583,2,0,2,2,0,2
2023-06-01,49164,1,0,1,2,0,2
2023-06-01,60907,2,0,2,1,0,1
2023-06-01,199653,8,1,9,3,3,3
2023-06-01,199883,12,1,13,4,2,4
2023-06-01,58074,7,0,7,1,0,1
2023-06-01,50424,1,0,1,2,0,2
2023-06-01,58078,1,0,1,2,0,2
2023-06-01,39527,1,1,2,1,2,3
2023-06-01,41055,1,0,1,1,0,1
2023-06-01,62055,11,0,11,1,0,1
2023-06-01,34740,7,0,7,3,0,3
2023-06-01,41414,1,0,1,1,0,1
2023-06-01,43474,1,1,2,2,1,2
2023-06-01,26324,16,0,16,3,0,3
2023-06-01,48669,3,0,3,2,0,2
2023-06-01,43046,4,1,5,3,2,3
2023-06-01,212699,1,0,1,1,0,1
2023-06-01,200773,51,0,51,3,0,3
2023-06-01,212544,2,0,2,1,0,1
2023-06-01,41672,2,0,2,1,0,1
2023-06-01,48671,1,0,1,1,0,1
2023-06-01,35291,2,0,2,1,0,1
2023-06-01,50220,2,0,2,2,0,2
2023-06-01,207958,1,0,1,2,0,2
2023-06-01,204373,9,0,9,4,0,4
2023-06-01,44807,1,0,1,1,0,1
2023-06-01,50324,4,1,5,7,3,7
2023-06-01,49229,13,2,15,4,3,4
2023-06-01,200125,3,0,3,6,0,6
2023-06-01,48563,1,0,1,1,0,1
2023-06-01,59892,1,0,1,2,0,2
2023-06-01,394113,1,0,1,1,0,1
2023-06-01,41850,1,0,1,1,0,1
2023-06-01,61279,1,0,1,1,0,1
2023-06-01,51626,2,0,2,2,0,2
2023-06-01,41858,3,0,3,1,0,1
2023-06-01,60694,1,0,1,2,0,2
2023-06-01,202666,1,0,1,2,0,2
2023-06-01,48537,2,0,2,2,0,2
2023-06-01,41953,7,0,7,4,0,4
2023-06-01,207589,4,4,8,3,1,3
2023-06-01,50940,1,0,1,2,0,2
2023-06-01,56458,1,0,1,1,0,1
2023-06-01,41573,1,0,1,2,0,2
2023-06-01,42123,1,0,1,1,0,1
2023-06-01,41011,11,0,11,1,0,1
2023-06-01,60984,1,0,1,2,0,2
2023-06-01,60118,11,1,12,2,1,2
2023-06-01,61389,2,0,2,1,0,1
2023-06-01,24695,2,0,2,1,0,1
2023-06-01,48459,2,0,2,1,0,1
2023-06-01,203230,1,0,1,4,0,4
2023-06-01,204930,2,0,2,3,0,3
2023-06-01,62001,2,0,2,6,0,6
2023-06-01,41763,1,0,1,1,0,1
2023-06-01,42405,2,0,2,6,0,6
2023-06-01,61250,3,0,3,4,0,4
2023-06-01,62425,1,0,1,1,0,1
2023-06-01,57009,3,0,3,2,0,2
2023-06-01,42786,1,0,1,3,0,3
2023-06-01,42614,1,0,1,1,0,1
2023-06-01,16157,3,0,3,1,0,1
2023-06-01,57792,2,0,2,3,0,3
2023-06-01,202723,5,0,5,3,0,3
2023-06-01,64471,1,0,1,3,0,3
2023-06-01,64452,1,0,1,1,0,1
2023-06-01,8317,2,0,2,2,0,2
2023-06-01,61059,1,0,1,1,0,1
2023-06-01,44756,2,0,2,1,0,1
2023-06-01,61050,1,1,2,2,3,3
2023-06-01,207752,2,0,2,2,0,2
2023-06-01,48836,3,0,3,1,0,1
2023-06-01,42756,1,0,1,2,0,2
2023-06-01,39669,1,0,1,1,0,1
2023-06-01,48401,1,0,1,1,0,1
2023-06-01,62185,1,0,1,1,0,1
2023-06-01,24592,8,2,10,7,5,8
2023-06-01,41043,1,0,1,2,0,2
2023-06-01,61958,1,0,1,3,0,3
2023-06-01,41807,2,0,2,2,0,2
2023-06-01,205139,1,0,1,5,0,5
2023-06-01,206430,9,1,10,1,1,2
2023-06-01,59735,1,0,1,2,0,2
2023-06-01,41646,1,0,1,1,0,1
2023-06-01,61033,1,0,1,1,0,1
2023-06-01,51492,5,0,5,5,0,5
2023-06-01,201343,4,0,4,1,0,1
2023-06-01,44826,2,0,2,3,0,3
2023-06-01,49734,1,0,1,1,0,1
2023-06-01,50704,1,0,1,1,0,1
2023-06-01,47225,1,0,1,2,0,2
2023-06-01,51441,1,0,1,1,0,1
2023-06-01,44740,1,0,1,2,0,2
2023-06-01,59545,12,2,14,15,5,16
2023-06-01,206348,5,0,5,2,0,2
2023-06-01,35161,2,0,2,1,0,1
2023-06-01,134926,16,2,18,3,1,3
2023-06-01,44739,1,0,1,1,0,1
2023-06-01,199451,2,0,2,4,0,4
2023-06-01,62279,1,0,1,2,0,2
2023-06-01,51909,1,0,1,1,0,1
2023-06-01,58023,2,0,2,3,0,3
2023-06-01,51099,2,0,2,1,0,1
2023-06-01,44656,3,1,4,2,2,2
2023-06-01,60175,9,1,10,3,3,3
2023-06-01,39033,1,0,1,3,0,3
2023-06-01,211590,1,0,1,3,0,3
2023-06-01,39532,1,0,1,1,0,1
2023-06-01,34848,6,3,9,5,4,5
2023-06-01,16186,11,5,16,5,4,5
2023-06-01,41381,10,0,10,2,0,2
2023-06-01,42304,3,0,3,1,0,1
2023-06-01,39555,1,1,2,3,2,3
2023-06-01,939,3,1,4,2,1,2
2023-06-01,39484,2,1,3,1,1,1
2023-06-01,42248,20,0,20,3,0,3
2023-06-01,39846,5,0,5,2,0,2
2023-06-01,41213,1,0,1,2,0,2
2023-06-01,50554,3,2,5,5,5,7
2023-06-01,209626,1,3,4,1,1,1
2023-06-01,39837,2,1,3,3,1,3
2023-06-01,199448,4,0,4,3,0,3
2023-06-01,48638,4,1,5,7,3,7
2023-06-01,31669,2,0,2,1,0,1
2023-06-01,62167,12,9,21,14,9,16
2023-06-01,41021,2,0,2,3,0,3
2023-06-01,39780,3,0,3,2,0,2
2023-06-01,59764,2,1,3,2,3,3
2023-06-01,44226,7,0,7,2,0,2
2023-06-01,39808,2,0,2,4,0,4
2023-06-01,39821,2,0,2,3,0,3
2023-06-01,201018,1,0,1,2,0,2
2023-06-01,39854,1,1,2,1,1,1
2023-06-01,15810,11,0,11,2,0,2
2023-06-01,40973,1,0,1,1,0,1
2023-06-01,51275,6,1,7,1,3,3
2023-06-01,41176,48,1,49,8,2,8
2023-06-01,202772,1,0,1,1,0,1
2023-06-01,201544,1,0,1,1,0,1
2023-06-01,62144,1,0,1,2,0,2
2023-06-01,209271,2,0,2,3,0,3
2023-06-01,39749,3,0,3,4,0,4
2023-06-01,42144,1,0,1,2,0,2
2023-06-01,44699,1,0,1,2,0,2
2023-06-01,42527,1,0,1,1,0,1
2023-06-01,27347,1,0,1,1,0,1
2023-06-01,198448,1,0,1,1,0,1
2023-06-01,400799,2,0,2,2,0,2
2023-06-01,23161,1,1,2,2,2,2
2023-06-01,204968,1,0,1,1,0,1
2023-06-01,204894,2,0,2,1,0,1
2023-06-01,204746,2,0,2,1,0,1
2023-06-01,43259,4,0,4,1,0,1
2023-06-01,198325,12,1,13,1,1,1
2023-06-01,39370,10,0,10,1,0,1
2023-06-01,44925,3,2,5,1,1,1
2023-06-01,50746,3,0,3,3,0,3
2023-06-01,39375,57,0,57,5,0,5
2023-06-01,44456,1,0,1,4,0,4
2023-06-01,13307,10,1,11,11,1,11
2023-06-01,41452,1,0,1,1,0,1
2023-06-01,5620,1,0,1,1,0,1
2023-06-01,42679,1,0,1,1,0,1
2023-06-01,42875,1,0,1,1,0,1
2023-06-01,44815,1,0,1,2,0,2
2023-06-01,61338,1,0,1,1,0,1
2023-06-01,212312,2,0,2,4,0,4
2023-06-01,57817,1,0,1,2,0,2
2023-06-01,203790,1,0,1,2,0,2
2023-06-01,203442,1,1,2,1,1,2
2023-06-01,39735,22,2,24,6,2,6
2023-06-01,57842,7,0,7,5,0,5
2023-06-01,57753,10,0,10,4,0,4
2023-06-01,200613,4,0,4,2,0,2
2023-06-01,41678,14,0,14,9,0,9
2023-06-01,39847,3,0,3,1,0,1
2023-06-01,39766,2,0,2,3,0,3
2023-06-01,39716,13,0,13,2,0,2
2023-06-01,42667,8,0,8,6,0,6
2023-06-01,39759,5,0,5,4,0,4
2023-06-01,59647,6,3,9,1,1,1
2023-06-01,39441,4,1,5,1,1,1
2023-06-01,43418,4,0,4,10,0,10
2023-06-01,39810,3,1,4,3,2,4
2023-06-01,25129,30,0,30,5,0,5
2023-06-01,48691,4,0,4,3,0,3
2023-06-01,57256,11,0,11,1,0,1
2023-06-01,40981,1,1,2,3,2,3
2023-06-01,24864,5,1,6,9,4,9
2023-06-01,39887,15,0,15,1,0,1
2023-06-01,47860,2,0,2,2,0,2
2023-06-01,39143,5,1,6,3,2,3
2023-06-01,59574,8,0,8,5,0,5
2023-06-01,39873,1,0,1,2,0,2
2023-06-01,199319,9,1,10,10,4,12
2023-06-01,206006,1,1,2,2,3,3
2023-06-01,20533,62,0,62,1,0,1
2023-06-01,41349,3,1,4,5,3,5
2023-06-01,25223,1,1,2,1,1,1
2023-06-01,29602,1,0,1,1,0,1
2023-06-01,28938,3,0,3,1,0,1
2023-06-01,199087,1,1,2,1,1,1
2023-06-01,210139,3,2,5,5,5,7
2023-06-01,41088,3,2,5,1,1,1
2023-06-01,210087,1,0,1,1,0,1
2023-06-01,35065,2,1,3,2,1,2
2023-06-01,38919,3,2,5,2,2,2
2023-06-01,49489,3,1,4,3,2,3
2023-06-01,41207,1,0,1,1,0,1
2023-06-01,30753,3,0,3,3,0,3
2023-06-01,41106,5,0,5,1,0,1
2023-06-01,57879,1,0,1,1,0,1
2023-06-01,60090,1,0,1,3,0,3
2023-06-01,49021,2,0,2,1,0,1
2023-06-01,208096,1,0,1,2,0,2
2023-06-01,34312,4,0,4,7,0,7
2023-06-01,29649,7,1,8,13,2,13
2023-06-01,201863,15,1,16,4,1,4
2023-06-01,399104,2,2,4,9,6,11
2023-06-01,41203,8,0,8,3,0,3
2023-06-01,41073,2,1,3,4,3,4
2023-06-01,41123,12,0,12,3,0,3
2023-06-01,41094,1,0,1,1,0,1
2023-06-01,41160,11,0,11,9,0,9
2023-06-01,41437,5,1,6,5,2,5
2023-06-01,41383,8,0,8,4,0,4
2023-06-01,209715,1,1,2,2,2,2
2023-06-01,51796,2,1,3,2,2,2
2023-06-01,36384,3,4,7,2,1,2
2023-06-01,45566,5,4,9,1,1,1
2023-06-01,196810,8,1,9,4,2,4
2023-06-01,41424,5,0,5,3,0,3
2023-06-01,201564,1,0,1,2,0,2
2023-06-01,48552,1,0,1,1,0,1
2023-06-01,48946,2,0,2,1,0,1
2023-06-01,42569,2,0,2,2,0,2
2023-06-01,198615,2,0,2,3,0,3
2023-06-01,44429,4,0,4,2,0,2
2023-06-01,24684,2,0,2,3,0,3
2023-06-01,16045,1,0,1,1,0,1
2023-06-01,42596,3,0,3,5,0,5
2023-06-01,50733,5,0,5,3,0,3
2023-06-01,212642,1,1,2,1,1,1
2023-06-01,41734,6,0,6,1,0,1
2023-06-01,41696,3,1,4,3,2,3
2023-06-01,202852,1,0,1,1,0,1
2023-06-01,34914,3,0,3,3,0,3
2023-06-01,50668,4,0,4,2,0,2
2023-06-01,206403,1,0,1,1,0,1
2023-06-01,206647,1,0,1,1,0,1
2023-06-01,51609,2,0,2,2,0,2
2023-06-01,48371,1,0,1,5,0,5
2023-06-01,51017,1,0,1,1,0,1
2023-06-01,209667,1,0,1,2,0,2
2023-06-01,208371,1,0,1,1,0,1
2023-06-01,208325,1,0,1,1,0,1
2023-06-01,31576,2,0,2,3,0,3
2023-06-01,39053,1,0,1,2,0,2
2023-06-01,198978,2,1,3,2,2,2
2023-06-01,201376,0,0,0,10,8,10
2023-06-01,199881,2,2,4,3,3,3
2023-06-01,60983,3,3,6,7,6,7
2023-06-01,209255,1,1,2,7,6,7
2023-06-01,199396,1,1,2,4,1,4
2023-06-01,60630,1,1,2,1,2,3
2023-06-01,207410,1,0,1,1,0,1
2023-06-01,61198,2,0,2,1,0,1
2023-06-01,200162,1,0,1,1,0,1
2023-06-01,212127,1,0,1,1,0,1
2023-06-01,197422,4,3,7,5,5,5
2023-06-01,205669,4,0,4,1,0,1
2023-06-01,207849,1,1,2,1,1,1
2023-06-01,204355,2,0,2,3,0,3
2023-06-01,203432,1,1,2,1,1,1
2023-06-01,206059,1,1,2,3,3,3
2023-06-01,41006,3,0,3,3,0,3
2023-06-01,203362,1,0,1,2,0,2
2023-06-01,206412,4,0,4,1,0,1
2023-06-01,39571,9,0,9,2,0,2
2023-06-01,41356,1,0,1,4,0,4
2023-06-01,56821,1,1,2,2,2,2
2023-06-01,50087,6,0,6,4,0,4
2023-06-01,34687,1,0,1,1,0,1
2023-06-01,57742,4,0,4,3,0,3
2023-06-01,208300,1,0,1,2,0,2
2023-06-01,48076,2,0,2,5,0,5
2023-06-01,41670,2,1,3,1,1,1
2023-06-01,206214,1,0,1,1,0,1
2023-06-01,41310,1,0,1,1,0,1
2023-06-01,41460,7,0,7,7,0,7
2023-06-01,57149,1,0,1,3,0,3
2023-06-01,41311,7,0,7,4,0,4
2023-06-01,41362,12,0,12,3,0,3
2023-06-01,41420,6,0,6,2,0,2
2023-06-01,41419,5,0,5,3,0,3
2023-06-01,213223,3,0,3,2,0,2
2023-06-01,213057,3,0,3,2,0,2
2023-06-01,29303,19,0,19,6,0,6
2023-06-01,41669,3,0,3,4,0,4
2023-06-01,42332,3,0,3,5,0,5
2023-06-01,51027,1,0,1,2,0,2
2023-06-01,41606,19,0,19,7,0,7
2023-06-01,64401,4,2,6,1,1,1
2023-06-01,198172,2,0,2,1,0,1
2023-06-01,213252,3,1,4,1,1,1
2023-06-01,213274,3,1,4,1,1,1
2023-06-01,35503,3,0,3,3,0,3
2023-06-01,35014,1,0,1,2,0,2
2023-06-01,61301,1,0,1,1,0,1
2023-06-01,201215,1,0,1,1,0,1
2023-06-01,205343,4,0,4,1,0,1
2023-06-01,41703,1,0,1,1,0,1
2023-06-01,51189,4,0,4,1,0,1
2023-06-01,41483,1,0,1,1,0,1
2023-06-01,41563,2,1,3,4,1,4
2023-06-01,41601,7,0,7,4,0,4
2023-06-01,13215,11,1,12,7,2,7
2023-06-01,213067,1,1,2,3,1,3
2023-06-01,204048,1,1,2,3,1,3
2023-06-01,202642,1,0,1,1,0,1
2023-06-01,206536,1,0,1,3,0,3
2023-06-01,44981,5,1,6,3,1,3
2023-06-01,47936,1,2,3,2,2,2
2023-06-01,210307,1,0,1,2,0,2
2023-06-01,208728,1,0,1,1,0,1
2023-06-01,54238,5,0,5,3,0,3
2023-06-01,39520,1,0,1,1,0,1
2023-06-01,59865,17,4,21,18,7,19
2023-06-01,41216,3,1,4,3,2,3
2023-06-01,60626,1,1,2,2,2,2
2023-06-01,2280,34,2,36,5,4,5
2023-06-01,47150,1,0,1,1,0,1
2023-06-01,2287,2,2,4,1,1,1
2023-06-01,2285,9,8,17,1,1,1
2023-06-01,198952,1,0,1,1,0,1
2023-06-01,199233,7,1,8,2,1,2
2023-06-01,48190,3,0,3,1,0,1
2023-06-01,45000,2,0,2,3,0,3
2023-06-01,60793,3,1,4,12,7,13
2023-06-01,8789,3,0,3,2,0,2
2023-06-01,44534,8,8,16,4,3,4
2023-06-01,9021,144,1,145,11,2,11
2023-06-01,34996,2,0,2,3,0,3
2023-06-01,12846,7,0,7,1,0,1
2023-06-01,41334,1,0,1,1,0,1
2023-06-01,41558,4,0,4,2,0,2
2023-06-01,41631,7,0,7,7,0,7
2023-06-01,42122,1,0,1,1,0,1
2023-06-01,42039,3,0,3,2,0,2
2023-06-01,209740,5,0,5,5,0,5
2023-06-01,49787,3,1,4,2,2,3
2023-06-01,25046,4,2,6,3,2,3
2023-06-01,33901,6,1,7,4,1,4
2023-06-01,12496,5,3,8,12,8,14
2023-06-01,64481,1,0,1,4,0,4
2023-06-01,206066,10,6,16,4,2,4
2023-06-01,209416,1,0,1,2,0,2
2023-06-01,35658,1,0,1,2,0,2
2023-06-01,209885,1,0,1,3,0,3
2023-06-01,45051,6,0,6,3,0,3
2023-06-01,209904,1,0,1,4,0,4
2023-06-01,209890,1,0,1,1,0,1
2023-06-01,206724,1,0,1,2,0,2
2023-06-01,44401,3,0,3,3,0,3
2023-06-01,202387,2,0,2,2,0,2
2023-06-01,206541,1,0,1,3,0,3
2023-06-01,62106,13,0,13,2,0,2
2023-06-01,211277,2,0,2,1,0,1
2023-06-01,204281,25,1,26,10,3,11
2023-06-01,203095,1,0,1,1,0,1
2023-06-01,197674,5,0,5,3,0,3
2023-06-01,199239,1,0,1,1,0,1
2023-06-01,44796,2,1,3,6,1,6
2023-06-01,60027,4,0,4,3,0,3
2023-06-01,1885,1,0,1,1,0,1
2023-06-01,41741,1,1,2,2,2,2
2023-06-01,42642,2,0,2,2,0,2
2023-06-01,47442,39,0,39,2,0,2
2023-06-01,49744,3,0,3,5,0,5
2023-06-01,43406,5,1,6,3,4,4
2023-06-01,8518,36,3,39,7,3,7
2023-06-01,5613,2,0,2,1,0,1
2023-06-01,34928,4,1,5,2,1,2
2023-06-01,203308,4,0,4,3,0,3
2023-06-01,41890,4,0,4,2,0,2
2023-06-01,41853,3,1,4,3,2,3
2023-06-01,41801,1,0,1,1,0,1
2023-06-01,196824,4,0,4,2,0,2
2023-06-01,41880,1,0,1,2,0,2
2023-06-01,205135,3,0,3,1,0,1
2023-06-01,41904,2,0,2,1,0,1
2023-06-01,196659,2,0,2,2,0,2
2023-06-01,42241,1,0,1,1,0,1
2023-06-01,28693,2,1,3,1,1,1
2023-06-01,398994,1,0,1,2,0,2
2023-06-01,41012,8,0,8,1,0,1
2023-06-01,41935,14,5,19,7,4,8
2023-06-01,35315,3,0,3,3,0,3
2023-06-01,31262,3,0,3,4,0,4
2023-06-01,199062,1,0,1,4,0,4
2023-06-01,24689,149,0,149,2,0,2
2023-06-01,205019,23,0,23,4,0,4
2023-06-01,50468,4,0,4,3,0,3
2023-06-01,42108,1,0,1,1,0,1
2023-06-01,51399,5,1,6,8,5,8
2023-06-01,204062,4,0,4,1,0,1
2023-06-01,205111,18,0,18,6,0,6
2023-06-01,42009,4,1,5,2,1,2
2023-06-01,12500,3,0,3,2,0,2
2023-06-01,25511,3,0,3,2,0,2
2023-06-01,21023,1,0,1,3,0,3
2023-06-01,201884,4,0,4,1,0,1
2023-06-01,201231,1,0,1,1,0,1
2023-06-01,211157,2,1,3,2,2,2
2023-06-01,199103,2,0,2,6,0,6
2023-06-01,198936,9,0,9,2,0,2
2023-06-01,47223,15,1,16,11,5,11
2023-06-01,202228,9,0,9,6,0,6
2023-06-01,205430,3,0,3,3,0,3
2023-06-01,198156,3,1,4,1,1,1
2023-06-01,210402,17,0,17,2,0,2
2023-06-01,56503,44,0,44,2,0,2
2023-06-01,58326,3,1,4,3,1,3
2023-06-01,399507,14,0,14,4,0,4
2023-06-01,202880,1,0,1,1,0,1
2023-06-01,202768,1,0,1,4,0,4
2023-06-01,207235,1,0,1,1,0,1
2023-06-01,206760,1,0,1,2,0,2
2023-06-01,62041,6,1,7,10,6,12
2023-06-01,59930,2,1,3,7,4,7
2023-06-01,62014,3,1,4,10,1,10
2023-06-01,44907,2,1,3,3,1,3
2023-06-01,47133,4,0,4,4,0,4
2023-06-01,57246,7,0,7,4,0,4
2023-06-01,202432,1,0,1,2,0,2
2023-06-01,43106,1,0,1,5,0,5
2023-06-01,59402,2,1,3,1,1,1
2023-06-01,49779,6,3,9,2,2,2
2023-06-01,58308,2,1,3,4,3,4
2023-06-01,56989,1,0,1,1,0,1
2023-06-01,57300,20,0,20,2,0,2
2023-06-01,49924,3,0,3,1,0,1
2023-06-01,198208,5,0,5,1,0,1
2023-06-01,58427,5,0,5,2,0,2
2023-06-01,58310,9,3,12,6,2,6
2023-06-01,31499,19,1,20,12,5,13
2023-06-01,59953,9,2,11,4,4,4
2023-06-01,44768,1,1,2,1,1,1
2023-06-01,47324,3,0,3,2,0,2
2023-06-01,47979,1,0,1,1,0,1
2023-06-01,24690,2,0,2,2,0,2
2023-06-01,51843,2,0,2,1,0,1
2023-06-01,61213,4,0,4,2,0,2
2023-06-01,8302,6,6,12,9,7,11
2023-06-01,42540,2,0,2,3,0,3
2023-06-01,51648,10,0,10,9,0,9
2023-06-01,51792,8,0,8,3,0,3
2023-06-01,50153,10,0,10,8,0,8
2023-06-01,204801,1,0,1,1,0,1
2023-06-01,205241,6,6,12,2,2,2
2023-06-01,9192,9,0,9,2,0,2
2023-06-01,205678,3,0,3,8,0,8
2023-06-01,209515,1,0,1,1,0,1
2023-06-01,209670,1,0,1,1,0,1
2023-06-01,201983,14,1,15,4,2,5
2023-06-01,41870,1,0,1,1,0,1
2023-06-01,209576,1,0,1,1,0,1
2023-06-01,204984,1,0,1,2,0,2
2023-06-01,212563,1,0,1,3,0,3
2023-06-01,209707,1,1,2,3,4,4
2023-06-01,32130,4,0,4,3,0,3
2023-06-01,205266,0,0,0,3,2,3
2023-06-01,205268,1,1,2,1,1,1
2023-06-01,41105,27,0,27,1,0,1
2023-06-01,35712,5,5,10,3,3,3
2023-06-01,209700,4,0,4,3,0,3
2023-06-01,209331,1,0,1,2,0,2
2023-06-01,209615,1,0,1,1,0,1
2023-06-01,208693,2,1,3,4,3,4
2023-06-01,199758,13,2,15,8,4,8
2023-06-01,196976,1,1,2,1,1,1
2023-06-01,41898,4,0,4,3,0,3
2023-06-01,50513,2,0,2,1,0,1
2023-06-01,208468,6,0,6,2,0,2
2023-06-01,43342,16,0,16,3,0,3
2023-06-01,43720,3,0,3,1,0,1
2023-06-01,9115,4,2,6,8,7,10
2023-06-01,41585,7,0,7,2,0,2
2023-06-01,201729,2,0,2,1,0,1
2023-06-01,49335,1,0,1,1,0,1
2023-06-01,42344,3,2,5,8,1,8
2023-06-01,43843,19,0,19,8,0,8
2023-06-01,48720,5,1,6,4,1,4
2023-06-01,41736,2,0,2,1,0,1
2023-06-01,204896,10,6,16,2,2,2
2023-06-01,48981,4,1,5,2,2,2
2023-06-01,51159,4,0,4,7,0,7
2023-06-01,41706,3,0,3,3,0,3
2023-06-01,62319,28,1,29,3,2,3
2023-06-01,56836,1,0,1,1,0,1
2023-06-01,202900,1,0,1,1,0,1
2023-06-01,41816,13,0,13,3,0,3
2023-06-01,41829,3,0,3,3,0,3
2023-06-01,41837,0,0,0,4,0,4
2023-06-01,8844,5,0,5,1,0,1
2023-06-01,41893,6,0,6,3,0,3
2023-06-01,41786,31,5,36,1,1,1
2023-06-01,60213,3,2,5,2,2,2
2023-06-01,198066,33,4,37,2,2,2
2023-06-01,198031,1,1,2,1,1,1
2023-06-01,43775,28,0,28,3,0,3
2023-06-01,47421,3,0,3,2,0,2
2023-06-01,61996,11,0,11,3,0,3
2023-06-01,212363,1,0,1,1,0,1
2023-06-01,50525,1,2,3,1,1,1
2023-06-01,211263,1,0,1,1,0,1
2023-06-01,49711,7,1,8,1,1,1
2023-06-01,56497,7,0,7,1,0,1
2023-06-01,44397,2,1,3,1,1,1
2023-06-01,202846,1,0,1,1,0,1
2023-06-01,201744,1,0,1,2,0,2
2023-06-01,200508,1,0,1,1,0,1
2023-06-01,42343,2,1,3,2,2,2
2023-06-01,42673,7,2,9,10,4,10
2023-06-01,206953,3,0,3,2,0,2
2023-06-01,203086,2,0,2,3,0,3
2023-06-01,50061,4,1,5,7,6,9
2023-06-01,34006,4,1,5,7,3,8
2023-06-01,203377,5,0,5,2,0,2
2023-06-01,42082,15,1,16,1,1,1
2023-06-01,39919,25,0,25,3,0,3
2023-06-01,5433,4,1,5,4,2,4
2023-06-01,42852,6,0,6,3,0,3
2023-06-01,34225,3,2,5,6,4,7
2023-06-01,41738,17,0,17,1,0,1
2023-06-01,34859,7,0,7,1,0,1
2023-06-01,57712,3,1,4,6,1,6
2023-06-01,41828,4,1,5,3,1,3
2023-06-01,201322,3,0,3,1,0,1
2023-06-01,47216,4,0,4,2,0,2
2023-06-01,199894,1,0,1,1,0,1
2023-06-01,43279,7,0,7,3,0,3
2023-06-01,42017,5,1,6,3,1,4
2023-06-01,12903,26,0,26,1,0,1
2023-06-01,35732,3,6,9,2,1,2
2023-06-01,13044,5,0,5,1,0,1
2023-06-01,211796,2,1,3,4,2,4
2023-06-01,42084,2,0,2,1,0,1
2023-06-01,57576,2,0,2,3,0,3
2023-06-01,196883,15,1,16,7,4,8
2023-06-01,42131,1,0,1,1,0,1
2023-06-01,29024,4,0,4,3,0,3
2023-06-01,42227,17,1,18,5,6,6
2023-06-01,29665,8,0,8,6,0,6
2023-06-01,41231,15,9,24,4,3,4
2023-06-01,42399,3,0,3,1,0,1
2023-06-01,35602,7,0,7,1,0,1
2023-06-01,42466,1,0,1,1,0,1
2023-06-01,43258,5,0,5,3,0,3
2023-06-01,201998,2,0,2,1,0,1
2023-06-01,42638,1,0,1,1,0,1
2023-06-01,34102,1,0,1,3,0,3
2023-06-01,42078,7,0,7,1,0,1
2023-06-01,210830,1,0,1,1,0,1
2023-06-01,58254,7,0,7,5,0,5
2023-06-01,210774,1,0,1,1,0,1
2023-06-01,28704,2,0,2,1,0,1
2023-06-01,60771,14,1,15,14,1,14
2023-06-01,39303,1,0,1,2,0,2
2023-06-01,48228,1,0,1,4,0,4
2023-06-01,61014,1,0,1,1,0,1
2023-06-01,44162,1,0,1,3,0,3
2023-06-01,42375,2,3,5,1,1,1
2023-06-01,57509,1,0,1,1,0,1
2023-06-01,42261,1,0,1,3,0,3
2023-06-01,212684,2,0,2,2,0,2
2023-06-01,42274,2,0,2,3,0,3
2023-06-01,200100,20,0,20,1,0,1
2023-06-01,42307,2,2,4,2,2,2
2023-06-01,41360,11,0,11,11,0,11
2023-06-01,41329,19,0,19,3,0,3
2023-06-01,42377,1,0,1,3,0,3
2023-06-01,35824,3,0,3,1,0,1
2023-06-01,42401,5,0,5,1,0,1
2023-06-01,42413,1,0,1,1,0,1
2023-06-01,206012,3,0,3,1,0,1
2023-06-01,41568,4,0,4,4,0,4
2023-06-01,47143,21,0,21,3,0,3
2023-06-01,42538,1,0,1,3,0,3
2023-06-01,31633,5,0,5,5,0,5
2023-06-01,35322,2,0,2,2,0,2
2023-06-01,57478,8,0,8,3,0,3
2023-06-01,42481,1,0,1,1,0,1
2023-06-01,42501,2,0,2,3,0,3
2023-06-01,31077,1,0,1,1,0,1
2023-06-01,42518,12,0,12,4,0,4
2023-06-01,50165,1,0,1,1,0,1
2023-06-01,47273,7,0,7,9,0,9
2023-06-01,42552,1,0,1,2,0,2
2023-06-01,41847,6,2,8,8,3,8
2023-06-01,35327,4,0,4,2,0,2
2023-06-01,42556,5,0,5,1,0,1
2023-06-01,202445,1,0,1,7,0,7
2023-06-01,42576,1,0,1,1,0,1
2023-06-01,58186,1,0,1,2,0,2
2023-06-01,48157,4,0,4,4,0,4
2023-06-01,42636,1,0,1,1,0,1
2023-06-01,42619,2,0,2,2,0,2
2023-06-01,48983,3,0,3,2,0,2
2023-06-01,48694,1,0,1,3,0,3
2023-06-01,42650,1,0,1,2,0,2
2023-06-01,43842,11,0,11,3,0,3
2023-06-01,42936,1,1,2,1,1,1
2023-06-01,198884,1,0,1,4,0,4
2023-06-01,42702,3,0,3,3,0,3
2023-06-01,42723,2,0,2,4,0,4
2023-06-01,34671,1,0,1,3,0,3
2023-06-01,42749,1,0,1,1,0,1
2023-06-01,50812,6,0,6,9,0,9
2023-06-01,48578,1,0,1,2,0,2
2023-06-01,6820,1,0,1,7,0,7
2023-06-01,29298,4,4,8,6,6,7
2023-06-01,42798,1,0,1,3,0,3
2023-06-01,44837,1,0,1,2,0,2
2023-06-01,44894,25,1,26,12,3,12
2023-06-01,209779,1,0,1,2,0,2
2023-06-01,42776,1,0,1,1,0,1
2023-06-01,42797,1,0,1,2,0,2
2023-06-01,42555,23,0,23,9,0,9
2023-06-01,210421,16,0,16,1,0,1
2023-06-01,201054,1,0,1,3,7,9
2023-06-01,202504,1,0,1,1,0,1
2023-06-01,202483,1,0,1,2,0,2
2023-06-01,42878,1,0,1,1,0,1
2023-06-01,42914,2,0,2,3,0,3
2023-06-01,49339,1,0,1,1,0,1
2023-06-01,42892,10,0,10,4,0,4
2023-06-01,42895,2,0,2,1,0,1
2023-06-01,44619,3,0,3,4,0,4
2023-06-01,42911,1,0,1,2,0,2
2023-06-01,42916,8,0,8,4,0,4
2023-06-01,42930,1,0,1,1,0,1
2023-06-01,58188,3,1,4,7,4,7
2023-06-01,199408,5,1,6,2,4,4
2023-06-01,212398,1,0,1,1,0,1
2023-06-01,53363,5,0,5,2,0,2
2023-06-01,42995,1,0,1,1,0,1
2023-06-01,42996,3,0,3,2,0,2
2023-06-01,197496,2,0,2,1,0,1
2023-06-01,43071,7,0,7,3,0,3
2023-06-01,208098,1,0,1,2,0,2
2023-06-01,43007,1,0,1,2,0,2
2023-06-01,43008,1,0,1,1,0,1
2023-06-01,51835,1,0,1,1,0,1
2023-06-01,43017,2,0,2,2,0,2
2023-06-01,43101,1,1,2,1,1,1
2023-06-01,43040,1,0,1,1,0,1
2023-06-01,43050,3,0,3,1,0,1
2023-06-01,201079,10,0,10,2,0,2
2023-06-01,43085,1,0,1,2,0,2
2023-06-01,34241,15,2,17,8,2,8
2023-06-01,28855,5,3,8,6,5,6
2023-06-01,42231,2,0,2,4,0,4
2023-06-01,43095,1,0,1,2,0,2
2023-06-01,43099,1,1,2,3,1,3
2023-06-01,44504,1,0,1,1,0,1
2023-06-01,59617,2,1,3,3,3,3
2023-06-01,39621,4,0,4,2,0,2
2023-06-01,43108,6,0,6,2,0,2
2023-06-01,47475,2,0,2,1,0,1
2023-06-01,43125,3,0,3,2,0,2
2023-06-01,43137,3,0,3,3,0,3
2023-06-01,28763,4,0,4,2,0,2
2023-06-01,43158,2,0,2,1,0,1
2023-06-01,203036,2,0,2,2,0,2
2023-06-01,43155,3,1,4,2,2,2
2023-06-01,212777,4,0,4,1,0,1
2023-06-01,60452,1,0,1,1,0,1
2023-06-01,62036,2,0,2,3,0,3
2023-06-01,43165,1,0,1,1,0,1
2023-06-01,12817,1,1,2,3,4,4
2023-06-01,29317,3,1,4,1,1,1
2023-06-01,43172,1,0,1,1,0,1
2023-06-01,43178,2,0,2,1,0,1
2023-06-01,43184,2,0,2,3,0,3
2023-06-01,212375,1,0,1,2,0,2
2023-06-01,34600,5,0,5,1,0,1
2023-06-01,209898,1,5,6,4,5,5
2023-06-01,207413,4,0,4,2,0,2
2023-06-01,56819,2,0,2,2,0,2
2023-06-01,43183,5,2,7,1,2,2
2023-06-01,48120,1,0,1,3,0,3
2023-06-01,34922,5,0,5,2,0,2
2023-06-01,61078,4,1,5,2,1,2
2023-06-01,43251,2,1,3,4,3,4
2023-06-01,31725,12,1,13,10,2,10
2023-06-01,50879,2,0,2,1,0,1
2023-06-01,42483,1,0,1,3,0,3
2023-06-01,43246,1,0,1,2,0,2
2023-06-01,12509,2,1,3,2,3,3
2023-06-01,50636,2,0,2,3,0,3
2023-06-01,43291,3,1,4,3,2,3
2023-06-01,44284,2,0,2,2,0,2
2023-06-01,213160,14,0,14,3,0,3
2023-06-01,43302,3,0,3,1,0,1
2023-06-01,43335,1,0,1,2,0,2
2023-06-01,56670,2,0,2,1,0,1
2023-06-01,43399,9,0,9,5,0,5
2023-06-01,29593,2,0,2,2,0,2
2023-06-01,43397,1,0,1,1,0,1
2023-06-01,43400,3,0,3,1,0,1
2023-06-01,43394,1,0,1,3,0,3
2023-06-01,43403,2,0,2,3,0,3
2023-06-01,43511,2,0,2,1,0,1
2023-06-01,42352,10,2,12,10,2,10
2023-06-01,35144,6,0,6,4,0,4
2023-06-01,43434,25,0,25,4,0,4
2023-06-01,43464,1,0,1,2,0,2
2023-06-01,43466,1,0,1,1,0,1
2023-06-01,52191,3,1,4,5,2,5
2023-06-01,43473,1,0,1,1,0,1
2023-06-01,203793,1,0,1,1,0,1
2023-06-01,211691,1,4,5,1,3,3
2023-06-01,43493,3,0,3,1,0,1
2023-06-01,43502,2,0,2,3,0,3
2023-06-01,43547,1,0,1,4,0,4
2023-06-01,24660,1,1,2,2,1,2
2023-06-01,203741,1,0,1,4,0,4
2023-06-01,43580,1,0,1,1,0,1
2023-06-01,43595,8,1,9,1,1,1
2023-06-01,43587,1,0,1,1,0,1
2023-06-01,60777,5,0,5,5,0,5
2023-06-01,43669,3,0,3,1,0,1
2023-06-01,33817,4,1,5,2,1,2
2023-06-01,43623,24,3,27,16,4,17
2023-06-01,43626,2,0,2,4,0,4
2023-06-01,198669,3,0,3,3,0,3
2023-06-01,44689,2,0,2,3,0,3
2023-06-01,42557,7,1,8,1,1,1
2023-06-01,35442,2,0,2,1,0,1
2023-06-01,43681,1,1,2,2,2,2
2023-06-01,51100,3,0,3,1,0,1
2023-06-01,44174,4,0,4,2,0,2
2023-06-01,200442,1,0,1,2,0,2
2023-06-01,43712,2,0,2,2,0,2
2023-06-01,43721,1,0,1,1,0,1
2023-06-01,206293,7,0,7,1,0,1
2023-06-01,43735,2,0,2,1,0,1
2023-06-01,43736,3,0,3,3,0,3
2023-06-01,15439,9,0,9,4,0,4
2023-06-01,43770,3,2,5,2,2,2
2023-06-01,43798,2,0,2,5,0,5
2023-06-01,34540,1,0,1,5,0,5
2023-06-01,43784,1,0,1,1,0,1
2023-06-01,41024,3,0,3,1,0,1
2023-06-01,35413,4,0,4,1,0,1
2023-06-01,43838,2,0,2,1,0,1
2023-06-01,43828,1,0,1,1,0,1
2023-06-01,12642,1,0,1,1,0,1
2023-06-01,62136,3,0,3,2,0,2
2023-06-01,43840,1,0,1,1,0,1
2023-06-01,199216,2,2,4,1,1,1
2023-06-01,43866,2,0,2,2,0,2
2023-06-01,34970,8,0,8,2,0,2
2023-06-01,41407,2,1,3,2,2,2
2023-06-01,204283,1,0,1,1,0,1
2023-06-01,43896,6,0,6,6,0,6
2023-06-01,24868,2,1,3,3,3,3
2023-06-01,43911,1,1,2,1,1,1
2023-06-01,210317,2,2,4,2,3,3
2023-06-01,43934,1,0,1,1,0,1
2023-06-01,44238,1,0,1,2,0,2
2023-06-01,62181,2,0,2,4,0,4
2023-06-01,41305,2,0,2,7,0,7
2023-06-01,43958,5,0,5,3,0,3
2023-06-01,48239,4,0,4,15,0,15
2023-06-01,41588,2,0,2,1,0,1
2023-06-01,43993,3,0,3,3,0,3
2023-06-01,41550,3,0,3,1,0,1
2023-06-01,209367,2,0,2,2,0,2
2023-06-01,42981,3,0,3,6,0,6
2023-06-01,212111,1,0,1,1,0,1
2023-06-01,210151,3,0,3,3,0,3
2023-06-01,42991,6,0,6,3,0,3
2023-06-01,198909,2,0,2,2,0,2
2023-06-01,25002,0,0,0,4,0,4
2023-06-01,201483,5,2,7,4,2,5
2023-06-01,212869,1,0,1,3,0,3
2023-06-01,43060,10,0,10,3,0,3
2023-06-01,50729,1,0,1,1,0,1
2023-06-01,43067,10,1,11,2,1,2
2023-06-01,51525,4,0,4,3,0,3
2023-06-01,201637,2,0,2,6,0,6
2023-06-01,35795,6,0,6,6,0,6
2023-06-01,43133,5,0,5,6,0,6
2023-06-01,39150,13,4,17,4,2,4
2023-06-01,205890,1,1,2,2,2,2
2023-06-01,43145,11,0,11,1,0,1
2023-06-01,24857,1,0,1,1,0,1
2023-06-01,43162,1,0,1,1,0,1
2023-06-01,43175,3,0,3,1,0,1
2023-06-01,62126,3,3,6,1,1,1
2023-06-01,205295,6,0,6,2,0,2
2023-06-01,43244,1,0,1,3,0,3
2023-06-01,42844,3,0,3,1,0,1
2023-06-01,207558,4,1,5,1,1,1
2023-06-01,211892,4,2,6,2,2,2
2023-06-01,29407,2,0,2,1,0,1
2023-06-01,6846,7,1,8,32,2,32
2023-06-01,201369,1,0,1,1,0,1
2023-06-01,43310,2,0,2,1,0,1
2023-06-01,43320,2,0,2,6,0,6
2023-06-01,42773,1,0,1,6,0,6
2023-06-01,57251,10,0,10,1,0,1
2023-06-01,48278,2,0,2,9,0,9
2023-06-01,35530,1,0,1,3,0,3
2023-06-01,43348,1,0,1,1,0,1
2023-06-01,43354,6,1,7,4,3,4
2023-06-01,57513,9,5,14,2,1,2
2023-06-01,203533,1,0,1,3,0,3
2023-06-01,49356,1,0,1,3,0,3
2023-06-01,50392,5,1,6,8,4,8
2023-06-01,57954,3,1,4,4,2,4
2023-06-01,42563,1,1,2,1,1,1
2023-06-01,51341,9,0,9,6,0,6
2023-06-01,62446,1,0,1,1,0,1
2023-06-01,43496,2,0,2,3,0,3
2023-06-01,43438,2,0,2,3,0,3
2023-06-01,35025,10,0,10,3,0,3
2023-06-01,208369,1,0,1,1,0,1
2023-06-01,51742,6,0,6,3,0,3
2023-06-01,208232,1,0,1,1,0,1
2023-06-01,43465,8,1,9,4,2,4
2023-06-01,31437,5,0,5,1,0,1
2023-06-01,43499,1,0,1,1,0,1
2023-06-01,43495,2,0,2,3,0,3
2023-06-01,43534,4,0,4,3,0,3
2023-06-01,43514,1,0,1,2,0,2
2023-06-01,43523,1,0,1,1,0,1
2023-06-01,211580,4,0,4,1,0,1
2023-06-01,43552,1,0,1,2,0,2
2023-06-01,8870,18,0,18,8,0,8
2023-06-01,43638,6,1,7,3,2,4
2023-06-01,61396,4,0,4,3,0,3
2023-06-01,43646,7,4,11,5,2,5
2023-06-01,43660,5,0,5,3,0,3
2023-06-01,5589,12,0,12,5,0,5
2023-06-01,197969,1,0,1,7,0,7
2023-06-01,43666,1,0,1,1,0,1
2023-06-01,204609,4,1,5,3,3,3
2023-06-01,43692,1,1,2,1,1,1
2023-06-01,43753,4,0,4,2,0,2
2023-06-01,199201,3,0,3,2,0,2
2023-06-01,204436,2,1,3,2,2,2
2023-06-01,200363,2,1,3,1,1,1
2023-06-01,203679,1,0,1,1,0,1
2023-06-01,43164,1,0,1,2,0,2
2023-06-01,43163,1,0,1,1,0,1
2023-06-01,61303,6,1,7,3,1,3
2023-06-01,197172,1,0,1,1,0,1
2023-06-01,43194,2,0,2,1,0,1
2023-06-01,43187,1,0,1,1,0,1
2023-06-01,43206,1,0,1,1,0,1
2023-06-01,47271,2,0,2,1,0,1
2023-06-01,48916,1,0,1,2,0,2
2023-06-01,39133,1,0,1,7,0,7
2023-06-01,44044,1,0,1,1,0,1
2023-06-01,31604,4,0,4,2,0,2
2023-06-01,6769,12,1,13,6,3,6
2023-06-01,199114,1,0,1,3,0,3
2023-06-01,51064,2,0,2,1,0,1
2023-06-01,198018,3,6,9,9,8,11
2023-06-01,209021,1,0,1,1,0,1
2023-06-01,43271,1,0,1,2,0,2
2023-06-01,43306,1,0,1,4,0,4
2023-06-01,31360,1,0,1,4,0,4
2023-06-01,43305,1,0,1,2,0,2
2023-06-01,43405,1,0,1,2,0,2
2023-06-01,58063,1,0,1,2,0,2
2023-06-01,48726,1,0,1,1,0,1
2023-06-01,43522,1,0,1,1,0,1
2023-06-01,33876,11,1,12,1,1,1
2023-06-01,43488,1,0,1,1,0,1
2023-06-01,43497,1,0,1,2,0,2
2023-06-01,39497,1,0,1,3,0,3
2023-06-01,43570,1,0,1,1,0,1
2023-06-01,35083,2,0,2,1,0,1
2023-06-01,50434,8,0,8,5,0,5
2023-06-01,48435,1,0,1,1,0,1
2023-06-01,201754,2,0,2,4,0,4
2023-06-01,211537,1,0,1,3,0,3
2023-06-01,57224,5,0,5,3,0,3
2023-06-01,43582,1,0,1,1,0,1
2023-06-01,47327,1,0,1,1,0,1
2023-06-01,43601,2,0,2,2,0,2
2023-06-01,208901,1,0,1,1,0,1
2023-06-01,12316,7,1,8,4,6,7
2023-06-01,43592,2,0,2,2,0,2
2023-06-01,28899,2,0,2,2,0,2
2023-06-01,31105,1,0,1,1,0,1
2023-06-01,43656,5,0,5,4,0,4
2023-06-01,43625,3,0,3,2,0,2
2023-06-01,43820,1,0,1,1,0,1
2023-06-01,201635,1,0,1,3,0,3
2023-06-01,43654,1,0,1,1,0,1
2023-06-01,43643,1,0,1,1,0,1
2023-06-01,56700,1,1,2,1,1,1
2023-06-01,201951,1,0,1,3,0,3
2023-06-01,201661,6,1,7,6,1,6
2023-06-01,43663,1,0,1,2,0,2
2023-06-01,43674,2,0,2,1,0,1
2023-06-01,42001,2,1,3,1,1,1
2023-06-01,44073,1,1,2,2,1,2
2023-06-01,8489,5,0,5,3,0,3
2023-06-01,39471,1,0,1,2,0,2
2023-06-01,43705,1,0,1,2,0,2
2023-06-01,43713,1,0,1,1,0,1
2023-06-01,43914,1,0,1,2,0,2
2023-06-01,43717,3,1,4,2,1,2
2023-06-01,199006,1,0,1,1,0,1
2023-06-01,43719,1,1,2,1,1,2
2023-06-01,43726,2,0,2,1,0,1
2023-06-01,205505,7,3,10,2,2,2
2023-06-01,43774,2,0,2,1,0,1
2023-06-01,43762,1,0,1,2,0,2
2023-06-01,43758,4,1,5,1,1,1
2023-06-01,43771,3,1,4,1,1,1
2023-06-01,43785,1,0,1,3,0,3
2023-06-01,41618,2,1,3,2,1,2
2023-06-01,43781,1,0,1,2,0,2
2023-06-01,43787,1,0,1,2,0,2
2023-06-01,51955,7,7,14,6,5,7
2023-06-01,43807,2,0,2,3,0,3
2023-06-01,43492,1,0,1,2,0,2
2023-06-01,42547,2,0,2,8,0,8
2023-06-01,43806,2,0,2,2,0,2
2023-06-01,43477,2,0,2,2,0,2
2023-06-01,14907,11,8,19,26,13,28
2023-06-01,211245,1,0,1,2,0,2
2023-06-01,43932,1,0,1,3,0,3
2023-06-01,43887,2,0,2,3,0,3
2023-06-01,43907,1,0,1,3,0,3
2023-06-01,43941,2,0,2,6,0,6
2023-06-01,212870,2,0,2,1,0,1
2023-06-01,43854,2,0,2,3,0,3
2023-06-01,201647,10,0,10,2,0,2
2023-06-01,212226,1,1,2,1,1,1
2023-06-01,43867,1,0,1,1,0,1
2023-06-01,56368,1,1,2,3,2,3
2023-06-01,43860,1,0,1,3,0,3
2023-06-01,43858,4,2,6,5,3,5
2023-06-01,206897,7,3,10,2,1,2
2023-06-01,35814,3,1,4,2,1,2
2023-06-01,43869,1,0,1,1,0,1
2023-06-01,43871,1,0,1,3,0,3
2023-06-01,43881,1,0,1,1,0,1
2023-06-01,49743,5,2,7,11,5,11
2023-06-01,199080,1,0,1,3,0,3
2023-06-01,20892,1,0,1,3,0,3
2023-06-01,43953,1,0,1,1,0,1
2023-06-01,198216,1,0,1,6,0,6
2023-06-01,43947,1,0,1,1,0,1
2023-06-01,43946,1,0,1,3,0,3
2023-06-01,43961,1,0,1,1,0,1
2023-06-01,43952,1,0,1,3,0,3
2023-06-01,44508,1,0,1,1,0,1
2023-06-01,44048,1,0,1,1,0,1
2023-06-01,43982,1,0,1,1,0,1
2023-06-01,44005,1,0,1,2,0,2
2023-06-01,196864,5,0,5,3,0,3
2023-06-01,25527,3,0,3,2,0,2
2023-06-01,43986,1,0,1,1,0,1
2023-06-01,43990,1,0,1,1,0,1
2023-06-01,43980,3,0,3,3,0,3
2023-06-01,15405,5,1,6,1,1,1
2023-06-01,44004,1,0,1,2,0,2
2023-06-01,43535,1,0,1,1,0,1
2023-06-01,197978,1,0,1,3,0,3
2023-06-01,43985,1,0,1,2,0,2
2023-06-01,24812,26,0,26,11,0,11
2023-06-01,47898,10,0,10,4,0,4
2023-06-01,57968,2,0,2,1,0,1
2023-06-01,44023,1,0,1,1,0,1
2023-06-01,198842,1,0,1,3,0,3
2023-06-01,44036,1,0,1,1,0,1
2023-06-01,206388,2,0,2,4,0,4
2023-06-01,203684,10,0,10,3,0,3
2023-06-01,44039,1,0,1,3,0,3
2023-06-01,44049,1,0,1,2,0,2
2023-06-01,44064,1,0,1,2,0,2
2023-06-01,47267,6,7,13,4,4,5
2023-06-01,41079,12,1,13,2,1,2
2023-06-01,44085,1,0,1,2,0,2
2023-06-01,44535,1,0,1,2,0,2
2023-06-01,44122,1,0,1,2,0,2
2023-06-01,25373,7,3,10,2,2,2
2023-06-01,44119,1,0,1,3,0,3
2023-06-01,48229,2,0,2,4,0,4
2023-06-01,44121,1,0,1,1,0,1
2023-06-01,57982,4,0,4,5,0,5
2023-06-01,44137,1,0,1,1,0,1
2023-06-01,44153,1,0,1,1,0,1
2023-06-01,44189,2,0,2,2,0,2
2023-06-01,44151,1,0,1,5,0,5
2023-06-01,209052,1,0,1,1,0,1
2023-06-01,204453,5,0,5,4,0,4
2023-06-01,44190,1,0,1,3,0,3
2023-06-01,48869,1,0,1,1,0,1
2023-06-01,51644,1,0,1,3,0,3
2023-06-01,44223,1,0,1,1,0,1
2023-06-01,44236,2,0,2,2,0,2
2023-06-01,44231,1,0,1,1,0,1
2023-06-01,198635,1,0,1,1,0,1
2023-06-01,44240,1,0,1,1,0,1
2023-06-01,44282,5,0,5,2,0,2
2023-06-01,210626,2,1,3,3,1,3
2023-06-01,44264,1,0,1,3,0,3
2023-06-01,44274,1,0,1,1,0,1
2023-06-01,34748,0,0,0,2,2,2
2023-06-01,44325,1,1,2,1,1,1
2023-06-01,44690,1,0,1,1,0,1
2023-06-01,207066,2,0,2,4,0,4
2023-06-01,42573,1,0,1,2,0,2
2023-06-01,42112,1,0,1,2,0,2
2023-06-01,44351,1,0,1,1,0,1
2023-06-01,44352,2,0,2,3,0,3
2023-06-01,198249,4,1,5,5,5,6
2023-06-01,44367,1,0,1,1,0,1
2023-06-01,44370,1,0,1,1,0,1
2023-06-01,44623,1,0,1,1,0,1
2023-06-01,44389,1,0,1,1,0,1
2023-06-01,201879,1,0,1,1,0,1
2023-06-01,42445,2,0,2,2,0,2
2023-06-01,44427,1,0,1,1,0,1
2023-06-01,31709,3,0,3,3,0,3
2023-06-01,44455,1,0,1,1,0,1
2023-06-01,44440,2,0,2,2,0,2
2023-06-01,44480,1,0,1,3,0,3
2023-06-01,44463,1,0,1,1,0,1
2023-06-01,44490,1,0,1,1,0,1
2023-06-01,47828,1,0,1,4,0,4
2023-06-01,44482,7,0,7,3,0,3
2023-06-01,20934,3,0,3,2,0,2
2023-06-01,44495,1,0,1,1,0,1
2023-06-01,44518,1,0,1,1,0,1
2023-06-01,25070,15,1,16,9,1,9
2023-06-01,44501,1,0,1,3,0,3
2023-06-01,44524,1,0,1,2,0,2
2023-06-01,20916,1,0,1,1,0,1
2023-06-01,25563,3,1,4,3,2,3
2023-06-01,24794,1,0,1,1,0,1
2023-06-01,31462,2,0,2,3,0,3
2023-06-01,3206,1,0,1,1,0,1
2023-06-01,21942,1,0,1,2,0,2
2023-06-01,211748,1,1,2,1,1,1
2023-06-01,9175,5,0,5,1,0,1
2023-06-01,197366,1,0,1,2,0,2
2023-06-01,44603,1,0,1,2,0,2
2023-06-01,44608,2,0,2,8,0,8
2023-06-01,44595,1,0,1,4,0,4
2023-06-01,44697,1,0,1,2,0,2
2023-06-01,209913,1,0,1,1,0,1
2023-06-01,61268,2,0,2,1,0,1
2023-06-01,44630,1,0,1,1,0,1
2023-06-01,44713,1,0,1,1,0,1
2023-06-01,35723,4,0,4,2,0,2
2023-06-01,44734,3,0,3,2,0,2
2023-06-01,59848,2,2,4,5,4,6
2023-06-01,59639,1,1,2,1,1,1
2023-06-01,199637,1,0,1,1,0,1
2023-06-01,39727,1,0,1,2,0,2
2023-06-01,1887,2,1,3,27,6,27
2023-06-01,44959,3,0,3,2,0,2
2023-06-01,12686,30,0,30,4,0,4
2023-06-01,44675,1,0,1,1,0,1
2023-06-01,57118,4,4,8,11,11,14
2023-06-01,210832,1,0,1,2,0,2
2023-06-01,44751,1,0,1,3,0,3
2023-06-01,43861,1,1,2,1,1,1
2023-06-01,52096,1,0,1,3,0,3
2023-06-01,44777,1,0,1,2,0,2
2023-06-01,44842,2,0,2,2,0,2
2023-06-01,34024,2,0,2,2,0,2
2023-06-01,44781,1,0,1,2,0,2
2023-06-01,49275,1,0,1,1,0,1
2023-06-01,44783,1,0,1,1,0,1
2023-06-01,44788,7,12,19,8,6,10
2023-06-01,55569,6,8,14,8,3,8
2023-06-01,44797,1,0,1,2,0,2
2023-06-01,197472,2,0,2,3,0,3
2023-06-01,202600,3,0,3,2,0,2
2023-06-01,44799,1,0,1,2,0,2
2023-06-01,43744,1,0,1,1,0,1
2023-06-01,25143,12,0,12,12,0,12
2023-06-01,43748,4,0,4,1,0,1
2023-06-01,1200,3,1,4,11,5,12
2023-06-01,43776,2,1,3,3,1,3
2023-06-01,43773,8,0,8,3,0,3
2023-06-01,43786,5,0,5,1,0,1
2023-06-01,59500,1,0,1,1,0,1
2023-06-01,59496,1,0,1,1,0,1
2023-06-01,6747,1,0,1,2,0,2
2023-06-01,199250,4,0,4,7,0,7
2023-06-01,204864,2,0,2,1,0,1
2023-06-01,205013,1,0,1,3,0,3
2023-06-01,41656,2,0,2,4,0,4
2023-06-01,210049,1,0,1,1,0,1
2023-06-01,43803,5,0,5,2,0,2
2023-06-01,197217,5,0,5,6,0,6
2023-06-01,34323,2,0,2,2,0,2
2023-06-01,44863,4,0,4,3,0,3
2023-06-01,202312,5,2,7,5,4,5
2023-06-01,43968,1,0,1,2,0,2
2023-06-01,198317,38,21,59,7,6,8
2023-06-01,43864,2,0,2,3,0,3
2023-06-01,43312,4,1,5,1,1,1
2023-06-01,43942,15,1,16,9,4,9
2023-06-01,202165,2,1,3,3,2,4
2023-06-01,30822,3,0,3,1,0,1
2023-06-01,43929,1,0,1,1,0,1
2023-06-01,43962,2,0,2,3,0,3
2023-06-01,34715,7,0,7,1,0,1
2023-06-01,44000,1,1,2,4,2,5
2023-06-01,205195,5,0,5,1,0,1
2023-06-01,44027,7,0,7,2,0,2
2023-06-01,44041,2,0,2,5,0,5
2023-06-01,39027,21,0,21,1,0,1
2023-06-01,197672,4,0,4,5,0,5
2023-06-01,202839,1,0,1,4,0,4
2023-06-01,208664,2,0,2,2,0,2
2023-06-01,44105,1,0,1,1,0,1
2023-06-01,47618,5,0,5,4,0,4
2023-06-01,206572,1,0,1,2,0,2
2023-06-01,203480,1,0,1,1,0,1
2023-06-01,205234,4,0,4,3,0,3
2023-06-01,41600,2,0,2,4,0,4
2023-06-01,44157,2,0,2,1,0,1
2023-06-01,34944,1,1,2,2,4,5
2023-06-01,208547,1,0,1,2,0,2
2023-06-01,201141,5,0,5,2,0,2
2023-06-01,12480,12,1,13,14,7,15
2023-06-01,44177,2,0,2,1,0,1
2023-06-01,213184,1,0,1,2,0,2
2023-06-01,44278,4,0,4,4,0,4
2023-06-01,44287,4,0,4,2,0,2
2023-06-01,48446,1,1,2,3,1,3
2023-06-01,44304,4,0,4,2,0,2
2023-06-01,212736,2,1,3,1,1,1
2023-06-01,44309,12,0,12,1,0,1
2023-06-01,34121,1,1,2,2,1,2
2023-06-01,44411,1,0,1,3,0,3
2023-06-01,213134,2,0,2,2,0,2
2023-06-01,57117,3,0,3,3,0,3
2023-06-01,212729,1,0,1,1,0,1
2023-06-01,197684,1,0,1,1,0,1
2023-06-01,44425,3,0,3,1,0,1
2023-06-01,202779,17,0,17,6,0,6
2023-06-01,44484,26,0,26,6,0,6
2023-06-01,43328,1,0,1,2,0,2
2023-06-01,34329,1,0,1,2,0,2
2023-06-01,200622,1,0,1,2,0,2
2023-06-01,34802,5,0,5,3,0,3
2023-06-01,29443,3,0,3,4,0,4
2023-06-01,207403,1,0,1,3,0,3
2023-06-01,44528,1,0,1,1,0,1
2023-06-01,44532,2,0,2,1,0,1
2023-06-01,44640,3,0,3,3,0,3
2023-06-01,44545,10,0,10,3,0,3
2023-06-01,20609,2,4,6,3,2,3
2023-06-01,44571,4,0,4,1,0,1
2023-06-01,44615,4,0,4,2,0,2
2023-06-01,44634,2,0,2,2,0,2
2023-06-01,44584,1,0,1,1,0,1
2023-06-01,44621,4,0,4,2,0,2
2023-06-01,200909,1,0,1,1,0,1
2023-06-01,44638,1,0,1,1,0,1
2023-06-01,13032,3,0,3,4,0,4
2023-06-01,44686,3,0,3,2,0,2
2023-06-01,44671,3,1,4,3,1,3
2023-06-01,42323,3,0,3,1,0,1
2023-06-01,44674,1,0,1,2,0,2
2023-06-01,197966,1,0,1,1,0,1
2023-06-01,44746,4,1,5,4,2,4
2023-06-01,9122,2,0,2,2,0,2
2023-06-01,57153,1,0,1,3,0,3
2023-06-01,61311,2,0,2,2,0,2
2023-06-01,44759,1,0,1,1,0,1
2023-06-01,44715,1,0,1,1,0,1
2023-06-01,210439,4,0,4,1,0,1
2023-06-01,44773,5,0,5,1,0,1
2023-06-01,44824,1,0,1,1,0,1
2023-06-01,35787,5,0,5,7,0,7
2023-06-01,48312,7,0,7,6,0,6
2023-06-01,44745,4,0,4,2,0,2
2023-06-01,47344,5,0,5,1,0,1
2023-06-01,44820,2,0,2,1,0,1
2023-06-01,44827,22,0,22,3,0,3
2023-06-01,44929,1,0,1,1,0,1
2023-06-01,44850,4,0,4,4,0,4
2023-06-01,44847,1,0,1,1,0,1
2023-06-01,44878,1,0,1,1,0,1
2023-06-01,34402,15,0,15,3,0,3
2023-06-01,44934,2,1,3,1,1,1
2023-06-01,51781,1,0,1,3,0,3
2023-06-01,203347,1,0,1,6,0,6
2023-06-01,51418,1,0,1,2,0,2
2023-06-01,25183,2,0,2,1,0,1
2023-06-01,3163,8,0,8,1,0,1
2023-06-01,45044,1,0,1,2,0,2
2023-06-01,45045,2,1,3,2,1,2
2023-06-01,51146,1,0,1,1,0,1
2023-06-01,47283,6,0,6,7,0,7
2023-06-01,47124,3,0,3,1,0,1
2023-06-01,41064,2,1,3,2,2,2
2023-06-01,202994,1,0,1,4,0,4
2023-06-01,57239,2,0,2,4,0,4
2023-06-01,47210,1,0,1,1,0,1
2023-06-01,205161,1,0,1,4,0,4
2023-06-01,204991,1,0,1,2,0,2
2023-06-01,49089,1,0,1,2,0,2
2023-06-01,62204,2,0,2,1,0,1
2023-06-01,47335,1,0,1,2,0,2
2023-06-01,47250,1,0,1,1,0,1
2023-06-01,47287,2,0,2,1,0,1
2023-06-01,31371,3,2,5,3,1,3
2023-06-01,203660,4,1,5,5,3,5
2023-06-01,47261,1,0,1,2,0,2
2023-06-01,47266,2,1,3,1,1,1
2023-06-01,202176,2,0,2,2,0,2
2023-06-01,47363,2,0,2,3,0,3
2023-06-01,47371,1,0,1,3,0,3
2023-06-01,47333,1,0,1,3,0,3
2023-06-01,139853,7,7,14,4,4,4
2023-06-01,203593,19,1,20,8,4,8
2023-06-01,207946,1,1,2,2,1,2
2023-06-01,208116,1,0,1,1,0,1
2023-06-01,47361,1,0,1,3,0,3
2023-06-01,41930,3,0,3,4,0,4
2023-06-01,47378,5,0,5,1,0,1
2023-06-01,208194,1,0,1,1,0,1
2023-06-01,47465,1,0,1,2,0,2
2023-06-01,42765,4,0,4,3,0,3
2023-06-01,206314,7,0,7,4,0,4
2023-06-01,34395,5,0,5,1,0,1
2023-06-01,41554,4,0,4,1,0,1
2023-06-01,209480,2,1,3,1,1,1
2023-06-01,47535,2,0,2,1,0,1
2023-06-01,48151,5,1,6,3,3,3
2023-06-01,198367,5,0,5,6,0,6
2023-06-01,47564,6,0,6,1,0,1
2023-06-01,47830,1,0,1,1,0,1
2023-06-01,212115,3,0,3,1,0,1
2023-06-01,42136,5,1,6,1,1,1
2023-06-01,47752,3,1,4,1,2,3
2023-06-01,47654,12,0,12,1,0,1
2023-06-01,47635,2,0,2,1,0,1
2023-06-01,206882,8,0,8,1,0,1
2023-06-01,47682,1,1,2,3,2,3
2023-06-01,60809,2,0,2,3,0,3
2023-06-01,47733,2,0,2,1,0,1
2023-06-01,6833,3,1,4,2,2,2
2023-06-01,50824,1,0,1,3,0,3
2023-06-01,62298,1,1,2,2,1,2
2023-06-01,207582,6,0,6,2,0,2
2023-06-01,47782,19,0,19,1,0,1
2023-06-01,47789,1,0,1,1,0,1
2023-06-01,35721,3,0,3,2,0,2
2023-06-01,50964,7,0,7,3,0,3
2023-06-01,47839,4,0,4,1,0,1
2023-06-01,47850,1,0,1,2,0,2
2023-06-01,203488,4,1,5,1,1,1
2023-06-01,210310,2,0,2,1,0,1
2023-06-01,47820,16,1,17,7,2,7
2023-06-01,47873,6,0,6,1,0,1
2023-06-01,211645,1,0,1,1,0,1
2023-06-01,48008,12,0,12,1,0,1
2023-06-01,47923,3,0,3,5,0,5
2023-06-01,31052,2,0,2,2,0,2
2023-06-01,203326,3,0,3,1,0,1
2023-06-01,207307,1,1,2,2,2,2
2023-06-01,51880,4,0,4,3,0,3
2023-06-01,51811,4,0,4,6,0,6
2023-06-01,57562,9,0,9,1,0,1
2023-06-01,198759,1,1,2,3,2,3
2023-06-01,199059,1,0,1,1,0,1
2023-06-01,39344,3,0,3,1,0,1
2023-06-01,204267,1,0,1,2,0,2
2023-06-01,212898,1,0,1,2,0,2
2023-06-01,51730,1,0,1,1,0,1
2023-06-01,48006,2,0,2,2,0,2
2023-06-01,47996,1,0,1,1,0,1
2023-06-01,212862,3,0,3,1,0,1
2023-06-01,211046,1,0,1,1,0,1
2023-06-01,28734,1,1,2,3,1,3
2023-06-01,213158,1,1,2,2,1,2
2023-06-01,48043,5,9,14,4,2,4
2023-06-01,50743,4,0,4,2,0,2
2023-06-01,41751,1,0,1,1,0,1
2023-06-01,43380,3,3,6,6,4,6
2023-06-01,29074,7,0,7,3,0,3
2023-06-01,47695,1,0,1,2,0,2
2023-06-01,47375,1,0,1,3,0,3
2023-06-01,47557,3,1,4,1,1,1
2023-06-01,20842,14,0,14,3,0,3
2023-06-01,47399,1,0,1,1,0,1
2023-06-01,47302,4,2,6,3,3,3
2023-06-01,60052,1,0,1,3,0,3
2023-06-01,47405,1,1,2,2,1,2
2023-06-01,20889,2,0,2,3,0,3
2023-06-01,47390,3,0,3,1,0,1
2023-06-01,47412,2,0,2,2,0,2
2023-06-01,197138,1,0,1,1,0,1
2023-06-01,47439,3,0,3,1,0,1
2023-06-01,47470,3,0,3,5,0,5
2023-06-01,57501,1,0,1,1,0,1
2023-06-01,206138,2,1,3,1,1,1
2023-06-01,47456,3,0,3,2,0,2
2023-06-01,212011,1,0,1,2,0,2
2023-06-01,24602,2,0,2,2,0,2
2023-06-01,47495,2,0,2,1,0,1
2023-06-01,47511,1,0,1,1,0,1
2023-06-01,15580,36,1,37,10,1,10
2023-06-01,203584,4,0,4,1,0,1
2023-06-01,47613,1,1,2,1,2,2
2023-06-01,198163,1,0,1,3,0,3
2023-06-01,196849,1,0,1,3,0,3
2023-06-01,62178,12,1,13,3,1,3
2023-06-01,41959,10,0,10,5,0,5
2023-06-01,25068,3,1,4,6,5,8
2023-06-01,44704,3,0,3,2,0,2
2023-06-01,44825,3,0,3,2,0,2
2023-06-01,15532,2,6,8,1,1,1
2023-06-01,212028,3,0,3,2,0,2
2023-06-01,41223,1,0,1,3,0,3
2023-06-01,42056,2,0,2,1,0,1
2023-06-01,58099,1,0,1,2,0,2
2023-06-01,47590,1,0,1,1,0,1
2023-06-01,211530,2,0,2,1,0,1
2023-06-01,47609,1,1,2,3,1,4
2023-06-01,47624,2,0,2,1,0,1
2023-06-01,47652,1,0,1,2,0,2
2023-06-01,47656,4,0,4,5,0,5
2023-06-01,47657,2,0,2,3,0,3
2023-06-01,50767,9,0,9,9,0,9
2023-06-01,64441,2,0,2,1,0,1
2023-06-01,207523,1,0,1,2,0,2
2023-06-01,202497,6,0,6,1,0,1
2023-06-01,202404,1,0,1,2,0,2
2023-06-01,47698,4,1,5,2,1,2
2023-06-01,47625,6,0,6,1,0,1
2023-06-01,49957,4,0,4,1,0,1
2023-06-01,207481,2,1,3,1,1,1
2023-06-01,39867,3,0,3,2,0,2
2023-06-01,50448,4,1,5,6,1,6
2023-06-01,47835,2,0,2,2,0,2
2023-06-01,47792,1,0,1,2,0,2
2023-06-01,47790,10,0,10,5,0,5
2023-06-01,197175,12,0,12,1,0,1
2023-06-01,47808,1,0,1,1,0,1
2023-06-01,206027,1,0,1,1,0,1
2023-06-01,47809,0,0,0,7,0,7
2023-06-01,47804,1,0,1,1,0,1
2023-06-01,42787,2,0,2,4,0,4
2023-06-01,47827,1,0,1,2,0,2
2023-06-01,44633,2,0,2,1,0,1
2023-06-01,58294,2,0,2,1,0,1
2023-06-01,207606,4,1,5,6,1,6
2023-06-01,47851,1,0,1,2,0,2
2023-06-01,47854,1,0,1,1,0,1
2023-06-01,47884,1,0,1,4,0,4
2023-06-01,47955,5,0,5,5,0,5
2023-06-01,47861,1,0,1,1,0,1
2023-06-01,47916,1,0,1,2,0,2
2023-06-01,43912,1,0,1,2,0,2
2023-06-01,200496,1,0,1,2,0,2
2023-06-01,48047,1,0,1,2,0,2
2023-06-01,48344,8,1,9,2,1,2
2023-06-01,24711,2,1,3,3,1,3
2023-06-01,51577,2,0,2,7,0,7
2023-06-01,47948,1,0,1,2,0,2
2023-06-01,47984,1,0,1,1,0,1
2023-06-01,39819,2,0,2,2,0,2
2023-06-01,29041,1,0,1,2,0,2
2023-06-01,200875,1,0,1,1,0,1
2023-06-01,203644,6,0,6,1,0,1
2023-06-01,42475,7,0,7,5,0,5
2023-06-01,47961,2,0,2,4,0,4
2023-06-01,50845,6,0,6,2,0,2
2023-06-01,47999,1,1,2,7,2,7
2023-06-01,47974,2,0,2,2,0,2
2023-06-01,24578,1,0,1,1,0,1
2023-06-01,48010,1,0,1,1,0,1
2023-06-01,48061,4,1,5,5,2,6
2023-06-01,48015,3,0,3,2,0,2
2023-06-01,48019,2,0,2,1,0,1
2023-06-01,48742,2,0,2,4,0,4
2023-06-01,48073,2,0,2,1,0,1
2023-06-01,48041,1,0,1,2,0,2
2023-06-01,202801,1,0,1,3,0,3
2023-06-01,48058,2,0,2,2,0,2
2023-06-01,48081,4,0,4,1,0,1
2023-06-01,205209,3,0,3,14,0,14
2023-06-01,48068,3,0,3,1,0,1
2023-06-01,208090,1,0,1,1,0,1
2023-06-01,49193,3,0,3,2,0,2
2023-06-01,211666,1,1,2,1,1,1
2023-06-01,48086,1,0,1,1,0,1
2023-06-01,35381,1,0,1,1,0,1
2023-06-01,25000,4,0,4,1,0,1
2023-06-01,57984,1,1,2,1,1,1
2023-06-01,48127,1,0,1,1,0,1
2023-06-01,48119,3,0,3,1,0,1
2023-06-01,48132,2,1,3,2,2,2
2023-06-01,25581,5,1,6,3,3,3
2023-06-01,48143,4,0,4,4,0,4
2023-06-01,51241,7,0,7,3,0,3
2023-06-01,48311,1,0,1,2,0,2
2023-06-01,207186,2,2,4,2,3,3
2023-06-01,204906,1,0,1,5,0,5
2023-06-01,48208,2,0,2,4,0,4
2023-06-01,48242,1,0,1,2,0,2
2023-06-01,21150,18,1,19,9,5,9
2023-06-01,57643,7,0,7,2,0,2
2023-06-01,211073,3,1,4,1,1,1
2023-06-01,59622,3,1,4,1,2,2
2023-06-01,203821,3,0,3,2,0,2
2023-06-01,33868,3,1,4,1,1,1
2023-06-01,15992,1,0,1,2,0,2
2023-06-01,47567,1,0,1,3,0,3
2023-06-01,24865,1,0,1,3,0,3
2023-06-01,33071,1,1,2,8,5,8
2023-06-01,48523,2,0,2,2,0,2
2023-06-01,60464,3,0,3,1,0,1
2023-06-01,205206,3,1,4,8,6,10
2023-06-01,49266,1,0,1,1,0,1
2023-06-01,43337,2,0,2,1,0,1
2023-06-01,48409,1,1,2,2,2,2
2023-06-01,43290,2,0,2,1,0,1
2023-06-01,48411,1,0,1,1,0,1
2023-06-01,48429,3,0,3,1,0,1
2023-06-01,207114,1,0,1,3,0,3
2023-06-01,48442,2,0,2,2,0,2
2023-06-01,33879,1,0,1,1,0,1
2023-06-01,5381,1,0,1,1,0,1
2023-06-01,47520,1,0,1,1,0,1
2023-06-01,47534,1,0,1,2,0,2
2023-06-01,47525,1,0,1,1,0,1
2023-06-01,47545,1,1,2,3,1,3
2023-06-01,47819,1,0,1,3,0,3
2023-06-01,47664,1,0,1,1,0,1
2023-06-01,39632,1,0,1,2,0,2
2023-06-01,39187,1,0,1,1,0,1
2023-06-01,44468,5,0,5,2,0,2
2023-06-01,41975,1,0,1,3,0,3
2023-06-01,47668,1,0,1,1,0,1
2023-06-01,42826,1,0,1,2,0,2
2023-06-01,47577,1,0,1,1,0,1
2023-06-01,50101,1,1,2,4,2,4
2023-06-01,43401,1,0,1,1,0,1
2023-06-01,48248,1,0,1,3,0,3
2023-06-01,48339,5,1,6,7,1,7
2023-06-01,48380,1,0,1,2,0,2
2023-06-01,213358,3,1,4,2,1,2
2023-06-01,62324,1,0,1,1,0,1
2023-06-01,47633,1,0,1,1,0,1
2023-06-01,47639,1,1,2,1,1,1
2023-06-01,47649,1,0,1,2,0,2
2023-06-01,47418,2,0,2,4,0,4
2023-06-01,47665,1,0,1,1,0,1
2023-06-01,202932,4,2,6,13,9,15
2023-06-01,20769,1,1,2,3,1,3
2023-06-01,47676,1,0,1,1,0,1
2023-06-01,47666,1,0,1,3,0,3
2023-06-01,47672,3,0,3,4,0,4
2023-06-01,47743,1,0,1,3,0,3
2023-06-01,212397,1,1,2,6,2,6
2023-06-01,47760,1,0,1,1,0,1
2023-06-01,47705,1,0,1,5,0,5
2023-06-01,62156,5,2,7,1,1,1
2023-06-01,205774,3,0,3,2,0,2
2023-06-01,41505,1,0,1,1,0,1
2023-06-01,47700,1,0,1,1,0,1
2023-06-01,209003,1,0,1,2,0,2
2023-06-01,41038,5,3,8,5,4,5
2023-06-01,35735,1,0,1,1,0,1
2023-06-01,47744,1,0,1,1,0,1
2023-06-01,47800,3,0,3,1,0,1
2023-06-01,47731,1,0,1,2,0,2
2023-06-01,47740,1,0,1,5,0,5
2023-06-01,56514,0,0,0,2,0,2
2023-06-01,35626,1,0,1,3,0,3
2023-06-01,15889,2,0,2,2,0,2
2023-06-01,47763,1,0,1,4,0,4
2023-06-01,47770,1,0,1,1,0,1
2023-06-01,8588,1,0,1,1,0,1
2023-06-01,47758,1,0,1,1,0,1
2023-06-01,44666,1,0,1,1,0,1
2023-06-01,47799,1,0,1,1,0,1
2023-06-01,47766,1,0,1,2,0,2
2023-06-01,47765,1,0,1,1,0,1
2023-06-01,47810,4,1,5,2,2,2
2023-06-01,47772,1,0,1,3,0,3
2023-06-01,49310,1,0,1,2,0,2
2023-06-01,47876,2,0,2,2,0,2
2023-06-01,47788,1,0,1,1,0,1
2023-06-01,47811,1,0,1,1,0,1
2023-06-01,2861,2,0,2,2,0,2
2023-06-01,47805,4,3,7,4,1,4
2023-06-01,50652,1,0,1,3,0,3
2023-06-01,47817,1,0,1,1,0,1
2023-06-01,47993,1,0,1,3,0,3
2023-06-01,47858,1,0,1,2,0,2
2023-06-01,199215,1,1,2,1,1,1
2023-06-01,47836,2,1,3,11,5,13
2023-06-01,47848,1,0,1,1,0,1
2023-06-01,39002,1,0,1,1,0,1
2023-06-01,47841,3,1,4,5,4,5
2023-06-01,47842,1,0,1,2,0,2
2023-06-01,47852,1,0,1,3,0,3
2023-06-01,47888,2,0,2,3,0,3
2023-06-01,203046,1,0,1,3,0,3
2023-06-01,47900,1,0,1,1,0,1
2023-06-01,47912,1,0,1,1,0,1
2023-06-01,47919,1,0,1,4,0,4
2023-06-01,47903,1,0,1,1,0,1
2023-06-01,47925,1,0,1,2,0,2
2023-06-01,138398,6,6,12,11,3,11
2023-06-01,44334,2,1,3,5,5,5
2023-06-01,48069,1,1,2,1,1,1
2023-06-01,30972,5,3,8,8,7,8
2023-06-01,47972,1,0,1,3,0,3
2023-06-01,59943,18,2,20,1,1,1
2023-06-01,47958,1,0,1,2,0,2
2023-06-01,47976,1,0,1,2,0,2
2023-06-01,25237,3,0,3,4,0,4
2023-06-01,47494,2,0,2,2,0,2
2023-06-01,31734,1,0,1,1,0,1
2023-06-01,47980,1,0,1,1,0,1
2023-06-01,48016,2,0,2,1,0,1
2023-06-01,209027,2,0,2,2,0,2
2023-06-01,47977,1,0,1,1,0,1
2023-06-01,51387,1,0,1,1,0,1
2023-06-01,47991,1,0,1,3,0,3
2023-06-01,48017,1,0,1,2,0,2
2023-06-01,56565,4,0,4,4,0,4
2023-06-01,48003,1,0,1,2,0,2
2023-06-01,200660,2,0,2,1,0,1
2023-06-01,48033,1,0,1,3,0,3
2023-06-01,48023,1,0,1,1,0,1
2023-06-01,8587,9,3,12,7,6,9
2023-06-01,48032,1,0,1,3,0,3
2023-06-01,48059,1,0,1,1,0,1
2023-06-01,60396,1,1,2,1,1,1
2023-06-01,208842,1,0,1,1,0,1
2023-06-01,51709,1,0,1,2,0,2
2023-06-01,48115,3,0,3,3,0,3
2023-06-01,58107,1,0,1,2,0,2
2023-06-01,47941,1,0,1,1,0,1
2023-06-01,48094,8,0,8,4,0,4
2023-06-01,212073,1,2,3,1,2,2
2023-06-01,48104,1,0,1,3,0,3
2023-06-01,8558,1,0,1,2,0,2
2023-06-01,48134,1,0,1,2,0,2
2023-06-01,57723,4,2,6,12,2,12
2023-06-01,48183,5,0,5,2,0,2
2023-06-01,48114,1,0,1,2,0,2
2023-06-01,48140,3,0,3,2,0,2
2023-06-01,48189,1,0,1,3,0,3
2023-06-01,48138,1,0,1,2,0,2
2023-06-01,48144,1,1,2,1,1,1
2023-06-01,48353,1,0,1,2,0,2
2023-06-01,43311,5,0,5,3,0,3
2023-06-01,48217,2,0,2,2,0,2
2023-06-01,62121,7,2,9,1,1,1
2023-06-01,39673,3,1,4,1,1,1
2023-06-01,48153,1,0,1,2,0,2
2023-06-01,48167,1,0,1,2,0,2
2023-06-01,48653,1,0,1,1,0,1
2023-06-01,48258,2,1,3,2,1,2
2023-06-01,48195,1,0,1,1,0,1
2023-06-01,21344,4,1,5,7,3,7
2023-06-01,205036,1,3,4,1,4,4
2023-06-01,56460,3,0,3,7,0,7
2023-06-01,57850,1,0,1,1,0,1
2023-06-01,48865,1,0,1,3,0,3
2023-06-01,48230,3,0,3,2,0,2
2023-06-01,29476,1,0,1,2,0,2
2023-06-01,48247,1,0,1,2,0,2
2023-06-01,47677,1,0,1,2,0,2
2023-06-01,48255,1,0,1,1,0,1
2023-06-01,34336,1,0,1,4,0,4
2023-06-01,48770,3,0,3,2,0,2
2023-06-01,48488,1,0,1,4,0,4
2023-06-01,211000,2,1,3,3,1,3
2023-06-01,38921,1,0,1,1,0,1
2023-06-01,48405,1,0,1,1,0,1
2023-06-01,211430,1,0,1,3,0,3
2023-06-01,48342,1,0,1,2,0,2
2023-06-01,48341,1,0,1,1,0,1
2023-06-01,48332,1,0,1,1,0,1
2023-06-01,57744,1,0,1,1,0,1
2023-06-01,52018,1,0,1,2,0,2
2023-06-01,43048,6,1,7,5,3,5
2023-06-01,33933,3,0,3,3,0,3
2023-06-01,48572,2,1,3,1,1,1
2023-06-01,48349,3,0,3,5,0,5
2023-06-01,13011,1,0,1,2,0,2
2023-06-01,48366,12,0,12,3,0,3
2023-06-01,48377,1,0,1,2,0,2
2023-06-01,48370,2,0,2,5,0,5
2023-06-01,48393,1,0,1,2,0,2
2023-06-01,48388,1,0,1,3,0,3
2023-06-01,48468,2,0,2,3,0,3
2023-06-01,48372,1,0,1,1,0,1
2023-06-01,48385,3,0,3,2,0,2
2023-06-01,48395,1,1,2,2,1,2
2023-06-01,207120,2,0,2,1,0,1
2023-06-01,212659,1,1,2,4,1,4
2023-06-01,48398,1,0,1,2,0,2
2023-06-01,44201,1,0,1,3,0,3
2023-06-01,48396,1,0,1,3,0,3
2023-06-01,202802,1,0,1,2,0,2
2023-06-01,48419,1,0,1,3,0,3
2023-06-01,48428,2,0,2,5,0,5
2023-06-01,41253,1,0,1,2,0,2
2023-06-01,198141,1,1,2,3,3,3
2023-06-01,48420,2,0,2,1,0,1
2023-06-01,20570,13,1,14,2,1,2
2023-06-01,208124,2,0,2,1,0,1
2023-06-01,199098,9,0,9,1,0,1
2023-06-01,48482,3,0,3,2,0,2
2023-06-01,48489,1,0,1,1,0,1
2023-06-01,48490,1,0,1,2,0,2
2023-06-01,48516,1,0,1,2,0,2
2023-06-01,197209,2,1,3,4,1,4
2023-06-01,20691,1,0,1,1,0,1
2023-06-01,198452,2,0,2,1,0,1
2023-06-01,47127,2,1,3,5,4,5
2023-06-01,48617,1,0,1,1,0,1
2023-06-01,48593,1,0,1,2,0,2
2023-06-01,48616,1,0,1,1,0,1
2023-06-01,34284,5,0,5,4,0,4
2023-06-01,50362,4,1,5,3,2,3
2023-06-01,48609,1,0,1,2,0,2
2023-06-01,48656,1,0,1,2,0,2
2023-06-01,35120,2,0,2,1,0,1
2023-06-01,50399,25,7,32,3,3,3
2023-06-01,48637,1,0,1,2,0,2
2023-06-01,48621,1,0,1,1,0,1
2023-06-01,48632,1,0,1,1,0,1
2023-06-01,48636,1,0,1,1,0,1
2023-06-01,48633,1,0,1,1,0,1
2023-06-01,197122,1,0,1,1,0,1
2023-06-01,207857,4,0,4,1,0,1
2023-06-01,202568,5,0,5,3,0,3
2023-06-01,48657,1,0,1,1,0,1
2023-06-01,51780,1,0,1,2,0,2
2023-06-01,48665,1,0,1,1,0,1
2023-06-01,213345,1,0,1,2,0,2
2023-06-01,31687,1,0,1,2,0,2
2023-06-01,48672,1,0,1,3,0,3
2023-06-01,48736,1,0,1,1,0,1
2023-06-01,48868,1,0,1,2,0,2
2023-06-01,48686,1,1,2,1,1,1
2023-06-01,48706,1,0,1,1,0,1
2023-06-01,48701,1,0,1,2,0,2
2023-06-01,196632,1,0,1,2,0,2
2023-06-01,39380,1,0,1,2,0,2
2023-06-01,41427,6,1,7,6,2,6
2023-06-01,51733,8,0,8,2,0,2
2023-06-01,42934,1,0,1,1,0,1
2023-06-01,48013,1,0,1,1,0,1
2023-06-01,48102,1,0,1,4,0,4
2023-06-01,47245,10,0,10,1,0,1
2023-06-01,48078,15,0,15,3,0,3
2023-06-01,48085,4,0,4,3,0,3
2023-06-01,212050,3,0,3,2,0,2
2023-06-01,25538,3,1,4,1,1,1
2023-06-01,48155,1,1,2,4,2,4
2023-06-01,57209,2,0,2,2,0,2
2023-06-01,50712,3,0,3,1,0,1
2023-06-01,49012,5,0,5,3,0,3
2023-06-01,20919,10,0,10,9,0,9
2023-06-01,48243,5,0,5,6,0,6
2023-06-01,203447,5,1,6,7,2,7
2023-06-01,57040,1,1,2,1,1,1
2023-06-01,44279,2,0,2,2,0,2
2023-06-01,44943,3,1,4,7,2,7
2023-06-01,48241,1,0,1,1,0,1
2023-06-01,48265,20,0,20,3,0,3
2023-06-01,34990,6,0,6,1,0,1
2023-06-01,207853,1,2,3,3,3,4
2023-06-01,57780,1,1,2,3,3,4
2023-06-01,200134,7,0,7,1,0,1
2023-06-01,51024,1,0,1,1,0,1
2023-06-01,21087,4,0,4,1,0,1
2023-06-01,48316,4,0,4,2,0,2
2023-06-01,42608,3,1,4,2,2,2
2023-06-01,48369,4,0,4,3,0,3
2023-06-01,48354,2,0,2,3,0,3
2023-06-01,47236,39,0,39,8,0,8
2023-06-01,208788,1,0,1,1,0,1
2023-06-01,48367,2,0,2,1,0,1
2023-06-01,51060,5,0,5,8,0,8
2023-06-01,207771,1,0,1,1,0,1
2023-06-01,203765,5,1,6,5,2,5
2023-06-01,201793,1,0,1,1,0,1
2023-06-01,41835,2,0,2,3,0,3
2023-06-01,213016,1,0,1,2,0,2
2023-06-01,213011,3,0,3,3,0,3
2023-06-01,212903,2,0,2,1,0,1
2023-06-01,59584,3,1,4,4,4,4
2023-06-01,208552,3,0,3,1,0,1
2023-06-01,48476,3,0,3,1,0,1
2023-06-01,48498,1,0,1,2,0,2
2023-06-01,48480,10,0,10,2,0,2
2023-06-01,48494,2,0,2,2,0,2
2023-06-01,48507,10,0,10,3,0,3
2023-06-01,48515,2,0,2,2,0,2
2023-06-01,39043,4,0,4,1,0,1
2023-06-01,48536,7,0,7,1,0,1
2023-06-01,34494,1,0,1,1,0,1
2023-06-01,48654,1,0,1,1,0,1
2023-06-01,48587,4,0,4,2,0,2
2023-06-01,210975,1,0,1,1,0,1
2023-06-01,49340,1,1,2,3,2,3
2023-06-01,48634,5,0,5,5,0,5
2023-06-01,12565,1,0,1,2,0,2
2023-06-01,48676,4,0,4,2,0,2
2023-06-01,48679,4,0,4,1,0,1
2023-06-01,48698,4,0,4,1,0,1
2023-06-01,48719,2,0,2,4,0,4
2023-06-01,39566,2,1,3,3,5,5
2023-06-01,42269,1,0,1,1,0,1
2023-06-01,13172,5,2,7,7,1,7
2023-06-01,61053,16,1,17,4,3,4
2023-06-01,31129,5,0,5,4,0,4
2023-06-01,207332,1,0,1,1,0,1
2023-06-01,48740,1,0,1,2,0,2
2023-06-01,41218,1,0,1,1,0,1
2023-06-01,39689,1,0,1,1,0,1
2023-06-01,196649,1,0,1,1,0,1
2023-06-01,42100,1,0,1,2,0,2
2023-06-01,43084,1,0,1,1,0,1
2023-06-01,48762,1,0,1,1,0,1
2023-06-01,48745,1,0,1,2,0,2
2023-06-01,48750,1,0,1,2,0,2
2023-06-01,48756,1,0,1,2,0,2
2023-06-01,48754,1,0,1,2,0,2
2023-06-01,60215,1,0,1,1,0,1
2023-06-01,201953,2,1,3,3,2,4
2023-06-01,48766,1,0,1,3,0,3
2023-06-01,48782,1,0,1,2,0,2
2023-06-01,35225,1,0,1,2,0,2
2023-06-01,58033,3,0,3,3,0,3
2023-06-01,48783,1,0,1,1,0,1
2023-06-01,48786,1,0,1,3,0,3
2023-06-01,48805,1,0,1,3,0,3
2023-06-01,48746,1,0,1,1,0,1
2023-06-01,48794,1,0,1,1,0,1
2023-06-01,48906,1,0,1,2,0,2
2023-06-01,48802,1,0,1,1,0,1
2023-06-01,48816,1,0,1,1,0,1
2023-06-01,48845,2,0,2,1,0,1
2023-06-01,48827,1,0,1,2,0,2
2023-06-01,48855,1,0,1,1,0,1
2023-06-01,48842,3,0,3,2,0,2
2023-06-01,48867,1,0,1,2,0,2
2023-06-01,48837,2,0,2,2,0,2
2023-06-01,39406,2,0,2,1,0,1
2023-06-01,49167,3,1,4,1,1,2
2023-06-01,48843,1,0,1,2,0,2
2023-06-01,48849,2,1,3,2,2,2
2023-06-01,43739,1,0,1,2,0,2
2023-06-01,51004,31,1,32,6,1,6
2023-06-01,196721,2,0,2,2,0,2
2023-06-01,35115,6,0,6,5,0,5
2023-06-01,31010,1,1,2,1,1,2
2023-06-01,48963,1,0,1,2,0,2
2023-06-01,196731,1,0,1,1,0,1
2023-06-01,48979,3,0,3,1,0,1
2023-06-01,212986,1,1,2,1,1,1
2023-06-01,49248,1,1,2,2,1,2
2023-06-01,61048,2,0,2,1,0,1
2023-06-01,49049,1,0,1,1,0,1
2023-06-01,56967,1,0,1,1,0,1
2023-06-01,49076,1,0,1,1,0,1
2023-06-01,49793,1,1,2,1,1,1
2023-06-01,49068,1,0,1,1,0,1
2023-06-01,49208,2,0,2,2,0,2
2023-06-01,49230,2,0,2,1,0,1
2023-06-01,49511,1,0,1,2,0,2
2023-06-01,196627,1,0,1,1,0,1
2023-06-01,56180,1,0,1,1,0,1
2023-06-01,49108,1,0,1,4,0,4
2023-06-01,49853,1,0,1,1,0,1
2023-06-01,199217,1,0,1,1,0,1
2023-06-01,49347,1,0,1,2,0,2
2023-06-01,49123,1,0,1,1,0,1
2023-06-01,41163,3,1,4,3,2,3
2023-06-01,49128,1,0,1,3,0,3
2023-06-01,49139,1,0,1,1,0,1
2023-06-01,49141,1,0,1,2,0,2
2023-06-01,212148,5,3,8,3,3,3
2023-06-01,49152,3,0,3,1,0,1
2023-06-01,3200,2,0,2,2,0,2
2023-06-01,49197,1,0,1,2,0,2
2023-06-01,49616,1,0,1,1,0,1
2023-06-01,49288,2,0,2,1,0,1
2023-06-01,49213,1,0,1,3,0,3
2023-06-01,49224,1,0,1,1,0,1
2023-06-01,49212,1,0,1,2,0,2
2023-06-01,12945,2,1,3,3,2,4
2023-06-01,49306,1,0,1,1,0,1
2023-06-01,49672,1,0,1,1,0,1
2023-06-01,49246,5,0,5,3,0,3
2023-06-01,203717,1,0,1,1,0,1
2023-06-01,49303,1,0,1,2,0,2
2023-06-01,49308,1,0,1,3,0,3
2023-06-01,49270,1,0,1,1,0,1
2023-06-01,42057,1,0,1,2,0,2
2023-06-01,213006,7,0,7,1,0,1
2023-06-01,49983,3,1,4,3,3,4
2023-06-01,49279,1,0,1,2,0,2
2023-06-01,196772,1,0,1,2,0,2
2023-06-01,21094,2,0,2,2,0,2
2023-06-01,49328,1,0,1,2,0,2
2023-06-01,49294,1,0,1,3,0,3
2023-06-01,16115,14,0,14,3,0,3
2023-06-01,196765,1,0,1,3,0,3
2023-06-01,31659,2,0,2,3,0,3
2023-06-01,49359,2,0,2,4,0,4
2023-06-01,49390,1,0,1,1,0,1
2023-06-01,49355,1,0,1,1,0,1
2023-06-01,56948,1,1,2,2,2,2
2023-06-01,49370,2,0,2,3,0,3
2023-06-01,58227,1,0,1,1,0,1
2023-06-01,49379,1,0,1,3,0,3
2023-06-01,49525,1,0,1,3,0,3
2023-06-01,49555,1,0,1,2,0,2
2023-06-01,199749,3,0,3,3,0,3
2023-06-01,49420,2,1,3,8,5,8
2023-06-01,196785,1,0,1,1,0,1
2023-06-01,49431,1,0,1,1,0,1
2023-06-01,64465,1,1,2,1,1,1
2023-06-01,196790,1,0,1,2,0,2
2023-06-01,49437,2,0,2,2,0,2
2023-06-01,196793,2,0,2,2,0,2
2023-06-01,49446,1,0,1,2,0,2
2023-06-01,49452,1,0,1,3,0,3
2023-06-01,41986,2,0,2,2,0,2
2023-06-01,57917,1,0,1,1,0,1
2023-06-01,49566,2,1,3,1,1,2
2023-06-01,49423,2,1,3,2,1,2
2023-06-01,212886,9,1,10,1,1,1
2023-06-01,57689,1,0,1,1,0,1
2023-06-01,49523,2,0,2,3,0,3
2023-06-01,49506,2,0,2,1,0,1
2023-06-01,42970,3,1,4,1,1,1
2023-06-01,196670,5,1,6,2,1,3
2023-06-01,49499,2,0,2,2,0,2
2023-06-01,49638,1,1,2,2,2,2
2023-06-01,49529,6,0,6,1,0,1
2023-06-01,49520,1,0,1,3,0,3
2023-06-01,197481,1,2,3,2,1,2
2023-06-01,49552,1,1,2,1,1,1
2023-06-01,204635,6,6,12,3,2,3
2023-06-01,49564,1,0,1,1,0,1
2023-06-01,49558,4,1,5,2,1,2
2023-06-01,24776,7,1,8,6,4,6
2023-06-01,61188,1,0,1,1,0,1
2023-06-01,49644,1,0,1,2,0,2
2023-06-01,49582,3,0,3,4,0,4
2023-06-01,212151,1,1,2,2,1,2
2023-06-01,51890,4,1,5,2,1,2
2023-06-01,49591,1,0,1,3,0,3
2023-06-01,49595,1,0,1,1,0,1
2023-06-01,49611,1,0,1,2,0,2
2023-06-01,49639,1,1,2,2,2,2
2023-06-01,49622,1,0,1,2,0,2
2023-06-01,41748,2,0,2,3,0,3
2023-06-01,49047,1,0,1,1,0,1
2023-06-01,49645,7,3,10,2,2,2
2023-06-01,49660,1,0,1,1,0,1
2023-06-01,35705,4,0,4,3,0,3
2023-06-01,39634,1,0,1,4,0,4
2023-06-01,49636,1,0,1,2,0,2
2023-06-01,196633,1,0,1,3,0,3
2023-06-01,198565,1,0,1,2,0,2
2023-06-01,209788,7,0,7,2,0,2
2023-06-01,12341,1,0,1,1,0,1
2023-06-01,8380,1,0,1,3,0,3
2023-06-01,15664,1,0,1,3,0,3
2023-06-01,30839,1,0,1,2,0,2
2023-06-01,49662,1,0,1,3,0,3
2023-06-01,8454,1,1,2,1,1,1
2023-06-01,12342,1,0,1,1,0,1
2023-06-01,21317,4,0,4,1,0,1
2023-06-01,196658,3,0,3,3,0,3
2023-06-01,150,3,0,3,1,0,1
2023-06-01,203015,5,1,6,4,1,4
2023-06-01,61127,0,0,0,7,0,7
2023-06-01,49667,1,0,1,1,0,1
2023-06-01,49998,1,0,1,1,0,1
2023-06-01,48559,7,3,10,7,4,8
2023-06-01,20611,1,0,1,1,0,1
2023-06-01,41060,1,0,1,2,0,2
2023-06-01,207284,1,0,1,2,0,2
2023-06-01,21228,5,0,5,1,0,1
2023-06-01,44104,1,0,1,1,0,1
2023-06-01,196677,1,0,1,3,0,3
2023-06-01,196716,1,0,1,1,0,1
2023-06-01,44511,1,1,2,2,1,2
2023-06-01,34085,1,0,1,4,0,4
2023-06-01,42791,1,0,1,2,0,2
2023-06-01,33998,2,0,2,1,0,1
2023-06-01,35060,1,0,1,3,0,3
2023-06-01,15741,1,0,1,1,0,1
2023-06-01,39317,1,0,1,1,0,1
2023-06-01,49799,1,0,1,3,0,3
2023-06-01,35330,6,0,6,2,0,2
2023-06-01,39928,1,0,1,5,0,5
2023-06-01,40989,1,0,1,2,0,2
2023-06-01,196702,1,0,1,3,0,3
2023-06-01,49684,1,1,2,3,2,3
2023-06-01,49670,1,0,1,1,0,1
2023-06-01,43559,4,0,4,2,0,2
2023-06-01,8621,4,1,5,3,1,3
2023-06-01,49905,2,0,2,3,0,3
2023-06-01,49730,1,0,1,3,0,3
2023-06-01,8962,1,0,1,2,0,2
2023-06-01,38970,1,1,2,1,1,1
2023-06-01,49691,1,0,1,3,0,3
2023-06-01,49712,1,0,1,3,0,3
2023-06-01,49731,1,0,1,1,0,1
2023-06-01,49739,1,0,1,3,0,3
2023-06-01,206939,1,1,2,3,1,3
2023-06-01,211269,1,0,1,1,0,1
2023-06-01,211071,1,0,1,3,0,3
2023-06-01,50213,1,1,2,1,1,1
2023-06-01,204061,1,0,1,3,0,3
2023-06-01,49772,1,0,1,2,0,2
2023-06-01,49958,2,0,2,1,0,1
2023-06-01,49812,1,0,1,1,0,1
2023-06-01,35027,3,0,3,3,0,3
2023-06-01,15495,3,1,4,2,1,2
2023-06-01,196668,1,0,1,3,0,3
2023-06-01,203596,14,2,16,8,3,8
2023-06-01,49952,3,0,3,4,0,4
2023-06-01,60382,2,0,2,3,0,3
2023-06-01,34844,3,0,3,7,0,7
2023-06-01,197680,1,0,1,3,0,3
2023-06-01,198706,2,0,2,2,0,2
2023-06-01,21379,6,0,6,10,0,10
2023-06-01,13281,1,0,1,1,0,1
2023-06-01,29061,47,0,47,8,0,8
2023-06-01,196707,1,0,1,2,0,2
2023-06-01,196780,1,0,1,1,0,1
2023-06-01,44730,1,0,1,2,0,2
2023-06-01,39542,8,1,9,2,2,2
2023-06-01,196667,1,0,1,1,0,1
2023-06-01,29363,4,0,4,3,0,3
2023-06-01,49843,1,0,1,1,0,1
2023-06-01,209120,1,0,1,1,0,1
2023-06-01,208274,1,0,1,1,0,1
2023-06-01,208783,1,0,1,1,0,1
2023-06-01,61430,11,6,17,8,3,9
2023-06-01,34154,5,1,6,10,5,10
2023-06-01,49861,2,0,2,4,0,4
2023-06-01,50349,5,0,5,9,0,9
2023-06-01,20705,25,5,30,3,2,3
2023-06-01,49256,3,0,3,4,0,4
2023-06-01,196758,3,0,3,1,0,1
2023-06-01,50783,3,0,3,1,0,1
2023-06-01,60684,4,0,4,4,0,4
2023-06-01,207966,2,0,2,4,0,4
2023-06-01,196767,48,0,48,4,0,4
2023-06-01,49373,3,4,7,1,1,1
2023-06-01,49391,2,0,2,1,0,1
2023-06-01,49498,5,0,5,3,0,3
2023-06-01,43072,18,0,18,1,0,1
2023-06-01,49513,1,0,1,1,0,1
2023-06-01,49080,1,0,1,1,0,1
2023-06-01,49411,1,0,1,2,0,2
2023-06-01,210327,1,0,1,1,0,1
2023-06-01,59492,6,0,6,5,0,5
2023-06-01,48748,3,0,3,2,0,2
2023-06-01,199820,7,0,7,4,0,4
2023-06-01,49481,3,0,3,2,0,2
2023-06-01,44557,4,0,4,1,0,1
2023-06-01,211731,2,1,3,2,2,2
2023-06-01,41238,2,0,2,3,0,3
2023-06-01,205667,1,0,1,2,0,2
2023-06-01,205682,3,0,3,6,0,6
2023-06-01,49502,3,0,3,2,0,2
2023-06-01,49531,66,0,66,6,0,6
2023-06-01,60031,1,0,1,1,0,1
2023-06-01,50742,1,0,1,1,0,1
2023-06-01,49551,2,0,2,1,0,1
2023-06-01,49557,1,0,1,1,0,1
2023-06-01,49589,1,0,1,1,0,1
2023-06-01,48915,4,0,4,5,0,5
2023-06-01,48947,1,0,1,1,0,1
2023-06-01,41153,2,0,2,4,0,4
2023-06-01,49577,2,0,2,2,0,2
2023-06-01,50761,13,0,13,3,0,3
2023-06-01,49578,3,0,3,2,0,2
2023-06-01,49002,5,0,5,3,0,3
2023-06-01,196826,2,0,2,5,0,5
2023-06-01,213138,1,1,2,4,4,5
2023-06-01,202169,6,1,7,2,1,2
2023-06-01,57981,6,0,6,4,0,4
2023-06-01,49617,2,0,2,2,0,2
2023-06-01,201224,3,0,3,1,0,1
2023-06-01,31412,4,0,4,2,0,2
2023-06-01,200593,1,0,1,4,0,4
2023-06-01,201664,1,0,1,2,0,2
2023-06-01,200966,1,0,1,1,0,1
2023-06-01,43407,4,1,5,7,5,9
2023-06-01,60705,1,0,1,6,0,6
2023-06-01,43270,8,0,8,2,0,2
2023-06-01,196685,1,0,1,1,0,1
2023-06-01,41082,13,0,13,5,0,5
2023-06-01,31465,1,0,1,1,0,1
2023-06-01,34612,4,1,5,6,2,6
2023-06-01,41477,8,0,8,7,0,7
2023-06-01,49693,3,0,3,2,0,2
2023-06-01,49701,8,0,8,2,0,2
2023-06-01,196698,1,0,1,1,0,1
2023-06-01,43349,1,0,1,3,0,3
2023-06-01,203473,1,0,1,3,0,3
2023-06-01,196688,1,0,1,1,0,1
2023-06-01,49724,17,0,17,4,0,4
2023-06-01,49722,1,0,1,2,0,2
2023-06-01,196776,6,0,6,5,0,5
2023-06-01,49741,1,0,1,1,0,1
2023-06-01,35631,1,0,1,1,0,1
2023-06-01,50171,3,1,4,2,2,2
2023-06-01,50893,1,0,1,1,0,1
2023-06-01,47922,1,0,1,1,0,1
2023-06-01,197020,1,0,1,2,0,2
2023-06-01,50883,2,0,2,1,0,1
2023-06-01,24819,2,0,2,2,0,2
2023-06-01,50888,1,0,1,1,0,1
2023-06-01,200521,56,3,59,2,1,2
2023-06-01,197027,1,0,1,1,0,1
2023-06-01,197022,1,0,1,1,0,1
2023-06-01,51047,1,0,1,2,0,2
2023-06-01,50906,1,1,2,1,1,1
2023-06-01,50976,1,0,1,2,0,2
2023-06-01,50927,5,0,5,3,0,3
2023-06-01,50905,1,1,2,3,1,3
2023-06-01,196899,1,0,1,2,0,2
2023-06-01,50912,2,0,2,2,0,2
2023-06-01,202763,3,0,3,2,0,2
2023-06-01,206267,3,0,3,4,0,4
2023-06-01,60674,1,1,2,1,2,2
2023-06-01,57265,1,1,2,1,1,1
2023-06-01,196933,2,0,2,2,0,2
2023-06-01,48303,2,1,3,8,1,8
2023-06-01,15870,5,0,5,1,0,1
2023-06-01,199040,1,0,1,2,0,2
2023-06-01,196893,1,0,1,3,0,3
2023-06-01,50951,1,0,1,3,0,3
2023-06-01,50945,1,0,1,2,0,2
2023-06-01,197044,1,0,1,2,0,2
2023-06-01,47904,2,1,3,2,1,2
2023-06-01,50954,2,1,3,1,2,2
2023-06-01,51232,1,0,1,1,0,1
2023-06-01,50981,5,0,5,3,0,3
2023-06-01,51821,3,0,3,2,0,2
2023-06-01,50974,1,0,1,1,0,1
2023-06-01,50988,2,0,2,2,0,2
2023-06-01,197052,1,0,1,1,0,1
2023-06-01,206707,1,0,1,1,0,1
2023-06-01,34563,2,0,2,3,0,3
2023-06-01,48667,3,0,3,2,0,2
2023-06-01,58213,1,0,1,1,0,1
2023-06-01,50984,1,0,1,1,0,1
2023-06-01,201827,1,0,1,2,0,2
2023-06-01,50991,1,0,1,1,0,1
2023-06-01,41666,1,2,3,4,3,4
2023-06-01,50502,1,0,1,2,0,2
2023-06-01,197060,2,0,2,2,0,2
2023-06-01,5435,4,1,5,8,3,8
2023-06-01,196912,1,0,1,1,0,1
2023-06-01,51005,1,0,1,1,0,1
2023-06-01,25594,1,0,1,3,0,3
2023-06-01,31702,1,0,1,1,0,1
2023-06-01,197067,1,0,1,1,0,1
2023-06-01,197069,1,1,2,2,1,2
2023-06-01,56544,3,0,3,1,0,1
2023-06-01,212189,8,0,8,1,0,1
2023-06-01,47099,1,0,1,1,0,1
2023-06-01,39077,2,0,2,1,0,1
2023-06-01,28985,2,0,2,3,0,3
2023-06-01,196967,1,1,2,2,1,2
2023-06-01,208008,2,1,3,3,2,3
2023-06-01,202185,1,0,1,1,0,1
2023-06-01,20577,4,0,4,2,0,2
2023-06-01,51067,1,0,1,2,0,2
2023-06-01,51117,1,0,1,1,0,1
2023-06-01,57302,1,0,1,1,0,1
2023-06-01,51081,1,1,2,1,1,1
2023-06-01,51065,1,0,1,2,0,2
2023-06-01,201318,3,1,4,2,2,2
2023-06-01,51071,1,0,1,1,0,1
2023-06-01,51186,1,0,1,3,0,3
2023-06-01,62344,1,0,1,1,0,1
2023-06-01,51121,3,0,3,3,0,3
2023-06-01,51091,1,1,2,1,1,1
2023-06-01,197104,1,0,1,1,0,1
2023-06-01,51094,1,0,1,2,0,2
2023-06-01,197042,2,0,2,2,0,2
2023-06-01,51096,1,0,1,1,0,1
2023-06-01,12672,5,2,7,2,1,2
2023-06-01,51166,1,0,1,1,0,1
2023-06-01,197109,1,0,1,1,0,1
2023-06-01,51108,1,0,1,3,0,3
2023-06-01,197111,1,0,1,2,0,2
2023-06-01,51122,1,0,1,1,0,1
2023-06-01,51181,1,0,1,1,0,1
2023-06-01,51141,1,0,1,2,0,2
2023-06-01,13174,6,0,6,1,0,1
2023-06-01,51134,4,2,6,5,1,5
2023-06-01,31704,1,0,1,1,0,1
2023-06-01,205134,1,0,1,1,0,1
2023-06-01,51143,1,1,2,2,2,2
2023-06-01,51157,1,0,1,1,0,1
2023-06-01,197055,1,0,1,3,0,3
2023-06-01,51165,1,0,1,2,0,2
2023-06-01,51160,1,0,1,1,0,1
2023-06-01,51179,1,0,1,1,0,1
2023-06-01,51183,1,0,1,3,0,3
2023-06-01,48822,2,1,3,7,3,7
2023-06-01,51192,2,0,2,1,0,1
2023-06-01,198014,1,0,1,1,0,1
2023-06-01,51318,4,0,4,3,0,3
2023-06-01,59415,3,0,3,3,0,3
2023-06-01,12516,2,0,2,5,0,5
2023-06-01,205582,4,1,5,4,3,4
2023-06-01,51193,3,0,3,3,0,3
2023-06-01,51195,1,0,1,1,0,1
2023-06-01,197130,1,0,1,1,0,1
2023-06-01,197135,1,0,1,1,0,1
2023-06-01,51208,1,0,1,1,0,1
2023-06-01,52002,1,0,1,2,0,2
2023-06-01,13273,33,0,33,3,0,3
2023-06-01,51256,1,0,1,1,0,1
2023-06-01,197181,2,0,2,4,0,4
2023-06-01,197224,1,0,1,1,0,1
2023-06-01,51224,3,1,4,2,3,3
2023-06-01,50335,2,0,2,1,0,1
2023-06-01,3232,5,0,5,1,0,1
2023-06-01,51231,1,0,1,1,0,1
2023-06-01,204054,1,0,1,1,0,1
2023-06-01,51240,1,0,1,3,0,3
2023-06-01,51244,1,0,1,1,0,1
2023-06-01,197198,1,0,1,1,0,1
2023-06-01,59497,26,4,30,7,1,7
2023-06-01,51253,1,0,1,1,0,1
2023-06-01,198108,1,0,1,2,0,2
2023-06-01,43283,1,0,1,2,0,2
2023-06-01,50446,3,1,4,4,1,4
2023-06-01,47491,2,0,2,1,0,1
2023-06-01,199450,2,0,2,1,0,1
2023-06-01,21474,3,0,3,1,0,1
2023-06-01,197005,1,0,1,1,0,1
2023-06-01,197159,5,0,5,1,0,1
2023-06-01,31447,1,0,1,1,0,1
2023-06-01,62239,1,1,2,2,2,2
2023-06-01,51413,1,1,2,1,1,1
2023-06-01,208810,1,0,1,2,0,2
2023-06-01,51385,1,0,1,3,0,3
2023-06-01,199209,1,0,1,1,0,1
2023-06-01,212918,2,0,2,1,0,1
2023-06-01,51296,1,0,1,1,0,1
2023-06-01,51680,1,0,1,2,0,2
2023-06-01,203730,10,0,10,4,0,4
2023-06-01,197218,3,0,3,2,0,2
2023-06-01,51404,2,0,2,3,0,3
2023-06-01,51419,1,0,1,3,0,3
2023-06-01,50621,15,1,16,3,2,3
2023-06-01,212284,1,0,1,1,0,1
2023-06-01,197250,3,0,3,1,0,1
2023-06-01,43868,1,0,1,1,0,1
2023-06-01,197134,1,0,1,1,0,1
2023-06-01,209383,3,1,4,3,1,3
2023-06-01,201603,4,1,5,2,2,2
2023-06-01,197153,1,0,1,1,0,1
2023-06-01,51448,3,0,3,3,0,3
2023-06-01,51442,1,0,1,1,0,1
2023-06-01,197444,2,2,4,1,1,1
2023-06-01,199015,3,1,4,3,1,3
2023-06-01,197251,3,0,3,4,0,4
2023-06-01,51528,3,0,3,10,0,10
2023-06-01,197255,1,0,1,2,0,2
2023-06-01,62259,4,0,4,4,0,4
2023-06-01,51460,3,0,3,3,0,3
2023-06-01,197681,1,0,1,1,0,1
2023-06-01,51599,1,0,1,1,0,1
2023-06-01,51518,1,0,1,1,0,1
2023-06-01,49313,2,0,2,1,0,1
2023-06-01,197269,3,1,4,4,2,4
2023-06-01,51516,1,0,1,2,0,2
2023-06-01,51509,1,1,2,1,1,1
2023-06-01,51521,1,0,1,3,0,3
2023-06-01,196792,2,0,2,1,0,1
2023-06-01,51589,2,0,2,3,0,3
2023-06-01,51592,36,0,36,1,0,1
2023-06-01,50860,3,0,3,2,0,2
2023-06-01,47517,2,0,2,4,0,4
2023-06-01,60555,3,0,3,2,0,2
2023-06-01,51565,1,0,1,1,0,1
2023-06-01,21449,4,1,5,7,6,8
2023-06-01,51398,1,0,1,1,0,1
2023-06-01,197365,1,0,1,2,0,2
2023-06-01,51414,1,0,1,3,0,3
2023-06-01,39818,1,0,1,1,0,1
2023-06-01,51410,1,1,2,3,3,3
2023-06-01,51434,1,0,1,1,0,1
2023-06-01,197230,1,0,1,2,0,2
2023-06-01,198333,13,2,15,4,3,4
2023-06-01,50561,4,0,4,1,0,1
2023-06-01,51471,1,0,1,2,0,2
2023-06-01,51435,1,0,1,3,0,3
2023-06-01,197232,1,0,1,3,0,3
2023-06-01,51421,1,1,2,1,1,1
2023-06-01,196898,2,0,2,1,0,1
2023-06-01,197702,1,0,1,3,0,3
2023-06-01,200322,7,1,8,2,2,3
2023-06-01,196945,3,1,4,7,3,7
2023-06-01,197306,1,0,1,1,0,1
2023-06-01,51493,1,0,1,3,0,3
2023-06-01,197238,1,0,1,2,0,2
2023-06-01,48467,13,1,14,4,1,5
2023-06-01,51443,1,0,1,2,0,2
2023-06-01,51455,1,0,1,3,0,3
2023-06-01,197488,1,0,1,1,0,1
2023-06-01,139471,11,0,11,3,0,3
2023-06-01,48483,8,0,8,3,0,3
2023-06-01,51450,1,0,1,1,0,1
2023-06-01,20909,2,0,2,3,0,3
2023-06-01,51454,1,1,2,1,1,1
2023-06-01,209467,1,1,2,1,1,1
2023-06-01,62378,1,0,1,4,0,4
2023-06-01,197258,1,0,1,3,0,3
2023-06-01,51475,1,0,1,2,0,2
2023-06-01,197257,1,0,1,1,0,1
2023-06-01,51480,1,0,1,1,0,1
2023-06-01,197276,1,0,1,1,0,1
2023-06-01,210795,1,0,1,1,0,1
2023-06-01,51476,1,0,1,1,0,1
2023-06-01,51494,1,0,1,3,0,3
2023-06-01,197278,1,0,1,1,0,1
2023-06-01,51496,1,1,2,2,2,2
2023-06-01,51506,1,0,1,2,0,2
2023-06-01,25378,1,0,1,3,0,3
2023-06-01,197265,1,0,1,2,0,2
2023-06-01,197086,1,0,1,3,0,3
2023-06-01,205834,2,0,2,2,0,2
2023-06-01,199743,4,2,6,1,3,3
2023-06-01,205091,2,1,3,2,1,2
2023-06-01,209997,2,0,2,2,0,2
2023-06-01,39255,2,0,2,4,0,4
2023-06-01,51513,1,0,1,3,0,3
2023-06-01,51741,1,1,2,1,1,1
2023-06-01,197273,1,0,1,1,0,1
2023-06-01,197270,1,0,1,1,0,1
2023-06-01,197266,1,0,1,3,0,3
2023-06-01,197274,6,0,6,3,0,3
2023-06-01,197082,2,0,2,2,0,2
2023-06-01,197379,1,0,1,4,0,4
2023-06-01,24732,2,0,2,3,0,3
2023-06-01,57693,1,0,1,1,0,1
2023-06-01,51527,6,0,6,2,0,2
2023-06-01,51536,1,0,1,2,0,2
2023-06-01,34562,1,0,1,1,0,1
2023-06-01,51533,1,0,1,1,0,1
2023-06-01,213172,1,0,1,2,0,2
2023-06-01,197279,1,0,1,1,0,1
2023-06-01,51537,1,0,1,2,0,2
2023-06-01,44710,2,0,2,3,0,3
2023-06-01,51545,5,0,5,3,0,3
2023-06-01,29655,7,2,9,6,7,9
2023-06-01,51743,1,0,1,1,0,1
2023-06-01,51573,1,0,1,2,0,2
2023-06-01,25514,2,0,2,1,0,1
2023-06-01,211186,5,3,8,3,2,3
2023-06-01,196986,1,0,1,2,0,2
2023-06-01,9131,1,0,1,1,0,1
2023-06-01,2613,2,4,6,4,4,5
2023-06-01,211049,1,0,1,2,0,2
2023-06-01,197162,1,0,1,3,0,3
2023-06-01,198001,1,0,1,2,0,2
2023-06-01,51272,1,0,1,1,0,1
2023-06-01,49773,1,0,1,1,0,1
2023-06-01,57661,4,0,4,4,0,4
2023-06-01,51279,3,0,3,5,0,5
2023-06-01,59533,13,0,13,4,0,4
2023-06-01,208461,1,0,1,2,0,2
2023-06-01,34223,4,0,4,4,0,4
2023-06-01,48604,2,0,2,1,0,1
2023-06-01,51291,1,0,1,3,0,3
2023-06-01,204626,2,0,2,2,0,2
2023-06-01,197552,1,0,1,1,0,1
2023-06-01,199398,1,0,1,1,0,1
2023-06-01,202172,2,0,2,1,0,1
2023-06-01,51371,2,0,2,1,0,1
2023-06-01,51382,1,0,1,1,0,1
2023-06-01,51380,7,0,7,8,0,8
2023-06-01,42074,2,0,2,3,0,3
2023-06-01,51393,2,0,2,1,0,1
2023-06-01,51436,2,0,2,1,0,1
2023-06-01,15831,2,0,2,1,0,1
2023-06-01,204064,5,1,6,2,1,2
2023-06-01,51424,4,0,4,3,0,3
2023-06-01,34393,5,2,7,6,4,6
2023-06-01,4446,0,0,0,2,2,2
2023-06-01,202667,2,0,2,1,0,1
2023-06-01,51478,5,0,5,1,0,1
2023-06-01,210610,1,0,1,1,0,1
2023-06-01,204726,1,0,1,1,0,1
2023-06-01,49778,1,3,4,1,1,1
2023-06-01,196682,5,1,6,6,3,6
2023-06-01,51511,10,0,10,1,0,1
2023-06-01,49546,8,0,8,1,0,1
2023-06-01,50398,3,1,4,5,4,5
2023-06-01,51597,12,1,13,6,2,6
2023-06-01,197112,7,0,7,2,0,2
2023-06-01,51583,16,0,16,3,0,3
2023-06-01,51612,2,0,2,2,0,2
2023-06-01,41929,5,0,5,4,0,4
2023-06-01,51948,3,0,3,7,0,7
2023-06-01,197318,2,0,2,2,0,2
2023-06-01,51655,8,0,8,4,0,4
2023-06-01,51652,1,0,1,3,0,3
2023-06-01,197317,5,0,5,1,0,1
2023-06-01,16323,14,0,14,3,0,3
2023-06-01,51726,1,0,1,1,0,1
2023-06-01,51725,3,0,3,1,0,1
2023-06-01,51715,1,0,1,3,0,3
2023-06-01,51717,4,0,4,3,0,3
2023-06-01,15461,5,0,5,4,0,4
2023-06-01,41161,3,0,3,1,0,1
2023-06-01,211774,2,1,3,1,1,1
2023-06-01,50671,14,0,14,4,0,4
2023-06-01,51613,2,0,2,3,0,3
2023-06-01,51672,1,0,1,3,0,3
2023-06-01,51853,1,0,1,3,0,3
2023-06-01,197559,1,0,1,2,0,2
2023-06-01,51608,1,1,2,1,2,2
2023-06-01,197303,2,0,2,3,0,3
2023-06-01,51633,1,0,1,3,0,3
2023-06-01,51627,1,0,1,2,0,2
2023-06-01,51639,1,0,1,1,0,1
2023-06-01,61983,1,0,1,1,0,1
2023-06-01,51750,1,0,1,2,0,2
2023-06-01,29620,3,0,3,3,0,3
2023-06-01,57259,0,0,0,4,0,4
2023-06-01,41714,37,0,37,4,0,4
2023-06-01,51651,1,0,1,1,0,1
2023-06-01,51654,1,0,1,2,0,2
2023-06-01,206379,3,0,3,3,0,3
2023-06-01,28924,17,0,17,2,0,2
2023-06-01,51667,1,0,1,3,0,3
2023-06-01,51690,4,0,4,1,0,1
2023-06-01,51673,1,0,1,1,0,1
2023-06-01,51893,1,0,1,3,0,3
2023-06-01,197321,1,0,1,2,0,2
2023-06-01,51688,1,0,1,1,0,1
2023-06-01,197374,1,0,1,1,0,1
2023-06-01,197368,1,0,1,1,0,1
2023-06-01,51677,13,0,13,7,0,7
2023-06-01,197340,2,0,2,1,0,1
2023-06-01,197323,1,0,1,2,0,2
2023-06-01,51689,1,0,1,1,0,1
2023-06-01,197386,1,0,1,1,0,1
2023-06-01,51766,1,0,1,1,0,1
2023-06-01,8798,5,1,6,5,1,5
2023-06-01,197215,1,0,1,2,0,2
2023-06-01,197326,1,0,1,1,0,1
2023-06-01,56657,1,0,1,2,0,2
2023-06-01,51700,1,0,1,2,0,2
2023-06-01,51719,1,0,1,2,0,2
2023-06-01,38961,1,0,1,4,0,4
2023-06-01,51694,1,0,1,1,0,1
2023-06-01,197327,1,0,1,3,0,3
2023-06-01,61322,1,0,1,1,0,1
2023-06-01,197357,1,1,2,3,1,3
2023-06-01,51729,1,0,1,1,0,1
2023-06-01,51753,1,0,1,1,0,1
2023-06-01,197346,1,0,1,2,0,2
2023-06-01,58096,6,0,6,5,0,5
2023-06-01,51712,1,0,1,1,0,1
2023-06-01,30730,1,0,1,6,0,6
2023-06-01,51772,1,0,1,1,0,1
2023-06-01,52158,1,1,2,1,1,1
2023-06-01,51723,1,0,1,3,0,3
2023-06-01,59905,7,0,7,3,0,3
2023-06-01,51735,1,0,1,1,0,1
2023-06-01,51732,1,0,1,1,0,1
2023-06-01,43278,7,0,7,6,0,6
2023-06-01,51888,1,0,1,1,0,1
2023-06-01,51746,1,0,1,1,0,1
2023-06-01,51752,2,1,3,8,6,10
2023-06-01,51767,1,0,1,1,0,1
2023-06-01,197489,1,0,1,2,0,2
2023-06-01,51770,1,0,1,2,0,2
2023-06-01,211920,1,0,1,1,0,1
2023-06-01,51768,2,0,2,3,0,3
2023-06-01,51817,1,0,1,1,0,1
2023-06-01,51794,1,0,1,1,0,1
2023-06-01,51774,1,0,1,1,0,1
2023-06-01,51875,2,0,2,1,0,1
2023-06-01,51816,1,0,1,1,0,1
2023-06-01,51810,1,1,2,1,2,2
2023-06-01,57508,2,2,4,1,1,1
2023-06-01,212030,2,0,2,2,0,2
2023-06-01,213222,2,0,2,1,0,1
2023-06-01,51802,1,0,1,1,0,1
2023-06-01,212633,0,0,0,2,0,2
2023-06-01,209336,2,0,2,3,0,3
2023-06-01,51845,2,0,2,2,0,2
2023-06-01,197391,1,0,1,1,0,1
2023-06-01,51808,1,0,1,1,0,1
2023-06-01,197380,5,0,5,3,0,3
2023-06-01,50311,2,2,4,4,2,4
2023-06-01,51823,2,0,2,7,0,7
2023-06-01,8792,5,1,6,4,1,4
2023-06-01,197429,1,0,1,3,0,3
2023-06-01,51882,1,0,1,2,0,2
2023-06-01,51840,21,1,22,3,1,3
2023-06-01,51851,1,0,1,1,0,1
2023-06-01,197211,1,0,1,3,0,3
2023-06-01,50562,1,0,1,2,0,2
2023-06-01,51850,1,0,1,1,0,1
2023-06-01,51846,1,0,1,1,0,1
2023-06-01,51838,1,0,1,2,0,2
2023-06-01,205998,3,0,3,4,0,4
2023-06-01,51857,4,1,5,4,1,4
2023-06-01,51854,1,0,1,1,0,1
2023-06-01,51858,1,0,1,1,0,1
2023-06-01,51912,1,0,1,1,0,1
2023-06-01,51869,1,0,1,1,0,1
2023-06-01,197416,1,1,2,1,1,1
2023-06-01,21009,2,0,2,1,0,1
2023-06-01,51887,2,0,2,1,0,1
2023-06-01,51926,1,0,1,2,0,2
2023-06-01,51877,1,0,1,2,0,2
2023-06-01,51879,1,0,1,4,0,4
2023-06-01,51884,1,0,1,1,0,1
2023-06-01,51883,1,1,2,2,1,2
2023-06-01,212337,2,1,3,2,1,2
2023-06-01,41694,2,0,2,1,0,1
2023-06-01,197427,2,0,2,2,0,2
2023-06-01,52047,1,0,1,2,0,2
2023-06-01,65114,1,0,1,3,0,3
2023-06-01,51915,1,0,1,1,0,1
2023-06-01,51911,1,0,1,1,0,1
2023-06-01,199851,1,0,1,1,0,1
2023-06-01,47881,2,0,2,1,0,1
2023-06-01,59528,1,0,1,1,0,1
2023-06-01,197436,1,0,1,2,0,2
2023-06-01,61047,6,0,6,2,0,2
2023-06-01,44548,3,0,3,1,0,1
2023-06-01,198725,2,1,3,1,1,1
2023-06-01,51959,1,0,1,4,0,4
2023-06-01,51903,3,1,4,7,1,7
2023-06-01,197447,2,0,2,3,0,3
2023-06-01,51954,1,0,1,1,0,1
2023-06-01,25069,3,0,3,3,0,3
2023-06-01,56678,1,0,1,3,0,3
2023-06-01,52024,1,0,1,1,0,1
2023-06-01,51998,1,0,1,1,0,1
2023-06-01,51981,1,0,1,2,0,2
2023-06-01,51971,1,0,1,2,0,2
2023-06-01,52022,4,1,5,2,1,2
2023-06-01,197473,2,1,3,2,1,2
2023-06-01,57800,1,0,1,5,0,5
2023-06-01,51995,1,0,1,1,0,1
2023-06-01,207366,2,0,2,1,0,1
2023-06-01,52090,1,0,1,3,0,3
2023-06-01,50864,8,2,10,4,1,4
2023-06-01,212537,1,0,1,3,0,3
2023-06-01,56332,1,0,1,1,0,1
2023-06-01,197514,1,0,1,2,0,2
2023-06-01,52004,2,1,3,2,1,2
2023-06-01,212631,1,0,1,1,0,1
2023-06-01,52034,1,0,1,1,0,1
2023-06-01,201355,1,0,1,1,0,1
2023-06-01,52032,1,0,1,2,0,2
2023-06-01,56625,2,0,2,1,0,1
2023-06-01,41375,2,0,2,5,0,5
2023-06-01,51635,1,0,1,5,0,5
2023-06-01,51668,1,0,1,4,0,4
2023-06-01,51663,2,0,2,2,0,2
2023-06-01,197325,2,0,2,3,0,3
2023-06-01,51670,3,0,3,2,0,2
2023-06-01,51686,1,0,1,1,0,1
2023-06-01,47224,7,0,7,1,0,1
2023-06-01,51831,1,0,1,1,0,1
2023-06-01,33962,3,1,4,7,3,7
2023-06-01,197331,2,0,2,2,0,2
2023-06-01,56574,1,0,1,3,0,3
2023-06-01,51716,1,0,1,2,0,2
2023-06-01,51727,1,0,1,3,0,3
2023-06-01,50916,7,0,7,3,0,3
2023-06-01,199718,2,0,2,1,0,1
2023-06-01,51763,2,0,2,3,0,3
2023-06-01,197364,2,0,2,2,0,2
2023-06-01,59541,1,0,1,2,0,2
2023-06-01,21205,1,0,1,1,0,1
2023-06-01,51824,2,0,2,1,0,1
2023-06-01,34901,4,0,4,2,0,2
2023-06-01,35600,5,4,9,7,6,8
2023-06-01,36791,6,3,9,4,2,4
2023-06-01,58108,1,0,1,1,0,1
2023-06-01,50968,7,0,7,2,0,2
2023-06-01,51839,1,1,2,2,2,2
2023-06-01,59557,1,0,1,3,0,3
2023-06-01,197410,1,0,1,2,0,2
2023-06-01,207841,4,1,5,5,4,6
2023-06-01,200082,1,0,1,1,0,1
2023-06-01,51914,1,0,1,2,0,2
2023-06-01,51927,1,0,1,1,0,1
2023-06-01,45025,14,0,14,6,0,6
2023-06-01,51937,7,0,7,1,0,1
2023-06-01,51932,3,0,3,3,0,3
2023-06-01,59700,1,0,1,1,0,1
2023-06-01,197459,1,0,1,1,0,1
2023-06-01,197449,2,0,2,2,0,2
2023-06-01,49897,1,0,1,4,0,4
2023-06-01,51990,3,0,3,1,0,1
2023-06-01,202086,2,0,2,1,0,1
2023-06-01,51991,2,0,2,1,0,1
2023-06-01,52008,6,0,6,3,0,3
2023-06-01,52003,2,1,3,3,2,4
2023-06-01,52001,1,0,1,1,0,1
2023-06-01,43378,3,0,3,3,0,3
2023-06-01,18811,2,0,2,1,0,1
2023-06-01,52028,1,0,1,3,0,3
2023-06-01,197482,7,0,7,10,0,10
2023-06-01,52040,7,0,7,2,0,2
2023-06-01,8925,7,2,9,4,3,4
2023-06-01,197490,1,1,2,2,1,2
2023-06-01,52072,1,0,1,1,0,1
2023-06-01,52074,2,0,2,2,0,2
2023-06-01,29293,1,0,1,2,0,2
2023-06-01,208072,2,0,2,2,0,2
2023-06-01,34918,1,0,1,7,2,7
2023-06-01,56699,3,0,3,2,0,2
2023-06-01,52120,1,0,1,1,0,1
2023-06-01,201268,2,0,2,1,0,1
2023-06-01,52131,2,0,2,1,0,1
2023-06-01,52127,1,2,3,1,1,2
2023-06-01,56415,1,0,1,1,0,1
2023-06-01,51874,3,0,3,6,0,6
2023-06-01,41967,4,0,4,10,0,10
2023-06-01,41352,2,1,3,2,2,2
2023-06-01,50550,8,0,8,5,0,5
2023-06-01,51960,12,0,12,7,0,7
2023-06-01,61299,3,0,3,2,0,2
2023-06-01,211608,1,0,1,1,0,1
2023-06-01,201530,5,1,6,2,1,2
2023-06-01,51917,5,0,5,2,0,2
2023-06-01,198346,4,0,4,4,0,4
2023-06-01,43113,1,0,1,1,0,1
2023-06-01,51972,5,1,6,5,1,5
2023-06-01,51976,1,0,1,4,0,4
2023-06-01,56812,7,0,7,3,0,3
2023-06-01,197454,5,0,5,2,0,2
2023-06-01,51979,1,0,1,2,0,2
2023-06-01,13026,2,0,2,1,0,1
2023-06-01,52139,2,0,2,1,0,1
2023-06-01,203157,1,0,1,6,0,6
2023-06-01,51986,1,0,1,1,0,1
2023-06-01,50401,5,0,5,3,0,3
2023-06-01,52078,1,0,1,7,0,7
2023-06-01,197479,4,0,4,3,0,3
2023-06-01,52124,1,0,1,2,0,2
2023-06-01,52062,1,0,1,1,0,1
2023-06-01,197502,1,0,1,4,0,4
2023-06-01,50161,15,0,15,1,0,1
2023-06-01,41247,2,0,2,4,0,4
2023-06-01,210945,1,1,2,3,3,3
2023-06-01,57474,7,0,7,2,0,2
2023-06-01,48121,1,0,1,1,0,1
2023-06-01,197300,3,0,3,3,0,3
2023-06-01,52208,1,0,1,1,0,1
2023-06-01,52180,13,0,13,2,0,2
2023-06-01,52182,1,0,1,1,0,1
2023-06-01,52190,1,0,1,1,0,1
2023-06-01,51739,1,0,1,1,0,1
2023-06-01,59670,2,0,2,2,0,2
2023-06-01,212833,2,0,2,1,0,1
2023-06-01,50913,1,0,1,1,0,1
2023-06-01,197538,1,0,1,2,0,2
2023-06-01,197527,1,0,1,1,0,1
2023-06-01,197507,1,0,1,2,0,2
2023-06-01,52168,1,0,1,2,0,2
2023-06-01,207380,1,0,1,2,0,2
2023-06-01,59613,4,4,8,4,2,4
2023-06-01,21343,1,0,1,3,3,3
2023-06-01,21489,6,0,6,3,0,3
2023-06-01,1837,2,0,2,2,0,2
2023-06-01,52172,1,0,1,1,0,1
2023-06-01,197526,1,0,1,5,0,5
2023-06-01,48256,1,0,1,2,0,2
2023-06-01,60191,8,2,10,6,5,7
2023-06-01,198137,3,0,3,2,0,2
2023-06-01,197544,1,0,1,2,0,2
2023-06-01,52198,1,0,1,3,0,3
2023-06-01,56334,4,0,4,2,0,2
2023-06-01,52197,1,0,1,1,0,1
2023-06-01,48856,1,0,1,1,0,1
2023-06-01,197536,1,0,1,3,0,3
2023-06-01,197551,1,0,1,5,0,5
2023-06-01,56863,1,0,1,1,0,1
2023-06-01,197534,1,0,1,1,0,1
2023-06-01,199612,1,1,2,3,1,3
2023-06-01,52217,1,0,1,3,0,3
2023-06-01,48772,1,0,1,1,0,1
2023-06-01,52211,1,0,1,2,0,2
2023-06-01,210850,2,0,2,1,0,1
2023-06-01,197012,1,0,1,1,0,1
2023-06-01,197093,1,0,1,2,0,2
2023-06-01,199381,1,0,1,4,0,4
2023-06-01,197554,6,0,6,1,0,1
2023-06-01,50318,1,0,1,1,0,1
2023-06-01,197548,1,0,1,2,0,2
2023-06-01,197766,2,0,2,2,0,2
2023-06-01,47950,5,2,7,2,4,5
2023-06-01,198999,1,0,1,1,0,1
2023-06-01,2115,2,0,2,1,0,1
2023-06-01,41591,1,0,1,1,0,1
2023-06-01,197337,1,0,1,2,0,2
2023-06-01,197500,1,1,2,2,2,2
2023-06-01,196762,1,0,1,3,0,3
2023-06-01,197562,2,0,2,1,0,1
2023-06-01,41312,2,0,2,1,0,1
2023-06-01,197202,1,1,2,2,2,2
2023-06-01,196837,1,0,1,3,0,3
2023-06-01,197656,1,0,1,1,0,1
2023-06-01,199968,2,0,2,1,0,1
2023-06-01,197187,1,0,1,1,0,1
2023-06-01,197241,1,0,1,1,0,1
2023-06-01,200565,3,0,3,5,0,5
2023-06-01,196863,3,0,3,2,0,2
2023-06-01,50931,1,0,1,1,0,1
2023-06-01,56531,1,1,2,1,1,1
2023-06-01,44386,6,0,6,5,0,5
2023-06-01,52114,2,1,3,2,1,2
2023-06-01,205382,1,0,1,2,0,2
2023-06-01,50861,1,0,1,2,0,2
2023-06-01,56358,1,0,1,4,0,4
2023-06-01,57057,0,1,1,3,2,3
2023-06-01,197577,3,0,3,1,0,1
2023-06-01,197574,1,0,1,3,0,3
2023-06-01,197700,1,0,1,2,0,2
2023-06-01,197578,1,0,1,1,0,1
2023-06-01,197579,2,2,4,2,2,2
2023-06-01,198264,1,0,1,2,0,2
2023-06-01,203464,8,0,8,2,0,2
2023-06-01,29128,6,0,6,1,0,1
2023-06-01,9078,1,0,1,2,0,2
2023-06-01,197302,1,0,1,2,0,2
2023-06-01,58029,6,0,6,1,0,1
2023-06-01,197582,1,0,1,1,0,1
2023-06-01,56409,1,0,1,2,0,2
2023-06-01,197593,1,0,1,2,0,2
2023-06-01,56408,1,0,1,2,0,2
2023-06-01,198241,1,0,1,2,0,2
2023-06-01,56428,2,1,3,3,1,3
2023-06-01,56545,1,0,1,1,0,1
2023-06-01,201663,1,0,1,1,0,1
2023-06-01,60551,7,1,8,2,1,3
2023-06-01,48666,1,0,1,1,0,1
2023-06-01,57453,1,0,1,1,0,1
2023-06-01,56432,1,0,1,2,0,2
2023-06-01,197610,3,0,3,5,0,5
2023-06-01,56455,1,0,1,3,0,3
2023-06-01,199753,3,1,4,2,2,2
2023-06-01,56439,1,1,2,3,2,4
2023-06-01,56445,1,0,1,1,0,1
2023-06-01,51885,1,0,1,1,0,1
2023-06-01,197597,1,0,1,2,0,2
2023-06-01,56452,1,0,1,1,0,1
2023-06-01,56454,1,0,1,1,0,1
2023-06-01,34717,1,0,1,3,0,3
2023-06-01,56470,1,0,1,1,0,1
2023-06-01,57414,1,0,1,1,0,1
2023-06-01,56481,1,0,1,2,0,2
2023-06-01,56475,3,0,3,4,0,4
2023-06-01,56483,1,0,1,2,0,2
2023-06-01,56492,1,0,1,2,0,2
2023-06-01,56743,1,0,1,1,0,1
2023-06-01,197627,1,0,1,1,0,1
2023-06-01,48894,11,4,15,6,3,6
2023-06-01,47466,2,0,2,1,0,1
2023-06-01,56499,1,0,1,1,0,1
2023-06-01,30935,5,0,5,5,0,5
2023-06-01,56506,1,0,1,2,0,2
2023-06-01,57554,2,0,2,1,0,1
2023-06-01,56502,1,0,1,1,0,1
2023-06-01,197655,1,0,1,3,0,3
2023-06-01,197635,1,0,1,2,0,2
2023-06-01,56505,1,0,1,2,0,2
2023-06-01,35591,2,0,2,2,0,2
2023-06-01,30931,14,2,16,5,3,5
2023-06-01,197639,1,1,2,3,2,3
2023-06-01,56527,4,0,4,1,0,1
2023-06-01,197642,1,0,1,1,0,1
2023-06-01,197645,2,0,2,4,0,4
2023-06-01,56524,1,0,1,3,0,3
2023-06-01,56530,1,0,1,1,0,1
2023-06-01,56557,1,0,1,3,0,3
2023-06-01,57955,1,0,1,3,0,3
2023-06-01,48345,5,4,9,10,6,11
2023-06-01,197599,1,0,1,2,0,2
2023-06-01,196645,21,1,22,6,1,6
2023-06-01,197733,2,0,2,1,0,1
2023-06-01,35275,1,0,1,1,0,1
2023-06-01,56543,1,0,1,2,0,2
2023-06-01,29186,2,1,3,5,2,5
2023-06-01,197659,2,1,3,2,1,2
2023-06-01,12785,1,0,1,1,0,1
2023-06-01,210648,1,1,2,1,1,1
2023-06-01,56558,1,0,1,2,0,2
2023-06-01,49204,1,1,2,3,1,3
2023-06-01,60973,2,1,3,3,2,3
2023-06-01,197662,2,0,2,2,0,2
2023-06-01,41385,3,0,3,2,0,2
2023-06-01,9130,1,0,1,3,0,3
2023-06-01,48415,1,0,1,1,0,1
2023-06-01,23242,5,0,5,2,0,2
2023-06-01,5531,3,0,3,2,0,2
2023-06-01,52170,1,0,1,3,0,3
2023-06-01,51288,4,0,4,1,0,1
2023-06-01,56331,2,0,2,2,0,2
2023-06-01,65412,0,0,0,2,0,2
2023-06-01,60562,3,0,3,1,0,1
2023-06-01,41297,4,0,4,3,0,3
2023-06-01,50895,1,0,1,1,0,1
2023-06-01,59945,4,0,4,3,0,3
2023-06-01,197065,2,0,2,1,0,1
2023-06-01,197169,1,0,1,2,0,2
2023-06-01,47628,4,0,4,3,0,3
2023-06-01,197105,1,0,1,2,0,2
2023-06-01,50833,4,2,6,5,2,7
2023-06-01,41836,2,0,2,2,0,2
2023-06-01,197576,1,0,1,1,0,1
2023-06-01,52205,1,0,1,1,0,1
2023-06-01,56351,3,0,3,1,0,1
2023-06-01,50005,2,0,2,1,0,1
2023-06-01,56352,3,0,3,2,0,2
2023-06-01,197566,1,0,1,1,0,1
2023-06-01,51463,1,0,1,1,0,1
2023-06-01,56354,8,0,8,7,0,7
2023-06-01,196938,1,0,1,7,0,7
2023-06-01,197567,1,0,1,1,0,1
2023-06-01,50859,2,0,2,4,0,4
2023-06-01,56375,2,0,2,1,0,1
2023-06-01,56416,1,0,1,1,0,1
2023-06-01,56441,3,0,3,1,0,1
2023-06-01,61999,9,0,9,2,0,2
2023-06-01,197632,1,0,1,2,0,2
2023-06-01,56405,1,0,1,1,0,1
2023-06-01,56413,1,0,1,2,0,2
2023-06-01,56392,2,0,2,3,0,3
2023-06-01,56752,1,0,1,1,0,1
2023-06-01,197594,2,0,2,3,0,3
2023-06-01,56436,1,0,1,2,0,2
2023-06-01,51124,2,0,2,1,0,1
2023-06-01,56440,3,0,3,1,0,1
2023-06-01,56451,6,0,6,5,0,5
2023-06-01,56513,1,1,2,1,1,1
2023-06-01,56461,2,0,2,1,0,1
2023-06-01,197602,2,1,3,4,2,4
2023-06-01,56477,1,1,2,1,1,1
2023-06-01,197611,1,0,1,1,0,1
2023-06-01,52166,1,0,1,3,0,3
2023-06-01,56511,1,2,3,4,2,6
2023-06-01,56522,2,0,2,3,0,3
2023-06-01,56525,1,0,1,1,0,1
2023-06-01,56493,3,0,3,1,0,1
2023-06-01,51863,2,2,4,7,3,7
2023-06-01,56536,1,0,1,1,0,1
2023-06-01,56523,2,1,3,3,5,5
2023-06-01,56532,2,1,3,3,3,3
2023-06-01,47560,1,0,1,1,0,1
2023-06-01,42537,1,0,1,3,0,3
2023-06-01,56542,7,0,7,4,0,4
2023-06-01,197679,1,0,1,2,0,2
2023-06-01,29397,1,0,1,3,0,3
2023-06-01,198450,1,0,1,1,0,1
2023-06-01,199520,5,1,6,4,3,4
2023-06-01,56576,1,0,1,1,0,1
2023-06-01,51622,14,0,14,2,0,2
2023-06-01,8753,3,0,3,2,0,2
2023-06-01,212218,1,0,1,1,0,1
2023-06-01,60534,5,1,6,3,2,3
2023-06-01,52215,2,0,2,2,0,2
2023-06-01,52222,1,0,1,1,0,1
2023-06-01,210038,1,0,1,1,0,1
2023-06-01,48477,1,0,1,3,0,3
2023-06-01,200349,2,0,2,1,0,1
2023-06-01,200637,1,0,1,3,0,3
2023-06-01,197035,8,0,8,7,0,7
2023-06-01,52218,3,0,3,1,0,1
2023-06-01,213258,1,0,1,2,0,2
2023-06-01,56932,2,0,2,3,0,3
2023-06-01,43135,3,0,3,2,0,2
2023-06-01,31683,6,0,6,3,0,3
2023-06-01,197115,1,0,1,1,0,1
2023-06-01,197263,1,0,1,1,0,1
2023-06-01,56344,4,1,5,4,4,5
2023-06-01,197663,7,0,7,2,0,2
2023-06-01,47342,7,0,7,1,0,1
2023-06-01,49554,4,1,5,2,1,3
2023-06-01,56359,1,0,1,1,0,1
2023-06-01,202800,1,0,1,2,0,2
2023-06-01,12567,1,0,1,1,0,1
2023-06-01,56353,1,0,1,1,0,1
2023-06-01,197572,1,0,1,4,0,4
2023-06-01,56423,2,0,2,3,0,3
2023-06-01,51194,2,0,2,1,0,1
2023-06-01,197335,4,0,4,1,0,1
2023-06-01,56449,4,0,4,8,0,8
2023-06-01,56399,1,0,1,1,0,1
2023-06-01,56401,1,0,1,1,0,1
2023-06-01,197592,2,0,2,6,0,6
2023-06-01,56437,3,0,3,2,0,2
2023-06-01,206973,3,0,3,2,0,2
2023-06-01,56435,3,0,3,3,0,3
2023-06-01,49880,14,0,14,2,0,2
2023-06-01,56459,3,0,3,2,0,2
2023-06-01,56462,3,0,3,4,0,4
2023-06-01,56597,1,0,1,1,0,1
2023-06-01,3289,2,0,2,1,0,1
2023-06-01,50662,2,0,2,1,0,1
2023-06-01,197716,1,0,1,3,0,3
2023-06-01,50949,2,0,2,2,0,2
2023-06-01,56649,1,0,1,1,0,1
2023-06-01,56620,1,0,1,1,0,1
2023-06-01,197747,1,0,1,3,0,3
2023-06-01,56644,2,0,2,3,0,3
2023-06-01,197732,3,0,3,1,0,1
2023-06-01,207275,1,0,1,1,0,1
2023-06-01,56622,2,0,2,1,0,1
2023-06-01,197987,1,0,1,2,0,2
2023-06-01,211311,1,0,1,2,0,2
2023-06-01,56741,2,0,2,7,0,7
2023-06-01,56641,1,1,2,2,3,3
2023-06-01,198307,1,0,1,2,0,2
2023-06-01,206948,8,0,8,3,0,3
2023-06-01,205485,1,0,1,4,0,4
2023-06-01,203397,2,0,2,1,0,1
2023-06-01,209738,2,0,2,3,0,3
2023-06-01,197839,2,0,2,3,0,3
2023-06-01,34405,1,0,1,1,0,1
2023-06-01,56658,1,0,1,1,0,1
2023-06-01,57248,3,0,3,3,0,3
2023-06-01,20772,1,0,1,1,0,1
2023-06-01,197124,1,0,1,1,0,1
2023-06-01,197786,4,0,4,1,0,1
2023-06-01,56663,5,0,5,3,0,3
2023-06-01,61971,1,0,1,3,0,3
2023-06-01,39577,5,1,6,2,1,2
2023-06-01,57160,1,0,1,2,0,2
2023-06-01,196851,2,0,2,3,0,3
2023-06-01,56667,12,0,12,1,0,1
2023-06-01,197813,1,0,1,3,0,3
2023-06-01,196880,2,0,2,2,0,2
2023-06-01,56674,4,2,6,3,3,3
2023-06-01,56677,4,0,4,2,0,2
2023-06-01,197777,1,0,1,2,0,2
2023-06-01,56698,2,0,2,2,0,2
2023-06-01,16163,1,0,1,3,0,3
2023-06-01,56692,1,0,1,1,0,1
2023-06-01,56690,20,1,21,2,2,3
2023-06-01,197772,1,0,1,1,0,1
2023-06-01,203805,1,0,1,1,0,1
2023-06-01,56855,3,0,3,2,0,2
2023-06-01,197773,1,0,1,1,0,1
2023-06-01,56691,1,0,1,1,0,1
2023-06-01,201743,2,1,3,1,1,1
2023-06-01,205299,3,0,3,1,0,1
2023-06-01,197783,1,0,1,2,0,2
2023-06-01,56763,1,0,1,2,0,2
2023-06-01,56756,1,0,1,3,0,3
2023-06-01,56705,1,0,1,2,0,2
2023-06-01,45039,1,0,1,2,0,2
2023-06-01,197778,1,0,1,1,0,1
2023-06-01,58166,1,0,1,2,0,2
2023-06-01,56702,3,0,3,1,0,1
2023-06-01,56712,2,0,2,4,0,4
2023-06-01,204766,1,0,1,3,0,3
2023-06-01,197780,1,0,1,2,0,2
2023-06-01,57162,1,0,1,2,0,2
2023-06-01,56839,2,0,2,1,0,1
2023-06-01,12298,3,0,3,2,0,2
2023-06-01,57145,1,0,1,1,0,1
2023-06-01,56713,1,0,1,2,0,2
2023-06-01,16044,10,0,10,7,0,7
2023-06-01,56717,1,1,2,2,2,2
2023-06-01,47117,2,0,2,5,0,5
2023-06-01,57125,1,0,1,1,0,1
2023-06-01,56719,1,0,1,1,0,1
2023-06-01,197801,1,0,1,2,0,2
2023-06-01,49350,4,0,4,4,0,4
2023-06-01,56721,1,0,1,1,0,1
2023-06-01,56714,2,0,2,1,0,1
2023-06-01,56730,6,2,8,3,2,3
2023-06-01,56720,4,0,4,4,0,4
2023-06-01,56725,1,0,1,1,0,1
2023-06-01,197796,1,0,1,2,0,2
2023-06-01,56728,2,0,2,2,0,2
2023-06-01,56806,1,0,1,2,0,2
2023-06-01,50218,1,0,1,3,0,3
2023-06-01,60553,1,0,1,1,0,1
2023-06-01,60517,35,1,36,9,4,10
2023-06-01,48384,1,0,1,2,0,2
2023-06-01,52080,8,1,9,1,1,1
2023-06-01,200750,4,1,5,3,1,3
2023-06-01,56751,1,0,1,1,0,1
2023-06-01,197797,3,0,3,1,0,1
2023-06-01,197935,1,0,1,3,0,3
2023-06-01,41235,2,0,2,3,0,3
2023-06-01,197154,1,0,1,2,0,2
2023-06-01,56750,1,0,1,1,0,1
2023-06-01,35022,2,0,2,1,0,1
2023-06-01,56760,5,0,5,3,0,3
2023-06-01,198103,3,0,3,3,0,3
2023-06-01,200978,2,1,3,3,1,3
2023-06-01,197802,3,0,3,1,0,1
2023-06-01,199943,2,1,3,2,3,4
2023-06-01,51944,8,2,10,5,5,7
2023-06-01,197881,1,0,1,2,0,2
2023-06-01,197809,3,0,3,3,0,3
2023-06-01,56772,1,0,1,1,0,1
2023-06-01,198921,1,0,1,3,0,3
2023-06-01,41249,2,0,2,1,0,1
2023-06-01,197836,1,0,1,3,0,3
2023-06-01,56770,1,0,1,1,0,1
2023-06-01,208039,2,0,2,1,0,1
2023-06-01,56785,1,0,1,1,0,1
2023-06-01,210579,2,3,5,1,1,1
2023-06-01,56776,4,0,4,4,0,4
2023-06-01,56829,2,0,2,2,0,2
2023-06-01,30953,2,0,2,2,0,2
2023-06-01,56783,1,0,1,2,0,2
2023-06-01,197819,3,0,3,2,0,2
2023-06-01,57177,1,0,1,2,0,2
2023-06-01,197828,1,0,1,2,0,2
2023-06-01,56793,1,1,2,1,2,3
2023-06-01,197824,1,0,1,3,0,3
2023-06-01,56929,1,0,1,2,0,2
2023-06-01,56835,3,0,3,7,0,7
2023-06-01,56792,1,0,1,1,0,1
2023-06-01,198687,1,1,2,2,2,2
2023-06-01,197844,2,0,2,3,0,3
2023-06-01,56794,1,0,1,3,0,3
2023-06-01,57305,2,0,2,7,0,7
2023-06-01,197840,1,0,1,3,0,3
2023-06-01,56895,1,0,1,1,0,1
2023-06-01,56827,1,0,1,1,0,1
2023-06-01,56807,1,3,4,2,1,2
2023-06-01,197857,1,0,1,3,0,3
2023-06-01,41152,3,0,3,3,0,3
2023-06-01,15575,1,0,1,1,0,1
2023-06-01,56818,2,0,2,2,0,2
2023-06-01,56811,1,0,1,2,0,2
2023-06-01,197838,2,2,4,3,4,5
2023-06-01,56826,1,0,1,1,0,1
2023-06-01,56816,4,0,4,1,0,1
2023-06-01,197776,1,0,1,3,0,3
2023-06-01,197831,6,0,6,2,0,2
2023-06-01,56838,1,0,1,5,0,5
2023-06-01,60708,1,1,2,1,1,2
2023-06-01,56845,2,0,2,3,0,3
2023-06-01,41026,2,0,2,4,0,4
2023-06-01,203313,1,0,1,1,0,1
2023-06-01,197895,1,1,2,1,1,1
2023-06-01,56846,2,0,2,5,0,5
2023-06-01,213354,11,1,12,1,1,1
2023-06-01,27281,17,9,26,12,13,17
2023-06-01,197852,1,0,1,1,0,1
2023-06-01,61289,1,0,1,2,0,2
2023-06-01,56847,2,0,2,2,0,2
2023-06-01,197849,2,0,2,4,0,4
2023-06-01,30880,10,2,12,6,2,6
2023-06-01,56848,1,0,1,1,0,1
2023-06-01,197920,2,0,2,2,0,2
2023-06-01,56853,1,0,1,3,0,3
2023-06-01,44030,2,1,3,6,2,6
2023-06-01,197873,1,0,1,3,0,3
2023-06-01,9016,1,0,1,2,0,2
2023-06-01,61216,2,0,2,1,0,1
2023-06-01,56879,2,1,3,3,1,3
2023-06-01,56874,1,0,1,3,0,3
2023-06-01,56866,1,0,1,2,0,2
2023-06-01,48462,1,0,1,3,0,3
2023-06-01,57215,1,0,1,1,0,1
2023-06-01,39856,1,0,1,1,0,1
2023-06-01,44932,16,0,16,4,0,4
2023-06-01,56869,2,0,2,4,0,4
2023-06-01,6694,8,1,9,6,1,6
2023-06-01,207170,3,0,3,3,0,3
2023-06-01,56880,1,0,1,3,0,3
2023-06-01,56804,3,0,3,3,0,3
2023-06-01,197916,1,0,1,1,0,1
2023-06-01,34127,13,1,14,3,1,3
2023-06-01,208542,1,0,1,3,0,3
2023-06-01,197888,3,0,3,3,0,3
2023-06-01,56888,2,0,2,3,0,3
2023-06-01,49458,2,0,2,4,0,4
2023-06-01,198414,10,0,10,3,0,3
2023-06-01,210283,1,0,1,2,0,2
2023-06-01,56904,1,0,1,3,0,3
2023-06-01,8664,6,1,7,10,6,10
2023-06-01,197878,1,0,1,2,0,2
2023-06-01,197877,1,0,1,1,0,1
2023-06-01,56930,1,0,1,2,0,2
2023-06-01,209907,2,0,2,1,0,1
2023-06-01,56907,1,0,1,1,0,1
2023-06-01,50516,6,0,6,4,0,4
2023-06-01,205391,1,0,1,2,0,2
2023-06-01,197880,2,0,2,3,0,3
2023-06-01,197341,1,0,1,2,0,2
2023-06-01,57018,2,0,2,3,0,3
2023-06-01,56896,1,0,1,1,0,1
2023-06-01,198030,1,0,1,4,0,4
2023-06-01,197669,3,3,6,6,4,6
2023-06-01,56955,1,0,1,1,0,1
2023-06-01,56914,1,0,1,3,0,3
2023-06-01,15707,2,0,2,2,0,2
2023-06-01,44301,2,0,2,1,0,1
2023-06-01,62433,1,0,1,1,0,1
2023-06-01,30948,1,0,1,1,0,1
2023-06-01,56936,1,0,1,1,0,1
2023-06-01,6778,0,0,0,2,0,2
2023-06-01,198704,3,0,3,2,0,2
2023-06-01,12328,1,0,1,1,0,1
2023-06-01,56926,2,0,2,2,0,2
2023-06-01,197894,1,0,1,1,0,1
2023-06-01,44001,1,0,1,1,0,1
2023-06-01,56954,1,0,1,2,0,2
2023-06-01,49601,17,2,19,3,1,3
2023-06-01,34883,1,1,2,1,1,1
2023-06-01,56935,1,0,1,1,0,1
2023-06-01,39031,1,0,1,1,0,1
2023-06-01,47862,14,2,16,9,2,9
2023-06-01,5473,1,0,1,1,0,1
2023-06-01,56949,2,0,2,3,0,3
2023-06-01,197750,5,0,5,1,0,1
2023-06-01,5545,1,0,1,1,0,1
2023-06-01,197910,1,0,1,1,0,1
2023-06-01,56947,3,0,3,1,0,1
2023-06-01,56944,1,0,1,1,0,1
2023-06-01,196953,8,1,9,3,1,3
2023-06-01,203897,8,0,8,3,0,3
2023-06-01,57591,1,0,1,1,0,1
2023-06-01,211694,2,1,3,2,2,3
2023-06-01,57066,2,0,2,2,0,2
2023-06-01,197905,1,0,1,1,0,1
2023-06-01,202293,6,0,6,4,0,4
2023-06-01,56959,1,0,1,2,0,2
2023-06-01,57103,2,1,3,2,2,2
2023-06-01,56975,2,1,3,4,1,4
2023-06-01,15730,1,0,1,2,0,2
2023-06-01,56998,1,0,1,1,0,1
2023-06-01,39793,1,0,1,1,0,1
2023-06-01,56977,4,0,4,2,0,2
2023-06-01,49715,11,0,11,6,0,6
2023-06-01,58334,3,0,3,8,0,8
2023-06-01,197918,1,0,1,1,0,1
2023-06-01,51058,1,1,2,5,3,6
2023-06-01,49381,2,0,2,1,0,1
2023-06-01,56982,1,0,1,1,0,1
2023-06-01,50717,9,0,9,1,0,1
2023-06-01,197665,1,0,1,2,0,2
2023-06-01,60839,4,0,4,5,0,5
2023-06-01,57005,3,0,3,2,0,2
2023-06-01,56991,1,0,1,1,0,1
2023-06-01,56988,2,0,2,3,0,3
2023-06-01,56978,1,0,1,1,0,1
2023-06-01,208053,1,0,1,1,0,1
2023-06-01,56886,1,0,1,1,0,1
2023-06-01,57003,1,0,1,2,0,2
2023-06-01,56996,1,0,1,2,0,2
2023-06-01,197928,1,0,1,2,0,2
2023-06-01,57001,1,0,1,1,0,1
2023-06-01,198094,1,0,1,2,0,2
2023-06-01,57007,1,1,2,6,1,6
2023-06-01,1936,0,0,0,2,0,2
2023-06-01,57284,1,0,1,3,0,3
2023-06-01,9036,9,1,10,10,1,10
2023-06-01,56963,1,1,2,1,2,2
2023-06-01,44760,2,0,2,3,0,3
2023-06-01,197930,1,0,1,3,0,3
2023-06-01,197929,7,0,7,3,0,3
2023-06-01,52163,4,0,4,3,0,3
2023-06-01,197933,1,1,2,2,2,2
2023-06-01,57006,1,0,1,1,0,1
2023-06-01,44079,2,0,2,1,0,1
2023-06-01,8496,6,1,7,2,2,3
2023-06-01,197678,1,1,2,2,1,2
2023-06-01,51292,1,0,1,1,0,1
2023-06-01,29205,6,0,6,3,0,3
2023-06-01,57051,1,0,1,1,0,1
2023-06-01,212616,4,1,5,1,1,1
2023-06-01,197934,1,0,1,3,0,3
2023-06-01,57029,2,1,3,4,2,4
2023-06-01,197936,4,1,5,4,3,4
2023-06-01,197725,5,0,5,2,0,2
2023-06-01,198051,1,0,1,1,0,1
2023-06-01,196666,1,0,1,2,0,2
2023-06-01,57035,1,0,1,1,0,1
2023-06-01,207869,4,1,5,1,1,1
2023-06-01,57115,1,0,1,2,0,2
2023-06-01,57047,1,0,1,1,0,1
2023-06-01,197941,1,0,1,1,0,1
2023-06-01,198004,4,0,4,4,0,4
2023-06-01,197940,1,0,1,1,0,1
2023-06-01,197939,1,0,1,1,0,1
2023-06-01,198524,1,1,2,8,2,8
2023-06-01,197944,1,0,1,1,0,1
2023-06-01,57046,1,0,1,2,0,2
2023-06-01,197947,1,0,1,3,0,3
2023-06-01,51397,1,0,1,3,0,3
2023-06-01,197948,1,0,1,2,0,2
2023-06-01,57058,1,0,1,1,0,1
2023-06-01,197764,2,0,2,3,0,3
2023-06-01,197294,4,0,4,3,0,3
2023-06-01,203937,6,0,6,6,0,6
2023-06-01,57071,1,0,1,1,0,1
2023-06-01,44577,8,0,8,3,0,3
2023-06-01,197952,1,0,1,2,0,2
2023-06-01,197955,1,0,1,3,0,3
2023-06-01,31004,5,1,6,3,3,3
2023-06-01,198049,1,0,1,1,0,1
2023-06-01,57556,1,0,1,1,0,1
2023-06-01,57255,1,0,1,1,0,1
2023-06-01,57092,1,0,1,2,0,2
2023-06-01,57089,1,0,1,2,0,2
2023-06-01,28836,12,0,12,2,0,2
2023-06-01,208075,1,1,2,1,2,2
2023-06-01,211382,1,0,1,1,0,1
2023-06-01,57109,1,0,1,1,0,1
2023-06-01,197958,1,0,1,1,0,1
2023-06-01,57108,1,0,1,3,0,3
2023-06-01,200463,4,0,4,1,0,1
2023-06-01,57102,4,0,4,2,0,2
2023-06-01,48707,18,0,18,6,0,6
2023-06-01,57105,1,0,1,2,0,2
2023-06-01,198019,1,0,1,1,0,1
2023-06-01,8917,1,0,1,1,0,1
2023-06-01,61410,1,0,1,1,0,1
2023-06-01,57116,1,0,1,1,0,1
2023-06-01,197967,1,0,1,1,0,1
2023-06-01,57121,5,0,5,7,0,7
2023-06-01,197982,3,1,4,3,2,3
2023-06-01,197604,1,0,1,1,0,1
2023-06-01,57122,1,0,1,1,0,1
2023-06-01,48338,1,0,1,1,0,1
2023-06-01,57126,1,0,1,2,0,2
2023-06-01,15643,1,0,1,3,0,3
2023-06-01,57130,4,0,4,2,0,2
2023-06-01,57159,1,0,1,3,0,3
2023-06-01,197976,1,0,1,1,0,1
2023-06-01,60471,5,0,5,2,0,2
2023-06-01,198224,1,0,1,1,0,1
2023-06-01,198278,1,0,1,1,0,1
2023-06-01,200826,8,1,9,1,1,1
2023-06-01,198393,2,0,2,2,0,2
2023-06-01,57150,1,0,1,1,0,1
2023-06-01,57143,1,0,1,1,0,1
2023-06-01,48321,1,0,1,2,0,2
2023-06-01,197977,1,0,1,5,0,5
2023-06-01,57890,2,0,2,3,0,3
2023-06-01,197979,4,0,4,4,0,4
2023-06-01,198820,9,0,9,3,0,3
2023-06-01,60336,1,0,1,3,0,3
2023-06-01,198158,1,0,1,3,0,3
2023-06-01,57281,1,0,1,1,0,1
2023-06-01,198050,3,0,3,3,0,3
2023-06-01,199978,4,0,4,11,0,11
2023-06-01,198048,1,0,1,1,0,1
2023-06-01,197726,25,1,26,8,3,8
2023-06-01,198052,4,0,4,3,0,3
2023-06-01,198069,1,0,1,1,0,1
2023-06-01,57533,1,1,2,2,2,2
2023-06-01,12639,3,0,3,2,0,2
2023-06-01,15624,1,0,1,4,0,4
2023-06-01,198106,1,0,1,1,0,1
2023-06-01,198067,1,0,1,5,0,5
2023-06-01,212754,2,2,4,3,2,3
2023-06-01,57312,1,0,1,1,0,1
2023-06-01,198098,1,0,1,3,0,3
2023-06-01,198072,1,0,1,6,0,6
2023-06-01,208937,1,0,1,1,0,1
2023-06-01,57323,1,0,1,3,0,3
2023-06-01,50265,2,1,3,11,5,11
2023-06-01,57314,1,0,1,1,0,1
2023-06-01,39465,1,0,1,1,0,1
2023-06-01,57322,1,0,1,1,0,1
2023-06-01,209860,2,0,2,2,0,2
2023-06-01,198074,1,0,1,2,0,2
2023-06-01,197865,1,0,1,2,0,2
2023-06-01,8811,1,0,1,1,0,1
2023-06-01,198081,2,0,2,3,0,3
2023-06-01,21485,1,2,3,2,2,2
2023-06-01,199212,2,0,2,3,0,3
2023-06-01,15832,2,0,2,2,0,2
2023-06-01,34664,1,0,1,1,0,1
2023-06-01,8279,1,0,1,2,0,2
2023-06-01,197295,5,0,5,5,0,5
2023-06-01,57341,1,0,1,2,0,2
2023-06-01,197875,1,0,1,2,0,2
2023-06-01,204835,2,0,2,2,0,2
2023-06-01,57339,1,0,1,2,0,2
2023-06-01,8828,1,0,1,2,0,2
2023-06-01,57343,1,0,1,2,0,2
2023-06-01,44439,3,2,5,4,4,5
2023-06-01,198109,1,0,1,2,0,2
2023-06-01,44779,1,0,1,1,0,1
2023-06-01,212126,1,0,1,1,0,1
2023-06-01,57270,3,0,3,1,0,1
2023-06-01,198114,4,0,4,1,0,1
2023-06-01,198130,5,0,5,2,0,2
2023-06-01,210315,5,0,5,1,0,1
2023-06-01,198611,7,4,11,6,3,6
2023-06-01,57349,1,0,1,2,0,2
2023-06-01,198117,1,0,1,1,0,1
2023-06-01,57372,2,0,2,2,0,2
2023-06-01,57350,4,0,4,2,0,2
2023-06-01,1930,65,1,66,12,6,12
2023-06-01,57354,5,1,6,5,2,5
2023-06-01,198126,1,0,1,1,0,1
2023-06-01,57360,1,0,1,2,0,2
2023-06-01,57363,45,8,53,14,7,16
2023-06-01,198124,1,0,1,1,0,1
2023-06-01,57783,2,0,2,2,0,2
2023-06-01,200893,1,0,1,1,0,1
2023-06-01,51357,2,0,2,3,0,3
2023-06-01,57480,2,0,2,2,0,2
2023-06-01,60343,2,0,2,3,0,3
2023-06-01,57442,1,0,1,1,0,1
2023-06-01,57445,1,0,1,2,0,2
2023-06-01,198176,1,0,1,2,0,2
2023-06-01,57451,1,0,1,1,0,1
2023-06-01,12058,1,0,1,3,0,3
2023-06-01,198195,1,0,1,1,0,1
2023-06-01,198184,2,0,2,5,0,5
2023-06-01,199413,7,0,7,4,0,4
2023-06-01,198190,1,0,1,1,0,1
2023-06-01,198197,1,0,1,1,0,1
2023-06-01,57457,9,0,9,2,0,2
2023-06-01,50396,2,0,2,2,0,2
2023-06-01,57461,2,0,2,1,0,1
2023-06-01,57482,1,0,1,1,0,1
2023-06-01,57560,2,1,3,1,1,1
2023-06-01,198191,2,0,2,3,0,3
2023-06-01,205685,1,0,1,7,0,7
2023-06-01,204568,1,0,1,4,0,4
2023-06-01,198896,1,0,1,3,0,3
2023-06-01,51191,8,4,12,1,1,1
2023-06-01,24858,2,0,2,1,0,1
2023-06-01,57488,1,0,1,3,0,3
2023-06-01,57486,2,0,2,1,0,1
2023-06-01,50466,5,0,5,6,0,6
2023-06-01,49149,1,0,1,1,0,1
2023-06-01,57504,2,0,2,2,0,2
2023-06-01,196665,4,0,4,1,0,1
2023-06-01,198212,1,0,1,1,0,1
2023-06-01,59778,10,0,10,8,0,8
2023-06-01,57274,3,0,3,3,0,3
2023-06-01,57519,1,0,1,2,0,2
2023-06-01,49627,3,1,4,8,8,10
2023-06-01,49816,4,0,4,2,0,2
2023-06-01,198207,1,0,1,3,0,3
2023-06-01,201068,1,0,1,2,0,2
2023-06-01,57514,2,0,2,3,0,3
2023-06-01,57692,3,1,4,1,1,1
2023-06-01,198227,5,0,5,5,0,5
2023-06-01,57524,2,0,2,2,0,2
2023-06-01,29305,2,0,2,4,0,4
2023-06-01,57526,5,0,5,2,0,2
2023-06-01,198263,2,0,2,3,0,3
2023-06-01,41388,3,0,3,5,0,5
2023-06-01,198232,5,0,5,4,0,4
2023-06-01,202541,1,0,1,3,0,3
2023-06-01,198238,1,0,1,2,0,2
2023-06-01,57525,1,0,1,4,0,4
2023-06-01,47424,1,0,1,1,0,1
2023-06-01,208720,5,0,5,2,0,2
2023-06-01,57531,5,0,5,2,0,2
2023-06-01,198261,1,0,1,3,0,3
2023-06-01,57536,3,0,3,4,0,4
2023-06-01,198258,1,0,1,2,0,2
2023-06-01,29043,1,0,1,2,0,2
2023-06-01,51227,1,0,1,1,0,1
2023-06-01,198237,1,0,1,1,0,1
2023-06-01,57538,1,0,1,1,0,1
2023-06-01,57535,2,0,2,3,0,3
2023-06-01,198284,2,1,3,1,1,1
2023-06-01,57547,5,0,5,2,0,2
2023-06-01,198324,1,1,2,1,2,2
2023-06-01,16100,1,0,1,1,0,1
2023-06-01,57570,1,0,1,1,0,1
2023-06-01,198244,2,0,2,3,0,3
2023-06-01,198245,1,0,1,2,0,2
2023-06-01,57550,3,0,3,2,0,2
2023-06-01,198253,1,0,1,1,0,1
2023-06-01,198251,2,0,2,3,0,3
2023-06-01,57553,1,0,1,1,0,1
2023-06-01,57557,1,0,1,2,0,2
2023-06-01,198255,3,0,3,4,0,4
2023-06-01,34911,5,0,5,5,0,5
2023-06-01,57552,2,0,2,1,0,1
2023-06-01,57561,1,0,1,1,0,1
2023-06-01,42353,16,0,16,4,0,4
2023-06-01,198334,1,0,1,6,0,6
2023-06-01,42223,1,0,1,1,0,1
2023-06-01,400506,6,0,6,3,0,3
2023-06-01,62864,39,0,39,1,0,1
2023-06-01,57569,1,0,1,4,0,4
2023-06-01,198281,1,0,1,2,0,2
2023-06-01,198273,1,0,1,3,0,3
2023-06-01,62053,2,0,2,2,0,2
2023-06-01,198639,1,0,1,1,0,1
2023-06-01,57587,4,1,5,4,2,4
2023-06-01,57583,4,0,4,2,0,2
2023-06-01,58055,3,1,4,7,1,7
2023-06-01,57582,1,0,1,1,0,1
2023-06-01,48613,2,0,2,2,0,2
2023-06-01,57572,1,0,1,1,0,1
2023-06-01,57577,5,0,5,2,0,2
2023-06-01,57593,1,0,1,2,0,2
2023-06-01,57586,1,0,1,5,0,5
2023-06-01,57589,1,0,1,1,0,1
2023-06-01,57885,1,0,1,2,0,2
2023-06-01,57584,1,0,1,1,0,1
2023-06-01,57592,3,0,3,1,0,1
2023-06-01,57594,1,0,1,2,0,2
2023-06-01,198300,1,0,1,1,0,1
2023-06-01,198303,1,1,2,2,2,2
2023-06-01,61283,1,1,2,1,1,1
2023-06-01,57599,1,0,1,1,0,1
2023-06-01,212542,2,0,2,4,0,4
2023-06-01,29102,2,0,2,8,0,8
2023-06-01,202622,1,0,1,2,0,2
2023-06-01,57601,1,0,1,2,0,2
2023-06-01,61412,1,0,1,1,0,1
2023-06-01,60335,1,0,1,2,0,2
2023-06-01,197064,3,1,4,11,1,11
2023-06-01,57462,1,0,1,1,0,1
2023-06-01,57605,1,0,1,2,0,2
2023-06-01,31154,5,0,5,3,0,3
2023-06-01,328753,1,0,1,3,0,3
2023-06-01,34773,1,0,1,1,0,1
2023-06-01,42349,3,1,4,1,1,1
2023-06-01,60828,1,0,1,1,0,1
2023-06-01,198314,1,0,1,1,0,1
2023-06-01,49087,1,0,1,1,0,1
2023-06-01,62254,1,0,1,2,0,2
2023-06-01,44492,3,0,3,2,0,2
2023-06-01,198328,4,3,7,3,2,3
2023-06-01,198329,1,0,1,1,0,1
2023-06-01,57623,1,0,1,2,0,2
2023-06-01,198338,1,0,1,1,0,1
2023-06-01,57876,1,0,1,3,0,3
2023-06-01,21124,1,0,1,1,0,1
2023-06-01,35318,1,0,1,2,0,2
2023-06-01,57627,1,0,1,1,0,1
2023-06-01,203768,1,0,1,1,0,1
2023-06-01,212932,2,0,2,2,0,2
2023-06-01,212755,1,1,2,2,2,3
2023-06-01,198040,2,0,2,6,0,6
2023-06-01,39585,1,0,1,1,0,1
2023-06-01,197964,2,2,4,5,4,6
2023-06-01,198348,1,0,1,3,0,3
2023-06-01,198112,2,0,2,4,0,4
2023-06-01,49848,9,0,9,4,0,4
2023-06-01,57637,1,0,1,2,0,2
2023-06-01,56937,1,0,1,1,0,1
2023-06-01,198374,2,0,2,5,0,5
2023-06-01,34691,3,0,3,8,0,8
2023-06-01,49389,18,0,18,3,0,3
2023-06-01,207685,6,0,6,2,0,2
2023-06-01,57638,1,0,1,4,0,4
2023-06-01,34491,1,0,1,3,0,3
2023-06-01,198353,1,0,1,1,0,1
2023-06-01,35731,3,1,4,2,1,2
2023-06-01,198359,1,0,1,1,0,1
2023-06-01,198337,1,1,2,2,3,3
2023-06-01,57939,2,0,2,2,0,2
2023-06-01,12417,17,1,18,2,2,3
2023-06-01,57725,2,0,2,1,0,1
2023-06-01,42374,3,0,3,2,0,2
2023-06-01,206349,1,0,1,1,0,1
2023-06-01,198083,1,0,1,4,0,4
2023-06-01,213058,2,0,2,1,0,1
2023-06-01,207984,3,0,3,3,0,3
2023-06-01,198397,2,0,2,2,0,2
2023-06-01,52026,48,0,48,3,0,3
2023-06-01,57726,1,0,1,1,0,1
2023-06-01,43862,5,1,6,3,2,3
2023-06-01,57820,1,0,1,1,0,1
2023-06-01,57720,1,1,2,1,1,1
2023-06-01,2585,1,0,1,2,0,2
2023-06-01,50819,4,2,6,1,1,1
2023-06-01,198445,1,0,1,2,0,2
2023-06-01,57737,3,0,3,2,0,2
2023-06-01,49258,1,0,1,2,0,2
2023-06-01,57749,1,0,1,2,0,2
2023-06-01,198438,1,0,1,2,0,2
2023-06-01,197087,1,1,2,2,2,2
2023-06-01,198437,1,0,1,1,0,1
2023-06-01,15716,2,1,3,3,2,3
2023-06-01,39377,12,0,12,1,0,1
2023-06-01,210126,1,0,1,1,0,1
2023-06-01,198443,1,0,1,1,0,1
2023-06-01,198442,2,0,2,2,0,2
2023-06-01,198447,1,0,1,3,0,3
2023-06-01,57764,3,0,3,3,0,3
2023-06-01,198874,1,0,1,1,0,1
2023-06-01,198457,1,0,1,1,0,1
2023-06-01,211451,1,0,1,2,0,2
2023-06-01,48460,1,0,1,1,0,1
2023-06-01,213398,1,0,1,1,0,1
2023-06-01,213047,1,0,1,3,0,3
2023-06-01,204360,1,0,1,2,0,2
2023-06-01,209801,1,0,1,4,0,4
2023-06-01,209430,1,0,1,2,0,2
2023-06-01,31829,4,0,4,1,0,1
2023-06-01,203176,3,0,3,4,0,4
2023-06-01,57759,1,0,1,1,0,1
2023-06-01,57766,1,0,1,3,0,3
2023-06-01,204295,3,0,3,3,0,3
2023-06-01,51015,2,0,2,3,0,3
2023-06-01,57857,1,0,1,1,0,1
2023-06-01,198466,1,0,1,1,0,1
2023-06-01,57787,1,0,1,1,0,1
2023-06-01,57788,1,0,1,1,0,1
2023-06-01,201160,21,0,21,3,0,3
2023-06-01,198472,1,0,1,2,0,2
2023-06-01,198481,2,0,2,3,0,3
2023-06-01,16005,1,0,1,2,0,2
2023-06-01,57812,3,0,3,4,0,4
2023-06-01,198470,1,0,1,3,0,3
2023-06-01,59393,1,0,1,3,0,3
2023-06-01,57805,1,0,1,3,0,3
2023-06-01,28865,2,0,2,3,0,3
2023-06-01,35835,1,0,1,2,0,2
2023-06-01,57806,1,0,1,3,0,3
2023-06-01,31007,2,0,2,1,0,1
2023-06-01,201461,2,0,2,1,0,1
2023-06-01,198166,3,0,3,3,0,3
2023-06-01,198493,2,0,2,3,0,3
2023-06-01,39922,1,0,1,1,0,1
2023-06-01,199383,2,0,2,1,0,1
2023-06-01,57808,5,0,5,2,0,2
2023-06-01,198503,1,0,1,1,0,1
2023-06-01,50584,9,0,9,3,0,3
2023-06-01,57813,1,0,1,3,0,3
2023-06-01,57815,2,0,2,4,0,4
2023-06-01,61039,1,0,1,1,0,1
2023-06-01,212059,1,1,2,2,2,2
2023-06-01,198494,1,1,2,1,1,1
2023-06-01,198498,6,0,6,5,0,5
2023-06-01,35273,2,0,2,1,0,1
2023-06-01,198495,1,0,1,3,0,3
2023-06-01,57828,1,0,1,2,0,2
2023-06-01,198515,1,0,1,3,0,3
2023-06-01,200513,3,0,3,3,0,3
2023-06-01,198613,1,0,1,2,0,2
2023-06-01,205781,1,0,1,3,0,3
2023-06-01,206149,3,0,3,3,0,3
2023-06-01,3165,2,0,2,6,0,6
2023-06-01,57838,1,0,1,1,0,1
2023-06-01,57854,1,0,1,3,0,3
2023-06-01,198512,1,0,1,1,0,1
2023-06-01,20682,4,0,4,4,0,4
2023-06-01,198509,1,0,1,3,0,3
2023-06-01,57875,1,0,1,3,0,3
2023-06-01,212673,2,0,2,3,0,3
2023-06-01,198525,2,2,4,4,5,6
2023-06-01,198546,1,0,1,3,0,3
2023-06-01,198530,1,0,1,1,0,1
2023-06-01,205307,1,0,1,1,0,1
2023-06-01,198529,2,0,2,2,0,2
2023-06-01,58279,2,0,2,1,0,1
2023-06-01,198531,1,1,2,1,1,1
2023-06-01,198532,1,0,1,1,0,1
2023-06-01,198379,3,0,3,2,0,2
2023-06-01,57904,1,0,1,1,0,1
2023-06-01,198534,1,0,1,2,0,2
2023-06-01,198595,5,1,6,6,3,6
2023-06-01,212329,2,2,4,1,1,1
2023-06-01,198269,2,0,2,3,0,3
2023-06-01,3245,5,1,6,8,7,11
2023-06-01,212442,1,0,1,1,0,1
2023-06-01,213014,1,0,1,1,0,1
2023-06-01,57874,3,0,3,1,0,1
2023-06-01,198543,1,1,2,1,2,2
2023-06-01,60624,4,0,4,5,0,5
2023-06-01,57882,5,0,5,2,0,2
2023-06-01,211883,1,0,1,3,0,3
2023-06-01,57901,1,0,1,1,0,1
2023-06-01,57892,1,0,1,1,0,1
2023-06-01,198554,9,0,9,8,0,8
2023-06-01,57923,1,0,1,2,0,2
2023-06-01,57897,1,0,1,1,0,1
2023-06-01,57887,1,0,1,1,0,1
2023-06-01,198560,1,0,1,2,0,2
2023-06-01,30731,9,0,9,2,0,2
2023-06-01,57899,1,0,1,1,0,1
2023-06-01,198891,1,0,1,4,0,4
2023-06-01,38932,18,0,18,5,0,5
2023-06-01,202140,9,1,10,5,2,5
2023-06-01,60831,2,0,2,2,0,2
2023-06-01,57941,1,0,1,2,0,2
2023-06-01,57940,1,0,1,2,0,2
2023-06-01,198574,1,0,1,1,0,1
2023-06-01,14987,3,2,5,3,1,3
2023-06-01,57920,1,0,1,1,0,1
2023-06-01,31800,3,0,3,9,0,9
2023-06-01,57946,1,0,1,2,0,2
2023-06-01,39173,2,0,2,1,0,1
2023-06-01,210027,1,0,1,1,0,1
2023-06-01,49107,6,0,6,3,0,3
2023-06-01,57947,1,0,1,1,0,1
2023-06-01,57063,2,0,2,1,0,1
2023-06-01,44840,1,0,1,1,0,1
2023-06-01,16150,7,30,37,4,1,4
2023-06-01,198581,1,0,1,3,0,3
2023-06-01,59685,1,0,1,1,0,1
2023-06-01,47967,1,0,1,2,0,2
2023-06-01,198633,1,0,1,1,0,1
2023-06-01,35490,1,0,1,1,0,1
2023-06-01,49720,19,8,27,7,3,9
2023-06-01,47703,1,0,1,2,0,2
2023-06-01,57945,1,0,1,2,0,2
2023-06-01,198817,1,0,1,3,0,3
2023-06-01,198716,1,0,1,3,0,3
2023-06-01,57937,1,0,1,1,0,1
2023-06-01,57250,4,0,4,4,0,4
2023-06-01,198592,2,0,2,4,0,4
2023-06-01,198665,1,0,1,1,0,1
2023-06-01,198593,1,0,1,2,0,2
2023-06-01,57949,1,0,1,1,0,1
2023-06-01,57953,1,0,1,2,0,2
2023-06-01,57962,1,0,1,1,0,1
2023-06-01,57956,1,0,1,1,0,1
2023-06-01,34293,1,0,1,1,0,1
2023-06-01,57988,12,0,12,3,0,3
2023-06-01,42717,2,0,2,1,0,1
2023-06-01,198600,1,0,1,2,0,2
2023-06-01,39394,2,0,2,2,0,2
2023-06-01,1921,12,12,24,20,12,21
2023-06-01,57973,3,0,3,4,0,4
2023-06-01,206319,1,0,1,4,0,4
2023-06-01,198646,1,0,1,1,0,1
2023-06-01,29479,12,2,14,3,2,3
2023-06-01,60219,1,0,1,6,0,6
2023-06-01,57966,2,0,2,8,0,8
2023-06-01,198604,2,0,2,3,0,3
2023-06-01,56813,1,1,2,2,2,2
2023-06-01,199429,1,0,1,1,0,1
2023-06-01,198606,1,0,1,3,0,3
2023-06-01,5464,4,0,4,3,0,3
2023-06-01,15669,1,1,2,3,1,3
2023-06-01,198713,2,0,2,2,0,2
2023-06-01,57995,1,0,1,1,0,1
2023-06-01,57983,1,0,1,1,0,1
2023-06-01,57993,6,0,6,1,0,1
2023-06-01,28974,2,0,2,4,0,4
2023-06-01,57441,1,0,1,2,0,2
2023-06-01,58034,1,0,1,1,0,1
2023-06-01,34891,2,1,3,2,2,2
2023-06-01,57985,1,0,1,2,0,2
2023-06-01,198798,1,0,1,1,0,1
2023-06-01,58006,1,0,1,1,0,1
2023-06-01,212750,1,0,1,1,0,1
2023-06-01,8774,12,1,13,4,3,4
2023-06-01,58017,1,0,1,2,0,2
2023-06-01,206381,2,0,2,1,0,1
2023-06-01,57998,8,0,8,1,0,1
2023-06-01,198327,3,0,3,2,0,2
2023-06-01,211724,2,0,2,1,0,1
2023-06-01,198640,1,0,1,1,0,1
2023-06-01,35493,3,0,3,2,0,2
2023-06-01,201977,2,0,2,2,0,2
2023-06-01,58035,1,0,1,1,0,1
2023-06-01,198628,1,0,1,1,0,1
2023-06-01,58008,1,0,1,2,0,2
2023-06-01,209067,1,0,1,2,0,2
2023-06-01,44774,1,0,1,1,0,1
2023-06-01,58004,1,0,1,2,0,2
2023-06-01,58086,1,0,1,1,0,1
2023-06-01,59687,3,0,3,1,0,1
2023-06-01,198637,1,0,1,1,0,1
2023-06-01,29251,1,0,1,1,0,1
2023-06-01,198645,1,0,1,3,0,3
2023-06-01,9213,2,0,2,1,0,1
2023-06-01,207881,4,1,5,2,2,2
2023-06-01,199379,1,0,1,1,0,1
2023-06-01,197744,2,0,2,2,0,2
2023-06-01,198956,1,1,2,1,1,1
2023-06-01,12861,8,0,8,4,0,4
2023-06-01,212882,7,1,8,5,5,5
2023-06-01,44755,1,0,1,1,0,1
2023-06-01,210988,1,0,1,2,0,2
2023-06-01,58021,2,0,2,1,0,1
2023-06-01,198670,1,0,1,3,0,3
2023-06-01,58031,2,0,2,1,0,1
2023-06-01,48683,3,1,4,5,1,5
2023-06-01,58032,1,0,1,3,0,3
2023-06-01,198649,2,0,2,1,0,1
2023-06-01,31158,9,0,9,3,0,3
2023-06-01,58072,2,0,2,2,0,2
2023-06-01,198650,1,1,2,1,1,1
2023-06-01,198701,2,0,2,5,0,5
2023-06-01,44921,2,0,2,3,0,3
2023-06-01,58048,4,0,4,2,0,2
2023-06-01,199777,3,0,3,2,0,2
2023-06-01,50142,1,0,1,1,0,1
2023-06-01,60510,3,0,3,2,0,2
2023-06-01,48810,1,0,1,1,0,1
2023-06-01,198675,3,0,3,3,0,3
2023-06-01,50578,1,0,1,1,0,1
2023-06-01,61236,4,0,4,1,0,1
2023-06-01,198695,1,0,1,1,0,1
2023-06-01,58077,1,0,1,1,0,1
2023-06-01,43011,1,0,1,1,0,1
2023-06-01,44014,4,1,5,1,1,2
2023-06-01,203422,1,0,1,2,0,2
2023-06-01,56621,4,1,5,3,1,3
2023-06-01,57776,6,0,6,2,0,2
2023-06-01,31466,1,0,1,1,0,1
2023-06-01,58066,2,0,2,1,0,1
2023-06-01,34909,7,2,9,4,2,4
2023-06-01,198693,1,0,1,2,0,2
2023-06-01,198712,2,0,2,3,0,3
2023-06-01,198677,1,0,1,3,0,3
2023-06-01,202470,2,0,2,1,0,1
2023-06-01,198674,1,0,1,2,0,2
2023-06-01,57337,5,0,5,3,0,3
2023-06-01,198683,1,0,1,3,0,3
2023-06-01,198684,1,0,1,1,0,1
2023-06-01,198688,1,0,1,1,0,1
2023-06-01,58083,1,1,2,2,2,2
2023-06-01,198676,1,0,1,1,0,1
2023-06-01,60195,2,0,2,3,0,3
2023-06-01,199857,2,0,2,3,0,3
2023-06-01,58090,1,0,1,1,0,1
2023-06-01,58103,1,0,1,1,0,1
2023-06-01,50707,1,0,1,1,0,1
2023-06-01,198765,1,0,1,2,0,2
2023-06-01,198449,1,0,1,2,0,2
2023-06-01,56593,2,0,2,3,0,3
2023-06-01,58102,1,1,2,2,2,2
2023-06-01,208310,5,0,5,5,0,5
2023-06-01,49930,2,0,2,1,0,1
2023-06-01,56744,1,0,1,1,0,1
2023-06-01,210787,1,0,1,2,0,2
2023-06-01,3201,1,0,1,3,0,3
2023-06-01,3173,1,0,1,2,0,2
2023-06-01,58042,3,0,3,2,0,2
2023-06-01,207526,1,0,1,1,0,1
2023-06-01,47486,1,0,1,2,0,2
2023-06-01,199898,3,0,3,3,0,3
2023-06-01,3179,1,0,1,1,0,1
2023-06-01,198746,1,0,1,1,0,1
2023-06-01,198744,1,0,1,1,0,1
2023-06-01,58178,1,0,1,1,0,1
2023-06-01,58135,1,0,1,3,0,3
2023-06-01,60304,4,1,5,2,1,2
2023-06-01,50133,7,0,7,1,0,1
2023-06-01,58118,2,0,2,3,0,3
2023-06-01,59563,1,0,1,1,0,1
2023-06-01,198771,1,0,1,1,0,1
2023-06-01,58125,1,0,1,1,0,1
2023-06-01,199090,1,0,1,2,0,2
2023-06-01,41074,1,0,1,1,0,1
2023-06-01,13069,2,0,2,1,0,1
2023-06-01,199274,7,2,9,5,1,5
2023-06-01,58138,2,1,3,8,8,10
2023-06-01,48484,2,0,2,8,0,8
2023-06-01,58129,2,0,2,2,0,2
2023-06-01,206082,4,2,6,3,1,3
2023-06-01,198808,1,0,1,3,0,3
2023-06-01,205344,2,1,3,5,3,5
2023-06-01,213095,2,0,2,1,0,1
2023-06-01,58147,1,0,1,2,0,2
2023-06-01,198782,1,0,1,3,0,3
2023-06-01,59585,1,0,1,1,0,1
2023-06-01,58164,1,0,1,2,0,2
2023-06-01,58149,1,0,1,2,0,2
2023-06-01,58226,1,1,2,7,2,7
2023-06-01,58225,1,0,1,3,0,3
2023-06-01,198788,1,0,1,3,0,3
2023-06-01,198801,1,0,1,1,0,1
2023-06-01,58163,1,0,1,2,0,2
2023-06-01,58162,1,0,1,2,0,2
2023-06-01,198644,1,1,2,2,2,2
2023-06-01,198806,1,0,1,2,0,2
2023-06-01,198794,1,1,2,2,2,2
2023-06-01,58172,1,0,1,1,0,1
2023-06-01,58190,1,0,1,2,0,2
2023-06-01,198826,1,0,1,5,0,5
2023-06-01,60466,2,0,2,5,0,5
2023-06-01,211848,1,0,1,2,0,2
2023-06-01,211090,2,1,3,7,4,7
2023-06-01,43812,8,0,8,5,0,5
2023-06-01,198809,1,0,1,1,0,1
2023-06-01,58284,1,0,1,1,0,1
2023-06-01,58170,1,0,1,1,0,1
2023-06-01,60418,1,0,1,1,0,1
2023-06-01,58228,1,0,1,1,0,1
2023-06-01,198811,1,0,1,3,0,3
2023-06-01,8661,14,1,15,4,1,4
2023-06-01,213206,1,0,1,2,0,2
2023-06-01,209975,5,4,9,4,3,4
2023-06-01,198812,1,1,2,1,1,1
2023-06-01,58179,1,0,1,3,0,3
2023-06-01,201226,2,0,2,2,0,2
2023-06-01,58187,1,0,1,2,0,2
2023-06-01,58196,3,0,3,5,0,5
2023-06-01,58195,1,0,1,2,0,2
2023-06-01,58194,1,0,1,2,0,2
2023-06-01,208868,1,1,2,3,2,3
2023-06-01,198927,1,0,1,3,0,3
2023-06-01,198832,1,0,1,1,0,1
2023-06-01,198881,5,0,5,3,0,3
2023-06-01,58241,1,0,1,2,0,2
2023-06-01,198827,1,1,2,3,2,4
2023-06-01,58204,1,0,1,2,0,2
2023-06-01,198858,1,0,1,2,0,2
2023-06-01,198835,1,0,1,1,0,1
2023-06-01,202029,2,0,2,1,0,1
2023-06-01,198840,1,0,1,1,0,1
2023-06-01,201786,2,0,2,4,0,4
2023-06-01,58258,2,0,2,1,0,1
2023-06-01,58239,4,1,5,5,4,6
2023-06-01,58240,1,0,1,1,0,1
2023-06-01,198845,1,0,1,2,0,2
2023-06-01,199038,1,0,1,1,0,1
2023-06-01,198841,1,0,1,2,0,2
2023-06-01,51394,2,0,2,5,0,5
2023-06-01,198948,3,0,3,4,0,4
2023-06-01,58298,2,1,3,1,1,1
2023-06-01,198851,1,0,1,1,0,1
2023-06-01,199544,5,4,9,2,2,2
2023-06-01,50659,1,0,1,1,0,1
2023-06-01,198863,1,0,1,1,0,1
2023-06-01,57176,1,0,1,1,0,1
2023-06-01,58266,3,0,3,1,0,1
2023-06-01,198873,1,0,1,3,0,3
2023-06-01,201126,12,0,12,7,0,7
2023-06-01,59939,7,4,11,5,4,5
2023-06-01,57377,1,0,1,1,0,1
2023-06-01,198877,1,1,2,2,2,2
2023-06-01,198876,1,0,1,2,0,2
2023-06-01,198880,1,0,1,1,0,1
2023-06-01,50790,2,0,2,2,0,2
2023-06-01,58278,1,0,1,2,0,2
2023-06-01,8363,1,0,1,1,0,1
2023-06-01,58292,3,0,3,2,0,2
2023-06-01,31716,5,0,5,1,0,1
2023-06-01,198888,1,0,1,1,0,1
2023-06-01,58290,5,0,5,2,0,2
2023-06-01,50489,6,10,16,7,5,8
2023-06-01,51950,4,0,4,2,0,2
2023-06-01,58281,2,0,2,2,0,2
2023-06-01,198915,1,0,1,2,0,2
2023-06-01,212012,3,1,4,1,1,1
2023-06-01,58283,1,0,1,2,0,2
2023-06-01,199214,1,0,1,1,0,1
2023-06-01,198897,1,0,1,1,0,1
2023-06-01,39402,8,1,9,2,1,2
2023-06-01,198901,3,0,3,3,0,3
2023-06-01,198899,1,0,1,2,0,2
2023-06-01,47203,9,0,9,3,0,3
2023-06-01,207306,1,3,4,3,4,4
2023-06-01,198900,1,0,1,1,0,1
2023-06-01,198914,1,0,1,3,0,3
2023-06-01,198907,2,0,2,3,0,3
2023-06-01,58297,2,0,2,1,0,1
2023-06-01,52128,1,0,1,1,0,1
2023-06-01,198910,1,0,1,4,0,4
2023-06-01,198905,2,0,2,2,0,2
2023-06-01,58295,1,0,1,2,0,2
2023-06-01,58301,1,0,1,2,0,2
2023-06-01,48089,8,0,8,4,0,4
2023-06-01,212796,1,1,2,1,1,1
2023-06-01,48333,2,0,2,1,0,1
2023-06-01,59424,4,0,4,2,0,2
2023-06-01,199755,0,0,0,2,0,2
2023-06-01,58234,2,0,2,1,0,1
2023-06-01,198975,3,0,3,3,0,3
2023-06-01,59461,1,0,1,1,0,1
2023-06-01,58341,1,0,1,2,0,2
2023-06-01,59468,1,0,1,1,0,1
2023-06-01,59394,1,0,1,1,0,1
2023-06-01,198955,1,0,1,3,0,3
2023-06-01,58346,3,1,4,2,1,2
2023-06-01,59420,1,0,1,3,0,3
2023-06-01,38938,6,1,7,3,3,3
2023-06-01,198705,1,0,1,3,0,3
2023-06-01,59439,2,2,4,8,1,8
2023-06-01,199014,1,0,1,1,0,1
2023-06-01,43487,5,0,5,3,0,3
2023-06-01,59400,1,0,1,2,0,2
2023-06-01,59401,1,0,1,3,0,3
2023-06-01,198995,2,0,2,1,0,1
2023-06-01,44567,2,1,3,3,1,3
2023-06-01,198996,1,0,1,1,0,1
2023-06-01,59416,1,0,1,3,0,3
2023-06-01,59465,1,0,1,2,0,2
2023-06-01,198982,1,0,1,1,0,1
2023-06-01,59619,2,0,2,1,0,1
2023-06-01,198986,2,0,2,2,0,2
2023-06-01,60805,1,1,2,2,2,2
2023-06-01,199117,2,0,2,2,0,2
2023-06-01,49993,1,0,1,1,0,1
2023-06-01,198992,1,1,2,3,2,3
2023-06-01,199016,1,0,1,2,0,2
2023-06-01,59459,2,0,2,3,0,3
2023-06-01,44505,1,0,1,4,0,4
2023-06-01,43234,1,0,1,3,0,3
2023-06-01,42119,1,0,1,4,0,4
2023-06-01,59573,1,0,1,2,0,2
2023-06-01,59442,1,0,1,1,0,1
2023-06-01,199010,1,0,1,2,0,2
2023-06-01,198664,1,0,1,1,0,1
2023-06-01,199005,3,0,3,4,0,4
2023-06-01,199007,1,0,1,3,0,3
2023-06-01,59452,1,0,1,1,0,1
2023-06-01,209828,6,1,7,2,1,2
2023-06-01,210517,1,0,1,1,0,1
2023-06-01,199165,1,1,2,1,1,1
2023-06-01,199022,1,0,1,2,0,2
2023-06-01,59454,1,0,1,1,0,1
2023-06-01,48505,3,0,3,3,0,3
2023-06-01,199029,4,0,4,2,0,2
2023-06-01,199013,1,0,1,2,0,2
2023-06-01,199649,1,0,1,2,0,2
2023-06-01,59495,2,0,2,3,0,3
2023-06-01,50358,4,0,4,4,0,4
2023-06-01,16320,1,0,1,1,0,1
2023-06-01,51180,2,0,2,1,0,1
2023-06-01,50780,15,0,15,1,0,1
2023-06-01,59478,6,0,6,1,0,1
2023-06-01,50751,4,0,4,1,0,1
2023-06-01,199113,2,0,2,2,0,2
2023-06-01,54903,4,0,4,1,0,1
2023-06-01,207246,4,0,4,3,0,3
2023-06-01,43094,2,0,2,1,0,1
2023-06-01,202722,2,0,2,1,0,1
2023-06-01,202943,3,0,3,2,0,2
2023-06-01,199064,6,0,6,5,0,5
2023-06-01,61335,1,2,3,1,1,1
2023-06-01,57781,20,0,20,6,0,6
2023-06-01,199119,1,0,1,1,0,1
2023-06-01,43849,2,0,2,4,3,4
2023-06-01,199070,4,1,5,5,2,5
2023-06-01,62359,1,2,3,1,1,1
2023-06-01,199069,1,0,1,1,0,1
2023-06-01,59531,1,0,1,1,0,1
2023-06-01,59534,2,0,2,2,0,2
2023-06-01,58126,1,0,1,1,0,1
2023-06-01,199147,1,0,1,1,0,1
2023-06-01,199076,3,0,3,3,0,3
2023-06-01,198179,1,0,1,1,0,1
2023-06-01,198761,5,0,5,2,0,2
2023-06-01,56962,2,0,2,3,0,3
2023-06-01,50352,5,1,6,8,6,10
2023-06-01,210525,1,0,1,1,0,1
2023-06-01,198091,1,0,1,3,0,3
2023-06-01,59571,1,0,1,2,0,2
2023-06-01,199074,2,0,2,2,0,2
2023-06-01,61360,16,0,16,3,0,3
2023-06-01,212285,3,0,3,2,0,2
2023-06-01,212489,1,0,1,1,0,1
2023-06-01,61960,2,0,2,2,0,2
2023-06-01,59548,1,0,1,2,0,2
2023-06-01,59544,1,0,1,1,0,1
2023-06-01,59553,1,0,1,1,0,1
2023-06-01,50092,2,0,2,1,0,1
2023-06-01,8192,22,0,22,7,0,7
2023-06-01,59593,1,0,1,3,0,3
2023-06-01,59591,1,0,1,4,0,4
2023-06-01,59636,1,0,1,3,0,3
2023-06-01,204954,1,0,1,1,0,1
2023-06-01,31503,1,0,1,1,0,1
2023-06-01,59600,2,0,2,2,0,2
2023-06-01,199121,1,1,2,2,2,3
2023-06-01,59604,1,0,1,3,0,3
2023-06-01,203416,5,6,11,6,4,6
2023-06-01,203058,15,3,18,3,1,3
2023-06-01,60847,4,0,4,3,0,3
2023-06-01,204401,1,0,1,1,0,1
2023-06-01,199131,1,0,1,2,0,2
2023-06-01,197375,1,0,1,3,0,3
2023-06-01,199125,2,0,2,4,0,4
2023-06-01,202288,1,1,2,1,1,1
2023-06-01,204383,2,1,3,1,1,1
2023-06-01,212224,1,1,2,1,1,1
2023-06-01,198122,1,0,1,1,0,1
2023-06-01,197315,2,0,2,2,0,2
2023-06-01,59611,2,0,2,4,0,4
2023-06-01,199638,1,0,1,2,0,2
2023-06-01,199663,1,0,1,2,0,2
2023-06-01,41131,1,0,1,1,0,1
2023-06-01,204699,1,0,1,1,0,1
2023-06-01,59614,1,0,1,2,0,2
2023-06-01,59680,1,0,1,1,0,1
2023-06-01,199144,1,0,1,1,0,1
2023-06-01,199149,1,0,1,1,0,1
2023-06-01,30891,1,0,1,1,0,1
2023-06-01,209596,1,0,1,1,0,1
2023-06-01,39342,1,0,1,2,0,2
2023-06-01,52223,1,0,1,1,0,1
2023-06-01,59616,13,0,13,2,0,2
2023-06-01,51196,1,0,1,1,0,1
2023-06-01,199526,2,0,2,3,0,3
2023-06-01,199151,1,0,1,1,0,1
2023-06-01,198778,1,0,1,1,0,1
2023-06-01,199153,1,0,1,1,0,1
2023-06-01,42214,2,2,4,1,1,1
2023-06-01,56905,3,0,3,3,0,3
2023-06-01,210612,1,0,1,1,0,1
2023-06-01,59990,4,1,5,1,2,2
2023-06-01,60272,1,0,1,3,0,3
2023-06-01,198133,1,0,1,2,0,2
2023-06-01,59648,1,0,1,1,0,1
2023-06-01,199049,1,0,1,2,0,2
2023-06-01,212496,6,1,7,1,1,1
2023-06-01,209221,1,1,2,2,1,2
2023-06-01,59635,1,0,1,1,0,1
2023-06-01,51347,1,0,1,3,0,3
2023-06-01,199167,2,1,3,1,1,1
2023-06-01,210078,6,0,6,1,0,1
2023-06-01,210593,2,0,2,1,0,1
2023-06-01,200066,1,0,1,1,0,1
2023-06-01,196741,1,0,1,1,0,1
2023-06-01,59641,1,0,1,1,0,1
2023-06-01,29588,14,2,16,4,4,5
2023-06-01,198865,1,0,1,2,0,2
2023-06-01,199179,1,0,1,2,0,2
2023-06-01,59663,1,0,1,1,0,1
2023-06-01,62232,1,0,1,1,0,1
2023-06-01,62315,2,0,2,1,0,1
2023-06-01,61179,1,0,1,1,0,1
2023-06-01,61243,1,0,1,2,0,2
2023-06-01,62065,1,0,1,3,0,3
2023-06-01,209926,1,0,1,2,0,2
2023-06-01,62083,2,1,3,2,1,2
2023-06-01,198803,3,0,3,1,0,1
2023-06-01,211687,3,0,3,1,0,1
2023-06-01,62008,6,1,7,3,1,3
2023-06-01,211433,3,0,3,1,0,1
2023-06-01,204584,2,0,2,1,0,1
2023-06-01,62006,3,0,3,3,0,3
2023-06-01,61979,4,0,4,3,0,3
2023-06-01,42447,2,0,2,3,0,3
2023-06-01,59734,4,0,4,2,0,2
2023-06-01,209954,1,0,1,2,0,2
2023-06-01,209922,1,0,1,2,0,2
2023-06-01,210725,1,0,1,3,0,3
2023-06-01,204467,2,2,4,1,1,1
2023-06-01,39707,17,0,17,2,0,2
2023-06-01,197825,8,8,16,6,3,6
2023-06-01,44741,14,0,14,1,0,1
2023-06-01,206067,157,36,193,7,6,8
2023-06-01,44442,1,0,1,1,0,1
2023-06-01,42176,3,0,3,7,0,7
2023-06-01,44276,1,0,1,2,0,2
2023-06-01,2871,0,0,0,1,0,1
2023-06-01,31644,2,0,2,1,0,1
2023-06-01,35527,14,0,14,2,0,2
2023-06-01,44292,5,0,5,1,0,1
2023-06-01,44295,2,1,3,3,2,3
2023-06-01,5463,3,1,4,4,2,4
2023-06-01,44298,1,0,1,1,0,1
2023-06-01,49533,2,0,2,3,0,3
2023-06-01,33835,5,1,6,5,4,5
2023-06-01,48052,1,0,1,2,0,2
2023-06-01,47949,1,0,1,7,0,7
2023-06-01,44366,2,0,2,3,0,3
2023-06-01,44424,4,0,4,2,0,2
2023-06-01,60111,11,7,18,7,4,7
2023-06-01,42789,2,1,3,1,1,2
2023-06-01,49322,1,1,2,3,2,3
2023-06-01,47128,2,0,2,3,0,3
2023-06-01,199945,12,0,12,1,0,1
2023-06-01,60730,4,0,4,5,0,5
2023-06-01,202570,1,0,1,1,0,1
2023-06-01,62340,3,0,3,5,0,5
2023-06-01,44465,1,0,1,1,0,1
2023-06-01,44644,1,1,2,2,2,2
2023-06-01,44460,2,0,2,2,0,2
2023-06-01,16128,5,1,6,6,4,7
2023-06-01,44766,1,0,1,1,0,1
2023-06-01,51206,1,0,1,2,0,2
2023-06-01,48313,2,0,2,1,0,1
2023-06-01,51575,1,0,1,1,0,1
2023-06-01,50482,51,0,51,6,0,6
2023-06-01,44483,1,0,1,1,0,1
2023-06-01,204304,1,0,1,2,0,2
2023-06-01,198816,1,0,1,1,0,1
2023-06-01,60856,5,0,5,3,0,3
2023-06-01,204168,4,0,4,3,0,3
2023-06-01,62051,1,0,1,2,0,2
2023-06-01,207107,1,0,1,2,0,2
2023-06-01,400536,5,1,6,1,1,1
2023-06-01,198549,4,1,5,2,2,2
2023-06-01,203315,6,4,10,3,3,3
2023-06-01,1152,1,2,3,1,1,1
2023-06-01,212849,4,0,4,1,0,1
2023-06-01,199769,1,0,1,1,0,1
2023-06-01,199773,3,0,3,1,0,1
2023-06-01,8878,2,1,3,11,8,12
2023-06-01,44229,1,1,2,1,1,1
2023-06-01,44765,1,0,1,7,0,7
2023-06-01,44302,2,0,2,5,0,5
2023-06-01,212650,2,1,3,1,1,1
2023-06-01,5542,7,0,7,2,0,2
2023-06-01,211325,1,1,2,1,1,1
2023-06-01,44384,2,0,2,5,0,5
2023-06-01,202122,1,0,1,1,0,1
2023-06-01,47237,13,2,15,4,3,4
2023-06-01,208119,1,0,1,1,0,1
2023-06-01,47684,6,0,6,5,0,5
2023-06-01,49633,3,2,5,4,2,4
2023-06-01,39845,5,1,6,5,2,5
2023-06-01,44575,10,0,10,2,0,2
2023-06-01,39814,3,0,3,3,0,3
2023-06-01,15615,2,0,2,1,0,1
2023-06-01,3281,2,0,2,3,0,3
2023-06-01,51268,1,0,1,1,0,1
2023-06-01,44446,3,0,3,1,0,1
2023-06-01,44942,10,0,10,4,0,4
2023-06-01,48083,6,0,6,5,0,5
2023-06-01,35270,1,0,1,3,0,3
2023-06-01,34601,1,1,2,1,1,1
2023-06-01,56684,1,0,1,2,0,2
2023-06-01,209211,1,0,1,1,0,1
2023-06-01,205479,4,3,7,7,6,8
2023-06-01,49031,1,0,1,2,0,2
2023-06-01,209440,1,0,1,1,0,1
2023-06-01,209284,10,0,10,4,0,4
2023-06-01,209927,2,0,2,1,0,1
2023-06-01,56642,3,0,3,1,0,1
2023-06-01,199263,1,0,1,2,0,2
2023-06-01,21269,2,1,3,1,1,1
2023-06-01,209166,1,0,1,1,0,1
2023-06-01,207597,1,1,2,4,2,5
2023-06-01,33058,7,0,7,6,0,6
2023-06-01,57935,8,0,8,6,0,6
2023-06-01,202682,2,2,4,3,1,3
2023-06-01,35357,5,0,5,2,0,2
2023-06-01,57650,1,0,1,1,0,1
2023-06-01,211811,1,0,1,1,0,1
2023-06-01,398129,1,0,1,1,0,1
2023-06-01,207704,2,0,2,1,0,1
2023-06-01,211379,1,0,1,1,0,1
2023-06-01,57898,5,0,5,8,0,8
2023-06-01,35351,1,0,1,1,0,1
2023-06-01,197190,6,2,8,2,1,2
2023-06-01,213117,1,0,1,2,0,2
2023-06-01,209217,1,0,1,2,0,2
2023-06-01,35305,2,0,2,1,0,1
2023-06-01,35241,1,0,1,1,0,1
2023-06-01,60142,18,3,21,7,2,7
2023-06-01,21499,21,4,25,1,1,1
2023-06-01,398108,2,0,2,1,0,1
2023-06-01,34289,2,1,3,1,1,1
2023-06-01,60253,4,6,10,1,1,1
2023-06-01,62112,2,0,2,1,0,1
2023-06-01,59650,1,0,1,1,0,1
2023-06-01,58014,3,1,4,1,1,1
2023-06-01,201192,1,0,1,1,0,1
2023-06-01,210082,1,0,1,2,0,2
2023-06-01,210081,1,1,2,2,2,2
2023-06-01,44385,2,1,3,1,1,1
2023-06-01,60823,3,1,4,2,2,4
2023-06-01,31642,4,0,4,1,0,1
2023-06-01,44631,1,1,2,1,1,1
2023-06-01,209816,1,0,1,1,0,1
2023-06-01,60296,1,0,1,2,0,2
2023-06-01,60432,2,1,3,2,1,2
2023-06-01,21086,6,0,6,4,0,4
2023-06-01,43364,21,2,23,6,2,6
2023-06-01,200616,1,0,1,2,0,2
2023-06-01,47136,15,0,15,3,0,3
2023-06-01,207918,1,0,1,1,0,1
2023-06-01,210819,1,1,2,1,1,1
2023-06-01,47723,35,1,36,5,4,6
2023-06-01,210024,1,0,1,1,0,1
2023-06-01,56661,2,0,2,1,0,1
2023-06-01,44525,16,0,16,3,0,3
2023-06-01,56371,1,0,1,2,0,2
2023-06-01,61321,1,0,1,2,0,2
2023-06-01,43943,2,0,2,2,0,2
2023-06-01,201406,1,0,1,2,0,2
2023-06-01,3187,1,0,1,1,0,1
2023-06-01,62411,1,0,1,2,0,2
2023-06-01,39488,4,0,4,1,0,1
2023-06-01,213130,2,0,2,2,0,2
2023-06-01,209852,1,0,1,1,0,1
2023-06-01,209179,1,0,1,4,0,4
2023-06-01,209213,1,0,1,1,0,1
2023-06-01,209248,1,0,1,1,0,1
2023-06-01,209668,1,0,1,1,0,1
2023-06-01,209229,1,0,1,2,0,2
2023-06-01,207677,1,0,1,1,0,1
2023-06-01,212333,1,0,1,1,0,1
2023-06-01,212480,1,0,1,1,0,1
2023-06-01,200679,1,0,1,2,0,2
2023-06-01,205396,1,0,1,1,0,1
2023-06-01,209679,1,0,1,1,0,1
2023-06-01,209445,1,0,1,2,0,2
2023-06-01,212772,3,1,4,2,1,2
2023-06-01,200632,1,1,2,1,1,1
2023-06-01,209099,1,0,1,4,0,4
2023-06-01,47806,17,0,17,4,0,4
2023-06-01,199534,1,0,1,4,0,4
2023-06-01,199281,1,0,1,1,0,1
2023-06-01,5468,6,0,6,4,0,4
2023-06-01,44868,1,0,1,1,0,1
2023-06-01,44973,2,2,4,8,8,10
2023-06-01,196733,3,1,4,1,1,2
2023-06-01,198813,3,1,4,3,1,3
2023-06-01,52157,4,1,5,2,2,2
2023-06-01,201328,3,0,3,2,0,2
2023-06-01,45055,20,0,20,1,0,1
2023-06-01,47295,3,1,4,2,2,2
2023-06-01,47134,6,0,6,2,0,2
2023-06-01,62023,30,2,32,8,6,9
2023-06-01,197711,5,0,5,1,0,1
2023-06-01,207361,1,0,1,1,0,1
2023-06-01,47269,5,1,6,3,1,3
2023-06-01,44447,1,0,1,2,0,2
2023-06-01,43097,4,1,5,3,2,4
2023-06-01,59696,1,0,1,3,0,3
2023-06-01,44793,12,0,12,1,0,1
2023-06-01,202273,1,0,1,1,0,1
2023-06-01,25189,4,0,4,7,0,7
2023-06-01,44542,3,0,3,1,0,1
2023-06-01,41363,3,0,3,2,0,2
2023-06-01,44767,1,0,1,3,0,3
2023-06-01,44923,2,1,3,4,2,4
2023-06-01,56366,1,1,2,1,1,1
2023-06-01,47446,1,0,1,2,0,2
2023-06-01,400687,2,0,2,5,0,5
2023-06-01,28742,4,0,4,3,0,3
2023-06-01,44637,3,0,3,1,0,1
2023-06-01,199101,1,1,2,1,1,1
2023-06-01,44613,1,0,1,1,0,1
2023-06-01,44763,2,0,2,1,0,1
2023-06-01,44646,12,0,12,10,0,10
2023-06-01,8301,32,1,33,16,6,18
2023-06-01,201707,3,0,3,1,0,1
2023-06-01,201189,1,1,2,3,1,3
2023-06-01,48092,4,0,4,5,0,5
2023-06-01,8934,27,0,27,4,0,4
2023-06-01,212208,10,0,10,3,0,3
2023-06-01,44701,1,0,1,1,0,1
2023-06-01,205773,1,1,2,1,1,1
2023-06-01,44707,2,0,2,2,0,2
2023-06-01,210785,1,1,2,1,1,1
2023-06-01,59569,3,0,3,1,0,1
2023-06-01,44791,5,0,5,1,0,1
2023-06-01,997,21,2,23,7,5,9
2023-06-01,34219,7,1,8,2,2,2
2023-06-01,6829,1,1,2,1,1,1
2023-06-01,43679,1,0,1,1,0,1
2023-06-01,60227,7,0,7,1,0,1
2023-06-01,6907,3,0,3,2,0,2
2023-06-01,44785,1,0,1,1,0,1
2023-06-01,44891,9,1,10,1,1,1
2023-06-01,44946,8,7,15,2,3,3
2023-06-01,205937,1,0,1,1,0,1
2023-06-01,44816,10,0,10,4,0,4
2023-06-01,34749,2,1,3,2,1,2
2023-06-01,29434,5,0,5,4,0,4
2023-06-01,206461,2,0,2,1,0,1
2023-06-01,44881,3,1,4,1,1,1
2023-06-01,213002,6,1,7,1,1,1
2023-06-01,44902,6,0,6,7,0,7
2023-06-01,48057,4,0,4,1,0,1
2023-06-01,44275,1,0,1,1,0,1
2023-06-01,60690,7,0,7,2,0,2
2023-06-01,196737,2,0,2,1,0,1
2023-06-01,24594,4,1,5,7,4,7
2023-06-01,202058,10,0,10,2,0,2
2023-06-01,44913,2,0,2,3,0,3
2023-06-01,28730,13,0,13,1,0,1
2023-06-01,41090,7,2,9,8,4,8
2023-06-01,207163,2,1,3,3,3,3
2023-06-01,8915,1,0,1,1,0,1
2023-06-01,35574,4,9,13,16,9,17
2023-06-01,48768,8,0,8,7,3,7
2023-06-01,61315,18,0,18,3,0,3
2023-06-01,210019,1,0,1,2,0,2
2023-06-01,206717,2,0,2,2,0,2
2023-06-01,57392,2,0,2,2,0,2
2023-06-01,47619,1,0,1,1,0,1
2023-06-01,201630,6,1,7,1,1,1
2023-06-01,56615,1,0,1,2,0,2
2023-06-01,198144,21,0,21,3,0,3
2023-06-01,44605,1,1,2,1,1,1
2023-06-01,61334,1,0,1,3,0,3
2023-06-01,48067,4,0,4,4,0,4
2023-06-01,12356,1,0,1,1,0,1
2023-06-01,200492,7,0,7,3,0,3
2023-06-01,44854,1,1,2,12,4,14
2023-06-01,48808,1,0,1,1,0,1
2023-06-01,206807,2,1,3,1,1,1
2023-06-01,212929,2,0,2,2,0,2
2023-06-01,211412,1,0,1,2,0,2
2023-06-01,210713,1,0,1,1,0,1
2023-06-01,61278,1,0,1,1,0,1
2023-06-01,210718,1,17,18,1,1,1
2023-06-01,48999,1,0,1,1,0,1
2023-06-01,50660,1,0,1,2,0,2
2023-06-01,57180,1,0,1,1,0,1
2023-06-01,51832,1,0,1,2,0,2
2023-06-01,49298,1,0,1,1,0,1
2023-06-01,58337,1,0,1,3,0,3
2023-06-01,60100,1,0,1,4,0,4
2023-06-01,208389,6,0,6,4,0,4
2023-06-01,198860,1,0,1,3,0,3
2023-06-01,43068,2,0,2,4,0,4
2023-06-01,202129,4,1,5,3,1,3
2023-06-01,199871,3,0,3,3,0,3
2023-06-01,60337,2,0,2,1,0,1
2023-06-01,50929,4,0,4,1,0,1
2023-06-01,56920,1,0,1,2,0,2
2023-06-01,60367,6,0,6,2,0,2
2023-06-01,50492,3,0,3,1,0,1
2023-06-01,50685,15,1,16,2,1,2
2023-06-01,50593,6,0,6,1,0,1
2023-06-01,59861,4,2,6,1,1,1
2023-06-01,51276,2,0,2,2,0,2
2023-06-01,61235,1,0,1,1,0,1
2023-06-01,50176,4,0,4,2,0,2
2023-06-01,210153,2,0,2,1,0,1
2023-06-01,49526,1,0,1,2,0,2
2023-06-01,50345,1,1,2,1,1,1
2023-06-01,35587,1,0,1,1,0,1
2023-06-01,50934,1,0,1,1,0,1
2023-06-01,50294,3,1,4,1,1,1
2023-06-01,56742,1,0,1,1,0,1
2023-06-01,31250,10,0,10,5,0,5
2023-06-01,42295,3,1,4,8,4,9
2023-06-01,44313,7,0,7,3,0,3
2023-06-01,56906,2,0,2,1,0,1
2023-06-01,25141,2,0,2,2,0,2
2023-06-01,213375,1,0,1,1,0,1
2023-06-01,24758,2,0,2,5,0,5
2023-06-01,206395,1,0,1,1,0,1
2023-06-01,204822,1,0,1,1,0,1
2023-06-01,204820,1,0,1,1,0,1
2023-06-01,204477,1,0,1,3,0,3
2023-06-01,199023,2,0,2,1,0,1
2023-06-01,40961,2,0,2,3,0,3
2023-06-01,29522,23,0,23,5,0,5
2023-06-01,34360,2,0,2,1,0,1
2023-06-01,197879,3,2,5,1,1,1
2023-06-01,9150,14,5,19,13,7,15
2023-06-01,201819,1,0,1,1,0,1
2023-06-01,49403,21,0,21,5,0,5
2023-06-01,212947,4,0,4,3,0,3
2023-06-01,44139,1,0,1,2,0,2
2023-06-01,41029,1,1,2,3,2,3
2023-06-01,60956,1,0,1,1,0,1
2023-06-01,47963,1,0,1,2,0,2
2023-06-01,60095,3,2,5,2,1,3
2023-06-01,47866,11,0,11,5,0,5
2023-06-01,60569,4,0,4,3,0,3
2023-06-01,205384,3,0,3,2,0,2
2023-06-01,62201,4,0,4,4,0,4
2023-06-01,199774,1,0,1,4,0,4
2023-06-01,202061,1,0,1,4,0,4
2023-06-01,205148,1,14,15,3,2,3
2023-06-01,196838,20,0,20,1,0,1
2023-06-01,47549,4,0,4,1,0,1
2023-06-01,61985,3,0,3,1,0,1
2023-06-01,60754,12,0,12,7,0,7
2023-06-01,60573,4,0,4,1,0,1
2023-06-01,49184,4,0,4,3,0,3
2023-06-01,29035,1,0,1,1,0,1
2023-06-01,213029,2,0,2,2,0,2
2023-06-01,60612,5,0,5,1,0,1
2023-06-01,59430,1,0,1,2,0,2
2023-06-01,200123,1,0,1,3,0,3
2023-06-01,213182,1,0,1,3,0,3
2023-06-01,207896,1,0,1,2,0,2
2023-06-01,3180,1,1,2,3,1,3
2023-06-01,3229,3,0,3,1,0,1
2023-06-01,50438,2,1,3,1,1,1
2023-06-01,49682,1,0,1,1,0,1
2023-06-01,25015,1,0,1,1,0,1
2023-06-01,25548,1,0,1,1,0,1
2023-06-01,35325,7,1,8,6,1,7
2023-06-01,57197,9,0,9,3,0,3
2023-06-01,62150,1,0,1,1,0,1
2023-06-01,202362,1,0,1,1,0,1
2023-06-01,205264,2,0,2,3,0,3
2023-06-01,61989,1,0,1,2,0,2
2023-06-01,42350,2,0,2,3,0,3
2023-06-01,212210,2,0,2,1,0,1
2023-06-01,59762,1,0,1,1,0,1
2023-06-01,198056,27,0,27,3,0,3
2023-06-01,210778,3,0,3,3,0,3
2023-06-01,208038,1,0,1,2,0,2
2023-06-01,61384,6,1,7,1,1,1
2023-06-01,44019,4,0,4,3,0,3
2023-06-01,58309,3,0,3,4,0,4
2023-06-01,50043,2,0,2,3,0,3
2023-06-01,211587,1,0,1,2,0,2
2023-06-01,41245,2,0,2,3,0,3
2023-06-01,42704,3,0,3,1,0,1
2023-06-01,41271,3,0,3,2,0,2
2023-06-01,8511,1,1,2,4,1,4
2023-06-01,212432,1,0,1,1,0,1
2023-06-01,62327,1,0,1,2,0,2
2023-06-01,210768,3,0,3,1,0,1
2023-06-01,56418,6,0,6,5,0,5
2023-06-01,61308,12,0,12,6,0,6
2023-06-01,200218,5,0,5,1,0,1
2023-06-01,40983,3,0,3,2,0,2
2023-06-01,39667,1,0,1,1,0,1
2023-06-01,41102,1,0,1,1,0,1
2023-06-01,198539,6,1,7,5,2,6
2023-06-01,207154,1,0,1,1,0,1
2023-06-01,39631,1,0,1,1,0,1
2023-06-01,9058,1,0,1,3,0,3
2023-06-01,208876,2,0,2,2,0,2
2023-06-01,212303,1,0,1,2,0,2
2023-06-01,49442,3,0,3,1,0,1
2023-06-01,207340,1,0,1,2,0,2
2023-06-01,20536,1,0,1,2,0,2
2023-06-01,28719,0,0,0,2,0,2
2023-06-01,56387,3,0,3,3,0,3
2023-06-01,60603,2,0,2,1,0,1
2023-06-01,210063,2,0,2,1,0,1
2023-06-01,44359,3,0,3,2,0,2
2023-06-01,61406,5,0,5,4,0,4
2023-06-01,62330,1,0,1,2,0,2
2023-06-01,201591,1,0,1,2,0,2
2023-06-01,204619,2,0,2,2,0,2
2023-06-01,59718,1,0,1,3,0,3
2023-06-01,47349,3,0,3,2,0,2
2023-06-01,51214,2,0,2,2,0,2
2023-06-01,61433,2,0,2,1,0,1
2023-06-01,58047,1,0,1,1,0,1
2023-06-01,59826,1,0,1,2,0,2
2023-06-01,59825,1,0,1,2,0,2
2023-06-01,210845,1,1,2,1,1,1
2023-06-01,48949,2,0,2,3,0,3
2023-06-01,61371,3,0,3,2,0,2
2023-06-01,210870,1,0,1,1,0,1
2023-06-01,61249,1,0,1,2,0,2
2023-06-01,61277,1,0,1,4,0,4
2023-06-01,44200,1,0,1,1,0,1
2023-06-01,212118,1,0,1,2,0,2
2023-06-01,61196,4,0,4,4,0,4
2023-06-01,61123,1,0,1,1,0,1
2023-06-01,51495,5,0,5,4,0,4
2023-06-01,20661,15,1,16,8,1,8
2023-06-01,211570,1,0,1,3,0,3
2023-06-01,61116,2,0,2,1,0,1
2023-06-01,204336,1,0,1,1,0,1
2023-06-01,208605,1,0,1,1,0,1
2023-06-01,208870,1,0,1,1,0,1
2023-06-01,50400,1,0,1,1,0,1
2023-06-01,16227,1,0,1,1,0,1
2023-06-01,212392,1,0,1,2,0,2
2023-06-01,208067,5,0,5,3,0,3
2023-06-01,47871,1,0,1,1,0,1
2023-06-01,57205,2,0,2,1,0,1
2023-06-01,47521,21,1,22,1,1,1
2023-06-01,48703,3,0,3,1,0,1
2023-06-01,34816,3,2,5,2,2,2
2023-06-01,49150,1,0,1,1,0,1
2023-06-01,51656,1,0,1,1,0,1
2023-06-01,47506,2,1,3,2,1,2
2023-06-01,197219,1,1,2,7,4,8
2023-06-01,48375,2,0,2,1,0,1
2023-06-01,47563,4,0,4,2,0,2
2023-06-01,44782,1,0,1,1,0,1
2023-06-01,197355,1,0,1,1,0,1
2023-06-01,47889,2,0,2,1,0,1
2023-06-01,209791,3,0,3,1,0,1
2023-06-01,210058,3,0,3,2,0,2
2023-06-01,203848,5,0,5,2,0,2
2023-06-01,211315,29,0,29,1,0,1
2023-06-01,11161,9,1,10,1,1,1
2023-06-01,213111,1,0,1,2,0,2
2023-06-01,213096,1,0,1,3,0,3
2023-06-01,207418,2,0,2,1,0,1
2023-06-01,209059,3,1,4,4,1,4
2023-06-01,212414,2,1,3,2,2,2
2023-06-01,213175,1,0,1,1,0,1
2023-06-01,200687,1,0,1,2,0,2
2023-06-01,213133,1,0,1,2,0,2
2023-06-01,47510,1,0,1,1,0,1
2023-06-01,197965,6,1,7,7,2,7
2023-06-01,57559,1,0,1,2,0,2
2023-06-01,209602,1,0,1,1,0,1
2023-06-01,62456,1,0,1,1,0,1
2023-06-01,199320,3,0,3,1,0,1
2023-06-01,41802,3,0,3,6,0,6
2023-06-01,47155,2,0,2,6,0,6
2023-06-01,47206,2,0,2,1,0,1
2023-06-01,10455,94,3,97,7,1,7
2023-06-01,39784,2,0,2,2,0,2
2023-06-01,47240,1,0,1,1,0,1
2023-06-01,43066,16,6,22,3,2,3
2023-06-01,34527,1,1,2,3,1,3
2023-06-01,47304,2,1,3,2,1,2
2023-06-01,47351,4,0,4,5,0,5
2023-06-01,56456,1,1,2,5,1,6
2023-06-01,29184,3,0,3,2,0,2
2023-06-01,200923,5,0,5,1,0,1
2023-06-01,47473,6,0,6,1,0,1
2023-06-01,31147,2,0,2,1,0,1
2023-06-01,43960,1,0,1,1,0,1
2023-06-01,48097,3,0,3,1,0,1
2023-06-01,57573,10,0,10,7,0,7
2023-06-01,42933,1,0,1,2,0,2
2023-06-01,211616,3,0,3,5,0,5
2023-06-01,47727,1,1,2,3,1,3
2023-06-01,212975,2,1,3,2,1,2
2023-06-01,21276,2,0,2,1,0,1
2023-06-01,47620,4,0,4,1,0,1
2023-06-01,48027,1,0,1,1,0,1
2023-06-01,47617,8,0,8,3,0,3
2023-06-01,47663,4,0,4,3,0,3
2023-06-01,39570,5,2,7,3,3,3
2023-06-01,12836,3,0,3,3,0,3
2023-06-01,35684,6,8,14,1,1,1
2023-06-01,199421,4,1,5,8,6,9
2023-06-01,60016,10,3,13,1,1,1
2023-06-01,47178,5,0,5,3,0,3
2023-06-01,44999,2,0,2,2,0,2
2023-06-01,44998,8,1,9,2,2,2
2023-06-01,47181,2,0,2,4,0,4
2023-06-01,207258,1,0,1,1,0,1
2023-06-01,50709,1,0,1,1,0,1
2023-06-01,45047,1,0,1,1,0,1
2023-06-01,45041,9,0,9,2,0,2
2023-06-01,15378,5,0,5,4,0,4
2023-06-01,12347,1,1,2,3,2,3
2023-06-01,29000,1,0,1,2,0,2
2023-06-01,213278,1,0,1,1,0,1
2023-06-01,212840,1,1,2,3,3,3
2023-06-01,41430,2,1,3,5,2,7
2023-06-01,209938,3,0,3,1,0,1
2023-06-01,60231,1,0,1,3,0,3
2023-06-01,47209,2,0,2,1,0,1
2023-06-01,47146,1,0,1,2,0,2
2023-06-01,199102,1,0,1,1,0,1
2023-06-01,29430,12,0,12,4,0,4
2023-06-01,13016,3,0,3,1,0,1
2023-06-01,211863,1,0,1,1,0,1
2023-06-01,47188,1,0,1,1,0,1
2023-06-01,47317,2,1,3,2,2,2
2023-06-01,200163,3,1,4,1,1,1
2023-06-01,210861,1,1,2,2,2,2
2023-06-01,211146,3,0,3,1,0,1
2023-06-01,6881,2,1,3,6,3,7
2023-06-01,25409,3,2,5,2,1,2
2023-06-01,8318,2,0,2,2,0,2
2023-06-01,47222,2,0,2,2,0,2
2023-06-01,47227,3,1,4,4,2,4
2023-06-01,28726,13,1,14,4,3,4
2023-06-01,44569,1,1,2,1,1,1
2023-06-01,47863,2,0,2,2,0,2
2023-06-01,47355,1,0,1,1,0,1
2023-06-01,51760,1,0,1,1,0,1
2023-06-01,35461,4,0,4,3,0,3
2023-06-01,47372,3,3,6,9,5,10
2023-06-01,49846,1,4,5,1,2,2
2023-06-01,47409,7,0,7,1,0,1
2023-06-01,43751,3,3,6,2,2,3
2023-06-01,48007,2,0,2,3,0,3
2023-06-01,198568,16,1,17,3,2,3
2023-06-01,28686,20,2,22,3,2,3
2023-06-01,42360,11,1,12,1,1,1
2023-06-01,42388,6,6,12,2,2,2
2023-06-01,42354,3,2,5,2,2,2
2023-06-01,207619,2,0,2,1,0,1
2023-06-01,61304,4,0,4,1,0,1
2023-06-01,204713,1,0,1,1,0,1
2023-06-01,209313,1,0,1,1,0,1
2023-06-01,47395,2,0,2,1,0,1
2023-06-01,41844,1,0,1,3,0,3
2023-06-01,44068,3,1,4,1,1,1
2023-06-01,197106,1,0,1,1,0,1
2023-06-01,201542,8,0,8,5,0,5
2023-06-01,41612,1,0,1,1,0,1
2023-06-01,204192,2,0,2,4,0,4
2023-06-01,50705,2,2,4,5,4,7
2023-06-01,201488,1,0,1,3,0,3
2023-06-01,204098,1,0,1,2,0,2
2023-06-01,201036,2,0,2,3,0,3
2023-06-01,47678,2,0,2,1,0,1
2023-06-01,44010,2,0,2,5,0,5
2023-06-01,210368,1,0,1,3,0,3
2023-06-01,201104,1,0,1,2,0,2
2023-06-01,203666,1,0,1,2,0,2
2023-06-01,210056,2,0,2,3,0,3
2023-06-01,43332,4,1,5,6,2,6
2023-06-01,50472,5,5,10,4,5,5
2023-06-01,213277,1,1,2,1,1,1
2023-06-01,207524,3,0,3,3,0,3
2023-06-01,41962,4,0,4,2,0,2
2023-06-01,42128,2,0,2,3,0,3
2023-06-01,49211,1,0,1,3,0,3
2023-06-01,41314,1,0,1,1,0,1
2023-06-01,59989,16,0,16,2,0,2
2023-06-01,201295,5,0,5,4,0,4
2023-06-01,200878,1,0,1,2,0,2
2023-06-01,6761,8,6,14,1,1,1
2023-06-01,200489,1,0,1,1,0,1
2023-06-01,60151,5,0,5,4,0,4
2023-06-01,206845,1,0,1,2,0,2
2023-06-01,212199,1,0,1,1,0,1
2023-06-01,9068,1,0,1,1,0,1
2023-06-01,202428,1,0,1,1,0,1
2023-06-01,212197,1,0,1,1,0,1
2023-06-01,47568,7,0,7,4,0,4
2023-06-01,47588,16,0,16,4,0,4
2023-06-01,199796,9,0,9,3,0,3
2023-06-01,47797,2,0,2,1,0,1
2023-06-01,42351,4,0,4,2,0,2
2023-06-01,49126,35,0,35,1,0,1
2023-06-01,47899,1,0,1,1,0,1
2023-06-01,47942,2,1,3,2,1,2
2023-06-01,25562,29,0,29,1,0,1
2023-06-01,202696,2,0,2,3,0,3
2023-06-01,16243,2,2,4,1,1,1
2023-06-01,47894,18,0,18,1,0,1
2023-06-01,62453,1,0,1,1,0,1
2023-06-01,47917,1,1,2,4,2,5
2023-06-01,49457,5,1,6,4,2,4
2023-06-01,209674,5,0,5,4,0,4
2023-06-01,210719,1,0,1,1,0,1
2023-06-01,213094,4,1,5,2,2,2
2023-06-01,203066,1,0,1,2,0,2
2023-06-01,47640,8,0,8,2,0,2
2023-06-01,47683,2,0,2,1,0,1
2023-06-01,47875,7,0,7,4,0,4
2023-06-01,48451,1,1,2,4,3,4
2023-06-01,47986,8,0,8,1,0,1
2023-06-01,201372,1,1,2,5,3,6
2023-06-01,206052,2,0,2,3,0,3
2023-06-01,48594,8,0,8,1,0,1
2023-06-01,213099,1,0,1,1,0,1
2023-06-01,51641,2,0,2,2,0,2
2023-06-01,213102,2,0,2,1,0,1
2023-06-01,12807,5,2,7,3,3,3
2023-06-01,56465,10,1,11,2,1,2
2023-06-01,47767,1,1,2,1,2,2
2023-06-01,47724,7,1,8,4,2,4
2023-06-01,59601,2,0,2,2,0,2
2023-06-01,47749,3,3,6,2,2,2
2023-06-01,47746,2,0,2,4,0,4
2023-06-01,56619,2,0,2,2,0,2
2023-06-01,47815,3,1,4,2,1,2
2023-06-01,44831,27,0,27,4,0,4
2023-06-01,47833,4,0,4,6,0,6
2023-06-01,12783,1,0,1,1,0,1
2023-06-01,48710,2,0,2,2,0,2
2023-06-01,204555,2,0,2,2,0,2
2023-06-01,48154,1,0,1,1,0,1
2023-06-01,41524,1,1,2,1,1,2
2023-06-01,201555,1,0,1,3,0,3
2023-06-01,16094,5,0,5,2,0,2
2023-06-01,47944,1,1,2,2,2,2
2023-06-01,34722,15,0,15,3,0,3
2023-06-01,47901,8,0,8,2,0,2
2023-06-01,200884,5,0,5,2,0,2
2023-06-01,48543,1,0,1,1,0,1
2023-06-01,203949,3,0,3,2,0,2
2023-06-01,48050,1,0,1,2,0,2
2023-06-01,212682,1,0,1,1,0,1
2023-06-01,202887,2,0,2,1,0,1
2023-06-01,48423,1,0,1,2,0,2
2023-06-01,50891,2,0,2,4,0,4
2023-06-01,199202,1,0,1,2,0,2
2023-06-01,48042,2,0,2,1,0,1
2023-06-01,197116,4,2,6,3,3,3
2023-06-01,48070,8,1,9,8,7,9
2023-06-01,48048,4,0,4,2,0,2
2023-06-01,48469,3,3,6,2,2,2
2023-06-01,60848,3,2,5,2,2,2
2023-06-01,48135,14,0,14,4,0,4
2023-06-01,59831,2,0,2,1,0,1
2023-06-01,58264,5,1,6,2,1,2
2023-06-01,202895,4,1,5,4,3,4
2023-06-01,21372,1,0,1,1,0,1
2023-06-01,48197,12,0,12,3,0,3
2023-06-01,48187,1,0,1,2,0,2
2023-06-01,48202,9,0,9,2,0,2
2023-06-01,48139,1,0,1,2,0,2
2023-06-01,59682,1,0,1,3,0,3
2023-06-01,204707,1,0,1,1,0,1
2023-06-01,205178,1,0,1,2,0,2
2023-06-01,43743,2,0,2,1,0,1
2023-06-01,57415,1,0,1,1,0,1
2023-06-01,204289,1,0,1,1,0,1
2023-06-01,207690,1,0,1,1,0,1
2023-06-01,49804,1,0,1,1,0,1
2023-06-01,6798,4,1,5,5,4,5
2023-06-01,60368,4,0,4,1,0,1
2023-06-01,47645,4,1,5,2,2,3
2023-06-01,199458,1,0,1,1,0,1
2023-06-01,12543,3,0,3,1,0,1
2023-06-01,199317,1,0,1,2,0,2
2023-06-01,60290,1,0,1,3,0,3
2023-06-01,204255,1,0,1,2,0,2
2023-06-01,12046,7,1,8,3,2,3
2023-06-01,48315,1,0,1,1,0,1
2023-06-01,210889,1,0,1,4,0,4
2023-06-01,399762,1,0,1,1,0,1
2023-06-01,27561,1,0,1,2,0,2
2023-06-01,9029,3,0,3,2,0,2
2023-06-01,43028,2,1,3,1,1,1
2023-06-01,206542,1,0,1,1,0,1
2023-06-01,52173,14,2,16,3,1,3
2023-06-01,206357,1,1,2,1,1,1
2023-06-01,201008,4,0,4,4,0,4
2023-06-01,21314,4,2,6,4,3,4
2023-06-01,47452,24,0,24,1,0,1
2023-06-01,60292,1,0,1,1,0,1
2023-06-01,207822,1,2,3,3,3,4
2023-06-01,204810,1,1,2,1,1,2
2023-06-01,51696,1,1,2,2,2,2
2023-06-01,48685,9,2,11,5,2,5
2023-06-01,61155,4,1,5,2,1,2
2023-06-01,201616,4,0,4,1,0,1
2023-06-01,48463,8,0,8,4,0,4
2023-06-01,48697,1,0,1,2,0,2
2023-06-01,48994,1,0,1,3,0,3
2023-06-01,209659,2,3,5,5,3,5
2023-06-01,203321,1,4,5,1,1,1
2023-06-01,196816,6,1,7,3,1,3
2023-06-01,47258,6,1,7,7,2,7
2023-06-01,57039,1,0,1,2,0,2
2023-06-01,49892,3,1,4,4,1,4
2023-06-01,49073,6,0,6,1,0,1
2023-06-01,200390,3,0,3,2,0,2
2023-06-01,201477,1,0,1,3,0,3
2023-06-01,48640,2,0,2,2,0,2
2023-06-01,48645,14,1,15,2,1,2
2023-06-01,35667,1,0,1,1,0,1
2023-06-01,210418,1,0,1,1,0,1
2023-06-01,211850,1,1,2,3,2,3
2023-06-01,57373,1,1,2,1,1,1
2023-06-01,49051,1,0,1,1,0,1
2023-06-01,35046,3,2,5,3,3,3
2023-06-01,42387,8,0,8,1,0,1
2023-06-01,13282,1,2,3,3,2,3
2023-06-01,207706,1,0,1,1,0,1
2023-06-01,47966,3,0,3,1,0,1
2023-06-01,213307,1,0,1,6,0,6
2023-06-01,207261,1,0,1,3,3,5
2023-06-01,197161,6,1,7,1,1,2
2023-06-01,208014,3,0,3,4,0,4
2023-06-01,199760,3,0,3,1,0,1
2023-06-01,57100,1,0,1,1,0,1
2023-06-01,204455,1,0,1,4,0,4
2023-06-01,197837,1,0,1,3,0,3
2023-06-01,197892,1,0,1,4,0,4
2023-06-01,57207,1,0,1,2,0,2
2023-06-01,56843,5,0,5,3,0,3
2023-06-01,210692,1,0,1,1,0,1
2023-06-01,210711,1,1,2,2,1,2
2023-06-01,39016,2,0,2,2,0,2
2023-06-01,208346,2,0,2,2,0,2
2023-06-01,200119,1,1,2,2,2,2
2023-06-01,202245,2,1,3,3,3,3
2023-06-01,212509,2,1,3,1,1,1
2023-06-01,209842,1,1,2,1,1,1
2023-06-01,209839,2,0,2,2,0,2
2023-06-01,8883,36,0,36,5,0,5
2023-06-01,48279,1,0,1,1,0,1
2023-06-01,48458,1,0,1,1,0,1
2023-06-01,200361,2,0,2,4,0,4
2023-06-01,57653,3,1,4,7,5,7
2023-06-01,60701,1,0,1,1,0,1
2023-06-01,200033,2,0,2,2,0,2
2023-06-01,202619,12,5,17,1,1,1
2023-06-01,48036,2,0,2,5,0,5
2023-06-01,41865,6,0,6,1,0,1
2023-06-01,48368,1,0,1,1,0,1
2023-06-01,61163,1,0,1,1,0,1
2023-06-01,211914,1,0,1,3,0,3
2023-06-01,212015,1,0,1,2,0,2
2023-06-01,211806,1,0,1,3,0,3
2023-06-01,212275,1,0,1,2,0,2
2023-06-01,213146,1,0,1,3,0,3
2023-06-01,58175,2,0,2,4,0,4
2023-06-01,211178,7,0,7,2,0,2
2023-06-01,206394,1,0,1,2,0,2
2023-06-01,211448,4,2,6,5,5,6
2023-06-01,50990,1,0,1,1,0,1
2023-06-01,39492,1,0,1,1,0,1
2023-06-01,201601,9,1,10,2,1,2
2023-06-01,59511,1,0,1,2,0,2
2023-06-01,34415,1,0,1,1,0,1
2023-06-01,211099,1,1,2,3,1,3
2023-06-01,202744,1,0,1,2,0,2
2023-06-01,206162,1,0,1,3,0,3
2023-06-01,52189,1,0,1,1,0,1
2023-06-01,199652,15,0,15,1,0,1
2023-06-01,43212,21,0,21,3,0,3
2023-06-01,56765,2,0,2,1,0,1
2023-06-01,60638,4,0,4,1,0,1
2023-06-01,47558,3,0,3,2,0,2
2023-06-01,33824,4,2,6,2,2,2
2023-06-01,198013,13,0,13,9,0,9
2023-06-01,202371,3,0,3,1,0,1
2023-06-01,196921,19,0,19,3,0,3
2023-06-01,35392,3,0,3,3,0,3
2023-06-01,49771,8,0,8,1,0,1
2023-06-01,210515,1,0,1,1,0,1
2023-06-01,211163,2,0,2,1,0,1
2023-06-01,206950,1,0,1,2,0,2
2023-06-01,206531,1,0,1,1,0,1
2023-06-01,211824,1,0,1,1,0,1
2023-06-01,213055,1,0,1,3,0,3
2023-06-01,212527,1,0,1,1,0,1
2023-06-01,212383,1,0,1,3,0,3
2023-06-01,212719,1,0,1,3,0,3
2023-06-01,12796,5,0,5,4,0,4
2023-06-01,48148,7,0,7,1,0,1
2023-06-01,12658,2,0,2,1,0,1
2023-06-01,48221,1,0,1,2,0,2
2023-06-01,1140,3,1,4,10,6,10
2023-06-01,49979,19,0,19,1,0,1
2023-06-01,34660,6,2,8,5,4,5
2023-06-01,48319,1,0,1,1,0,1
2023-06-01,48298,9,1,10,5,5,6
2023-06-01,48302,12,0,12,2,0,2
2023-06-01,48541,3,0,3,1,0,1
2023-06-01,48382,7,0,7,3,0,3
2023-06-01,48328,14,10,24,6,5,6
2023-06-01,200985,1,0,1,1,0,1
2023-06-01,212757,1,0,1,2,0,2
2023-06-01,206495,9,0,9,2,0,2
2023-06-01,57563,4,0,4,2,0,2
2023-06-01,48364,2,1,3,3,2,3
2023-06-01,39319,1,0,1,4,0,4
2023-06-01,205402,3,0,3,4,0,4
2023-06-01,202038,19,0,19,2,0,2
2023-06-01,47975,11,0,11,1,0,1
2023-06-01,44346,4,0,4,2,0,2
2023-06-01,47998,1,1,2,7,6,8
2023-06-01,61333,17,5,22,3,3,3
2023-06-01,211134,1,0,1,1,0,1
2023-06-01,41938,5,1,6,3,1,3
2023-06-01,201966,6,1,7,6,3,6
2023-06-01,211334,1,0,1,1,0,1
2023-06-01,49122,2,0,2,1,0,1
2023-06-01,29140,3,6,9,13,10,14
2023-06-01,49312,5,1,6,3,3,3
2023-06-01,49154,3,0,3,1,0,1
2023-06-01,49265,14,0,14,4,0,4
2023-06-01,48661,2,1,3,2,1,2
2023-06-01,48670,1,1,2,4,2,4
2023-06-01,29385,3,0,3,1,0,1
2023-06-01,49732,7,0,7,3,0,3
2023-06-01,41841,1,0,1,3,0,3
2023-06-01,196648,3,0,3,3,0,3
2023-06-01,39049,4,0,4,2,0,2
2023-06-01,209928,1,0,1,1,0,1
2023-06-01,41854,0,0,0,2,0,2
2023-06-01,207493,1,0,1,1,0,1
2023-06-01,207458,1,0,1,1,0,1
2023-06-01,207379,1,0,1,2,0,2
2023-06-01,207463,1,2,3,2,1,3
2023-06-01,207453,1,0,1,2,0,2
2023-06-01,207423,2,0,2,1,0,1
2023-06-01,207421,1,1,2,1,1,1
2023-06-01,48034,8,0,8,1,0,1
2023-06-01,16255,2,0,2,2,0,2
2023-06-01,200515,2,0,2,4,0,4
2023-06-01,212482,2,0,2,1,0,1
2023-06-01,48100,1,0,1,1,0,1
2023-06-01,48128,40,0,40,4,0,4
2023-06-01,48365,6,0,6,1,0,1
2023-06-01,48379,1,0,1,1,0,1
2023-06-01,39893,1,0,1,2,0,2
2023-06-01,25433,2,1,3,3,1,3
2023-06-01,15866,3,1,4,2,1,2
2023-06-01,39067,2,0,2,4,0,4
2023-06-01,210978,1,0,1,1,0,1
2023-06-01,207819,1,0,1,1,0,1
2023-06-01,207596,1,0,1,1,0,1
2023-06-01,49330,1,0,1,1,0,1
2023-06-01,207826,1,0,1,3,0,3
2023-06-01,41946,5,0,5,2,0,2
2023-06-01,197304,8,0,8,1,0,1
2023-06-01,57765,1,0,1,3,0,3
2023-06-01,199238,1,0,1,1,0,1
2023-06-01,206282,2,0,2,5,0,5
2023-06-01,202472,1,0,1,1,0,1
2023-06-01,205447,2,0,2,1,0,1
2023-06-01,203985,4,0,4,2,0,2
2023-06-01,199363,1,0,1,1,0,1
2023-06-01,201936,1,0,1,1,0,1
2023-06-01,48212,15,0,15,1,0,1
2023-06-01,48249,1,0,1,6,0,6
2023-06-01,50870,3,0,3,1,0,1
2023-06-01,56791,14,1,15,3,3,3
2023-06-01,33923,22,1,23,8,3,8
2023-06-01,201925,10,2,12,3,2,4
2023-06-01,48850,1,0,1,1,2,2
2023-06-01,48394,1,0,1,3,0,3
2023-06-01,49255,1,0,1,1,0,1
2023-06-01,48417,7,1,8,9,5,9
2023-06-01,48450,3,0,3,1,0,1
2023-06-01,34738,9,0,9,4,0,4
2023-06-01,48472,1,0,1,2,0,2
2023-06-01,42572,7,1,8,1,1,1
2023-06-01,44219,8,1,9,3,1,3
2023-06-01,48580,7,0,7,1,0,1
2023-06-01,43168,4,0,4,2,0,2
2023-06-01,209115,1,0,1,3,0,3
2023-06-01,199431,1,0,1,3,0,3
2023-06-01,48532,1,0,1,1,0,1
2023-06-01,47670,1,0,1,1,0,1
2023-06-01,39826,7,0,7,2,0,2
2023-06-01,209629,1,0,1,1,0,1
2023-06-01,205808,1,0,1,1,0,1
2023-06-01,50431,1,0,1,3,0,3
2023-06-01,197236,1,0,1,1,0,1
2023-06-01,2864,3,0,3,1,0,1
2023-06-01,8381,2,0,2,2,0,2
2023-06-01,3279,1,0,1,3,0,3
2023-06-01,48277,1,0,1,1,0,1
2023-06-01,48118,1,0,1,1,0,1
2023-06-01,51803,1,1,2,1,1,1
2023-06-01,64423,5,0,5,3,0,3
2023-06-01,210442,1,0,1,2,0,2
2023-06-01,208941,1,0,1,4,0,4
2023-06-01,197901,3,0,3,2,0,2
2023-06-01,42146,1,0,1,4,0,4
2023-06-01,58060,2,0,2,1,0,1
2023-06-01,210390,1,0,1,1,0,1
2023-06-01,44956,2,0,2,1,0,1
2023-06-01,43049,2,0,2,2,0,2
2023-06-01,198681,1,0,1,2,0,2
2023-06-01,212940,1,0,1,1,0,1
2023-06-01,209458,1,0,1,1,0,1
2023-06-01,47463,1,0,1,1,0,1
2023-06-01,209398,1,0,1,3,0,3
2023-06-01,45001,1,0,1,1,0,1
2023-06-01,48184,1,0,1,1,0,1
2023-06-01,201147,1,0,1,2,0,2
2023-06-01,48511,1,1,2,1,1,1
2023-06-01,201593,2,0,2,2,0,2
2023-06-01,51340,1,0,1,3,0,3
2023-06-01,50765,1,1,2,1,1,1
2023-06-01,62108,1,0,1,2,0,2
2023-06-01,43047,2,0,2,3,0,3
2023-06-01,206326,1,0,1,3,0,3
2023-06-01,204752,1,0,1,4,0,4
2023-06-01,60108,1,0,1,1,0,1
2023-06-01,204674,1,0,1,2,0,2
2023-06-01,212206,1,0,1,1,0,1
2023-06-01,202969,1,0,1,2,0,2
2023-06-01,60313,1,0,1,1,0,1
2023-06-01,204532,3,0,3,2,0,2
2023-06-01,204485,1,0,1,1,0,1
2023-06-01,204671,2,1,3,4,2,4
2023-06-01,60286,4,0,4,2,0,2
2023-06-01,204929,6,0,6,2,0,2
2023-06-01,209918,1,0,1,1,0,1
2023-06-01,212006,1,0,1,1,0,1
2023-06-01,62339,1,0,1,1,0,1
2023-06-01,47845,1,0,1,2,0,2
2023-06-01,41773,1,0,1,1,0,1
2023-06-01,25482,5,1,6,4,2,5
2023-06-01,49168,1,0,1,2,0,2
2023-06-01,210894,1,0,1,4,0,4
2023-06-01,60635,1,0,1,3,0,3
2023-06-01,48431,4,0,4,1,0,1
2023-06-01,21203,2,0,2,2,0,2
2023-06-01,25436,2,0,2,1,0,1
2023-06-01,205754,1,0,1,3,0,3
2023-06-01,201389,1,0,1,2,0,2
2023-06-01,208140,7,0,7,2,0,2
2023-06-01,34876,56,0,56,1,0,1
2023-06-01,38924,1,1,2,2,1,2
2023-06-01,43323,15,1,16,5,2,5
2023-06-01,196801,1,0,1,3,0,3
2023-06-01,60192,6,0,6,2,0,2
2023-06-01,41134,3,0,3,1,0,1
2023-06-01,57388,12,3,15,7,1,7
2023-06-01,56782,1,0,1,3,0,3
2023-06-01,15966,1,1,2,10,7,11
2023-06-01,198455,1,1,2,3,3,3
2023-06-01,31178,13,1,14,4,3,4
2023-06-01,34108,16,3,19,3,1,3
2023-06-01,31264,7,1,8,3,2,3
2023-06-01,48825,3,0,3,2,0,2
2023-06-01,44572,8,0,8,1,0,1
2023-06-01,57326,1,0,1,1,0,1
2023-06-01,202842,1,0,1,2,0,2
2023-06-01,57134,8,0,8,1,0,1
2023-06-01,41698,3,1,4,2,2,2
2023-06-01,48797,3,0,3,2,0,2
2023-06-01,48840,8,0,8,2,0,2
2023-06-01,48812,1,0,1,1,0,1
2023-06-01,49069,2,0,2,1,0,1
2023-06-01,34975,15,0,15,1,0,1
2023-06-01,48864,1,0,1,2,0,2
2023-06-01,48873,3,0,3,1,0,1
2023-06-01,49182,7,2,9,3,3,3
2023-06-01,48884,6,0,6,2,0,2
2023-06-01,207999,1,1,2,2,2,3
2023-06-01,201514,1,0,1,4,0,4
2023-06-01,49046,2,0,2,2,0,2
2023-06-01,211089,1,0,1,1,0,1
2023-06-01,199561,1,0,1,2,0,2
2023-06-01,48966,12,0,12,4,0,4
2023-06-01,48967,2,0,2,3,0,3
2023-06-01,199597,4,0,4,2,0,2
2023-06-01,31256,2,0,2,1,0,1
2023-06-01,60642,1,0,1,1,0,1
2023-06-01,39839,3,1,4,3,2,3
2023-06-01,48972,3,2,5,6,5,6
2023-06-01,49148,12,1,13,3,1,3
2023-06-01,197081,2,0,2,1,0,1
2023-06-01,204645,3,1,4,1,1,1
2023-06-01,48136,1,0,1,2,0,2
2023-06-01,49001,4,0,4,1,0,1
2023-06-01,39412,1,0,1,1,0,1
2023-06-01,49026,1,0,1,1,0,1
2023-06-01,43678,1,0,1,3,0,3
2023-06-01,49024,15,1,16,3,2,3
2023-06-01,49044,3,0,3,2,0,2
2023-06-01,49058,3,1,4,1,1,1
2023-06-01,57002,22,0,22,3,0,3
2023-06-01,397401,3,0,3,2,0,2
2023-06-01,49083,2,0,2,1,0,1
2023-06-01,48739,15,1,16,6,4,7
2023-06-01,11323,10,0,10,7,0,7
2023-06-01,201327,1,0,1,2,0,2
2023-06-01,47713,1,0,1,1,0,1
2023-06-01,48937,7,0,7,3,0,3
2023-06-01,49890,1,1,2,1,1,1
2023-06-01,49409,6,4,10,2,1,2
2023-06-01,34215,2,2,4,1,2,2
2023-06-01,8847,15,0,15,3,0,3
2023-06-01,47543,11,2,13,1,1,1
2023-06-01,49840,8,0,8,1,0,1
2023-06-01,204622,3,0,3,6,0,6
2023-06-01,49680,16,0,16,2,0,2
2023-06-01,61434,1,0,1,1,0,1
2023-06-01,38922,1,0,1,1,0,1
2023-06-01,49725,1,1,2,1,1,1
2023-06-01,49888,1,1,2,5,3,5
2023-06-01,209802,1,0,1,1,0,1
2023-06-01,198398,3,0,3,3,0,3
2023-06-01,197697,7,1,8,3,1,4
2023-06-01,49112,5,0,5,1,0,1
2023-06-01,197168,1,0,1,1,0,1
2023-06-01,51614,1,0,1,1,0,1
2023-06-01,61975,1,0,1,2,0,2
2023-06-01,35125,3,0,3,1,0,1
2023-06-01,29276,2,0,2,1,0,1
2023-06-01,208900,1,0,1,1,0,1
2023-06-01,39598,5,1,6,2,1,2
2023-06-01,39688,2,0,2,4,0,4
2023-06-01,212566,1,0,1,2,0,2
2023-06-01,211613,3,0,3,5,0,5
2023-06-01,35005,2,0,2,3,0,3
2023-06-01,62432,0,0,0,1,0,1
2023-06-01,207911,1,0,1,2,0,2
2023-06-01,198226,1,0,1,2,0,2
2023-06-01,213235,1,0,1,2,0,2
2023-06-01,64776,1,0,1,1,0,1
2023-06-01,212764,3,0,3,4,0,4
2023-06-01,35583,1,0,1,1,0,1
2023-06-01,39762,8,0,8,4,0,4
2023-06-01,397044,3,0,3,1,0,1
2023-06-01,206539,10,0,10,7,0,7
2023-06-01,198938,3,0,3,4,0,4
2023-06-01,44118,2,0,2,1,0,1
2023-06-01,60974,3,0,3,2,0,2
2023-06-01,44100,3,0,3,1,0,1
2023-06-01,60441,5,0,5,2,0,2
2023-06-01,199230,1,0,1,6,0,6
2023-06-01,211456,2,0,2,1,0,1
2023-06-01,16299,2,0,2,1,0,1
2023-06-01,49293,9,0,9,1,0,1
2023-06-01,203599,1,0,1,1,0,1
2023-06-01,199778,1,0,1,1,0,1
2023-06-01,49987,1,0,1,1,0,1
2023-06-01,51213,2,0,2,4,0,4
2023-06-01,16006,5,1,6,2,1,2
2023-06-01,16015,3,0,3,3,0,3
2023-06-01,44617,1,0,1,3,0,3
2023-06-01,60879,4,1,5,5,3,5
2023-06-01,50166,4,1,5,4,2,4
2023-06-01,41066,7,0,7,1,0,1
2023-06-01,8291,12,0,12,3,0,3
2023-06-01,206849,4,0,4,1,0,1
2023-06-01,48960,2,1,3,1,1,1
2023-06-01,49594,6,0,6,1,0,1
2023-06-01,49011,2,0,2,1,0,1
2023-06-01,206208,1,0,1,1,0,1
2023-06-01,62457,1,0,1,2,0,2
2023-06-01,60844,1,0,1,2,0,2
2023-06-01,8570,22,0,22,1,0,1
2023-06-01,43452,5,0,5,2,0,2
2023-06-01,61264,1,0,1,2,0,2
2023-06-01,49637,2,0,2,3,0,3
2023-06-01,59917,2,0,2,2,0,2
2023-06-01,61431,15,0,15,4,0,4
2023-06-01,59443,6,0,6,5,0,5
2023-06-01,42672,1,0,1,2,0,2
2023-06-01,62152,1,0,1,2,0,2
2023-06-01,64453,1,0,1,3,0,3
2023-06-01,198619,2,0,2,2,0,2
2023-06-01,48780,6,0,6,1,0,1
2023-06-01,211249,9,0,9,2,0,2
2023-06-01,42626,3,0,3,1,0,1
2023-06-01,206887,1,0,1,1,0,1
2023-06-01,29399,20,4,24,5,3,5
2023-06-01,35709,4,1,5,8,6,9
2023-06-01,211760,4,1,5,3,1,3
2023-06-01,209684,4,0,4,4,0,4
2023-06-01,209682,1,0,1,2,0,2
2023-06-01,209681,1,1,2,2,1,2
2023-06-01,62009,2,2,4,2,2,2
2023-06-01,41864,1,0,1,2,0,2
2023-06-01,203395,1,0,1,3,0,3
2023-06-01,209001,1,0,1,1,0,1
2023-06-01,209649,3,1,4,2,1,2
2023-06-01,213314,1,1,2,1,2,2
2023-06-01,201978,1,0,1,3,3,4
2023-06-01,209610,1,0,1,1,0,1
2023-06-01,209654,1,0,1,1,0,1
2023-06-01,59885,3,0,3,1,0,1
2023-06-01,41745,14,2,16,2,2,3
2023-06-01,31628,5,0,5,1,0,1
2023-06-01,43991,8,0,8,1,0,1
2023-06-01,204105,1,0,1,1,0,1
2023-06-01,48909,10,1,11,3,1,3
2023-06-01,51849,7,0,7,4,0,4
2023-06-01,49761,5,0,5,4,0,4
2023-06-01,50415,1,1,2,2,2,2
2023-06-01,51156,1,0,1,3,0,3
2023-06-01,207979,2,1,3,1,1,1
2023-06-01,43594,8,1,9,3,3,3
2023-06-01,197289,2,0,2,2,0,2
2023-06-01,49066,1,0,1,1,0,1
2023-06-01,49064,3,0,3,2,0,2
2023-06-01,60738,1,0,1,5,0,5
2023-06-01,8305,1,0,1,3,0,3
2023-06-01,39805,2,0,2,5,0,5
2023-06-01,197002,2,0,2,1,0,1
2023-06-01,207878,4,0,4,2,0,2
2023-06-01,51758,5,1,6,4,3,4
2023-06-01,196681,1,0,1,5,0,5
2023-06-01,59480,1,0,1,1,0,1
2023-06-01,59488,1,0,1,1,0,1
2023-06-01,44742,1,0,1,1,0,1
2023-06-01,59482,2,0,2,3,0,3
2023-06-01,199846,5,1,6,3,1,4
2023-06-01,199190,2,0,2,2,0,2
2023-06-01,59537,1,0,1,1,0,1
2023-06-01,46900,1,1,2,2,1,2
2023-06-01,62959,2,0,2,2,0,2
2023-06-01,46623,2,0,2,2,0,2
2023-06-01,394490,1,1,2,1,1,1
2023-06-01,40434,1,0,1,1,0,1
2023-06-01,53503,10,0,10,1,0,1
2023-06-01,395473,6,0,6,4,0,4
2023-06-01,26117,1,0,1,1,0,1
2023-06-01,397426,1,0,1,1,0,1
2023-06-01,46771,1,1,2,2,3,3
2023-06-01,18812,2,0,2,1,0,1
2023-06-01,29804,12,1,13,4,1,4
2023-06-01,136393,32,0,32,1,0,1
2023-06-01,54658,5,0,5,3,0,3
2023-06-01,18719,3,0,3,1,0,1
2023-06-01,19008,3,1,4,7,6,9
2023-06-01,47086,1,0,1,1,0,1
2023-06-01,400521,2,1,3,2,2,2
2023-06-01,2735,1,0,1,2,0,2
2023-06-01,400404,7,0,7,2,0,2
2023-06-01,20425,1,0,1,2,0,2
2023-06-01,4977,4,0,4,4,0,4
2023-06-01,36689,6,0,6,1,0,1
2023-06-01,7253,1,1,2,2,1,3
2023-06-01,15334,7,0,7,2,0,2
2023-06-01,397549,1,0,1,2,0,2
2023-06-01,14368,4,0,4,1,0,1
2023-06-01,36306,11,0,11,6,0,6
2023-06-01,11949,1,0,1,2,0,2
2023-06-01,40828,3,0,3,2,0,2
2023-06-01,393558,3,0,3,4,0,4
2023-06-01,32889,17,0,17,4,0,4
2023-06-01,32110,8,1,9,5,2,5
2023-06-01,21659,2,1,3,4,3,4
2023-06-01,396253,72,29,101,13,11,13
2023-06-01,22006,27,0,27,5,0,5
2023-06-01,396427,7,0,7,1,0,1
2023-06-01,396320,1,1,2,3,1,3
2023-06-01,396538,1,0,1,3,0,3
2023-06-01,395955,2,0,2,2,0,2
2023-06-01,53626,3,0,3,4,0,4
2023-06-01,27414,1,0,1,2,0,2
2023-06-01,26489,1,0,1,1,0,1
2023-06-01,36736,1,0,1,2,0,2
2023-06-01,13915,1,0,1,2,0,2
2023-06-01,32670,1,0,1,1,0,1
2023-06-01,47089,2,0,2,4,0,4
2023-06-01,32411,2,0,2,2,0,2
2023-06-01,26219,1,0,1,3,0,3
2023-06-01,30305,18,0,18,1,0,1
2023-06-01,395176,4,1,5,5,2,5
2023-06-01,16511,2,0,2,3,0,3
2023-06-01,396155,2,0,2,1,0,1
2023-06-01,398106,1,1,2,3,3,3
2023-06-01,44273,18,62,80,12,17,17
2023-06-01,398105,1,1,2,3,3,3
2023-06-01,397516,1,1,2,3,3,3
2023-06-01,397521,1,1,2,3,3,3
2023-06-01,397519,2,2,4,4,3,4
2023-06-01,398102,1,1,2,3,3,3
2023-06-01,398788,1,1,2,3,3,3
2023-06-01,397514,1,1,2,3,3,3
2023-06-01,398104,1,1,2,3,3,3
2023-06-01,397513,1,1,2,3,3,3
2023-06-01,397515,1,1,2,3,3,3
2023-06-01,19761,4,0,4,1,0,1
2023-06-01,54006,7,0,7,4,0,4
2023-06-01,62798,4,0,4,2,0,2
2023-06-01,399329,1,0,1,1,0,1
2023-06-01,395066,2,0,2,2,0,2
2023-06-01,30269,7,1,8,3,3,3
2023-06-01,39990,2,0,2,3,0,3
2023-06-01,395347,4,0,4,3,0,3
2023-06-01,46881,1,0,1,3,0,3
2023-06-01,46657,4,1,5,1,1,1
2023-06-01,31844,2,0,2,2,0,2
2023-06-01,395060,3,0,3,4,0,4
2023-06-01,397352,1,0,1,1,0,1
2023-06-01,63387,1,0,1,1,0,1
2023-06-01,17297,1,0,1,3,0,3
2023-06-01,393652,1,0,1,1,0,1
2023-06-01,53471,3,0,3,1,0,1
2023-06-01,399821,3,2,5,2,2,2
2023-06-01,62566,15,0,15,6,0,6
2023-06-01,14945,2,0,2,2,0,2
2023-06-01,46607,1,0,1,1,0,1
2023-06-01,16428,1,0,1,2,0,2
2023-06-01,46778,3,0,3,2,0,2
2023-06-01,1437,2,0,2,3,0,3
2023-06-01,395063,1,1,2,2,2,2
2023-06-01,396383,1,0,1,3,0,3
2023-06-01,32871,1,0,1,1,0,1
2023-06-01,27394,1,0,1,1,0,1
2023-06-01,20261,1,0,1,2,0,2
2023-06-01,33486,2,0,2,3,0,3
2023-06-01,25918,1,0,1,1,0,1
2023-06-01,54974,1,0,1,1,0,1
2023-06-01,32881,8,0,8,6,0,6
2023-06-01,7233,2,2,4,1,1,1
2023-06-01,55104,2,0,2,4,0,4
2023-06-01,63386,3,0,3,1,0,1
2023-06-01,25816,10,0,10,6,0,6
2023-06-01,46329,3,0,3,3,0,3
2023-06-01,396970,4,2,6,1,1,2
2023-06-01,398138,1,0,1,1,0,1
2023-06-01,394688,4,0,4,2,0,2
2023-06-01,40260,8,1,9,2,1,2
2023-06-01,11425,1,0,1,1,0,1
2023-06-01,53455,5,0,5,1,0,1
2023-06-01,397824,2,2,4,3,2,3
2023-06-01,21528,4,1,5,4,2,4
2023-06-01,53502,2,0,2,2,0,2
2023-06-01,33134,3,0,3,3,0,3
2023-06-01,11674,1,0,1,2,0,2
2023-06-01,53412,2,0,2,1,0,1
2023-06-01,54369,3,0,3,2,0,2
2023-06-01,13897,2,0,2,1,0,1
2023-06-01,46617,2,0,2,4,0,4
2023-06-01,400514,1,0,1,2,0,2
2023-06-01,63109,1,0,1,2,0,2
2023-06-01,395953,2,0,2,1,0,1
2023-06-01,398483,1,1,2,2,2,2
2023-06-01,212597,1,0,1,2,0,2
2023-06-01,19555,7,0,7,1,0,1
2023-06-01,36146,24,1,25,2,1,2
2023-06-01,26809,2,1,3,1,1,1
2023-06-01,400285,4,0,4,3,0,3
2023-06-01,394693,1,0,1,1,0,1
2023-06-01,1819,20,0,20,3,0,3
2023-06-01,395450,2,1,3,1,1,1
2023-06-01,394219,1,0,1,1,0,1
2023-06-01,40905,1,0,1,1,0,1
2023-06-01,30604,4,0,4,3,0,3
2023-06-01,40600,2,0,2,2,0,2
2023-06-01,46249,1,0,1,1,0,1
2023-06-01,53372,1,0,1,2,0,2
2023-06-01,53760,2,0,2,2,0,2
2023-06-01,400086,1,0,1,1,0,1
2023-06-01,400145,2,0,2,2,0,2
2023-06-01,13467,3,0,3,3,0,3
2023-06-01,396179,1,0,1,1,0,1
2023-06-01,399875,1,0,1,1,0,1
2023-06-01,47025,1,0,1,1,0,1
2023-06-01,12219,2,0,2,2,0,2
2023-06-01,396530,1,0,1,2,0,2
2023-06-01,397155,2,0,2,1,0,1
2023-06-01,35869,1,0,1,2,0,2
2023-06-01,46254,4,0,4,2,0,2
2023-06-01,42567,8,1,9,9,7,11
2023-06-01,12050,19,0,19,4,0,4
2023-06-01,22846,2,0,2,3,0,3
2023-06-01,17004,2,0,2,2,0,2
2023-06-01,62643,13,1,14,2,1,2
2023-06-01,46518,3,0,3,4,0,4
2023-06-01,26732,1,0,1,1,0,1
2023-06-01,20030,19,0,19,3,0,3
2023-06-01,40082,2,0,2,1,0,1
2023-06-01,63357,3,0,3,1,0,1
2023-06-01,400614,1,0,1,1,0,1
2023-06-01,55670,14,1,15,7,1,7
2023-06-01,133696,30,0,30,2,0,2
2023-06-01,134012,2,6,8,4,1,4
2023-06-01,23682,20,0,20,3,0,3
2023-06-01,7468,29,11,40,7,2,7
2023-06-01,137260,3,0,3,1,0,1
2023-06-01,7624,7,0,7,1,0,1
2023-06-01,38592,43,0,43,4,0,4
2023-06-01,9405,3,1,4,2,1,2
2023-06-01,133119,35,3,38,4,1,4
2023-06-01,150436,10,0,10,3,0,3
2023-06-01,55688,16,2,18,3,1,3
2023-06-01,131117,1,1,2,1,1,1
2023-06-01,131118,1,1,2,1,1,1
2023-06-01,38508,1,1,2,1,1,1
2023-06-01,136108,1,1,2,1,1,1
2023-06-01,138138,1,1,2,1,1,1
2023-06-01,18283,51,1,52,10,4,10
2023-06-01,7511,19,1,20,6,4,6
2023-06-01,45079,10,3,13,2,2,2
2023-06-01,24173,235,258,493,42,14,42
2023-06-01,24176,7,0,7,1,0,1
2023-06-01,4711,20,1,21,5,4,5
2023-06-01,7668,10,1,11,10,6,12
2023-06-01,210278,10,1,11,6,4,7
2023-06-01,45680,7,1,8,3,1,3
2023-06-01,38738,9,1,10,6,1,6
2023-06-01,139006,7,4,11,3,2,3
2023-06-01,131310,43,3,46,10,5,10
2023-06-01,133579,63,0,63,3,0,3
2023-06-01,58621,53,7,60,3,3,3
2023-06-01,131621,2,1,3,1,1,1
2023-06-01,131960,6,0,6,3,0,3
2023-06-01,139753,2,0,2,2,0,2
2023-06-01,133612,476,285,761,2,2,2
2023-06-01,18291,18,95,113,1,1,1
2023-06-01,131486,6,2,8,3,3,4
2023-06-01,137718,56,4,60,5,3,5
2023-06-01,133538,9,0,9,1,0,1
2023-06-01,45075,6,0,6,2,0,2
2023-06-01,131591,204,19,223,1,1,1
2023-06-01,55992,27,1,28,6,2,6
2023-06-01,54890,1,0,1,3,0,3
2023-06-01,55674,8,36,44,11,2,11
2023-06-01,18007,3,1,4,10,3,10
2023-06-01,64302,1,1,2,27,5,27
2023-06-01,136041,15,0,15,10,0,10
2023-06-01,56135,5,0,5,5,0,5
2023-06-01,45270,4,0,4,5,0,5
2023-06-01,10207,16,2,18,3,2,3
2023-06-01,45577,69,3,72,7,3,7
2023-06-01,7551,8,0,8,4,0,4
2023-06-01,133934,5,1,6,5,1,5
2023-06-01,132070,1,0,1,1,0,1
2023-06-01,18334,14,0,14,1,0,1
2023-06-01,132856,1,0,1,1,0,1
2023-06-01,56242,25,0,25,2,0,2
2023-06-01,327907,38,10,48,4,3,4
2023-06-01,328170,14,1,15,5,2,5
2023-06-01,328598,1,0,1,4,0,4
2023-06-01,37723,1,1,2,1,1,1
2023-06-01,328592,3,0,3,3,0,3
2023-06-01,328257,1,0,1,1,0,1
2023-06-01,328888,10,2,12,6,2,7
2023-06-01,328399,4,0,4,4,0,4
2023-06-01,328575,4,1,5,2,2,2
2023-06-01,328271,2,1,3,2,2,3
2023-06-01,328595,2,0,2,1,0,1
2023-06-01,328586,4,0,4,2,0,2
2023-06-01,328589,1,0,1,3,0,3
2023-06-01,328631,27,1,28,5,1,5
2023-06-01,328614,5,0,5,2,0,2
2023-06-01,328599,2,0,2,1,0,1
2023-06-01,328568,5,0,5,4,0,4
2023-06-01,328580,3,3,6,4,4,4
2023-06-01,328566,3,0,3,2,0,2
2023-06-01,328690,2,0,2,1,0,1
2023-06-01,328636,3,0,3,2,0,2
2023-06-01,328581,2,1,3,2,1,2
2023-06-01,328320,9,0,9,4,0,4
2023-06-01,328562,3,0,3,5,0,5
2023-06-01,329122,1,0,1,1,0,1
2023-06-01,328585,8,0,8,3,0,3
2023-06-01,328242,2,1,3,4,3,5
2023-06-01,328038,6,0,6,4,0,4
2023-06-01,328057,8,0,8,3,0,3
2023-06-01,327751,7,0,7,6,0,6
2023-06-01,328548,1,0,1,3,0,3
2023-06-01,328547,1,0,1,5,0,5
2023-06-01,328560,2,1,3,3,3,3
2023-06-01,328557,2,0,2,2,0,2
2023-06-01,328611,4,0,4,3,0,3
2023-06-01,327687,167,34,201,6,5,6
2023-06-01,328556,3,0,3,2,0,2
2023-06-01,328650,2,0,2,2,0,2
2023-06-01,328137,21,5,26,16,5,17
2023-06-01,328583,2,0,2,3,0,3
2023-06-01,328569,1,0,1,2,0,2
2023-06-01,328565,1,0,1,1,0,1
2023-06-01,328591,1,0,1,2,0,2
2023-06-01,328558,1,0,1,1,0,1
2023-06-01,37682,35,3,38,2,1,2
2023-06-01,328538,1,0,1,5,0,5
2023-06-01,328544,2,0,2,3,0,3
2023-06-01,328528,21,1,22,3,2,3
2023-06-01,328534,2,0,2,3,0,3
2023-06-01,328542,3,0,3,1,0,1
2023-06-01,328537,1,1,2,2,1,2
2023-06-01,328552,1,0,1,1,0,1
2023-06-01,328531,1,0,1,1,0,1
2023-06-01,328524,1,0,1,1,0,1
2023-06-01,328574,1,0,1,2,0,2
2023-06-01,328549,3,0,3,1,0,1
2023-06-01,328736,1,0,1,1,0,1
2023-06-01,328561,1,0,1,1,0,1
2023-06-01,328521,5,0,5,2,0,2
2023-06-01,328526,1,1,2,1,1,1
2023-06-01,328533,3,0,3,2,0,2
2023-06-01,328535,4,1,5,4,2,4
2023-06-01,328610,2,0,2,4,0,4
2023-06-01,327932,8,1,9,8,2,8
2023-06-01,328555,5,0,5,3,0,3
2023-06-01,328518,1,0,1,1,0,1
2023-06-01,328567,1,0,1,3,0,3
2023-06-01,328164,2,0,2,3,0,3
2023-06-01,328519,1,1,2,4,2,4
2023-06-01,328539,32,0,32,3,0,3
2023-06-01,328590,5,0,5,2,0,2
2023-06-01,328529,4,0,4,2,0,2
2023-06-01,328510,29,1,30,5,1,5
2023-06-01,328546,5,0,5,1,0,1
2023-06-01,328541,2,1,3,1,1,1
2023-06-01,328516,1,0,1,2,0,2
2023-06-01,328530,1,0,1,2,0,2
2023-06-01,328512,3,1,4,8,3,8
2023-06-01,327991,6,1,7,4,2,4
2023-06-01,328497,3,0,3,3,0,3
2023-06-01,328536,3,0,3,4,0,4
2023-06-01,328553,1,0,1,3,0,3
2023-06-01,328509,5,0,5,1,0,1
2023-06-01,328514,1,0,1,2,0,2
2023-06-01,37594,8,0,8,1,0,1
2023-06-01,328551,2,0,2,2,0,2
2023-06-01,328498,2,0,2,4,0,4
2023-06-01,328391,2,1,3,5,2,5
2023-06-01,328501,5,2,7,6,4,6
2023-06-01,328505,3,0,3,3,0,3
2023-06-01,328500,3,0,3,1,0,1
2023-06-01,328491,1,0,1,1,0,1
2023-06-01,328453,3,1,4,1,1,1
2023-06-01,328503,17,0,17,3,0,3
2023-06-01,327924,5,0,5,2,0,2
2023-06-01,328474,12,1,13,4,2,5
2023-06-01,328468,1,0,1,4,0,4
2023-06-01,328467,2,1,3,3,2,4
2023-06-01,328493,1,0,1,1,0,1
2023-06-01,328482,3,0,3,3,0,3
2023-06-01,328473,6,0,6,4,0,4
2023-06-01,37546,35,0,35,4,0,4
2023-06-01,328570,3,0,3,4,0,4
2023-06-01,328483,1,1,2,2,1,2
2023-06-01,328460,1,0,1,1,0,1
2023-06-01,328461,1,1,2,4,1,4
2023-06-01,328450,1,0,1,1,0,1
2023-06-01,328577,2,0,2,1,0,1
2023-06-01,328449,10,0,10,3,0,3
2023-06-01,328469,6,0,6,8,0,8
2023-06-01,12556,11,0,11,7,0,7
2023-06-01,328705,1,0,1,1,0,1
2023-06-01,328477,1,0,1,1,0,1
2023-06-01,37003,3,0,3,3,0,3
2023-06-01,328441,2,1,3,6,1,6
2023-06-01,328432,2,0,2,1,0,1
2023-06-01,328434,1,0,1,3,0,3
2023-06-01,328478,3,1,4,3,1,3
2023-06-01,327898,2,0,2,2,0,2
2023-06-01,328496,1,0,1,1,0,1
2023-06-01,328504,1,0,1,1,0,1
2023-06-01,328490,1,1,2,6,2,6
2023-06-01,327813,20,7,27,11,3,11
2023-06-01,328480,15,0,15,4,0,4
2023-06-01,21491,86,0,86,3,0,3
2023-06-01,328462,1,0,1,1,0,1
2023-06-01,328448,1,0,1,1,0,1
2023-06-01,328447,1,0,1,1,0,1
2023-06-01,327752,7,0,7,2,0,2
2023-06-01,328427,4,0,4,1,0,1
2023-06-01,328578,7,17,24,4,3,4
2023-06-01,328466,1,0,1,1,0,1
2023-06-01,328435,1,0,1,1,0,1
2023-06-01,328443,6,0,6,1,0,1
2023-06-01,327707,34,0,34,5,0,5
2023-06-01,328523,3,4,7,5,2,5
2023-06-01,328487,2,0,2,1,0,1
2023-06-01,328875,4,0,4,1,0,1
2023-06-01,328015,9,0,9,3,0,3
2023-06-01,328616,5,0,5,4,0,4
2023-06-01,328253,4,0,4,2,0,2
2023-06-01,328423,4,2,6,5,2,5
2023-06-01,328424,2,0,2,1,0,1
2023-06-01,329129,6,0,6,1,0,1
2023-06-01,328431,1,0,1,3,0,3
2023-06-01,328451,7,0,7,2,0,2
2023-06-01,328476,1,0,1,1,0,1
2023-06-01,328430,1,0,1,1,0,1
2023-06-01,328484,1,0,1,2,0,2
2023-06-01,328440,1,0,1,1,0,1
2023-06-01,328488,2,0,2,2,0,2
2023-06-01,328436,12,1,13,6,1,6
2023-06-01,327791,9,0,9,6,0,6
2023-06-01,37549,31,0,31,4,0,4
2023-06-01,328517,4,1,5,6,3,6
2023-06-01,328506,1,0,1,1,0,1
2023-06-01,328507,1,1,2,6,2,6
2023-06-01,328494,3,0,3,1,0,1
2023-06-01,328475,29,0,29,4,0,4
2023-06-01,328479,5,0,5,4,0,4
2023-06-01,328513,1,0,1,2,0,2
2023-06-01,328465,1,0,1,1,0,1
2023-06-01,328456,3,0,3,3,0,3
2023-06-01,328454,2,0,2,1,0,1
2023-06-01,328414,1,1,2,1,1,2
2023-06-01,328088,6,1,7,3,1,3
2023-06-01,37563,10,0,10,1,0,1
2023-06-01,328210,9,0,9,4,0,4
2023-06-01,328222,1,0,1,1,0,1
2023-06-01,327893,2,1,3,4,1,4
2023-06-01,328176,5,0,5,5,0,5
2023-06-01,328405,7,0,7,3,0,3
2023-06-01,328444,4,0,4,5,0,5
2023-06-01,328419,1,0,1,1,0,1
2023-06-01,328429,3,0,3,3,0,3
2023-06-01,328413,3,0,3,3,0,3
2023-06-01,328397,3,0,3,2,0,2
2023-06-01,37150,5,1,6,4,2,4
2023-06-01,328417,2,0,2,4,0,4
2023-06-01,328388,3,0,3,5,0,5
2023-06-01,328385,1,0,1,2,0,2
2023-06-01,328383,1,0,1,1,0,1
2023-06-01,328387,4,0,4,2,0,2
2023-06-01,328386,2,1,3,4,2,4
2023-06-01,328375,5,0,5,5,0,5
2023-06-01,328420,1,0,1,2,0,2
2023-06-01,328403,1,0,1,1,0,1
2023-06-01,328380,1,0,1,1,0,1
2023-06-01,328401,1,0,1,2,0,2
2023-06-01,328068,22,1,23,6,1,6
2023-06-01,328364,32,0,32,3,0,3
2023-06-01,37634,17,0,17,4,0,4
2023-06-01,37645,33,1,34,5,2,5
2023-06-01,21271,14,3,17,3,3,4
2023-06-01,328884,9,0,9,6,0,6
2023-06-01,328426,8,0,8,3,0,3
2023-06-01,328367,1,0,1,1,0,1
2023-06-01,328371,1,0,1,1,0,1
2023-06-01,328361,1,0,1,3,0,3
2023-06-01,328356,4,0,4,4,0,4
2023-06-01,327975,10,0,10,3,0,3
2023-06-01,328373,2,0,2,4,0,4
2023-06-01,328362,1,0,1,1,0,1
2023-06-01,328350,17,1,18,6,3,6
2023-06-01,327820,8,0,8,3,0,3
2023-06-01,327996,56,0,56,4,2,4
2023-06-01,328347,5,0,5,3,0,3
2023-06-01,37577,83,0,83,7,0,7
2023-06-01,63293,64,44,108,57,36,58
2023-06-01,37582,20,2,22,3,1,3
2023-06-01,327796,1,0,1,2,0,2
2023-06-01,327719,2,0,2,2,0,2
2023-06-01,3745,3,0,3,5,0,5
2023-06-01,327875,1,0,1,4,0,4
2023-06-01,328010,2,1,3,3,1,4
2023-06-01,328349,9,0,9,1,0,1
2023-06-01,328346,5,1,6,3,1,3
2023-06-01,328502,3,0,3,1,0,1
2023-06-01,328337,3,1,4,3,1,3
2023-06-01,328339,3,1,4,5,1,5
2023-06-01,328384,8,1,9,4,2,4
2023-06-01,328348,1,0,1,2,0,2
2023-06-01,328334,5,1,6,5,1,5
2023-06-01,328437,5,2,7,6,1,6
2023-06-01,328370,2,0,2,2,0,2
2023-06-01,328392,1,0,1,2,0,2
2023-06-01,328353,1,0,1,1,0,1
2023-06-01,328336,5,1,6,3,1,3
2023-06-01,328343,4,0,4,2,0,2
2023-06-01,328408,1,0,1,1,0,1
2023-06-01,328358,5,1,6,1,1,1
2023-06-01,328485,3,0,3,1,0,1
2023-06-01,328331,5,0,5,2,0,2
2023-06-01,328344,10,0,10,7,0,7
2023-06-01,328903,4,0,4,1,0,1
2023-06-01,328372,1,0,1,2,0,2
2023-06-01,328352,1,0,1,2,0,2
2023-06-01,328335,1,0,1,2,0,2
2023-06-01,328355,1,0,1,1,0,1
2023-06-01,328266,20,7,27,4,4,5
2023-06-01,328359,1,0,1,1,0,1
2023-06-01,328327,22,1,23,5,2,5
2023-06-01,328369,1,0,1,1,0,1
2023-06-01,328351,1,0,1,3,0,3
2023-06-01,37649,52,0,52,5,0,5
2023-06-01,25250,26,0,26,4,0,4
2023-06-01,37720,3,0,3,7,0,7
2023-06-01,36894,2,0,2,1,0,1
2023-06-01,328638,18,1,19,4,2,4
2023-06-01,328216,2,0,2,3,0,3
2023-06-01,327830,6,0,6,1,0,1
2023-06-01,328323,2,0,2,4,0,4
2023-06-01,328319,3,0,3,2,0,2
2023-06-01,328394,3,0,3,2,0,2
2023-06-01,328816,1,0,1,2,0,2
2023-06-01,328376,2,0,2,1,0,1
2023-06-01,328122,1,0,1,1,0,1
2023-06-01,328332,1,0,1,2,0,2
2023-06-01,328324,1,0,1,1,0,1
2023-06-01,328313,3,0,3,4,0,4
2023-06-01,327861,2,0,2,5,0,5
2023-06-01,327962,5,0,5,3,0,3
2023-06-01,328297,1,1,2,1,1,1
2023-06-01,328341,1,1,2,3,3,3
2023-06-01,328305,1,0,1,2,0,2
2023-06-01,328302,5,0,5,2,0,2
2023-06-01,140595,7,0,7,7,3,7
2023-06-01,328296,3,0,3,1,0,1
2023-06-01,328285,1,1,2,2,1,2
2023-06-01,328315,12,5,17,4,3,4
2023-06-01,328286,4,0,4,3,0,3
2023-06-01,328287,1,0,1,4,0,4
2023-06-01,328307,1,0,1,3,0,3
2023-06-01,36978,7,0,7,3,0,3
2023-06-01,328292,1,0,1,2,0,2
2023-06-01,37394,1,1,2,1,1,1
2023-06-01,328308,1,0,1,2,0,2
2023-06-01,328304,2,0,2,1,0,1
2023-06-01,328282,4,0,4,3,0,3
2023-06-01,328310,3,0,3,2,0,2
2023-06-01,328617,1,0,1,1,0,1
2023-06-01,328278,7,1,8,3,1,3
2023-06-01,328284,6,0,6,1,0,1
2023-06-01,328288,1,0,1,1,0,1
2023-06-01,328275,1,0,1,3,0,3
2023-06-01,37521,9,1,10,4,1,4
2023-06-01,329078,2,0,2,1,0,1
2023-06-01,327897,15,0,15,5,0,5
2023-06-01,328270,9,1,10,7,2,7
2023-06-01,328281,1,0,1,1,0,1
2023-06-01,328280,1,1,2,1,1,1
2023-06-01,328295,1,0,1,1,0,1
2023-06-01,328289,3,0,3,1,0,1
2023-06-01,327984,2,0,2,5,0,5
2023-06-01,328256,4,0,4,3,0,3
2023-06-01,328274,2,0,2,1,0,1
2023-06-01,328300,1,0,1,2,0,2
2023-06-01,328260,1,0,1,2,0,2
2023-06-01,328293,1,0,1,1,0,1
2023-06-01,37356,76,3,79,6,3,6
2023-06-01,328262,2,1,3,4,2,5
2023-06-01,328269,7,0,7,4,0,4
2023-06-01,327900,16,0,16,4,0,4
2023-06-01,328261,4,0,4,2,0,2
2023-06-01,328230,5,0,5,3,0,3
2023-06-01,329250,1,0,1,1,0,1
2023-06-01,329254,1,0,1,1,0,1
2023-06-01,328178,12,1,13,5,2,5
2023-06-01,329247,1,0,1,1,0,1
2023-06-01,329246,1,0,1,1,0,1
2023-06-01,329248,1,0,1,1,0,1
2023-06-01,329244,1,0,1,1,0,1
2023-06-01,329243,1,0,1,2,0,2
2023-06-01,329240,1,0,1,2,0,2
2023-06-01,329237,1,0,1,3,0,3
2023-06-01,329251,1,0,1,1,0,1
2023-06-01,329241,1,0,1,1,0,1
2023-06-01,329236,1,0,1,1,0,1
2023-06-01,328200,36,3,39,3,1,3
2023-06-01,329222,4,0,4,1,0,1
2023-06-01,328785,12,0,12,5,0,5
2023-06-01,329235,1,0,1,1,0,1
2023-06-01,328957,1,0,1,1,0,1
2023-06-01,64945,3,0,3,1,0,1
2023-06-01,329214,3,0,3,4,0,4
2023-06-01,8582,2,0,2,3,0,3
2023-06-01,329223,1,0,1,1,0,1
2023-06-01,37005,2,0,2,1,0,1
2023-06-01,329239,1,0,1,2,0,2
2023-06-01,329232,1,0,1,1,0,1
2023-06-01,329215,2,0,2,4,0,4
2023-06-01,329211,5,1,6,3,2,3
2023-06-01,329207,4,0,4,2,0,2
2023-06-01,328658,5,0,5,2,0,2
2023-06-01,329230,2,0,2,2,0,2
2023-06-01,327872,4,1,5,4,3,5
2023-06-01,329206,1,0,1,1,0,1
2023-06-01,329202,1,0,1,3,0,3
2023-06-01,329027,4,0,4,1,0,1
2023-06-01,328856,5,0,5,4,0,4
2023-06-01,329205,1,0,1,1,0,1
2023-06-01,329221,1,0,1,1,0,1
2023-06-01,36940,4,1,5,7,1,7
2023-06-01,329182,2,0,2,5,0,5
2023-06-01,3291,1,0,1,1,0,1
2023-06-01,329183,1,0,1,3,0,3
2023-06-01,328961,3,5,8,1,2,2
2023-06-01,327946,3,0,3,1,0,1
2023-06-01,329006,7,0,7,4,0,4
2023-06-01,37114,3,0,3,3,0,3
2023-06-01,327710,1,0,1,1,0,1
2023-06-01,329255,1,0,1,1,0,1
2023-06-01,329252,1,0,1,1,0,1
2023-06-01,328916,2,1,3,2,2,2
2023-06-01,329177,1,1,2,1,1,1
2023-06-01,329176,4,0,4,2,0,2
2023-06-01,329198,1,0,1,2,0,2
2023-06-01,329179,1,0,1,1,0,1
2023-06-01,329200,3,0,3,1,0,1
2023-06-01,329210,1,0,1,1,0,1
2023-06-01,329174,1,0,1,3,0,3
2023-06-01,329166,1,1,2,4,1,4
2023-06-01,329208,1,0,1,1,0,1
2023-06-01,329171,1,0,1,1,0,1
2023-06-01,328943,6,1,7,4,1,4
2023-06-01,327871,5,0,5,1,0,1
2023-06-01,328676,3,0,3,3,0,3
2023-06-01,329155,3,0,3,2,0,2
2023-06-01,329154,2,0,2,1,0,1
2023-06-01,329170,1,0,1,2,0,2
2023-06-01,329135,5,0,5,1,0,1
2023-06-01,329169,1,0,1,1,0,1
2023-06-01,329151,1,0,1,1,0,1
2023-06-01,329140,1,0,1,1,0,1
2023-06-01,329142,1,0,1,1,0,1
2023-06-01,329157,1,0,1,1,0,1
2023-06-01,329165,1,0,1,1,0,1
2023-06-01,329126,4,1,5,4,3,4
2023-06-01,329185,1,0,1,2,0,2
2023-06-01,329194,1,0,1,1,0,1
2023-06-01,328997,8,0,8,2,0,2
2023-06-01,329124,1,0,1,1,0,1
2023-06-01,329125,5,0,5,3,0,3
2023-06-01,328169,2,0,2,1,0,1
2023-06-01,329143,1,0,1,1,0,1
2023-06-01,328704,7,0,7,1,0,1
2023-06-01,327767,13,3,16,6,3,6
2023-06-01,329136,1,0,1,1,0,1
2023-06-01,329138,1,0,1,1,0,1
2023-06-01,329128,1,0,1,1,0,1
2023-06-01,329161,1,0,1,1,0,1
2023-06-01,329159,5,0,5,3,0,3
2023-06-01,327983,3,1,4,7,3,7
2023-06-01,329144,4,0,4,1,0,1
2023-06-01,65515,1,0,1,1,0,1
2023-06-01,329133,1,0,1,1,0,1
2023-06-01,329132,1,1,2,1,1,1
2023-06-01,329121,2,0,2,3,0,3
2023-06-01,329108,1,0,1,1,0,1
2023-06-01,329123,1,0,1,1,0,1
2023-06-01,329110,3,0,3,1,0,1
2023-06-01,329167,1,0,1,1,0,1
2023-06-01,329094,1,0,1,2,0,2
2023-06-01,328803,7,3,10,3,1,3
2023-06-01,329029,5,1,6,3,1,3
2023-06-01,329097,3,0,3,3,0,3
2023-06-01,329111,1,0,1,2,0,2
2023-06-01,329091,1,0,1,1,0,1
2023-06-01,329228,1,0,1,1,0,1
2023-06-01,329106,1,0,1,2,0,2
2023-06-01,329082,4,0,4,1,0,1
2023-06-01,329098,1,0,1,3,0,3
2023-06-01,329088,4,1,5,1,1,1
2023-06-01,328661,12,1,13,5,1,5
2023-06-01,329101,5,1,6,3,2,3
2023-06-01,37531,30,1,31,4,1,4
2023-06-01,329107,1,0,1,1,0,1
2023-06-01,329134,1,0,1,1,0,1
2023-06-01,329119,1,0,1,1,0,1
2023-06-01,329069,1,1,2,2,2,2
2023-06-01,329095,1,1,2,2,2,2
2023-06-01,329067,1,0,1,1,0,1
2023-06-01,328727,8,0,8,1,0,1
2023-06-01,329089,2,0,2,1,0,1
2023-06-01,329074,1,0,1,1,0,1
2023-06-01,329087,5,0,5,3,0,3
2023-06-01,329086,4,0,4,1,0,1
2023-06-01,329063,3,0,3,5,0,5
2023-06-01,329084,2,0,2,1,0,1
2023-06-01,329056,5,4,9,1,1,1
2023-06-01,329065,3,0,3,1,0,1
2023-06-01,329068,5,0,5,2,0,2
2023-06-01,329071,1,0,1,1,0,1
2023-06-01,329083,1,1,2,2,2,2
2023-06-01,328992,4,0,4,1,0,1
2023-06-01,329049,1,0,1,2,0,2
2023-06-01,329058,2,0,2,1,0,1
2023-06-01,329045,2,0,2,1,0,1
2023-06-01,329062,1,1,2,1,1,2
2023-06-01,329057,2,0,2,2,0,2
2023-06-01,329039,5,0,5,1,0,1
2023-06-01,329050,1,0,1,1,0,1
2023-06-01,329072,1,0,1,1,0,1
2023-06-01,329035,1,1,2,2,2,3
2023-06-01,328751,2,0,2,1,0,1
2023-06-01,329048,1,0,1,1,0,1
2023-06-01,329053,3,0,3,4,0,4
2023-06-01,329066,1,0,1,2,0,2
2023-06-01,329064,1,0,1,3,0,3
2023-06-01,329033,3,1,4,2,1,2
2023-06-01,329028,3,1,4,3,1,3
2023-06-01,329044,3,0,3,3,0,3
2023-06-01,329075,1,0,1,1,0,1
2023-06-01,329031,2,0,2,2,0,2
2023-06-01,329020,5,0,5,1,0,1
2023-06-01,329038,1,0,1,1,0,1
2023-06-01,329021,1,0,1,2,0,2
2023-06-01,329026,0,0,0,2,0,2
2023-06-01,25568,8,0,8,2,0,2
2023-06-01,329041,1,0,1,1,0,1
2023-06-01,329054,2,0,2,1,0,1
2023-06-01,329034,1,0,1,1,0,1
2023-06-01,329016,1,0,1,1,0,1
2023-06-01,329023,1,0,1,1,0,1
2023-06-01,329160,1,0,1,1,0,1
2023-06-01,329022,2,0,2,2,0,2
2023-06-01,329014,1,0,1,1,0,1
2023-06-01,328111,6,1,7,3,1,3
2023-06-01,329013,1,0,1,1,0,1
2023-06-01,329032,1,0,1,2,0,2
2023-06-01,329024,4,5,9,3,2,3
2023-06-01,329036,1,0,1,2,0,2
2023-06-01,327746,8,0,8,4,0,4
2023-06-01,329011,1,0,1,1,0,1
2023-06-01,329009,2,0,2,2,0,2
2023-06-01,328732,10,1,11,4,1,4
2023-06-01,329099,1,0,1,1,0,1
2023-06-01,329109,1,0,1,1,0,1
2023-06-01,328999,5,0,5,3,0,3
2023-06-01,329010,1,0,1,1,0,1
2023-06-01,328991,1,0,1,2,0,2
2023-06-01,329005,1,0,1,1,0,1
2023-06-01,329002,2,0,2,2,0,2
2023-06-01,328987,7,1,8,4,1,4
2023-06-01,328994,5,0,5,2,0,2
2023-06-01,328979,1,1,2,1,1,1
2023-06-01,328993,5,0,5,3,0,3
2023-06-01,328989,5,0,5,3,0,3
2023-06-01,329181,12,0,12,1,0,1
2023-06-01,328981,1,0,1,1,0,1
2023-06-01,327906,2,0,2,3,0,3
2023-06-01,328984,1,1,2,1,1,1
2023-06-01,328977,7,1,8,4,2,4
2023-06-01,327966,9,1,10,4,2,4
2023-06-01,328633,4,1,5,3,2,4
2023-06-01,328970,3,0,3,3,0,3
2023-06-01,328971,1,0,1,1,0,1
2023-06-01,329186,1,0,1,1,0,1
2023-06-01,37659,4,0,4,2,0,2
2023-06-01,328966,4,0,4,3,0,3
2023-06-01,328974,5,0,5,2,0,2
2023-06-01,328808,2,0,2,2,0,2
2023-06-01,328745,5,16,21,4,2,5
2023-06-01,328214,6,0,6,4,0,4
2023-06-01,328964,1,1,2,5,4,5
2023-06-01,329019,1,0,1,1,0,1
2023-06-01,24757,488,4,492,4,2,4
2023-06-01,328955,1,0,1,1,0,1
2023-06-01,328952,1,0,1,4,0,4
2023-06-01,328954,3,0,3,1,0,1
2023-06-01,328948,3,0,3,2,0,2
2023-06-01,329012,1,0,1,1,0,1
2023-06-01,328972,5,0,5,1,0,1
2023-06-01,328944,1,0,1,1,0,1
2023-06-01,328942,5,1,6,5,1,5
2023-06-01,328946,3,0,3,4,0,4
2023-06-01,328988,4,1,5,3,1,3
2023-06-01,328959,3,0,3,1,0,1
2023-06-01,328016,5,1,6,2,1,3
2023-06-01,328950,4,1,5,2,1,2
2023-06-01,328938,1,0,1,1,0,1
2023-06-01,328945,3,0,3,3,0,3
2023-06-01,328939,5,1,6,4,4,4
2023-06-01,328953,1,0,1,1,0,1
2023-06-01,328940,3,0,3,2,0,2
2023-06-01,328965,1,0,1,1,0,1
2023-06-01,37725,3,0,3,3,0,3
2023-06-01,328923,1,1,2,1,1,1
2023-06-01,328980,2,0,2,2,0,2
2023-06-01,328925,3,0,3,2,0,2
2023-06-01,328949,1,0,1,1,0,1
2023-06-01,328733,10,0,10,2,0,2
2023-06-01,328922,1,0,1,1,0,1
2023-06-01,328826,2,0,2,4,0,4
2023-06-01,328918,1,0,1,1,0,1
2023-06-01,328915,4,0,4,4,0,4
2023-06-01,328906,4,0,4,1,0,1
2023-06-01,329184,4,0,4,3,0,3
2023-06-01,328899,1,0,1,1,0,1
2023-06-01,328895,5,1,6,3,2,3
2023-06-01,328932,1,0,1,1,0,1
2023-06-01,328719,3,0,3,3,0,3
2023-06-01,328933,1,0,1,2,0,2
2023-06-01,328934,1,0,1,1,0,1
2023-06-01,328978,1,0,1,1,0,1
2023-06-01,32860,18,1,19,2,1,2
2023-06-01,328893,1,0,1,1,0,1
2023-06-01,328902,1,0,1,2,0,2
2023-06-01,328887,1,0,1,1,0,1
2023-06-01,328914,4,0,4,1,0,1
2023-06-01,328900,4,0,4,2,0,2
2023-06-01,328935,1,1,2,3,1,3
2023-06-01,328920,1,0,1,1,0,1
2023-06-01,329047,1,1,2,2,2,3
2023-06-01,328996,1,0,1,2,0,2
2023-06-01,328917,5,0,5,4,0,4
2023-06-01,328896,1,0,1,1,0,1
2023-06-01,328845,1,0,1,2,0,2
2023-06-01,328882,1,0,1,1,0,1
2023-06-01,328941,3,0,3,1,0,1
2023-06-01,328890,3,0,3,2,0,2
2023-06-01,328891,4,0,4,1,0,1
2023-06-01,328870,3,2,5,3,2,3
2023-06-01,328876,3,0,3,2,0,2
2023-06-01,328874,3,0,3,2,0,2
2023-06-01,328894,1,0,1,1,0,1
2023-06-01,328892,1,0,1,1,0,1
2023-06-01,327960,10,1,11,4,3,4
2023-06-01,328931,4,1,5,5,1,5
2023-06-01,328864,1,0,1,1,0,1
2023-06-01,327769,6,0,6,1,0,1
2023-06-01,328853,1,0,1,1,0,1
2023-06-01,328919,2,0,2,2,0,2
2023-06-01,328854,2,0,2,1,0,1
2023-06-01,328862,1,0,1,2,0,2
2023-06-01,328883,2,0,2,1,0,1
2023-06-01,328872,2,0,2,3,0,3
2023-06-01,328863,1,0,1,1,0,1
2023-06-01,328849,1,0,1,1,0,1
2023-06-01,328869,1,0,1,1,0,1
2023-06-01,328850,1,0,1,1,0,1
2023-06-01,328852,1,0,1,2,0,2
2023-06-01,328861,2,0,2,3,0,3
2023-06-01,328877,1,0,1,1,0,1
2023-06-01,328848,1,1,2,3,2,4
2023-06-01,328855,4,3,7,3,2,3
2023-06-01,328859,1,0,1,1,0,1
2023-06-01,328868,3,0,3,4,0,4
2023-06-01,328851,1,0,1,1,0,1
2023-06-01,328858,5,0,5,1,0,1
2023-06-01,328840,2,3,5,5,4,6
2023-06-01,328847,2,0,2,3,0,3
2023-06-01,328831,2,0,2,5,0,5
2023-06-01,328843,1,1,2,3,1,3
2023-06-01,328837,4,0,4,4,0,4
2023-06-01,328839,1,1,2,2,2,2
2023-06-01,328838,1,1,2,1,1,1
2023-06-01,328825,4,1,5,1,1,1
2023-06-01,37599,5,0,5,5,0,5
2023-06-01,328820,4,1,5,4,3,4
2023-06-01,328819,5,0,5,3,0,3
2023-06-01,328815,3,0,3,2,0,2
2023-06-01,328897,1,0,1,1,0,1
2023-06-01,328836,1,0,1,2,0,2
2023-06-01,328911,1,0,1,3,0,3
2023-06-01,328929,3,0,3,2,0,2
2023-06-01,328912,1,0,1,3,0,3
2023-06-01,328885,3,0,3,3,0,3
2023-06-01,328881,3,0,3,2,0,2
2023-06-01,328818,3,1,4,3,2,3
2023-06-01,328822,1,1,2,2,2,2
2023-06-01,328821,3,0,3,2,0,2
2023-06-01,328817,2,0,2,1,0,1
2023-06-01,328835,7,0,7,1,0,1
2023-06-01,328829,4,1,5,4,2,4
2023-06-01,328805,7,0,7,1,0,1
2023-06-01,327756,7,0,7,3,0,3
2023-06-01,328813,4,1,5,1,1,1
2023-06-01,328951,1,0,1,2,0,2
2023-06-01,328802,4,1,5,2,1,2
2023-06-01,328812,1,0,1,3,0,3
2023-06-01,37550,23,1,24,4,1,5
2023-06-01,328857,5,0,5,2,0,2
2023-06-01,327829,7,0,7,3,0,3
2023-06-01,328806,1,0,1,2,0,2
2023-06-01,328811,1,0,1,1,0,1
2023-06-01,328795,5,0,5,5,0,5
2023-06-01,328763,1,0,1,3,0,3
2023-06-01,328810,5,0,5,5,0,5
2023-06-01,328400,4,0,4,7,0,7
2023-06-01,328789,1,0,1,1,0,1
2023-06-01,328797,6,0,6,2,0,2
2023-06-01,328947,1,0,1,1,0,1
2023-06-01,328792,3,0,3,4,0,4
2023-06-01,328790,2,3,5,3,3,3
2023-06-01,328794,2,0,2,1,0,1
2023-06-01,328798,1,0,1,1,0,1
2023-06-01,328800,1,0,1,1,0,1
2023-06-01,328791,1,0,1,1,0,1
2023-06-01,761467,1,0,1,1,0,1
2023-06-01,328787,1,1,2,1,1,1
2023-06-01,328780,3,0,3,6,0,6
2023-06-01,328779,4,0,4,5,0,5
2023-06-01,328777,1,0,1,4,0,4
2023-06-01,328784,1,0,1,1,0,1
2023-06-01,328761,1,0,1,3,0,3
2023-06-01,328823,2,0,2,1,0,1
2023-06-01,328775,1,0,1,3,0,3
2023-06-01,328714,1,1,2,3,1,3
2023-06-01,328782,1,0,1,1,0,1
2023-06-01,329127,1,0,1,1,0,1
2023-06-01,329114,2,0,2,2,0,2
2023-06-01,37381,36,1,37,6,2,6
2023-06-01,328809,1,1,2,1,1,1
2023-06-01,328768,1,0,1,1,0,1
2023-06-01,328744,2,0,2,3,0,3
2023-06-01,328772,3,0,3,4,0,4
2023-06-01,328758,1,0,1,1,0,1
2023-06-01,328742,1,0,1,2,0,2
2023-06-01,328796,1,0,1,2,0,2
2023-06-01,328793,1,0,1,1,0,1
2023-06-01,328730,1,0,1,2,0,2
2023-06-01,328750,5,0,5,4,0,4
2023-06-01,328743,2,0,2,1,0,1
2023-06-01,328717,4,0,4,2,0,2
2023-06-01,328722,4,0,4,2,0,2
2023-06-01,328760,1,0,1,3,0,3
2023-06-01,328713,4,0,4,2,0,2
2023-06-01,328712,2,0,2,3,0,3
2023-06-01,328737,4,0,4,2,0,2
2023-06-01,328767,1,1,2,5,3,5
2023-06-01,328718,5,0,5,1,0,1
2023-06-01,328723,4,0,4,3,0,3
2023-06-01,328783,1,0,1,1,0,1
2023-06-01,327817,2,1,3,4,3,4
2023-06-01,328708,2,0,2,2,0,2
2023-06-01,328724,3,0,3,3,0,3
2023-06-01,328721,1,0,1,1,0,1
2023-06-01,328771,1,0,1,1,0,1
2023-06-01,328755,1,0,1,2,0,2
2023-06-01,328749,3,0,3,4,0,4
2023-06-01,328697,2,0,2,2,0,2
2023-06-01,37724,3,1,4,2,2,3
2023-06-01,328746,1,0,1,1,0,1
2023-06-01,328706,1,1,2,5,1,6
2023-06-01,328754,3,0,3,3,0,3
2023-06-01,328703,2,0,2,1,0,1
2023-06-01,328729,3,0,3,3,0,3
2023-06-01,328725,3,0,3,1,0,1
2023-06-01,328630,2,0,2,1,0,1
2023-06-01,328365,4,1,5,3,2,3
2023-06-01,328699,2,1,3,4,2,4
2023-06-01,328720,3,1,4,3,2,3
2023-06-01,328696,4,0,4,3,0,3
2023-06-01,328716,1,0,1,1,0,1
2023-06-01,37542,20,2,22,8,3,8
2023-06-01,328735,1,0,1,4,0,4
2023-06-01,328734,7,0,7,3,0,3
2023-06-01,328710,4,0,4,3,0,3
2023-06-01,328707,3,0,3,1,0,1
2023-06-01,328711,4,0,4,1,0,1
2023-06-01,328672,5,0,5,5,0,5
2023-06-01,328693,2,1,3,2,1,2
2023-06-01,328303,8,0,8,3,0,3
2023-06-01,328770,1,0,1,1,0,1
2023-06-01,328769,1,0,1,1,0,1
2023-06-01,328752,1,0,1,2,0,2
2023-06-01,328709,4,0,4,1,0,1
2023-06-01,328698,1,0,1,3,0,3
2023-06-01,328677,2,1,3,5,2,5
2023-06-01,205897,9,6,15,7,6,8
2023-06-01,328702,3,0,3,2,0,2
2023-06-01,328464,4,0,4,2,0,2
2023-06-01,328700,1,1,2,1,1,1
2023-06-01,328670,1,0,1,4,0,4
2023-06-01,328669,1,0,1,1,0,1
2023-06-01,37316,2,0,2,3,0,3
2023-06-01,328695,1,0,1,1,0,1
2023-06-01,328666,1,0,1,1,0,1
2023-06-01,328652,4,0,4,2,0,2
2023-06-01,328668,4,1,5,1,1,1
2023-06-01,328656,1,0,1,3,0,3
2023-06-01,328679,4,0,4,1,0,1
2023-06-01,328657,3,0,3,5,0,5
2023-06-01,328637,5,0,5,2,0,2
2023-06-01,328647,1,0,1,1,0,1
2023-06-01,6879,25,0,25,3,0,3
2023-06-01,2561,76,0,76,3,0,3
2023-06-01,328762,2,0,2,1,0,1
2023-06-01,328738,1,0,1,1,0,1
2023-06-01,328662,1,0,1,1,0,1
2023-06-01,327784,2,0,2,3,0,3
2023-06-01,328649,1,0,1,1,0,1
2023-06-01,328694,1,0,1,1,0,1
2023-06-01,201811,2,1,3,4,4,6
2023-06-01,328639,1,0,1,1,0,1
2023-06-01,328643,1,0,1,3,0,3
2023-06-01,328061,9,0,9,3,0,3
2023-06-01,328624,1,1,2,4,2,4
2023-06-01,15022,5,2,7,5,4,5
2023-06-01,328645,4,0,4,3,0,3
2023-06-01,328641,4,3,7,2,1,2
2023-06-01,328648,1,0,1,1,0,1
2023-06-01,328627,1,0,1,1,0,1
2023-06-01,329042,1,0,1,3,0,3
2023-06-01,328604,3,0,3,1,0,1
2023-06-01,327822,5,3,8,6,3,6
2023-06-01,328701,3,0,3,2,0,2
2023-06-01,328618,2,0,2,4,0,4
2023-06-01,328612,1,1,2,2,1,2
2023-06-01,328660,2,0,2,3,0,3
2023-06-01,328622,5,0,5,2,0,2
2023-06-01,328621,7,0,7,5,0,5
2023-06-01,328654,1,0,1,1,0,1
2023-06-01,328927,1,0,1,1,0,1
2023-06-01,328634,1,0,1,1,0,1
2023-06-01,328629,1,0,1,1,0,1
2023-06-01,328644,1,1,2,2,2,2
2023-06-01,327773,5,0,5,3,0,3
2023-06-01,4608,9,13,22,13,7,13
2023-06-01,56172,3,1,4,3,3,6
2023-06-01,55567,4,0,4,4,0,4
2023-06-01,131188,8,1,9,3,2,3
2023-06-01,131267,51,0,51,10,0,10
2023-06-01,142352,4,0,4,4,0,4
2023-06-01,24233,16,0,16,4,0,4
2023-06-01,38306,6,0,6,2,0,2
2023-06-01,23720,5,1,6,1,1,1
2023-06-01,209584,1,1,2,1,1,1
2023-06-01,150318,1,1,2,2,2,2
2023-06-01,5087,84,4,88,3,1,3
2023-06-01,149129,1,1,2,1,1,1
2023-06-01,45570,11,3,14,2,2,2
2023-06-01,23900,9,0,9,8,0,8
2023-06-01,55508,9,0,9,3,0,3
2023-06-01,24337,24,0,24,10,0,10
2023-06-01,24338,2,0,2,4,0,4
2023-06-01,24130,11,1,12,11,2,12
2023-06-01,23871,55,2,57,7,3,8
2023-06-01,23627,7,1,8,3,3,3
2023-06-01,55385,5,1,6,4,1,4
2023-06-01,7527,2,1,3,3,2,3
2023-06-01,24257,3,0,3,5,0,5
2023-06-01,17693,4,0,4,2,0,2
2023-06-01,24259,13,1,14,5,3,5
2023-06-01,7505,4,1,5,4,2,4
2023-06-01,150172,4,1,5,6,1,6
2023-06-01,139609,2,1,3,11,2,11
2023-06-01,45891,18,0,18,4,0,4
2023-06-01,134525,3,0,3,1,0,1
2023-06-01,17958,7,1,8,5,5,7
2023-06-01,132805,1,0,1,1,0,1
2023-06-01,132804,1,0,1,1,0,1
2023-06-01,45441,5,0,5,2,0,2
2023-06-01,18015,17,0,17,6,0,6
2023-06-01,38639,9,3,12,5,4,5
2023-06-01,38896,48,0,48,6,0,6
2023-06-01,58634,4,0,4,3,0,3
2023-06-01,137455,7,3,10,4,3,4
2023-06-01,55898,5,1,6,4,1,4
2023-06-01,23816,8,1,9,8,4,9
2023-06-01,131965,50,0,50,3,0,3
2023-06-01,10030,128,10,138,9,7,10
2023-06-01,10174,7,0,7,2,0,2
2023-06-01,58608,1,0,1,1,0,1
2023-06-01,56235,2,0,2,2,0,2
2023-06-01,56237,1,1,2,2,1,2
2023-06-01,9340,244,1,245,34,3,34
2023-06-01,56238,1,0,1,2,0,2
2023-06-01,24282,7,1,8,4,2,4
2023-06-01,135477,12,3,15,7,2,7
2023-06-01,45289,7,0,7,1,0,1
2023-06-01,59149,11,0,11,4,0,4
2023-06-01,56236,1,1,2,1,1,1
2023-06-01,56240,2,0,2,1,0,1
2023-06-01,56262,10,0,10,5,0,5
2023-06-01,137996,7,1,8,9,2,9
2023-06-01,7595,6,1,7,5,2,5
2023-06-01,17755,2,0,2,2,0,2
2023-06-01,132016,2,0,2,3,0,3
2023-06-01,9466,18,2,20,4,1,4
2023-06-01,38149,3,0,3,1,0,1
2023-06-01,56263,2,0,2,3,0,3
2023-06-01,139994,13,12,25,1,1,1
2023-06-01,56265,5,0,5,4,0,4
2023-06-01,56289,4,0,4,2,0,2
2023-06-01,136169,4,0,4,3,0,3
2023-06-01,7677,10,0,10,3,0,3
2023-06-01,55604,5,0,5,3,0,3
2023-06-01,38760,14,5,19,1,1,1
2023-06-01,134143,25,1,26,5,2,5
2023-06-01,56003,4,0,4,1,0,1
2023-06-01,150216,1,0,1,2,0,2
2023-06-01,58392,2,1,3,15,5,15
2023-06-01,136736,1,1,2,1,1,1
2023-06-01,150204,3,0,3,1,0,1
2023-06-01,141934,4,1,5,4,2,4
2023-06-01,58528,5,0,5,2,0,2
2023-06-01,45331,4,0,4,2,0,2
2023-06-01,138823,8,7,15,7,3,7
2023-06-01,137053,3,0,3,1,0,1
2023-06-01,23750,65,2,67,12,1,12
2023-06-01,140607,13,0,13,2,0,2
2023-06-01,59378,5,1,6,12,2,12
2023-06-01,18400,4,1,5,14,3,14
2023-06-01,131318,1,0,1,1,0,1
2023-06-01,131316,6,0,6,5,0,5
2023-06-01,131342,5,0,5,2,0,2
2023-06-01,131455,6,0,6,4,0,4
2023-06-01,149931,3,0,3,1,0,1
2023-06-01,131460,6,0,6,2,0,2
2023-06-01,9472,3,0,3,1,0,1
2023-06-01,10101,23,0,23,3,0,3
2023-06-01,131467,3,0,3,2,0,2
2023-06-01,131474,1,0,1,1,0,1
2023-06-01,55698,3,0,3,1,0,1
2023-06-01,131473,3,0,3,3,0,3
2023-06-01,56252,1,0,1,4,0,4
2023-06-01,55350,5,1,6,8,2,8
2023-06-01,9752,8,1,9,1,1,1
2023-06-01,132021,6,0,6,6,0,6
2023-06-01,135366,7,0,7,3,0,3
2023-06-01,45452,5,0,5,5,0,5
2023-06-01,132032,2,0,2,1,0,1
2023-06-01,58631,2,2,4,2,2,2
2023-06-01,58422,1,0,1,1,0,1
2023-06-01,55309,22,1,23,12,1,12
2023-06-01,131345,2,0,2,2,0,2
2023-06-01,135387,12,0,12,2,0,2
2023-06-01,138074,10,1,11,4,1,4
2023-06-01,58381,18,1,19,3,1,3
2023-06-01,45499,32,2,34,11,3,11
2023-06-01,131896,9,0,9,4,0,4
2023-06-01,131904,6,0,6,1,0,1
2023-06-01,56290,3,0,3,1,0,1
2023-06-01,9876,18,0,18,7,0,7
2023-06-01,132027,1,0,1,1,0,1
2023-06-01,55575,5,0,5,3,0,3
2023-06-01,132028,2,0,2,2,0,2
2023-06-01,134753,4,1,5,6,2,6
2023-06-01,24189,2,0,2,1,0,1
2023-06-01,56081,4,0,4,1,0,1
2023-06-01,58979,1,0,1,1,0,1
2023-06-01,150059,1,0,1,1,0,1
2023-06-01,132033,1,0,1,1,0,1
2023-06-01,134778,1,0,1,1,0,1
2023-06-01,141226,20,1,21,3,2,3
2023-06-01,131160,1,1,2,4,2,4
2023-06-01,58387,3,0,3,4,0,4
2023-06-01,58456,1,0,1,1,0,1
2023-06-01,55894,1,0,1,1,0,1
2023-06-01,132035,5,5,10,2,1,2
2023-06-01,38207,32,0,32,2,0,2
2023-06-01,131347,1,0,1,2,0,2
2023-06-01,38253,12,0,12,1,0,1
2023-06-01,135516,5,0,5,3,0,3
2023-06-01,133121,5,0,5,3,0,3
2023-06-01,150316,3,0,3,2,0,2
2023-06-01,4768,106,1,107,34,8,35
2023-06-01,132042,1,0,1,1,0,1
2023-06-01,58433,3,0,3,3,0,3
2023-06-01,24441,43,11,54,8,4,8
2023-06-01,134148,2,1,3,12,6,13
2023-06-01,23756,41,7,48,5,2,5
2023-06-01,58497,4,0,4,1,0,1
2023-06-01,132144,1,0,1,1,0,1
2023-06-01,134754,2,0,2,2,0,2
2023-06-01,32242,5,0,5,4,0,4
2023-06-01,55361,21,0,21,1,0,1
2023-06-01,132145,11,0,11,7,0,7
2023-06-01,23831,9,0,9,3,0,3
2023-06-01,58533,2,0,2,3,0,3
2023-06-01,132150,1,0,1,3,0,3
2023-06-01,132151,2,0,2,7,0,7
2023-06-01,132152,4,0,4,3,0,3
2023-06-01,132634,6,0,6,3,0,3
2023-06-01,138463,2,0,2,1,0,1
2023-06-01,58872,2,0,2,3,0,3
2023-06-01,134278,4,0,4,1,0,1
2023-06-01,38909,3,0,3,2,0,2
2023-06-01,134966,2,0,2,3,0,3
2023-06-01,45657,6,0,6,2,0,2
2023-06-01,132265,2,0,2,1,0,1
2023-06-01,132162,2,0,2,1,0,1
2023-06-01,132164,3,1,4,4,2,4
2023-06-01,38146,25,8,33,6,1,6
2023-06-01,140586,3,0,3,6,0,6
2023-06-01,142412,1,1,2,8,3,8
2023-06-01,132166,4,0,4,1,0,1
2023-06-01,132201,3,0,3,3,0,3
2023-06-01,132170,5,0,5,2,0,2
2023-06-01,58537,1,1,2,1,1,1
2023-06-01,132172,1,0,1,1,0,1
2023-06-01,149935,2,1,3,2,1,2
2023-06-01,132193,1,0,1,2,0,2
2023-06-01,9821,5,1,6,23,8,24
2023-06-01,58503,2,0,2,2,0,2
2023-06-01,131775,11,3,14,10,5,10
2023-06-01,10214,49,7,56,5,4,5
2023-06-01,131112,1,1,2,1,1,1
2023-06-01,132682,1,0,1,1,0,1
2023-06-01,140815,18,0,18,2,0,2
2023-06-01,150330,2,0,2,2,0,2
2023-06-01,136753,3,0,3,1,0,1
2023-06-01,45150,3,0,3,2,0,2
2023-06-01,138998,2,0,2,1,0,1
2023-06-01,149135,2,1,3,1,1,1
2023-06-01,131693,4,0,4,2,0,2
2023-06-01,58488,5,0,5,5,0,5
2023-06-01,58579,2,1,3,1,1,1
2023-06-01,132208,5,0,5,2,0,2
2023-06-01,135480,7,1,8,5,1,5
2023-06-01,131694,7,0,7,2,0,2
2023-06-01,38289,13,0,13,2,0,2
2023-06-01,17471,67,13,80,4,2,4
2023-06-01,132489,5,0,5,2,0,2
2023-06-01,135587,3,0,3,1,0,1
2023-06-01,58562,2,2,4,1,1,1
2023-06-01,12740,1,0,1,3,0,3
2023-06-01,24192,7,1,8,3,3,4
2023-06-01,131369,1,0,1,1,0,1
2023-06-01,133800,53,1,54,8,2,8
2023-06-01,136080,1,0,1,1,0,1
2023-06-01,131357,5,0,5,3,0,3
2023-06-01,141056,3,1,4,8,1,8
2023-06-01,140389,16,1,17,5,1,5
2023-06-01,45713,5,0,5,2,0,2
2023-06-01,9749,31,2,33,5,1,5
2023-06-01,135406,6,0,6,6,0,6
2023-06-01,63961,8,1,9,31,8,31
2023-06-01,137869,1,0,1,1,0,1
2023-06-01,131354,1,0,1,4,0,4
2023-06-01,132228,2,1,3,2,1,3
2023-06-01,132229,2,0,2,2,0,2
2023-06-01,131697,1,0,1,4,0,4
2023-06-01,59135,1,0,1,1,0,1
2023-06-01,56307,13,1,14,7,1,7
2023-06-01,132230,1,0,1,1,0,1
2023-06-01,132232,1,1,2,2,1,2
2023-06-01,55973,1,0,1,1,0,1
2023-06-01,131703,1,0,1,1,0,1
2023-06-01,56126,4,0,4,3,0,3
2023-06-01,132241,8,0,8,1,0,1
2023-06-01,58580,30,0,30,13,0,13
2023-06-01,132236,2,0,2,3,0,3
2023-06-01,131317,3,3,6,1,1,1
2023-06-01,45707,10,0,10,1,0,1
2023-06-01,58582,3,0,3,3,0,3
2023-06-01,132239,2,0,2,4,0,4
2023-06-01,132240,7,0,7,2,0,2
2023-06-01,45320,3,1,4,2,1,2
2023-06-01,58551,6,0,6,1,0,1
2023-06-01,45950,3,0,3,2,0,2
2023-06-01,133495,11,0,11,5,0,5
2023-06-01,135225,12,0,12,1,0,1
2023-06-01,132242,1,0,1,3,0,3
2023-06-01,64059,1,0,1,1,0,1
2023-06-01,17564,9,6,15,2,2,2
2023-06-01,45762,3,0,3,3,0,3
2023-06-01,24121,4,2,6,4,3,5
2023-06-01,132043,2,1,3,2,1,2
2023-06-01,150146,1,0,1,1,0,1
2023-06-01,7641,19,1,20,2,1,2
2023-06-01,132253,2,0,2,2,0,2
2023-06-01,58602,1,0,1,3,0,3
2023-06-01,131715,2,0,2,4,0,4
2023-06-01,58589,4,0,4,3,0,3
2023-06-01,9275,7,0,7,2,0,2
2023-06-01,58876,1,0,1,3,0,3
2023-06-01,132257,5,3,8,3,2,3
2023-06-01,58590,4,0,4,2,0,2
2023-06-01,131358,4,0,4,1,0,1
2023-06-01,131360,4,0,4,2,0,2
2023-06-01,134787,2,0,2,1,0,1
2023-06-01,131709,2,0,2,2,0,2
2023-06-01,58617,1,0,1,1,0,1
2023-06-01,9951,1,0,1,1,0,1
2023-06-01,131710,2,0,2,2,0,2
2023-06-01,132468,9,0,9,3,2,4
2023-06-01,45152,14,0,14,2,0,2
2023-06-01,131365,3,2,5,2,2,2
2023-06-01,58598,1,0,1,2,0,2
2023-06-01,134636,4,0,4,2,0,2
2023-06-01,55789,3,0,3,5,0,5
2023-06-01,9832,41,5,46,10,1,10
2023-06-01,150320,3,0,3,1,0,1
2023-06-01,131713,4,2,6,3,2,3
2023-06-01,139975,0,0,0,2,0,2
2023-06-01,63730,3,0,3,1,0,1
2023-06-01,38716,16,0,16,5,0,5
2023-06-01,135302,5,0,5,3,0,3
2023-06-01,55905,3,0,3,1,0,1
2023-06-01,58615,2,0,2,2,0,2
2023-06-01,55541,3,0,3,3,0,3
2023-06-01,134627,2,0,2,2,0,2
2023-06-01,58616,2,1,3,5,2,5
2023-06-01,63967,5,1,6,4,1,4
2023-06-01,131363,3,0,3,3,0,3
2023-06-01,131362,2,0,2,2,0,2
2023-06-01,132305,1,0,1,1,0,1
2023-06-01,55711,8,0,8,1,0,1
2023-06-01,132306,2,0,2,1,0,1
2023-06-01,131724,4,0,4,4,0,4
2023-06-01,136543,4,0,4,2,0,2
2023-06-01,132308,3,0,3,3,0,3
2023-06-01,7633,248,88,336,12,7,12
2023-06-01,133401,2,0,2,2,0,2
2023-06-01,132309,4,0,4,1,0,1
2023-06-01,131144,1,1,2,2,2,2
2023-06-01,38830,2,1,3,3,2,3
2023-06-01,56271,2,0,2,3,0,3
2023-06-01,58703,1,0,1,3,0,3
2023-06-01,56092,4,0,4,4,0,4
2023-06-01,131446,1,0,1,1,0,1
2023-06-01,131294,1,0,1,1,0,1
2023-06-01,17473,10,2,12,7,2,7
2023-06-01,56148,4,0,4,2,0,2
2023-06-01,17553,5,0,5,3,0,3
2023-06-01,11911,82,3,85,4,1,4
2023-06-01,56248,4,0,4,5,0,5
2023-06-01,150516,1,1,2,1,1,1
2023-06-01,32590,43,30,73,41,22,45
2023-06-01,58409,3,0,3,3,0,3
2023-06-01,58449,4,0,4,3,0,3
2023-06-01,46057,2,1,3,2,2,2
2023-06-01,10217,10,1,11,14,3,14
2023-06-01,135476,1,0,1,3,0,3
2023-06-01,56253,4,0,4,1,0,1
2023-06-01,136102,8,0,8,1,0,1
2023-06-01,133436,2,0,2,2,0,2
2023-06-01,37908,6,1,7,4,3,4
2023-06-01,131787,1,0,1,2,0,2
2023-06-01,56254,2,0,2,1,0,1
2023-06-01,56255,2,0,2,3,0,3
2023-06-01,149994,7,0,7,35,7,37
2023-06-01,150319,2,0,2,1,0,1
2023-06-01,45559,8,0,8,3,0,3
2023-06-01,45599,4,0,4,3,0,3
2023-06-01,131343,5,0,5,5,0,5
2023-06-01,131790,2,0,2,1,0,1
2023-06-01,38275,2,0,2,3,0,3
2023-06-01,38750,25,0,25,4,0,4
2023-06-01,23905,8,1,9,3,2,3
2023-06-01,132003,2,0,2,1,0,1
2023-06-01,55891,1,13,14,2,2,2
2023-06-01,131993,3,0,3,4,0,4
2023-06-01,58419,3,0,3,3,0,3
2023-06-01,56259,4,0,4,3,0,3
2023-06-01,24305,3,2,5,3,1,3
2023-06-01,58390,1,0,1,2,0,2
2023-06-01,132046,22,4,26,14,5,14
2023-06-01,9976,11,0,11,3,0,3
2023-06-01,140732,3,0,3,1,0,1
2023-06-01,45561,6,1,7,5,3,5
2023-06-01,132052,3,0,3,1,0,1
2023-06-01,24334,32,13,45,6,6,6
2023-06-01,17554,30,1,31,10,5,10
2023-06-01,19993,6,0,6,1,0,1
2023-06-01,132059,2,0,2,1,0,1
2023-06-01,38477,23,1,24,3,1,3
2023-06-01,55614,5,0,5,1,0,1
2023-06-01,138829,6,1,7,4,3,4
2023-06-01,58445,10,1,11,4,1,5
2023-06-01,9234,12,0,12,2,0,2
2023-06-01,58446,1,0,1,1,0,1
2023-06-01,9290,4,0,4,4,0,4
2023-06-01,132160,4,0,4,4,0,4
2023-06-01,131348,5,0,5,2,0,2
2023-06-01,132066,1,0,1,3,0,3
2023-06-01,58394,2,0,2,2,0,2
2023-06-01,38505,8,0,8,3,0,3
2023-06-01,141467,3,1,4,2,2,2
2023-06-01,132080,10,0,10,3,0,3
2023-06-01,30133,40,36,76,1,1,1
2023-06-01,45910,15,21,36,4,3,5
2023-06-01,58395,5,0,5,1,0,1
2023-06-01,62184,1,1,2,1,1,1
2023-06-01,132272,1,0,1,1,0,1
2023-06-01,132277,2,1,3,1,1,1
2023-06-01,58613,1,0,1,1,0,1
2023-06-01,131716,2,0,2,1,0,1
2023-06-01,24471,11,0,11,6,0,6
2023-06-01,58987,2,0,2,1,0,1
2023-06-01,58623,4,0,4,1,0,1
2023-06-01,58629,0,0,0,19,6,19
2023-06-01,134204,15,105,120,2,1,2
2023-06-01,138423,39,3,42,5,2,5
2023-06-01,150324,2,0,2,2,0,2
2023-06-01,142295,4,0,4,3,0,3
2023-06-01,131723,1,0,1,3,0,3
2023-06-01,45732,7,0,7,3,0,3
2023-06-01,131722,2,0,2,1,0,1
2023-06-01,142510,2,0,2,3,0,3
2023-06-01,56178,2,1,3,3,2,3
2023-06-01,132315,1,1,2,1,1,1
2023-06-01,131364,3,0,3,4,0,4
2023-06-01,131728,5,0,5,4,0,4
2023-06-01,132326,4,0,4,3,0,3
2023-06-01,24574,3,0,3,2,0,2
2023-06-01,55909,3,1,4,1,1,1
2023-06-01,134791,4,0,4,3,0,3
2023-06-01,131726,1,0,1,2,0,2
2023-06-01,132330,1,0,1,3,0,3
2023-06-01,132329,5,0,5,5,0,5
2023-06-01,141918,3,0,3,2,0,2
2023-06-01,134711,7,0,7,4,0,4
2023-06-01,38611,25,0,25,5,0,5
2023-06-01,150327,2,0,2,1,0,1
2023-06-01,140214,6,0,6,4,0,4
2023-06-01,132334,1,0,1,1,0,1
2023-06-01,58665,3,0,3,1,0,1
2023-06-01,56002,5,0,5,3,0,3
2023-06-01,7718,16,2,18,2,1,2
2023-06-01,132338,1,0,1,2,0,2
2023-06-01,133989,9,1,10,10,1,10
2023-06-01,134941,1,0,1,1,0,1
2023-06-01,132339,1,0,1,1,0,1
2023-06-01,58609,1,0,1,1,0,1
2023-06-01,132278,1,0,1,1,0,1
2023-06-01,38057,4,0,4,5,0,5
2023-06-01,150357,1,1,2,2,2,2
2023-06-01,132344,2,0,2,1,0,1
2023-06-01,131721,1,0,1,1,0,1
2023-06-01,58624,1,1,2,1,1,1
2023-06-01,134034,2,16,18,3,1,3
2023-06-01,131224,2,0,2,3,0,3
2023-06-01,132111,41,4,45,10,2,10
2023-06-01,131373,5,1,6,2,3,3
2023-06-01,56171,1,0,1,1,0,1
2023-06-01,4769,7,0,7,5,0,5
2023-06-01,55405,4,0,4,3,0,3
2023-06-01,134804,2,0,2,3,0,3
2023-06-01,55437,2,0,2,2,0,2
2023-06-01,51830,2,0,2,2,0,2
2023-06-01,140457,5,1,6,7,1,7
2023-06-01,138886,9,1,10,6,4,6
2023-06-01,150215,2,0,2,1,0,1
2023-06-01,136560,1,0,1,1,0,1
2023-06-01,140890,1,0,1,1,0,1
2023-06-01,132340,2,0,2,2,0,2
2023-06-01,58670,3,0,3,1,0,1
2023-06-01,150329,2,0,2,2,0,2
2023-06-01,23818,9,0,9,5,0,5
2023-06-01,58645,1,0,1,4,0,4
2023-06-01,56197,12,0,12,4,0,4
2023-06-01,132342,3,0,3,2,0,2
2023-06-01,132343,2,0,2,3,0,3
2023-06-01,134802,3,0,3,4,0,4
2023-06-01,136515,9,1,10,7,1,7
2023-06-01,133623,10,0,10,9,0,9
2023-06-01,9229,39,0,39,7,0,7
2023-06-01,136141,8,0,8,4,0,4
2023-06-01,150331,3,0,3,2,0,2
2023-06-01,64300,22,91,113,5,4,5
2023-06-01,132349,1,0,1,3,0,3
2023-06-01,150232,1,0,1,1,0,1
2023-06-01,58685,1,0,1,1,0,1
2023-06-01,141855,2,0,2,3,0,3
2023-06-01,45828,6,0,6,3,0,3
2023-06-01,142369,2,1,3,3,2,3
2023-06-01,132284,1,0,1,1,0,1
2023-06-01,58622,2,0,2,3,0,3
2023-06-01,139089,1,0,1,6,0,6
2023-06-01,24559,2,0,2,3,0,3
2023-06-01,58625,1,0,1,1,0,1
2023-06-01,132303,4,0,4,2,0,2
2023-06-01,56072,2,0,2,1,0,1
2023-06-01,149134,1,0,1,1,0,1
2023-06-01,134876,4,1,5,3,2,3
2023-06-01,137967,27,12,39,7,1,7
2023-06-01,132341,2,0,2,1,0,1
2023-06-01,139976,1,1,2,3,3,3
2023-06-01,24521,59,1,60,11,3,12
2023-06-01,132651,0,1,1,3,1,3
2023-06-01,134632,1,0,1,1,0,1
2023-06-01,131907,4,0,4,1,0,1
2023-06-01,132397,2,0,2,2,0,2
2023-06-01,58641,3,1,4,2,1,2
2023-06-01,58642,2,0,2,2,0,2
2023-06-01,132322,8,0,8,1,0,1
2023-06-01,150429,3,1,4,1,1,1
2023-06-01,150026,1,0,1,1,0,1
2023-06-01,132351,3,0,3,4,0,4
2023-06-01,150334,1,1,2,2,1,2
2023-06-01,132382,4,0,4,1,0,1
2023-06-01,132356,2,0,2,2,0,2
2023-06-01,132355,2,0,2,1,0,1
2023-06-01,38874,4,0,4,1,0,1
2023-06-01,46039,3,0,3,3,0,3
2023-06-01,58677,1,0,1,3,0,3
2023-06-01,131732,2,0,2,2,0,2
2023-06-01,138611,4,0,4,2,0,2
2023-06-01,58684,2,0,2,2,0,2
2023-06-01,132161,5,0,5,1,0,1
2023-06-01,149136,1,1,2,1,1,1
2023-06-01,132360,1,0,1,1,0,1
2023-06-01,132361,2,0,2,4,0,4
2023-06-01,4859,3,1,4,2,1,2
2023-06-01,150219,2,0,2,3,0,3
2023-06-01,45735,1,0,1,12,0,12
2023-06-01,149704,5,0,5,5,0,5
2023-06-01,132364,3,0,3,2,0,2
2023-06-01,55639,6,3,9,5,3,5
2023-06-01,58499,3,1,4,2,1,2
2023-06-01,150155,1,0,1,1,0,1
2023-06-01,55912,4,2,6,3,3,3
2023-06-01,132370,3,4,7,4,2,5
2023-06-01,4770,12,2,14,7,2,7
2023-06-01,58742,1,0,1,1,0,1
2023-06-01,38009,20,0,20,1,0,1
2023-06-01,147045,1,0,1,1,0,1
2023-06-01,132376,3,0,3,2,0,2
2023-06-01,58690,1,0,1,1,0,1
2023-06-01,17551,9,1,10,1,1,1
2023-06-01,132378,1,0,1,2,0,2
2023-06-01,201755,4,0,4,1,0,1
2023-06-01,136469,1,0,1,1,0,1
2023-06-01,58700,2,0,2,2,0,2
2023-06-01,17939,10,1,11,6,1,6
2023-06-01,132484,4,0,4,2,0,2
2023-06-01,150336,2,0,2,3,0,3
2023-06-01,150338,1,0,1,1,0,1
2023-06-01,149137,1,1,2,1,1,1
2023-06-01,9230,84,7,91,19,1,19
2023-06-01,58695,3,0,3,2,0,2
2023-06-01,131735,13,1,14,8,1,8
2023-06-01,137363,6,0,6,6,0,6
2023-06-01,132387,2,0,2,1,0,1
2023-06-01,132388,4,0,4,5,0,5
2023-06-01,131737,1,0,1,2,0,2
2023-06-01,131375,5,1,6,5,3,5
2023-06-01,23899,0,0,0,4,0,4
2023-06-01,9249,34,0,34,2,0,2
2023-06-01,134812,6,1,7,2,1,2
2023-06-01,133437,3,0,3,1,0,1
2023-06-01,38573,6,0,6,4,0,4
2023-06-01,132594,1,0,1,3,0,3
2023-06-01,132599,7,0,7,5,0,5
2023-06-01,140327,4,0,4,1,0,1
2023-06-01,134303,2,0,2,1,0,1
2023-06-01,131772,1,0,1,2,0,2
2023-06-01,131785,4,0,4,3,0,3
2023-06-01,131769,16,0,16,6,0,6
2023-06-01,137352,2,0,2,3,0,3
2023-06-01,133337,3,1,4,4,1,5
2023-06-01,132768,54,2,56,3,2,3
2023-06-01,23934,21,0,21,2,0,2
2023-06-01,136436,3,0,3,2,0,2
2023-06-01,58812,3,0,3,3,0,3
2023-06-01,132799,3,1,4,7,3,7
2023-06-01,139922,26,6,32,3,1,3
2023-06-01,150138,3,0,3,1,0,1
2023-06-01,132611,1,0,1,1,0,1
2023-06-01,149138,1,1,2,1,1,1
2023-06-01,131963,1,1,2,2,2,2
2023-06-01,131779,2,0,2,2,0,2
2023-06-01,132613,1,0,1,2,0,2
2023-06-01,150340,2,0,2,3,0,3
2023-06-01,150348,3,0,3,1,0,1
2023-06-01,150342,1,0,1,3,0,3
2023-06-01,55779,2,0,2,2,0,2
2023-06-01,150228,1,0,1,3,0,3
2023-06-01,138096,6,1,7,12,1,12
2023-06-01,150229,1,0,1,1,0,1
2023-06-01,58813,10,4,14,3,2,3
2023-06-01,56055,5,1,6,2,2,2
2023-06-01,131783,3,0,3,3,0,3
2023-06-01,132620,1,0,1,3,0,3
2023-06-01,55424,32,0,32,2,0,2
2023-06-01,23991,22,7,29,9,2,9
2023-06-01,58814,4,0,4,3,0,3
2023-06-01,131781,2,0,2,5,0,5
2023-06-01,131782,2,0,2,2,0,2
2023-06-01,56209,53,4,57,3,3,3
2023-06-01,56301,6,1,7,2,1,2
2023-06-01,132616,1,0,1,3,0,3
2023-06-01,150447,1,0,1,1,0,1
2023-06-01,150351,1,0,1,1,0,1
2023-06-01,131784,1,0,1,1,0,1
2023-06-01,45588,88,0,88,17,0,17
2023-06-01,150352,3,0,3,1,0,1
2023-06-01,150226,1,0,1,1,0,1
2023-06-01,58826,8,10,18,7,4,7
2023-06-01,38165,20,15,35,10,3,10
2023-06-01,58654,4,0,4,1,0,1
2023-06-01,131786,1,0,1,1,0,1
2023-06-01,58875,1,0,1,3,0,3
2023-06-01,132791,2,0,2,1,0,1
2023-06-01,135895,5,1,6,4,3,5
2023-06-01,131421,6,0,6,4,0,4
2023-06-01,150973,1,0,1,1,0,1
2023-06-01,45581,4,0,4,3,0,3
2023-06-01,147309,3,0,3,1,0,1
2023-06-01,132688,5,0,5,1,0,1
2023-06-01,131392,12,2,14,1,1,1
2023-06-01,23778,9,1,10,6,4,7
2023-06-01,132733,6,0,6,1,0,1
2023-06-01,150275,1,0,1,1,0,1
2023-06-01,132798,2,0,2,3,0,3
2023-06-01,24289,7,1,8,3,2,3
2023-06-01,132694,4,1,5,2,1,2
2023-06-01,142339,5,1,6,3,1,3
2023-06-01,45287,50,7,57,12,3,12
2023-06-01,7532,45,1,46,5,2,5
2023-06-01,55693,8,0,8,1,0,1
2023-06-01,4833,8,1,9,4,1,5
2023-06-01,58817,1,0,1,1,0,1
2023-06-01,58915,2,1,3,1,1,1
2023-06-01,132518,7,0,7,1,0,1
2023-06-01,132713,1,0,1,1,0,1
2023-06-01,132217,1,0,1,1,0,1
2023-06-01,133076,7,0,7,1,0,1
2023-06-01,135055,4,0,4,3,0,3
2023-06-01,135062,6,0,6,3,0,3
2023-06-01,150230,2,0,2,1,0,1
2023-06-01,138130,4,0,4,4,0,4
2023-06-01,149974,1,0,1,3,0,3
2023-06-01,132703,1,0,1,1,0,1
2023-06-01,134371,12,46,58,6,2,6
2023-06-01,150375,1,0,1,1,0,1
2023-06-01,138474,7,0,7,1,0,1
2023-06-01,150374,1,1,2,1,1,1
2023-06-01,150354,1,0,1,1,0,1
2023-06-01,45711,2,0,2,1,0,1
2023-06-01,132706,1,0,1,1,0,1
2023-06-01,135602,23,0,23,1,0,1
2023-06-01,56028,4,1,5,2,1,2
2023-06-01,149142,1,0,1,2,0,2
2023-06-01,132826,12,0,12,5,0,5
2023-06-01,138536,24,5,29,9,1,9
2023-06-01,64065,3,0,3,3,0,3
2023-06-01,132638,1,0,1,2,0,2
2023-06-01,132702,1,0,1,1,0,1
2023-06-01,134801,1,0,1,1,0,1
2023-06-01,138655,16,1,17,7,2,7
2023-06-01,150683,9,0,9,1,0,1
2023-06-01,132637,6,0,6,7,0,7
2023-06-01,142310,2,0,2,2,0,2
2023-06-01,132639,4,0,4,1,0,1
2023-06-01,132718,4,0,4,2,0,2
2023-06-01,9313,24,0,24,4,0,4
2023-06-01,132722,3,0,3,3,0,3
2023-06-01,150063,1,0,1,3,0,3
2023-06-01,137678,7,8,15,4,1,4
2023-06-01,150372,2,0,2,1,0,1
2023-06-01,38129,4,0,4,2,0,2
2023-06-01,132566,8,1,9,3,1,3
2023-06-01,38625,12,0,12,3,0,3
2023-06-01,150234,1,0,1,1,0,1
2023-06-01,150239,2,0,2,1,0,1
2023-06-01,132711,2,1,3,2,1,2
2023-06-01,45158,16,2,18,16,3,16
2023-06-01,131214,6,0,6,3,0,3
2023-06-01,132642,4,1,5,4,3,4
2023-06-01,55923,22,0,22,4,0,4
2023-06-01,132567,3,1,4,2,1,2
2023-06-01,133306,1,1,2,2,2,2
2023-06-01,135304,1,1,2,2,2,2
2023-06-01,132571,2,0,2,1,0,1
2023-06-01,24039,3,0,3,2,0,2
2023-06-01,136119,29,1,30,14,7,17
2023-06-01,132668,4,0,4,3,0,3
2023-06-01,7690,6,1,7,7,2,7
2023-06-01,132726,8,0,8,1,0,1
2023-06-01,149963,1,0,1,2,0,2
2023-06-01,132394,4,0,4,2,0,2
2023-06-01,24510,3,0,3,1,0,1
2023-06-01,132395,2,0,2,1,0,1
2023-06-01,38843,11,1,12,4,1,4
2023-06-01,150218,1,0,1,2,0,2
2023-06-01,58557,2,0,2,3,0,3
2023-06-01,56107,2,0,2,1,0,1
2023-06-01,132402,1,1,2,3,2,3
2023-06-01,150237,2,1,3,1,1,1
2023-06-01,150187,2,0,2,2,0,2
2023-06-01,142331,3,0,3,3,0,3
2023-06-01,58702,2,0,2,2,0,2
2023-06-01,140423,4,7,11,4,3,4
2023-06-01,150238,3,1,4,2,2,2
2023-06-01,136566,1,2,3,1,1,1
2023-06-01,136565,2,3,5,2,2,2
2023-06-01,33229,2,1,3,6,4,6
2023-06-01,132417,1,0,1,2,0,2
2023-06-01,141312,8,5,13,7,3,8
2023-06-01,132415,2,0,2,1,0,1
2023-06-01,10022,37,0,37,6,0,6
2023-06-01,58704,5,0,5,8,0,8
2023-06-01,45552,3,1,4,4,1,4
2023-06-01,58726,1,0,1,1,0,1
2023-06-01,56285,1,0,1,1,0,1
2023-06-01,58553,4,0,4,5,0,5
2023-06-01,132653,4,4,8,4,1,4
2023-06-01,58556,2,0,2,2,0,2
2023-06-01,9667,27,0,27,2,0,2
2023-06-01,58718,2,0,2,5,0,5
2023-06-01,131218,1,0,1,1,0,1
2023-06-01,142345,2,0,2,3,0,3
2023-06-01,149968,1,0,1,3,0,3
2023-06-01,136176,4,0,4,2,0,2
2023-06-01,132429,3,1,4,1,1,1
2023-06-01,58708,4,1,5,3,2,3
2023-06-01,137526,9,2,11,8,1,8
2023-06-01,150163,1,0,1,2,0,2
2023-06-01,58712,2,0,2,4,0,4
2023-06-01,9627,62,0,62,5,0,5
2023-06-01,55994,16,1,17,3,1,3
2023-06-01,58710,2,0,2,1,0,1
2023-06-01,132774,4,1,5,17,9,17
2023-06-01,150069,3,1,4,1,1,1
2023-06-01,38883,27,6,33,13,3,13
2023-06-01,132448,1,0,1,4,0,4
2023-06-01,58714,3,2,5,1,1,1
2023-06-01,54187,2,1,3,4,1,4
2023-06-01,132434,13,1,14,6,1,6
2023-06-01,132435,10,0,10,1,0,1
2023-06-01,58750,6,1,7,5,4,5
2023-06-01,132445,20,0,20,2,0,2
2023-06-01,131148,4,1,5,1,1,1
2023-06-01,141966,2,1,3,4,2,4
2023-06-01,150982,1,0,1,1,0,1
2023-06-01,132440,1,1,2,1,1,2
2023-06-01,132441,1,0,1,1,0,1
2023-06-01,136290,5,1,6,4,1,4
2023-06-01,135687,2,0,2,3,0,3
2023-06-01,150070,4,0,4,1,0,1
2023-06-01,53767,5,1,6,5,1,5
2023-06-01,131738,3,0,3,3,0,3
2023-06-01,45295,11,1,12,11,1,11
2023-06-01,131368,4,0,4,3,0,3
2023-06-01,132423,5,1,6,3,2,3
2023-06-01,132454,3,0,3,1,0,1
2023-06-01,140708,1,0,1,1,0,1
2023-06-01,132453,23,1,24,5,3,5
2023-06-01,132018,1,0,1,1,0,1
2023-06-01,132450,2,0,2,3,0,3
2023-06-01,149967,1,0,1,1,0,1
2023-06-01,131746,10,0,10,6,0,6
2023-06-01,149829,4,0,4,3,0,3
2023-06-01,132643,2,0,2,3,0,3
2023-06-01,131743,10,0,10,4,0,4
2023-06-01,132892,19,21,40,1,1,1
2023-06-01,132462,4,0,4,1,0,1
2023-06-01,142543,1,0,1,2,0,2
2023-06-01,150243,1,0,1,1,0,1
2023-06-01,45447,3,0,3,2,0,2
2023-06-01,134640,5,1,6,5,1,5
2023-06-01,149662,2,0,2,2,0,2
2023-06-01,58576,3,0,3,3,0,3
2023-06-01,150261,2,0,2,2,0,2
2023-06-01,140766,44,18,62,2,1,2
2023-06-01,56298,4,0,4,3,0,3
2023-06-01,38900,6,0,6,2,0,2
2023-06-01,58428,1,0,1,1,0,1
2023-06-01,58429,1,0,1,1,0,1
2023-06-01,134967,5,1,6,4,2,4
2023-06-01,55966,4,4,8,5,4,5
2023-06-01,139721,1,1,2,3,4,4
2023-06-01,140895,0,0,0,3,0,3
2023-06-01,132040,11,10,21,12,5,13
2023-06-01,132075,6,0,6,2,0,2
2023-06-01,149969,1,0,1,3,0,3
2023-06-01,58457,3,0,3,3,0,3
2023-06-01,63914,4,0,4,2,0,2
2023-06-01,132173,1,0,1,1,0,1
2023-06-01,10219,36,1,37,2,1,2
2023-06-01,39640,4,0,4,3,6,8
2023-06-01,202603,1,0,1,1,0,1
2023-06-01,38216,2,0,2,2,0,2
2023-06-01,134818,1,0,1,1,0,1
2023-06-01,150245,1,1,2,1,1,1
2023-06-01,58400,4,0,4,1,0,1
2023-06-01,27435,102,19,121,5,5,6
2023-06-01,58385,4,0,4,4,0,4
2023-06-01,18166,1,0,1,1,0,1
2023-06-01,139337,4,0,4,1,0,1
2023-06-01,58403,1,0,1,2,0,2
2023-06-01,132094,1,0,1,1,0,1
2023-06-01,134968,8,20,28,4,3,4
2023-06-01,38209,29,1,30,5,1,5
2023-06-01,58465,1,0,1,3,0,3
2023-06-01,55684,8,1,9,2,1,2
2023-06-01,58475,3,1,4,2,2,2
2023-06-01,18394,1,0,1,2,0,2
2023-06-01,58545,1,0,1,3,0,3
2023-06-01,150379,2,0,2,2,0,2
2023-06-01,140077,4,0,4,5,0,5
2023-06-01,132712,4,0,4,1,0,1
2023-06-01,132730,18,2,20,3,3,4
2023-06-01,132697,5,0,5,1,0,1
2023-06-01,132645,5,1,6,4,2,4
2023-06-01,7483,18,0,18,12,0,12
2023-06-01,46052,4,1,5,3,2,4
2023-06-01,58914,1,0,1,4,0,4
2023-06-01,150384,2,0,2,1,0,1
2023-06-01,46061,17,0,17,3,0,3
2023-06-01,55919,2,0,2,2,0,2
2023-06-01,150385,3,1,4,1,1,1
2023-06-01,56089,7,1,8,1,1,1
2023-06-01,55651,4,3,7,1,1,1
2023-06-01,131332,2,0,2,3,0,3
2023-06-01,133680,12,1,13,8,2,8
2023-06-01,132745,2,0,2,2,0,2
2023-06-01,132739,2,0,2,2,0,2
2023-06-01,58909,5,0,5,1,0,1
2023-06-01,132649,3,1,4,4,1,4
2023-06-01,132304,5,1,6,3,1,3
2023-06-01,131388,14,0,14,1,0,1
2023-06-01,138763,10,0,10,1,0,1
2023-06-01,58922,2,0,2,1,0,1
2023-06-01,55695,5,27,32,2,1,2
2023-06-01,133200,12,0,12,1,0,1
2023-06-01,142560,1,0,1,1,0,1
2023-06-01,141126,5,1,6,6,2,6
2023-06-01,58916,1,0,1,1,0,1
2023-06-01,139597,1,0,1,4,0,4
2023-06-01,132859,1,0,1,1,0,1
2023-06-01,64072,4,1,5,2,1,3
2023-06-01,58986,5,0,5,1,0,1
2023-06-01,59216,10,4,14,1,1,1
2023-06-01,38713,42,0,42,3,0,3
2023-06-01,134783,13,0,13,4,0,4
2023-06-01,63690,2,0,2,1,0,1
2023-06-01,59067,6,0,6,2,0,2
2023-06-01,55359,26,7,33,4,3,5
2023-06-01,134856,2,0,2,3,0,3
2023-06-01,132760,3,0,3,2,0,2
2023-06-01,45641,3,1,4,3,2,4
2023-06-01,132652,8,16,24,6,3,6
2023-06-01,59143,3,0,3,2,0,2
2023-06-01,132816,2,4,6,4,3,5
2023-06-01,9226,5,1,6,8,5,9
2023-06-01,10029,279,32,311,13,7,13
2023-06-01,132753,4,1,5,1,1,1
2023-06-01,146954,1,0,1,1,0,1
2023-06-01,58920,1,0,1,3,0,3
2023-06-01,38714,10,0,10,2,0,2
2023-06-01,45495,1,0,1,4,0,4
2023-06-01,133383,1,0,1,2,0,2
2023-06-01,132797,1,1,2,1,1,2
2023-06-01,132749,1,0,1,2,0,2
2023-06-01,132660,4,0,4,2,0,2
2023-06-01,140465,6,0,6,3,0,3
2023-06-01,45637,3,2,5,10,2,10
2023-06-01,18159,6,0,6,2,0,2
2023-06-01,132862,1,0,1,3,0,3
2023-06-01,132246,1,0,1,3,0,3
2023-06-01,59019,42,23,65,8,3,9
2023-06-01,132867,2,0,2,3,0,3
2023-06-01,38894,3,0,3,2,0,2
2023-06-01,58944,2,0,2,3,0,3
2023-06-01,138959,2,0,2,1,0,1
2023-06-01,132662,1,0,1,2,0,2
2023-06-01,132667,1,0,1,3,0,3
2023-06-01,17804,5,1,6,2,1,3
2023-06-01,132663,3,0,3,2,0,2
2023-06-01,139967,13,3,16,15,9,19
2023-06-01,58946,2,0,2,1,0,1
2023-06-01,58947,2,0,2,4,0,4
2023-06-01,58821,20,0,20,7,0,7
2023-06-01,142308,4,0,4,6,0,6
2023-06-01,132891,1,0,1,1,0,1
2023-06-01,56286,7,5,12,7,5,8
2023-06-01,132874,4,0,4,2,0,2
2023-06-01,132878,1,0,1,2,0,2
2023-06-01,142602,1,0,1,1,0,1
2023-06-01,150387,1,0,1,1,0,1
2023-06-01,131383,4,0,4,2,0,2
2023-06-01,58958,1,0,1,1,0,1
2023-06-01,150680,2,0,2,1,0,1
2023-06-01,132780,5,1,6,1,1,1
2023-06-01,132983,2,0,2,1,0,1
2023-06-01,58834,14,10,24,1,3,4
2023-06-01,133333,2,1,3,2,1,2
2023-06-01,23951,83,16,99,30,10,31
2023-06-01,132670,1,1,2,1,1,1
2023-06-01,132887,1,0,1,3,0,3
2023-06-01,58989,2,0,2,3,0,3
2023-06-01,134047,4,0,4,2,0,2
2023-06-01,132881,5,0,5,4,0,4
2023-06-01,131385,1,0,1,1,0,1
2023-06-01,132890,26,0,26,8,0,8
2023-06-01,132885,4,1,5,3,1,3
2023-06-01,65460,0,0,0,2,0,2
2023-06-01,132911,1,0,1,1,0,1
2023-06-01,139306,1,0,1,2,0,2
2023-06-01,132843,3,0,3,2,0,2
2023-06-01,131454,5,0,5,1,0,1
2023-06-01,9764,28,2,30,1,1,1
2023-06-01,132895,6,1,7,5,3,5
2023-06-01,133030,3,0,3,1,0,1
2023-06-01,134684,17,0,17,5,0,5
2023-06-01,150262,3,0,3,1,0,1
2023-06-01,136821,2,0,2,1,0,1
2023-06-01,132902,1,0,1,1,0,1
2023-06-01,58962,8,0,8,1,0,1
2023-06-01,132898,5,1,6,3,1,3
2023-06-01,45733,3,0,3,3,0,3
2023-06-01,134827,1,0,1,1,0,1
2023-06-01,150254,2,0,2,1,0,1
2023-06-01,63901,1,0,1,1,0,1
2023-06-01,132102,1,0,1,2,0,2
2023-06-01,56256,2,0,2,1,0,1
2023-06-01,137341,2,0,2,2,0,2
2023-06-01,142374,2,3,5,5,2,5
2023-06-01,58473,5,1,6,6,1,6
2023-06-01,58504,19,1,20,6,1,6
2023-06-01,132117,3,0,3,1,0,1
2023-06-01,45357,2,0,2,3,0,3
2023-06-01,132107,6,0,6,1,0,1
2023-06-01,131351,4,0,4,3,0,3
2023-06-01,23966,160,1,161,13,1,13
2023-06-01,58506,2,0,2,1,0,1
2023-06-01,17907,2,1,3,2,1,2
2023-06-01,58479,2,0,2,3,0,3
2023-06-01,63748,1,0,1,2,0,2
2023-06-01,131352,1,0,1,1,0,1
2023-06-01,58480,4,0,4,5,0,5
2023-06-01,58484,1,0,1,1,0,1
2023-06-01,58492,4,0,4,4,0,4
2023-06-01,45302,17,0,17,7,0,7
2023-06-01,38378,3,0,3,3,0,3
2023-06-01,131378,3,1,4,2,1,2
2023-06-01,58976,2,0,2,3,0,3
2023-06-01,150166,1,0,1,1,0,1
2023-06-01,56281,1,0,1,3,0,3
2023-06-01,56284,4,1,5,5,2,5
2023-06-01,58778,3,0,3,4,3,4
2023-06-01,132608,8,2,10,3,1,3
2023-06-01,150394,2,0,2,2,0,2
2023-06-01,150039,2,1,3,1,1,1
2023-06-01,150391,2,0,2,1,0,1
2023-06-01,45931,5,0,5,3,0,3
2023-06-01,9651,3,0,3,4,0,4
2023-06-01,24342,158,6,164,14,1,14
2023-06-01,131442,29,0,29,4,0,4
2023-06-01,9811,35,0,35,2,0,2
2023-06-01,131995,2,0,2,1,0,1
2023-06-01,131998,2,0,2,3,0,3
2023-06-01,139460,14,0,14,5,0,5
2023-06-01,131999,2,1,3,2,1,2
2023-06-01,56261,1,0,1,2,0,2
2023-06-01,58378,1,0,1,2,0,2
2023-06-01,132858,1,0,1,1,0,1
2023-06-01,150393,2,1,3,1,1,1
2023-06-01,63862,3,0,3,5,3,5
2023-06-01,56260,3,0,3,1,0,1
2023-06-01,45286,2,0,2,2,0,2
2023-06-01,132300,11,1,12,4,2,5
2023-06-01,58375,2,0,2,4,0,4
2023-06-01,58371,1,0,1,3,0,3
2023-06-01,58372,4,0,4,2,0,2
2023-06-01,24195,15,1,16,5,1,5
2023-06-01,58377,5,0,5,3,0,3
2023-06-01,132005,5,1,6,1,1,1
2023-06-01,138596,5,0,5,3,0,3
2023-06-01,24347,2,0,2,1,0,1
2023-06-01,58442,1,0,1,1,0,1
2023-06-01,58437,2,0,2,4,0,4
2023-06-01,131778,8,0,8,3,0,3
2023-06-01,135152,4,0,4,1,0,1
2023-06-01,45326,41,67,108,6,2,6
2023-06-01,7700,20,2,22,1,1,1
2023-06-01,131371,4,0,4,2,0,2
2023-06-01,24168,3,0,3,2,0,2
2023-06-01,18424,4,1,5,4,2,4
2023-06-01,150399,3,0,3,2,0,2
2023-06-01,150397,2,0,2,2,0,2
2023-06-01,134330,3,1,4,1,1,1
2023-06-01,932,1,1,2,1,1,1
2023-06-01,132472,1,0,1,2,0,2
2023-06-01,63498,1,0,1,1,0,1
2023-06-01,46050,5,1,6,1,1,1
2023-06-01,9688,6,0,6,1,0,1
2023-06-01,58648,6,0,6,3,0,3
2023-06-01,58739,2,0,2,3,0,3
2023-06-01,58737,1,0,1,1,0,1
2023-06-01,150257,2,0,2,2,0,2
2023-06-01,2042,9,0,9,1,0,1
2023-06-01,10034,2,0,2,2,0,2
2023-06-01,150188,1,0,1,1,0,1
2023-06-01,132473,1,0,1,2,0,2
2023-06-01,38148,12,0,12,4,0,4
2023-06-01,138007,7,0,7,5,0,5
2023-06-01,58932,2,0,2,2,0,2
2023-06-01,24545,5,0,5,5,0,5
2023-06-01,150408,2,0,2,2,0,2
2023-06-01,131475,3,1,4,2,1,2
2023-06-01,132494,3,0,3,2,0,2
2023-06-01,141831,2,0,2,2,0,2
2023-06-01,147221,4,0,4,2,0,2
2023-06-01,58744,7,7,14,7,5,7
2023-06-01,131757,1,0,1,1,0,1
2023-06-01,9423,1,0,1,3,0,3
2023-06-01,150263,2,1,3,1,1,1
2023-06-01,131379,1,0,1,2,0,2
2023-06-01,131372,1,0,1,2,0,2
2023-06-01,135286,3,0,3,1,0,1
2023-06-01,131749,7,1,8,4,2,4
2023-06-01,132499,9,0,9,6,0,6
2023-06-01,132497,31,102,133,2,2,2
2023-06-01,137959,6,4,10,5,2,5
2023-06-01,56124,2,0,2,1,0,1
2023-06-01,132507,3,0,3,3,0,3
2023-06-01,137259,3,0,3,1,0,1
2023-06-01,212237,3,7,10,4,6,7
2023-06-01,139952,14,0,14,6,0,6
2023-06-01,131911,9,1,10,4,3,4
2023-06-01,139427,5,1,6,2,1,2
2023-06-01,138881,9,20,29,9,5,9
2023-06-01,134252,5,0,5,3,0,3
2023-06-01,134503,1,1,2,3,3,3
2023-06-01,134513,2,0,2,3,0,3
2023-06-01,131268,6,0,6,2,0,2
2023-06-01,134509,9,0,9,2,0,2
2023-06-01,136799,2,0,2,3,0,3
2023-06-01,58696,2,0,2,1,0,1
2023-06-01,150058,2,1,3,1,1,2
2023-06-01,9430,39,4,43,9,3,9
2023-06-01,134286,8,0,8,3,0,3
2023-06-01,134521,5,5,10,6,6,6
2023-06-01,63399,27,13,40,27,19,30
2023-06-01,63884,1,0,1,1,0,1
2023-06-01,134869,4,1,5,3,2,3
2023-06-01,134529,1,0,1,1,0,1
2023-06-01,133683,6,0,6,1,0,1
2023-06-01,64018,4,1,5,7,2,7
2023-06-01,150406,2,1,3,3,1,3
2023-06-01,133817,9,1,10,15,1,15
2023-06-01,150192,1,0,1,1,0,1
2023-06-01,150220,0,0,0,8,0,8
2023-06-01,125,27,0,27,5,0,5
2023-06-01,64020,2,0,2,2,0,2
2023-06-01,149975,1,0,1,2,0,2
2023-06-01,56073,3,0,3,5,0,5
2023-06-01,62597,31,31,62,20,17,21
2023-06-01,133624,4,0,4,2,0,2
2023-06-01,133930,9,1,10,7,2,7
2023-06-01,133360,4,0,4,3,0,3
2023-06-01,133364,1,0,1,1,0,1
2023-06-01,138965,41,0,41,5,0,5
2023-06-01,131542,2,0,2,1,0,1
2023-06-01,133361,2,0,2,4,0,4
2023-06-01,133627,2,0,2,1,0,1
2023-06-01,133274,1,0,1,2,0,2
2023-06-01,133273,1,0,1,1,0,1
2023-06-01,134327,4,0,4,2,0,2
2023-06-01,131091,5,8,13,5,4,5
2023-06-01,132581,7,0,7,4,0,4
2023-06-01,45935,11,0,11,1,0,1
2023-06-01,132831,6,0,6,2,0,2
2023-06-01,131170,1,0,1,3,0,3
2023-06-01,131182,2,0,2,1,0,1
2023-06-01,141058,2,1,3,4,2,4
2023-06-01,132968,4,0,4,3,0,3
2023-06-01,150296,1,5,6,1,4,4
2023-06-01,150060,2,0,2,2,0,2
2023-06-01,132905,4,0,4,2,0,2
2023-06-01,149147,1,0,1,1,0,1
2023-06-01,150419,1,1,2,2,1,2
2023-06-01,133276,7,0,7,3,0,3
2023-06-01,63796,2,0,2,1,0,1
2023-06-01,139607,4,0,4,1,0,1
2023-06-01,9746,5,1,6,1,1,2
2023-06-01,149621,12,0,12,2,0,2
2023-06-01,59094,6,0,6,3,0,3
2023-06-01,24481,9,1,10,4,2,5
2023-06-01,150442,1,0,1,1,0,1
2023-06-01,63494,1,1,2,1,1,1
2023-06-01,59070,39,0,39,1,0,1
2023-06-01,150180,5,5,10,1,1,1
2023-06-01,150418,1,0,1,1,0,1
2023-06-01,4642,12,0,12,1,0,1
2023-06-01,23767,30,1,31,6,3,6
2023-06-01,131226,1,0,1,1,0,1
2023-06-01,56068,4,0,4,3,0,3
2023-06-01,134165,0,0,0,2,0,2
2023-06-01,137268,2,0,2,4,0,4
2023-06-01,133597,4,0,4,3,0,3
2023-06-01,133206,12,0,12,5,0,5
2023-06-01,134217,1,0,1,1,0,1
2023-06-01,133633,3,0,3,1,0,1
2023-06-01,132506,3,0,3,3,0,3
2023-06-01,7593,1,0,1,2,0,2
2023-06-01,150104,2,1,3,3,1,3
2023-06-01,138346,16,1,17,4,1,4
2023-06-01,65530,0,0,0,4,0,4
2023-06-01,133006,2,0,2,3,0,3
2023-06-01,133716,2,0,2,1,0,1
2023-06-01,9468,4,0,4,4,0,4
2023-06-01,38524,16,0,16,12,0,12
2023-06-01,133326,8,0,8,4,0,4
2023-06-01,137591,4,0,4,3,0,3
2023-06-01,131189,3,0,3,2,0,2
2023-06-01,133158,10,0,10,5,0,5
2023-06-01,38609,3,0,3,4,0,4
2023-06-01,55858,2,0,2,2,0,2
2023-06-01,139606,2,0,2,1,0,1
2023-06-01,133198,4,0,4,4,0,4
2023-06-01,59167,4,0,4,1,0,1
2023-06-01,140813,4,0,4,3,0,3
2023-06-01,140171,27,3,30,9,3,9
2023-06-01,9830,41,3,44,19,1,19
2023-06-01,63846,1,0,1,1,0,1
2023-06-01,55741,2,2,4,1,1,1
2023-06-01,150422,2,0,2,3,0,3
2023-06-01,150359,2,1,3,1,1,1
2023-06-01,149148,1,1,2,1,1,1
2023-06-01,149149,1,1,2,1,1,1
2023-06-01,149150,1,1,2,1,1,1
2023-06-01,149151,1,1,2,1,1,1
2023-06-01,150424,3,0,3,2,0,2
2023-06-01,150423,1,1,2,1,1,1
2023-06-01,133698,3,0,3,3,0,3
2023-06-01,133636,1,0,1,1,0,1
2023-06-01,57567,7,0,7,4,0,4
2023-06-01,140028,2,0,2,4,0,4
2023-06-01,63503,1,0,1,1,0,1
2023-06-01,133864,2,0,2,1,0,1
2023-06-01,133730,4,0,4,1,0,1
2023-06-01,150270,3,0,3,2,0,2
2023-06-01,150274,3,0,3,1,0,1
2023-06-01,150488,2,0,2,2,0,2
2023-06-01,150272,2,0,2,2,0,2
2023-06-01,133729,1,1,2,1,1,1
2023-06-01,134858,8,1,9,2,1,2
2023-06-01,198723,1,1,2,3,1,3
2023-06-01,133694,10,0,10,1,0,1
2023-06-01,9519,14,0,14,10,0,10
2023-06-01,133737,3,0,3,3,0,3
2023-06-01,63919,5,0,5,5,0,5
2023-06-01,59267,4,0,4,3,0,3
2023-06-01,133755,2,0,2,1,0,1
2023-06-01,150067,2,0,2,1,0,1
2023-06-01,150431,3,0,3,3,0,3
2023-06-01,135792,6,0,6,2,0,2
2023-06-01,59256,7,2,9,1,1,1
2023-06-01,139759,3,2,5,4,2,4
2023-06-01,45193,4,1,5,1,1,1
2023-06-01,150450,3,0,3,2,0,2
2023-06-01,133700,5,0,5,3,0,3
2023-06-01,133638,8,0,8,1,0,1
2023-06-01,133552,1,0,1,1,0,1
2023-06-01,132840,3,0,3,2,0,2
2023-06-01,63826,2,0,2,1,0,1
2023-06-01,132057,2,0,2,3,0,3
2023-06-01,63504,3,0,3,2,0,2
2023-06-01,63506,1,0,1,1,0,1
2023-06-01,134428,19,0,19,6,0,6
2023-06-01,133751,1,0,1,1,0,1
2023-06-01,63508,4,1,5,3,2,3
2023-06-01,131706,20,2,22,16,6,16
2023-06-01,23808,8,0,8,3,0,3
2023-06-01,135617,2,0,2,2,0,2
2023-06-01,150434,3,2,5,2,1,3
2023-06-01,138911,1,2,3,1,1,1
2023-06-01,63834,1,0,1,1,0,1
2023-06-01,139785,1,0,1,1,0,1
2023-06-01,131574,1,0,1,3,0,3
2023-06-01,133657,4,2,6,3,1,3
2023-06-01,213120,2,1,3,1,1,1
2023-06-01,59173,3,2,5,3,3,3
2023-06-01,141681,6,2,8,1,1,1
2023-06-01,151080,6,1,7,2,1,2
2023-06-01,150435,1,0,1,1,0,1
2023-06-01,63511,1,0,1,2,0,2
2023-06-01,63843,1,0,1,2,0,2
2023-06-01,131243,5,0,5,3,0,3
2023-06-01,63509,4,0,4,1,0,1
2023-06-01,150287,2,0,2,3,0,3
2023-06-01,63510,2,1,3,4,3,4
2023-06-01,133644,1,0,1,2,0,2
2023-06-01,133818,1,0,1,1,0,1
2023-06-01,133727,1,0,1,1,0,1
2023-06-01,63512,5,0,5,1,0,1
2023-06-01,63513,4,0,4,3,0,3
2023-06-01,133768,2,0,2,1,0,1
2023-06-01,63844,8,0,8,2,0,2
2023-06-01,63941,1,0,1,1,0,1
2023-06-01,133802,2,1,3,1,2,2
2023-06-01,150185,2,0,2,2,0,2
2023-06-01,147181,6,1,7,4,2,4
2023-06-01,138594,4,0,4,4,0,4
2023-06-01,138358,6,0,6,5,0,5
2023-06-01,134018,2,0,2,1,0,1
2023-06-01,150290,1,0,1,1,0,1
2023-06-01,134229,2,0,2,3,0,3
2023-06-01,150441,2,0,2,1,0,1
2023-06-01,139195,29,6,35,12,3,12
2023-06-01,133778,15,0,15,4,0,4
2023-06-01,134416,1,0,1,4,0,4
2023-06-01,63848,1,0,1,2,0,2
2023-06-01,134414,1,0,1,2,0,2
2023-06-01,24519,4,0,4,2,0,2
2023-06-01,150103,2,1,3,1,1,1
2023-06-01,58791,5,2,7,8,4,8
2023-06-01,150356,1,0,1,1,0,1
2023-06-01,63851,3,0,3,4,0,4
2023-06-01,38712,44,2,46,10,1,10
2023-06-01,147252,2,0,2,2,0,2
2023-06-01,133659,2,0,2,2,0,2
2023-06-01,133785,1,0,1,1,0,1
2023-06-01,133789,2,0,2,2,0,2
2023-06-01,150181,1,0,1,1,0,1
2023-06-01,133796,3,0,3,3,0,3
2023-06-01,63852,5,0,5,1,0,1
2023-06-01,150573,2,1,3,1,1,1
2023-06-01,150742,1,0,1,1,0,1
2023-06-01,133726,4,0,4,2,0,2
2023-06-01,133799,6,0,6,1,0,1
2023-06-01,59133,4,0,4,1,0,1
2023-06-01,140141,1,0,1,1,0,1
2023-06-01,133793,1,0,1,3,0,3
2023-06-01,136131,5,0,5,3,0,3
2023-06-01,137207,1,1,2,5,3,7
2023-06-01,133651,7,0,7,2,0,2
2023-06-01,63890,5,0,5,5,0,5
2023-06-01,17469,87,0,87,10,0,10
2023-06-01,134021,29,7,36,5,2,6
2023-06-01,133610,2,0,2,2,0,2
2023-06-01,58664,27,1,28,7,1,7
2023-06-01,56038,25,2,27,17,2,17
2023-06-01,63945,6,0,6,4,0,4
2023-06-01,45572,12,0,12,4,0,4
2023-06-01,38546,8,1,9,1,1,1
2023-06-01,134504,1,0,1,1,0,1
2023-06-01,146952,3,0,3,2,0,2
2023-06-01,133859,3,0,3,4,0,4
2023-06-01,133863,1,0,1,4,0,4
2023-06-01,133548,3,0,3,4,0,4
2023-06-01,45168,3,0,3,1,0,1
2023-06-01,133686,1,0,1,1,0,1
2023-06-01,133581,1,0,1,2,0,2
2023-06-01,133783,2,0,2,1,0,1
2023-06-01,133669,3,0,3,3,0,3
2023-06-01,63917,2,0,2,1,0,1
2023-06-01,150191,2,1,3,1,1,1
2023-06-01,63922,2,0,2,1,0,1
2023-06-01,138685,2,5,7,2,4,4
2023-06-01,133870,1,0,1,1,0,1
2023-06-01,149840,1,0,1,1,0,1
2023-06-01,133926,1,1,2,1,1,1
2023-06-01,63923,4,0,4,2,0,2
2023-06-01,23923,103,1,104,10,1,10
2023-06-01,135148,2,0,2,1,0,1
2023-06-01,133900,4,0,4,4,0,4
2023-06-01,133874,1,1,2,1,1,1
2023-06-01,137114,7,0,7,2,0,2
2023-06-01,133650,1,0,1,1,0,1
2023-06-01,133876,5,2,7,4,3,4
2023-06-01,133803,2,1,3,1,1,1
2023-06-01,133932,8,0,8,2,0,2
2023-06-01,63612,63,0,63,1,0,1
2023-06-01,24085,102,4,106,5,2,5
2023-06-01,135921,3,1,4,1,1,1
2023-06-01,133886,3,0,3,3,0,3
2023-06-01,18055,16,3,19,1,1,1
2023-06-01,138884,5,7,12,8,3,8
2023-06-01,150460,1,0,1,1,0,1
2023-06-01,133890,2,0,2,2,0,2
2023-06-01,150452,3,0,3,1,0,1
2023-06-01,150462,1,0,1,2,0,2
2023-06-01,133671,2,0,2,2,0,2
2023-06-01,150076,1,0,1,1,0,1
2023-06-01,133684,4,0,4,2,0,2
2023-06-01,133901,1,0,1,1,0,1
2023-06-01,18149,3,2,5,4,4,4
2023-06-01,59273,8,0,8,7,0,7
2023-06-01,133653,5,3,8,2,1,2
2023-06-01,198834,2,0,2,2,0,2
2023-06-01,133240,4,0,4,3,0,3
2023-06-01,133904,2,2,4,3,3,3
2023-06-01,133663,3,0,3,2,0,2
2023-06-01,59195,2,0,2,4,0,4
2023-06-01,134058,4,1,5,1,1,1
2023-06-01,150457,1,1,2,1,1,1
2023-06-01,134855,3,1,4,4,1,4
2023-06-01,133707,4,0,4,4,0,4
2023-06-01,135202,4,1,5,3,1,3
2023-06-01,150563,1,0,1,1,0,1
2023-06-01,142631,4,1,5,6,1,6
2023-06-01,150455,3,0,3,1,0,1
2023-06-01,133114,3,1,4,1,1,1
2023-06-01,150459,3,1,4,1,1,1
2023-06-01,135149,1,0,1,1,0,1
2023-06-01,133692,6,1,7,2,2,2
2023-06-01,131306,4,0,4,3,0,3
2023-06-01,133912,1,0,1,2,0,2
2023-06-01,133914,2,0,2,3,0,3
2023-06-01,63931,3,1,4,5,3,5
2023-06-01,132113,9,3,12,6,4,6
2023-06-01,133918,5,0,5,3,0,3
2023-06-01,133551,1,0,1,1,0,1
2023-06-01,133920,3,0,3,1,0,1
2023-06-01,59139,14,0,14,6,0,6
2023-06-01,63860,1,0,1,1,0,1
2023-06-01,140690,2,1,3,2,1,2
2023-06-01,150581,2,0,2,1,0,1
2023-06-01,133933,14,0,14,3,0,3
2023-06-01,133805,1,0,1,1,0,1
2023-06-01,63797,1,1,2,2,2,2
2023-06-01,141486,2,0,2,1,0,1
2023-06-01,132783,4,0,4,2,0,2
2023-06-01,133999,1,0,1,2,0,2
2023-06-01,131425,4,0,4,2,0,2
2023-06-01,133923,2,1,3,1,1,2
2023-06-01,63935,1,0,1,3,0,3
2023-06-01,18207,516,10,526,5,1,5
2023-06-01,136696,14,2,16,5,1,5
2023-06-01,150295,1,0,1,1,0,1
2023-06-01,133938,6,1,7,2,2,3
2023-06-01,63861,1,0,1,1,0,1
2023-06-01,150661,1,0,1,1,0,1
2023-06-01,133935,1,0,1,1,0,1
2023-06-01,134100,2,0,2,1,0,1
2023-06-01,134060,2,0,2,3,0,3
2023-06-01,59049,1,0,1,2,0,2
2023-06-01,63950,3,3,6,3,2,3
2023-06-01,38858,15,0,15,7,0,7
2023-06-01,133940,1,0,1,3,0,3
2023-06-01,133936,11,1,12,5,1,5
2023-06-01,63938,1,0,1,3,0,3
2023-06-01,133807,2,0,2,2,0,2
2023-06-01,133943,2,0,2,3,0,3
2023-06-01,150480,1,0,1,1,0,1
2023-06-01,133718,4,0,4,1,0,1
2023-06-01,131899,34,0,34,1,0,1
2023-06-01,136610,4,0,4,2,0,2
2023-06-01,59107,40,0,40,4,0,4
2023-06-01,150662,1,0,1,1,0,1
2023-06-01,150575,2,0,2,1,0,1
2023-06-01,135810,9,1,10,7,6,9
2023-06-01,149587,4,1,5,1,1,1
2023-06-01,150032,4,0,4,1,0,1
2023-06-01,59110,1,1,2,9,6,9
2023-06-01,142271,1,1,2,6,2,6
2023-06-01,131465,1,0,1,2,0,2
2023-06-01,133723,1,0,1,2,0,2
2023-06-01,133947,4,1,5,1,1,1
2023-06-01,141145,4,1,5,5,2,5
2023-06-01,150194,1,0,1,1,0,1
2023-06-01,135493,3,0,3,3,0,3
2023-06-01,3661,7,2,9,6,4,7
2023-06-01,17824,0,0,0,2,2,2
2023-06-01,3662,7,11,18,17,13,18
2023-06-01,9939,33,0,33,4,0,4
2023-06-01,63867,6,0,6,2,0,2
2023-06-01,136215,12,0,12,5,0,5
2023-06-01,133951,4,0,4,5,0,5
2023-06-01,133950,4,1,5,5,1,5
2023-06-01,24211,7,3,10,6,4,6
2023-06-01,24213,9,1,10,4,3,4
2023-06-01,63868,4,0,4,2,0,2
2023-06-01,147224,2,2,4,5,3,5
2023-06-01,150586,2,1,3,1,1,1
2023-06-01,150090,0,0,0,2,0,2
2023-06-01,133722,2,0,2,1,0,1
2023-06-01,45346,1,0,1,3,0,3
2023-06-01,133953,4,0,4,2,0,2
2023-06-01,134907,6,0,6,3,0,3
2023-06-01,132784,3,0,3,1,0,1
2023-06-01,133959,1,1,2,7,5,9
2023-06-01,141329,13,10,23,6,2,6
2023-06-01,141514,47,1,48,8,2,9
2023-06-01,141324,11,3,14,4,1,4
2023-06-01,136055,4,1,5,4,1,4
2023-06-01,63869,4,0,4,2,0,2
2023-06-01,134061,4,0,4,2,0,2
2023-06-01,63086,18,0,18,4,0,4
2023-06-01,133809,7,2,9,5,3,5
2023-06-01,150305,1,0,1,2,0,2
2023-06-01,134001,6,1,7,3,1,3
2023-06-01,134066,1,0,1,4,0,4
2023-06-01,133839,2,0,2,3,0,3
2023-06-01,133971,4,16,20,3,2,3
2023-06-01,45649,3,0,3,3,0,3
2023-06-01,132135,2,0,2,4,0,4
2023-06-01,133964,4,0,4,1,0,1
2023-06-01,134070,1,0,1,1,0,1
2023-06-01,134075,1,0,1,5,0,5
2023-06-01,133819,4,0,4,2,0,2
2023-06-01,150669,1,0,1,2,0,2
2023-06-01,137048,4,0,4,3,0,3
2023-06-01,141834,8,1,9,1,1,1
2023-06-01,134074,2,0,2,2,0,2
2023-06-01,134073,4,1,5,1,1,1
2023-06-01,134076,1,1,2,1,1,1
2023-06-01,150667,2,0,2,1,0,1
2023-06-01,131657,8,0,8,6,0,6
2023-06-01,149052,6,0,6,1,0,1
2023-06-01,15084,32,2,34,22,3,24
2023-06-01,139432,2,0,2,1,0,1
2023-06-01,149157,1,0,1,1,0,1
2023-06-01,137289,21,0,21,2,0,2
2023-06-01,63741,16,1,17,7,1,7
2023-06-01,150470,2,0,2,1,0,1
2023-06-01,140680,1,0,1,1,0,1
2023-06-01,134080,2,0,2,1,0,1
2023-06-01,63954,2,0,2,3,0,3
2023-06-01,134081,1,0,1,2,0,2
2023-06-01,135852,8,1,9,6,1,6
2023-06-01,17461,11,0,11,3,0,3
2023-06-01,150202,1,0,1,2,0,2
2023-06-01,133811,4,5,9,4,2,4
2023-06-01,63968,4,0,4,3,0,3
2023-06-01,133815,38,2,40,5,3,5
2023-06-01,150312,1,0,1,1,0,1
2023-06-01,131433,1,0,1,1,0,1
2023-06-01,131901,3,0,3,2,0,2
2023-06-01,18266,3,1,4,2,1,2
2023-06-01,59111,1,1,2,2,1,2
2023-06-01,59183,5,0,5,2,0,2
2023-06-01,138024,17,0,17,8,0,8
2023-06-01,63957,4,0,4,2,0,2
2023-06-01,136072,10,0,10,5,0,5
2023-06-01,59147,13,0,13,3,0,3
2023-06-01,63872,6,0,6,3,0,3
2023-06-01,132762,3,0,3,1,0,1
2023-06-01,134101,2,0,2,2,0,2
2023-06-01,134102,3,1,4,1,1,1
2023-06-01,133816,1,0,1,2,0,2
2023-06-01,134105,1,0,1,2,0,2
2023-06-01,136506,4,0,4,2,0,2
2023-06-01,133996,3,0,3,1,0,1
2023-06-01,134112,4,0,4,2,0,2
2023-06-01,133995,2,0,2,3,0,3
2023-06-01,134224,2,1,3,1,1,1
2023-06-01,134107,4,0,4,2,0,2
2023-06-01,134054,3,0,3,2,0,2
2023-06-01,23862,12,2,14,4,1,4
2023-06-01,63964,1,0,1,1,0,1
2023-06-01,133969,2,1,3,1,3,4
2023-06-01,131426,5,0,5,1,0,1
2023-06-01,142527,4,1,5,4,2,4
2023-06-01,133970,3,1,4,2,1,2
2023-06-01,133986,2,0,2,2,0,2
2023-06-01,9633,1,0,1,1,0,1
2023-06-01,134110,5,0,5,1,0,1
2023-06-01,63966,3,0,3,3,0,3
2023-06-01,150681,1,0,1,2,0,2
2023-06-01,134151,6,0,6,3,0,3
2023-06-01,63874,4,0,4,4,0,4
2023-06-01,134082,1,0,1,2,0,2
2023-06-01,134115,1,0,1,1,0,1
2023-06-01,55669,14,0,14,3,0,3
2023-06-01,133821,4,0,4,1,0,1
2023-06-01,131427,8,0,8,1,0,1
2023-06-01,55697,3,0,3,4,0,4
2023-06-01,140411,1,0,1,1,0,1
2023-06-01,136331,4,0,4,1,0,1
2023-06-01,133975,2,0,2,1,0,1
2023-06-01,134119,4,1,5,5,2,6
2023-06-01,133967,7,1,8,3,2,3
2023-06-01,63876,1,0,1,1,0,1
2023-06-01,138737,7,1,8,8,1,8
2023-06-01,133983,4,0,4,1,0,1
2023-06-01,134129,1,0,1,1,0,1
2023-06-01,133965,7,1,8,2,1,2
2023-06-01,395517,4,0,4,1,0,1
2023-06-01,150483,2,0,2,1,0,1
2023-06-01,58824,2,0,2,3,0,3
2023-06-01,133990,1,0,1,1,0,1
2023-06-01,133303,4,0,4,4,0,4
2023-06-01,150577,2,0,2,2,0,2
2023-06-01,133966,4,0,4,2,0,2
2023-06-01,134131,1,0,1,1,0,1
2023-06-01,133822,2,0,2,3,0,3
2023-06-01,149409,5,0,5,4,0,4
2023-06-01,63877,1,0,1,1,0,1
2023-06-01,134332,1,0,1,1,0,1
2023-06-01,135307,7,0,7,10,0,10
2023-06-01,134137,1,0,1,1,0,1
2023-06-01,136637,3,0,3,2,0,2
2023-06-01,150620,1,0,1,2,0,2
2023-06-01,150490,1,0,1,1,0,1
2023-06-01,150487,2,1,3,2,1,2
2023-06-01,142354,4,0,4,2,0,2
2023-06-01,63879,1,0,1,2,0,2
2023-06-01,134145,2,0,2,3,0,3
2023-06-01,139352,1,0,1,3,0,3
2023-06-01,134142,1,0,1,1,0,1
2023-06-01,63972,2,2,4,3,3,3
2023-06-01,134020,4,0,4,2,0,2
2023-06-01,134023,5,0,5,1,0,1
2023-06-01,63971,1,0,1,2,0,2
2023-06-01,55816,4,0,4,3,0,3
2023-06-01,136606,3,0,3,1,0,1
2023-06-01,133827,5,5,10,4,2,4
2023-06-01,134146,10,32,42,7,3,7
2023-06-01,149522,5,3,8,8,10,13
2023-06-01,138828,4,0,4,2,0,2
2023-06-01,136073,1,0,1,1,0,1
2023-06-01,134147,3,0,3,3,0,3
2023-06-01,133976,1,0,1,1,0,1
2023-06-01,17993,37,0,37,6,0,6
2023-06-01,150321,1,0,1,2,0,2
2023-06-01,134024,1,0,1,2,0,2
2023-06-01,18134,24,0,24,1,0,1
2023-06-01,133824,1,0,1,1,0,1
2023-06-01,134155,2,0,2,1,0,1
2023-06-01,134163,1,0,1,1,0,1
2023-06-01,133829,3,0,3,1,0,1
2023-06-01,150482,3,1,4,1,1,1
2023-06-01,150489,2,0,2,1,0,1
2023-06-01,150685,1,0,1,1,0,1
2023-06-01,134597,2,0,2,1,0,1
2023-06-01,134068,2,0,2,2,0,2
2023-06-01,134161,1,0,1,2,0,2
2023-06-01,138239,6,1,7,1,1,1
2023-06-01,134164,1,0,1,2,0,2
2023-06-01,65542,0,0,0,2,0,2
2023-06-01,65544,2,0,2,2,0,2
2023-06-01,133279,13,0,13,2,0,2
2023-06-01,133825,1,0,1,1,0,1
2023-06-01,134133,1,0,1,1,0,1
2023-06-01,134030,1,0,1,1,0,1
2023-06-01,150485,2,0,2,2,0,2
2023-06-01,150514,1,0,1,1,0,1
2023-06-01,132896,4,0,4,2,0,2
2023-06-01,135915,2,1,3,1,1,1
2023-06-01,131430,5,0,5,3,0,3
2023-06-01,210897,2,0,2,4,0,4
2023-06-01,134173,2,0,2,2,0,2
2023-06-01,132962,2,0,2,4,0,4
2023-06-01,18051,25,2,27,2,1,2
2023-06-01,133826,1,0,1,1,0,1
2023-06-01,138115,3,1,4,4,3,5
2023-06-01,134057,1,0,1,1,0,1
2023-06-01,134008,4,0,4,3,0,3
2023-06-01,133011,1,0,1,2,0,2
2023-06-01,134052,4,0,4,2,0,2
2023-06-01,137651,5,1,6,5,1,5
2023-06-01,134179,3,0,3,1,0,1
2023-06-01,46028,13,0,13,4,0,4
2023-06-01,131950,13,0,13,2,0,2
2023-06-01,136373,13,144,157,3,1,3
2023-06-01,134183,1,0,1,2,0,2
2023-06-01,133985,1,1,2,1,1,1
2023-06-01,59171,3,0,3,1,0,1
2023-06-01,150691,1,0,1,1,0,1
2023-06-01,131436,5,2,7,5,1,5
2023-06-01,150610,1,0,1,1,0,1
2023-06-01,150585,2,0,2,1,0,1
2023-06-01,134050,1,0,1,2,0,2
2023-06-01,63984,4,0,4,5,0,5
2023-06-01,134187,0,0,0,7,0,7
2023-06-01,197981,3,1,4,9,4,9
2023-06-01,134264,8,0,8,3,0,3
2023-06-01,63882,4,0,4,2,0,2
2023-06-01,133984,4,0,4,4,0,4
2023-06-01,140499,4,0,4,1,0,1
2023-06-01,134029,2,0,2,2,0,2
2023-06-01,137406,8,1,9,4,1,4
2023-06-01,135345,26,0,26,6,0,6
2023-06-01,201246,7,1,8,2,2,3
2023-06-01,17889,3,0,3,7,0,7
2023-06-01,134203,1,0,1,1,0,1
2023-06-01,45493,2,0,2,1,0,1
2023-06-01,133834,4,0,4,3,0,3
2023-06-01,63987,2,0,2,2,0,2
2023-06-01,133832,1,0,1,1,0,1
2023-06-01,134214,1,0,1,3,0,3
2023-06-01,134036,4,0,4,3,0,3
2023-06-01,10208,5,1,6,4,1,4
2023-06-01,133835,1,0,1,1,0,1
2023-06-01,59278,10,2,12,12,6,12
2023-06-01,132561,1,0,1,1,0,1
2023-06-01,11031,9,0,9,11,0,11
2023-06-01,150496,3,0,3,1,0,1
2023-06-01,134027,5,0,5,3,0,3
2023-06-01,134225,1,0,1,3,0,3
2023-06-01,136486,5,0,5,2,0,2
2023-06-01,131903,1,0,1,2,0,2
2023-06-01,38574,2,1,3,2,2,3
2023-06-01,150492,1,0,1,1,0,1
2023-06-01,132924,4,0,4,2,0,2
2023-06-01,45971,2,0,2,3,0,3
2023-06-01,150493,2,1,3,1,1,1
2023-06-01,150692,3,1,4,2,1,2
2023-06-01,134226,4,0,4,3,0,3
2023-06-01,134044,2,0,2,1,0,1
2023-06-01,55302,1,0,1,2,0,2
2023-06-01,150697,2,1,3,3,1,3
2023-06-01,149419,4,0,4,3,0,3
2023-06-01,131595,1,0,1,3,0,3
2023-06-01,58398,3,0,3,2,0,2
2023-06-01,140849,4,0,4,4,0,4
2023-06-01,136900,5,2,7,7,2,7
2023-06-01,134235,1,0,1,1,0,1
2023-06-01,134232,1,1,2,3,1,3
2023-06-01,133493,2,0,2,1,0,1
2023-06-01,64095,5,2,7,3,2,3
2023-06-01,134306,4,0,4,2,0,2
2023-06-01,132852,5,0,5,2,0,2
2023-06-01,134016,4,0,4,1,0,1
2023-06-01,134239,1,0,1,1,0,1
2023-06-01,18356,4,2,6,1,1,1
2023-06-01,135729,2,0,2,1,0,1
2023-06-01,150699,3,0,3,1,0,1
2023-06-01,142511,7,0,7,1,0,1
2023-06-01,134043,2,0,2,1,0,1
2023-06-01,150696,3,0,3,2,0,2
2023-06-01,134305,7,1,8,3,1,3
2023-06-01,134407,2,0,2,3,0,3
2023-06-01,135644,5,0,5,1,0,1
2023-06-01,150504,2,1,3,1,1,1
2023-06-01,55680,6,1,7,4,2,4
2023-06-01,149160,1,1,2,2,2,2
2023-06-01,149161,3,0,3,1,0,1
2023-06-01,134346,4,0,4,4,0,4
2023-06-01,150505,1,0,1,1,0,1
2023-06-01,150515,2,0,2,1,0,1
2023-06-01,63998,5,0,5,4,0,4
2023-06-01,150509,3,0,3,1,0,1
2023-06-01,150701,3,0,3,1,0,1
2023-06-01,131434,5,0,5,1,0,1
2023-06-01,56159,5,0,5,2,0,2
2023-06-01,134691,1,0,1,1,0,1
2023-06-01,45734,4,1,5,3,1,3
2023-06-01,63580,1,0,1,3,0,3
2023-06-01,135229,2,0,2,3,0,3
2023-06-01,59115,1,1,2,2,2,2
2023-06-01,134363,3,0,3,3,0,3
2023-06-01,133305,1,0,1,1,0,1
2023-06-01,134042,19,0,19,1,0,1
2023-06-01,134367,1,0,1,1,0,1
2023-06-01,133256,2,0,2,3,0,3
2023-06-01,150510,3,0,3,2,0,2
2023-06-01,150606,1,0,1,1,0,1
2023-06-01,134259,9,0,9,1,0,1
2023-06-01,134329,4,0,4,1,0,1
2023-06-01,140876,6,0,6,1,0,1
2023-06-01,134680,3,0,3,1,0,1
2023-06-01,138774,4,0,4,2,0,2
2023-06-01,140036,1,0,1,4,0,4
2023-06-01,150705,1,0,1,2,0,2
2023-06-01,136308,7,1,8,12,4,12
2023-06-01,150608,2,0,2,2,0,2
2023-06-01,134788,9,0,9,5,0,5
2023-06-01,134310,1,0,1,1,0,1
2023-06-01,64002,1,0,1,1,0,1
2023-06-01,63883,3,0,3,1,0,1
2023-06-01,18307,2,0,2,2,0,2
2023-06-01,135661,3,0,3,1,0,1
2023-06-01,64003,4,0,4,1,0,1
2023-06-01,38227,3,1,4,3,1,3
2023-06-01,134376,1,0,1,1,0,1
2023-06-01,134378,5,0,5,4,0,4
2023-06-01,133843,5,0,5,3,0,3
2023-06-01,138126,2,0,2,2,0,2
2023-06-01,134379,3,0,3,2,0,2
2023-06-01,134411,2,0,2,4,0,4
2023-06-01,139049,4,0,4,1,0,1
2023-06-01,132861,1,0,1,1,0,1
2023-06-01,147084,2,0,2,3,0,3
2023-06-01,146940,2,0,2,1,0,1
2023-06-01,133842,2,0,2,3,0,3
2023-06-01,134403,3,0,3,4,0,4
2023-06-01,135531,5,0,5,1,0,1
2023-06-01,137877,3,0,3,1,0,1
2023-06-01,135456,1,0,1,4,0,4
2023-06-01,141898,15,2,17,18,6,18
2023-06-01,150609,1,0,1,3,0,3
2023-06-01,135548,1,0,1,3,0,3
2023-06-01,135218,3,0,3,2,0,2
2023-06-01,135552,1,0,1,1,0,1
2023-06-01,150704,3,2,5,1,1,1
2023-06-01,150709,2,0,2,2,0,2
2023-06-01,135549,4,0,4,3,0,3
2023-06-01,135553,8,0,8,2,0,2
2023-06-01,135700,8,0,8,2,0,2
2023-06-01,133092,4,0,4,3,0,3
2023-06-01,135449,3,0,3,6,0,6
2023-06-01,150710,1,1,2,4,1,4
2023-06-01,150707,3,1,4,3,1,3
2023-06-01,150708,2,0,2,1,0,1
2023-06-01,135512,2,0,2,3,0,3
2023-06-01,135451,3,0,3,2,0,2
2023-06-01,132822,1,0,1,1,0,1
2023-06-01,150811,2,1,3,2,1,2
2023-06-01,132750,4,0,4,1,0,1
2023-06-01,135688,4,0,4,5,0,5
2023-06-01,135213,3,0,3,1,0,1
2023-06-01,135219,7,0,7,2,0,2
2023-06-01,135215,4,0,4,2,0,2
2023-06-01,135564,2,0,2,1,0,1
2023-06-01,45240,3,1,4,1,1,1
2023-06-01,4611,13,0,13,2,0,2
2023-06-01,135565,3,0,3,2,0,2
2023-06-01,150241,1,1,2,1,1,1
2023-06-01,23694,5,0,5,2,0,2
2023-06-01,135234,6,3,9,2,1,2
2023-06-01,150589,3,1,4,1,1,1
2023-06-01,139982,3,2,5,6,4,6
2023-06-01,150511,1,0,1,1,0,1
2023-06-01,131232,5,0,5,2,0,2
2023-06-01,63490,7,8,15,4,1,4
2023-06-01,142376,4,0,4,4,0,4
2023-06-01,141671,10,1,11,6,1,6
2023-06-01,133258,4,0,4,2,0,2
2023-06-01,58763,4,0,4,2,0,2
2023-06-01,135572,12,1,13,6,2,6
2023-06-01,132969,3,0,3,1,0,1
2023-06-01,140170,3,0,3,4,0,4
2023-06-01,150714,2,0,2,3,0,3
2023-06-01,63749,2,0,2,4,0,4
2023-06-01,64612,0,0,0,1,0,1
2023-06-01,134734,3,16,19,8,5,8
2023-06-01,140988,1,0,1,1,0,1
2023-06-01,135578,2,0,2,3,0,3
2023-06-01,141723,6,1,7,3,1,3
2023-06-01,398109,2,1,3,1,1,1
2023-06-01,135583,2,0,2,1,0,1
2023-06-01,135582,6,1,7,5,1,5
2023-06-01,134707,4,1,5,12,1,12
2023-06-01,135773,4,1,5,1,1,1
2023-06-01,133148,1,0,1,2,0,2
2023-06-01,150715,3,0,3,1,0,1
2023-06-01,138317,6,0,6,2,0,2
2023-06-01,150716,1,0,1,1,0,1
2023-06-01,135723,6,0,6,2,0,2
2023-06-01,149939,2,0,2,3,0,3
2023-06-01,135595,1,0,1,2,0,2
2023-06-01,135592,1,0,1,1,0,1
2023-06-01,135760,8,2,10,11,8,12
2023-06-01,150591,2,0,2,1,0,1
2023-06-01,150625,3,1,4,1,1,1
2023-06-01,135585,2,0,2,2,0,2
2023-06-01,131659,6,0,6,13,0,13
2023-06-01,9915,3,0,3,2,0,2
2023-06-01,202297,1,6,7,5,4,7
2023-06-01,150813,1,0,1,1,0,1
2023-06-01,135594,2,0,2,5,0,5
2023-06-01,135454,1,0,1,3,0,3
2023-06-01,135735,9,0,9,7,0,7
2023-06-01,135191,5,0,5,1,0,1
2023-06-01,59274,2,0,2,2,0,2
2023-06-01,131910,2,1,3,2,1,3
2023-06-01,135779,4,0,4,1,0,1
2023-06-01,24225,10,2,12,4,2,4
2023-06-01,135459,6,0,6,3,0,3
2023-06-01,135604,4,0,4,3,0,3
2023-06-01,135722,14,1,15,3,1,3
2023-06-01,135733,4,0,4,2,0,2
2023-06-01,150094,1,0,1,1,0,1
2023-06-01,135730,1,0,1,1,0,1
2023-06-01,135775,6,1,7,3,1,3
2023-06-01,135777,23,0,23,2,0,2
2023-06-01,150013,3,0,3,1,0,1
2023-06-01,135606,2,0,2,2,0,2
2023-06-01,135901,10,1,11,2,1,2
2023-06-01,63753,2,0,2,2,0,2
2023-06-01,150618,1,0,1,2,0,2
2023-06-01,150343,1,0,1,1,0,1
2023-06-01,131240,1,0,1,1,0,1
2023-06-01,131299,4,0,4,2,0,2
2023-06-01,131247,8,3,11,1,1,1
2023-06-01,45887,16,1,17,6,1,6
2023-06-01,131230,1,0,1,1,0,1
2023-06-01,150014,2,1,3,1,1,1
2023-06-01,131244,2,0,2,5,0,5
2023-06-01,150347,1,0,1,2,0,2
2023-06-01,150621,2,0,2,1,0,1
2023-06-01,24270,3,1,4,1,1,1
2023-06-01,131276,4,0,4,1,0,1
2023-06-01,135685,3,0,3,1,0,1
2023-06-01,131282,1,0,1,3,0,3
2023-06-01,131286,1,0,1,1,0,1
2023-06-01,131287,2,0,2,1,0,1
2023-06-01,24558,3,1,4,3,1,3
2023-06-01,40747,3,1,4,1,1,1
2023-06-01,131290,1,0,1,2,0,2
2023-06-01,4801,1,0,1,1,0,1
2023-06-01,131292,4,0,4,1,0,1
2023-06-01,150530,3,0,3,3,0,3
2023-06-01,150517,2,0,2,3,0,3
2023-06-01,139972,3,13,16,4,1,4
2023-06-01,131295,1,0,1,1,0,1
2023-06-01,136137,2,0,2,1,0,1
2023-06-01,131296,2,0,2,1,0,1
2023-06-01,150541,1,0,1,2,0,2
2023-06-01,150721,2,0,2,2,0,2
2023-06-01,63754,4,0,4,2,0,2
2023-06-01,63755,3,0,3,2,0,2
2023-06-01,138257,10,1,11,1,1,2
2023-06-01,131312,1,0,1,3,0,3
2023-06-01,135679,4,0,4,2,0,2
2023-06-01,135686,2,1,3,4,3,4
2023-06-01,138493,2,0,2,2,0,2
2023-06-01,150529,2,0,2,2,0,2
2023-06-01,131744,0,0,0,2,0,2
2023-06-01,151200,3,0,3,2,0,2
2023-06-01,135158,5,1,6,15,5,16
2023-06-01,151204,2,0,2,1,0,1
2023-06-01,151203,1,1,2,3,1,3
2023-06-01,147087,6,1,7,4,3,4
2023-06-01,136493,8,1,9,3,3,3
2023-06-01,132019,1,1,2,1,1,1
2023-06-01,131341,3,0,3,2,0,2
2023-06-01,131582,3,0,3,3,0,3
2023-06-01,136993,20,0,20,2,0,2
2023-06-01,135081,9,0,9,8,0,8
2023-06-01,131448,10,0,10,2,0,2
2023-06-01,131464,18,35,53,7,5,8
2023-06-01,150722,2,0,2,1,0,1
2023-06-01,140062,2,0,2,1,0,1
2023-06-01,134912,5,0,5,2,0,2
2023-06-01,131684,1,0,1,2,0,2
2023-06-01,135445,15,0,15,2,0,2
2023-06-01,135682,3,0,3,1,0,1
2023-06-01,138826,1,0,1,8,2,8
2023-06-01,23913,3,0,3,5,0,5
2023-06-01,131891,1,0,1,3,0,3
2023-06-01,134877,16,2,18,15,4,15
2023-06-01,147269,3,18,21,1,1,1
2023-06-01,131996,3,1,4,4,1,4
2023-06-01,132337,31,6,37,16,8,19
2023-06-01,133210,2,1,3,9,4,9
2023-06-01,132014,5,0,5,2,0,2
2023-06-01,150240,1,0,1,2,0,2
2023-06-01,149240,9,1,10,16,6,17
2023-06-01,135762,6,0,6,2,0,2
2023-06-01,132030,1,0,1,1,0,1
2023-06-01,132044,1,0,1,1,0,1
2023-06-01,150267,1,0,1,1,0,1
2023-06-01,135932,9,1,10,5,1,5
2023-06-01,135462,2,0,2,1,0,1
2023-06-01,45809,6,1,7,4,3,4
2023-06-01,63761,1,0,1,1,0,1
2023-06-01,400171,2,0,2,1,0,1
2023-06-01,135258,1,0,1,3,0,3
2023-06-01,134928,14,1,15,6,3,6
2023-06-01,134324,2,0,2,1,0,1
2023-06-01,135464,4,0,4,2,0,2
2023-06-01,132089,1,0,1,3,0,3
2023-06-01,135463,2,0,2,3,0,3
2023-06-01,132083,2,0,2,3,0,3
2023-06-01,135767,2,0,2,2,0,2
2023-06-01,138064,8,4,12,10,4,10
2023-06-01,150980,1,0,1,1,0,1
2023-06-01,134262,2,1,3,1,1,1
2023-06-01,10112,1,0,1,1,0,1
2023-06-01,132219,1,0,1,3,0,3
2023-06-01,135764,1,0,1,3,0,3
2023-06-01,132092,10,17,27,5,3,5
2023-06-01,135763,6,3,9,2,1,2
2023-06-01,138738,2,0,2,3,0,3
2023-06-01,135761,10,1,11,2,1,2
2023-06-01,134599,8,0,8,3,0,3
2023-06-01,64037,4,0,4,3,0,3
2023-06-01,55366,10,5,15,4,3,5
2023-06-01,150819,1,1,2,1,1,1
2023-06-01,137620,4,1,5,1,1,1
2023-06-01,135712,4,0,4,2,0,2
2023-06-01,132100,7,0,7,1,0,1
2023-06-01,132123,3,0,3,3,0,3
2023-06-01,134149,3,0,3,2,0,2
2023-06-01,59123,9,1,10,5,3,5
2023-06-01,132133,5,0,5,3,0,3
2023-06-01,55780,3,0,3,3,0,3
2023-06-01,132386,1,0,1,1,0,1
2023-06-01,55662,4,0,4,1,0,1
2023-06-01,138771,8,0,8,3,0,3
2023-06-01,150233,1,0,1,1,0,1
2023-06-01,132134,1,1,2,9,3,9
2023-06-01,132205,2,0,2,1,0,1
2023-06-01,135699,10,0,10,3,0,3
2023-06-01,132218,1,0,1,2,0,2
2023-06-01,24016,52,3,55,4,2,4
2023-06-01,134698,2,0,2,2,0,2
2023-06-01,132222,4,0,4,3,0,3
2023-06-01,135705,7,0,7,2,0,2
2023-06-01,135692,9,0,9,3,0,3
2023-06-01,134824,3,0,3,2,0,2
2023-06-01,138712,9,0,9,4,0,4
2023-06-01,55781,7,0,7,2,0,2
2023-06-01,133203,7,0,7,4,0,4
2023-06-01,132976,26,1,27,8,2,8
2023-06-01,135690,3,1,4,2,1,2
2023-06-01,131402,8,0,8,3,0,3
2023-06-01,131302,2,1,3,3,1,3
2023-06-01,23671,30,1,31,17,3,17
2023-06-01,135472,3,1,4,3,2,3
2023-06-01,132248,1,0,1,1,0,1
2023-06-01,10223,7,0,7,7,0,7
2023-06-01,132256,2,0,2,3,0,3
2023-06-01,9875,118,7,125,4,2,5
2023-06-01,139177,4,0,4,2,0,2
2023-06-01,132270,3,0,3,2,0,2
2023-06-01,131767,8,0,8,5,0,5
2023-06-01,135471,2,0,2,1,0,1
2023-06-01,55922,2,0,2,2,0,2
2023-06-01,150235,1,0,1,1,0,1
2023-06-01,132254,2,0,2,1,0,1
2023-06-01,63757,1,0,1,1,0,1
2023-06-01,132320,1,0,1,1,0,1
2023-06-01,132365,5,0,5,1,0,1
2023-06-01,63615,1,0,1,2,0,2
2023-06-01,131482,1,0,1,1,0,1
2023-06-01,133112,2,0,2,3,0,3
2023-06-01,134663,1,1,2,1,1,1
2023-06-01,136302,13,2,15,4,1,4
2023-06-01,132327,2,0,2,2,0,2
2023-06-01,132400,10,0,10,1,0,1
2023-06-01,132398,1,1,2,2,2,2
2023-06-01,132401,1,1,2,1,1,1
2023-06-01,141333,2,0,2,1,0,1
2023-06-01,132416,1,0,1,1,0,1
2023-06-01,133075,7,2,9,3,3,4
2023-06-01,132424,1,0,1,2,0,2
2023-06-01,136008,2,0,2,2,0,2
2023-06-01,137391,1,0,1,2,0,2
2023-06-01,18022,2,0,2,3,0,3
2023-06-01,132436,4,0,4,5,0,5
2023-06-01,132433,2,0,2,1,0,1
2023-06-01,132438,4,0,4,1,0,1
2023-06-01,63646,117,6,123,4,2,4
2023-06-01,132443,1,0,1,1,0,1
2023-06-01,132476,1,1,2,1,2,2
2023-06-01,132464,2,2,4,2,1,2
2023-06-01,18187,4,1,5,17,2,17
2023-06-01,135468,5,0,5,1,0,1
2023-06-01,135474,4,0,4,2,0,2
2023-06-01,132486,3,0,3,2,0,2
2023-06-01,4851,26,4,30,9,2,9
2023-06-01,132498,1,0,1,1,0,1
2023-06-01,132491,3,0,3,5,0,5
2023-06-01,149120,2,0,2,2,0,2
2023-06-01,132298,19,29,48,11,4,11
2023-06-01,132764,2,0,2,2,0,2
2023-06-01,133469,11,0,11,1,0,1
2023-06-01,150729,2,0,2,2,0,2
2023-06-01,149944,1,0,1,3,0,3
2023-06-01,132685,2,0,2,3,0,3
2023-06-01,132622,7,0,7,2,0,2
2023-06-01,132626,1,0,1,1,0,1
2023-06-01,150727,2,1,3,1,1,1
2023-06-01,24556,30,31,61,6,3,6
2023-06-01,137704,5,31,36,3,2,3
2023-06-01,132735,1,0,1,2,0,2
2023-06-01,132727,4,0,4,3,0,3
2023-06-01,132741,2,0,2,3,0,3
2023-06-01,135473,2,0,2,2,0,2
2023-06-01,132686,4,0,4,3,0,3
2023-06-01,213347,2,2,4,2,2,2
2023-06-01,38090,22,0,22,16,0,16
2023-06-01,138106,3,2,5,7,1,7
2023-06-01,135444,6,0,6,3,0,3
2023-06-01,149781,4,1,5,6,2,7
2023-06-01,150151,4,0,4,3,0,3
2023-06-01,150726,3,0,3,1,0,1
2023-06-01,133141,8,0,8,2,0,2
2023-06-01,135695,1,0,1,1,0,1
2023-06-01,150093,1,0,1,1,0,1
2023-06-01,132808,2,1,3,5,4,5
2023-06-01,132806,5,1,6,2,1,2
2023-06-01,135716,3,0,3,1,0,1
2023-06-01,63758,3,0,3,2,0,2
2023-06-01,63759,1,0,1,1,0,1
2023-06-01,63641,14,0,14,2,0,2
2023-06-01,135702,3,0,3,1,0,1
2023-06-01,132812,1,0,1,1,0,1
2023-06-01,46034,3,0,3,2,0,2
2023-06-01,135753,4,1,5,2,1,2
2023-06-01,135460,4,0,4,3,0,3
2023-06-01,135756,2,1,3,1,1,1
2023-06-01,135487,1,0,1,2,0,2
2023-06-01,135751,3,0,3,1,0,1
2023-06-01,148968,7,2,9,16,6,16
2023-06-01,134626,2,0,2,3,0,3
2023-06-01,135757,2,0,2,2,0,2
2023-06-01,135873,4,0,4,1,0,1
2023-06-01,135697,18,1,19,2,2,3
2023-06-01,137453,13,1,14,4,1,4
2023-06-01,131340,2,0,2,3,0,3
2023-06-01,132908,1,0,1,1,0,1
2023-06-01,135693,5,0,5,1,0,1
2023-06-01,133045,9,1,10,9,3,9
2023-06-01,133068,1,0,1,1,0,1
2023-06-01,133156,1,0,1,1,0,1
2023-06-01,134319,20,1,21,2,1,2
2023-06-01,149268,13,3,16,3,2,3
2023-06-01,133149,1,0,1,1,0,1
2023-06-01,142448,2,0,2,1,0,1
2023-06-01,150539,2,0,2,1,0,1
2023-06-01,59057,1,0,1,1,0,1
2023-06-01,17434,6,2,8,2,1,3
2023-06-01,150523,3,1,4,2,1,2
2023-06-01,150732,2,0,2,1,0,1
2023-06-01,133386,2,0,2,3,0,3
2023-06-01,65501,0,0,0,2,0,2
2023-06-01,65503,0,0,0,2,0,2
2023-06-01,133557,4,18,22,2,1,2
2023-06-01,135475,1,0,1,1,0,1
2023-06-01,63629,3,1,4,2,1,2
2023-06-01,135216,1,1,2,1,1,1
2023-06-01,141014,10,2,12,8,4,8
2023-06-01,137139,8,0,8,3,0,3
2023-06-01,38166,51,0,51,10,0,10
2023-06-01,63762,1,0,1,1,0,1
2023-06-01,133483,1,0,1,2,0,2
2023-06-01,133872,2,0,2,4,0,4
2023-06-01,133476,2,1,3,1,1,1
2023-06-01,135239,12,1,13,4,2,4
2023-06-01,64310,1,0,1,1,0,1
2023-06-01,133580,3,0,3,2,0,2
2023-06-01,150057,1,0,1,1,0,1
2023-06-01,133742,1,1,2,1,1,1
2023-06-01,132955,4,0,4,2,0,2
2023-06-01,135748,2,1,3,2,2,2
2023-06-01,133622,1,0,1,3,0,3
2023-06-01,133583,1,1,2,3,1,3
2023-06-01,138466,9,5,14,8,5,8
2023-06-01,133866,10,0,10,3,0,3
2023-06-01,135481,1,0,1,1,0,1
2023-06-01,134345,6,0,6,2,0,2
2023-06-01,133310,4,0,4,1,0,1
2023-06-01,133889,1,0,1,1,0,1
2023-06-01,133958,1,0,1,1,0,1
2023-06-01,150242,1,1,2,3,2,3
2023-06-01,134072,2,0,2,1,0,1
2023-06-01,150639,2,0,2,1,0,1
2023-06-01,133040,2,0,2,1,0,1
2023-06-01,135746,5,1,6,1,1,2
2023-06-01,150735,3,0,3,1,0,1
2023-06-01,135612,3,0,3,1,0,1
2023-06-01,135758,8,0,8,1,0,1
2023-06-01,150653,2,0,2,4,0,4
2023-06-01,150738,2,0,2,1,0,1
2023-06-01,135483,1,0,1,2,0,2
2023-06-01,58610,12,0,12,1,0,1
2023-06-01,64088,2,0,2,3,0,3
2023-06-01,132384,10,9,19,4,3,5
2023-06-01,131686,8,0,8,2,0,2
2023-06-01,135868,5,0,5,1,0,1
2023-06-01,135195,1,0,1,1,0,1
2023-06-01,135625,1,0,1,1,0,1
2023-06-01,135632,8,0,8,2,0,2
2023-06-01,135626,1,0,1,3,0,3
2023-06-01,17705,22,1,23,15,4,15
2023-06-01,135627,1,0,1,1,0,1
2023-06-01,135628,6,0,6,3,0,3
2023-06-01,134437,4,0,4,3,0,3
2023-06-01,134832,3,0,3,2,0,2
2023-06-01,63631,35,0,35,13,0,13
2023-06-01,135636,15,26,41,5,1,5
2023-06-01,146872,13,145,158,2,1,2
2023-06-01,135637,5,0,5,2,0,2
2023-06-01,135639,1,0,1,1,0,1
2023-06-01,150737,2,0,2,3,0,3
2023-06-01,135643,2,0,2,2,0,2
2023-06-01,63634,4,0,4,3,0,3
2023-06-01,135175,12,0,12,1,0,1
2023-06-01,147137,3,182,185,9,3,9
2023-06-01,135484,4,1,5,1,1,1
2023-06-01,63764,5,0,5,1,0,1
2023-06-01,140810,9,2,11,1,1,1
2023-06-01,150821,1,0,1,1,0,1
2023-06-01,131765,3,0,3,3,0,3
2023-06-01,134702,5,2,7,3,1,3
2023-06-01,10222,9,1,10,5,2,6
2023-06-01,135813,2,0,2,1,0,1
2023-06-01,137837,1,0,1,1,0,1
2023-06-01,64297,6,0,6,2,0,2
2023-06-01,149478,3,1,4,1,1,1
2023-06-01,136165,4,0,4,3,0,3
2023-06-01,135647,2,0,2,2,0,2
2023-06-01,64298,3,0,3,2,0,2
2023-06-01,150659,2,1,3,2,1,2
2023-06-01,135806,5,1,6,8,4,8
2023-06-01,135820,3,0,3,1,0,1
2023-06-01,135818,4,0,4,2,0,2
2023-06-01,135811,4,0,4,4,0,4
2023-06-01,135815,4,0,4,1,0,1
2023-06-01,132958,2,0,2,1,0,1
2023-06-01,55482,10,1,11,6,2,6
2023-06-01,135652,4,0,4,1,0,1
2023-06-01,140920,2,1,3,3,1,3
2023-06-01,136056,1,0,1,3,0,3
2023-06-01,150256,1,0,1,1,0,1
2023-06-01,135654,13,0,13,4,0,4
2023-06-01,63768,4,0,4,1,0,1
2023-06-01,63767,4,0,4,2,0,2
2023-06-01,63766,6,1,7,3,1,3
2023-06-01,64314,2,0,2,1,0,1
2023-06-01,135485,1,0,1,2,0,2
2023-06-01,134784,1,0,1,1,0,1
2023-06-01,135662,4,0,4,1,0,1
2023-06-01,58650,12,0,12,2,0,2
2023-06-01,135668,2,0,2,5,0,5
2023-06-01,64309,1,0,1,3,0,3
2023-06-01,135672,1,0,1,1,0,1
2023-06-01,135812,2,0,2,2,0,2
2023-06-01,37893,5,0,5,5,0,5
2023-06-01,150248,1,0,1,1,0,1
2023-06-01,135876,9,2,11,3,1,3
2023-06-01,135801,4,1,5,4,1,4
2023-06-01,146932,2,1,3,2,1,2
2023-06-01,135857,1,0,1,1,0,1
2023-06-01,135675,2,0,2,1,0,1
2023-06-01,150021,6,15,21,4,1,4
2023-06-01,137002,1,0,1,3,0,3
2023-06-01,135878,1,0,1,1,0,1
2023-06-01,64303,1,0,1,1,0,1
2023-06-01,133260,2,0,2,1,0,1
2023-06-01,135802,4,0,4,1,0,1
2023-06-01,45949,3,0,3,1,0,1
2023-06-01,135808,5,1,6,1,1,1
2023-06-01,135804,1,0,1,1,0,1
2023-06-01,150486,1,0,1,1,0,1
2023-06-01,136007,1,0,1,1,0,1
2023-06-01,135882,4,0,4,4,0,4
2023-06-01,139029,2,0,2,3,0,3
2023-06-01,131912,3,1,4,4,1,4
2023-06-01,135890,1,0,1,2,0,2
2023-06-01,135892,1,0,1,1,0,1
2023-06-01,135889,4,0,4,1,0,1
2023-06-01,150656,2,1,3,1,1,1
2023-06-01,135805,2,0,2,1,0,1
2023-06-01,135875,1,0,1,1,0,1
2023-06-01,135897,1,0,1,1,0,1
2023-06-01,135898,1,0,1,1,0,1
2023-06-01,64306,2,0,2,1,0,1
2023-06-01,64305,1,0,1,2,0,2
2023-06-01,7540,144,1,145,8,1,8
2023-06-01,64308,1,0,1,2,0,2
2023-06-01,64307,3,0,3,2,0,2
2023-06-01,134932,10,1,11,7,1,7
2023-06-01,136000,16,1,17,1,1,1
2023-06-01,133382,4,0,4,3,0,3
2023-06-01,135645,2,0,2,2,0,2
2023-06-01,135858,3,0,3,2,0,2
2023-06-01,136004,5,0,5,2,0,2
2023-06-01,136005,1,0,1,1,0,1
2023-06-01,136001,10,1,11,6,3,6
2023-06-01,139951,3,1,4,2,1,3
2023-06-01,140728,1,0,1,1,0,1
2023-06-01,137609,4,0,4,2,0,2
2023-06-01,135874,1,0,1,1,0,1
2023-06-01,135866,3,1,4,2,1,2
2023-06-01,136006,1,0,1,1,0,1
2023-06-01,136232,1,0,1,1,0,1
2023-06-01,136009,4,0,4,3,0,3
2023-06-01,136010,3,0,3,2,0,2
2023-06-01,131262,9,5,14,3,2,3
2023-06-01,136145,4,0,4,2,0,2
2023-06-01,211392,13,0,13,2,0,2
2023-06-01,136015,1,0,1,1,0,1
2023-06-01,136016,1,0,1,1,0,1
2023-06-01,135862,4,0,4,1,0,1
2023-06-01,138814,2,1,3,5,2,5
2023-06-01,150955,2,0,2,1,0,1
2023-06-01,150949,2,0,2,1,0,1
2023-06-01,136014,6,1,7,3,1,3
2023-06-01,136784,9,0,9,3,0,3
2023-06-01,136033,2,0,2,1,0,1
2023-06-01,136783,3,0,3,2,0,2
2023-06-01,136023,1,0,1,2,0,2
2023-06-01,135797,3,0,3,2,0,2
2023-06-01,135721,4,0,4,1,0,1
2023-06-01,139562,4,0,4,3,0,3
2023-06-01,135863,4,0,4,2,0,2
2023-06-01,135526,2,1,3,6,1,6
2023-06-01,136024,2,0,2,4,0,4
2023-06-01,64312,1,0,1,1,0,1
2023-06-01,132159,2,0,2,1,0,1
2023-06-01,136035,3,0,3,2,0,2
2023-06-01,136036,1,0,1,1,0,1
2023-06-01,132988,4,0,4,1,0,1
2023-06-01,135834,17,47,64,10,2,10
2023-06-01,150378,1,0,1,1,0,1
2023-06-01,135871,2,2,4,1,1,1
2023-06-01,136352,4,16,20,3,1,3
2023-06-01,136044,3,0,3,2,0,2
2023-06-01,136053,1,0,1,1,0,1
2023-06-01,137672,2,0,2,2,0,2
2023-06-01,150657,2,0,2,2,0,2
2023-06-01,23953,50,1,51,5,1,5
2023-06-01,135861,4,0,4,2,0,2
2023-06-01,132409,1,0,1,1,0,1
2023-06-01,134725,1,0,1,1,0,1
2023-06-01,136178,4,0,4,2,0,2
2023-06-01,136054,4,0,4,3,0,3
2023-06-01,135422,6,0,6,4,0,4
2023-06-01,132430,2,0,2,1,0,1
2023-06-01,133080,4,0,4,2,0,2
2023-06-01,134863,20,16,36,4,1,4
2023-06-01,133008,1,0,1,1,0,1
2023-06-01,63704,1,0,1,1,0,1
2023-06-01,137163,4,1,5,2,1,2
2023-06-01,135124,5,0,5,4,0,4
2023-06-01,150745,1,0,1,1,0,1
2023-06-01,136152,1,0,1,1,0,1
2023-06-01,136135,1,0,1,1,0,1
2023-06-01,142044,1,0,1,2,0,2
2023-06-01,132485,2,0,2,2,0,2
2023-06-01,136060,7,0,7,2,0,2
2023-06-01,136134,6,0,6,4,0,4
2023-06-01,138797,6,1,7,2,1,2
2023-06-01,136138,3,0,3,3,0,3
2023-06-01,134277,5,0,5,3,0,3
2023-06-01,136140,5,0,5,2,0,2
2023-06-01,150383,1,0,1,1,0,1
2023-06-01,150632,2,1,3,2,1,3
2023-06-01,135851,12,1,13,7,2,7
2023-06-01,63722,1,0,1,1,0,1
2023-06-01,132407,1,0,1,1,0,1
2023-06-01,136118,1,0,1,1,0,1
2023-06-01,136372,4,0,4,2,0,2
2023-06-01,59126,5,1,6,5,4,7
2023-06-01,139541,3,0,3,2,0,2
2023-06-01,135848,4,1,5,5,1,5
2023-06-01,150613,1,0,1,2,0,2
2023-06-01,136149,1,0,1,1,0,1
2023-06-01,135849,3,0,3,1,0,1
2023-06-01,59150,2,0,2,2,0,2
2023-06-01,136151,2,0,2,2,0,2
2023-06-01,133268,4,0,4,1,0,1
2023-06-01,133270,4,0,4,3,0,3
2023-06-01,136241,1,0,1,3,0,3
2023-06-01,136071,1,0,1,1,0,1
2023-06-01,136153,2,0,2,2,0,2
2023-06-01,135845,4,1,5,4,1,4
2023-06-01,142038,2,0,2,2,0,2
2023-06-01,59272,4,0,4,3,0,3
2023-06-01,150553,2,0,2,1,0,1
2023-06-01,136156,6,0,6,4,0,4
2023-06-01,149117,2,1,3,1,1,1
2023-06-01,150100,7,0,7,1,0,1
2023-06-01,150584,6,0,6,1,0,1
2023-06-01,135798,2,0,2,2,0,2
2023-06-01,18274,8,0,8,4,0,4
2023-06-01,136516,6,15,21,3,1,3
2023-06-01,135782,4,2,6,2,1,2
2023-06-01,135778,4,0,4,1,0,1
2023-06-01,134996,3,0,3,1,0,1
2023-06-01,136161,3,0,3,4,0,4
2023-06-01,47582,3,0,3,1,0,1
2023-06-01,56057,6,0,6,1,0,1
2023-06-01,133645,1,0,1,2,0,2
2023-06-01,136058,1,0,1,1,0,1
2023-06-01,136059,3,0,3,1,0,1
2023-06-01,136164,3,0,3,3,0,3
2023-06-01,136166,4,3,7,4,2,4
2023-06-01,136061,3,0,3,3,0,3
2023-06-01,134946,3,0,3,1,0,1
2023-06-01,135908,4,1,5,1,1,1
2023-06-01,137498,7,17,24,3,3,3
2023-06-01,150747,2,0,2,1,0,1
2023-06-01,135964,4,0,4,4,0,4
2023-06-01,135780,9,7,16,4,3,4
2023-06-01,135010,1,0,1,1,0,1
2023-06-01,136062,1,0,1,1,0,1
2023-06-01,142370,3,1,4,3,2,3
2023-06-01,150252,1,0,1,1,0,1
2023-06-01,136172,1,0,1,3,0,3
2023-06-01,147240,6,1,7,2,1,2
2023-06-01,136698,4,0,4,3,0,3
2023-06-01,135181,2,1,3,1,1,1
2023-06-01,133792,1,0,1,1,0,1
2023-06-01,138963,1,0,1,1,0,1
2023-06-01,136400,3,0,3,8,0,8
2023-06-01,133457,4,0,4,1,0,1
2023-06-01,134944,1,4,5,3,2,3
2023-06-01,150633,1,0,1,1,0,1
2023-06-01,142127,24,0,24,3,0,3
2023-06-01,136239,4,0,4,1,0,1
2023-06-01,136177,3,0,3,3,0,3
2023-06-01,136171,3,1,4,1,1,1
2023-06-01,136206,2,0,2,1,0,1
2023-06-01,136179,1,1,2,2,1,2
2023-06-01,135823,5,0,5,1,0,1
2023-06-01,133231,6,0,6,2,0,2
2023-06-01,135826,4,2,6,3,1,3
2023-06-01,135822,9,0,9,4,0,4
2023-06-01,140976,2,0,2,2,0,2
2023-06-01,150253,1,0,1,2,0,2
2023-06-01,139623,1,0,1,9,0,9
2023-06-01,136183,2,0,2,1,0,1
2023-06-01,136184,5,0,5,2,0,2
2023-06-01,136078,3,0,3,1,0,1
2023-06-01,136063,2,0,2,1,0,1
2023-06-01,136201,4,0,4,1,0,1
2023-06-01,136202,2,0,2,5,0,5
2023-06-01,134290,8,1,9,4,1,4
2023-06-01,134045,2,0,2,1,0,1
2023-06-01,136064,2,0,2,1,0,1
2023-06-01,136189,3,1,4,3,2,3
2023-06-01,137071,2,0,2,2,0,2
2023-06-01,136203,1,0,1,1,0,1
2023-06-01,135275,2,0,2,3,0,3
2023-06-01,136724,2,1,3,1,1,1
2023-06-01,135839,5,2,7,1,1,1
2023-06-01,137154,5,0,5,4,0,4
2023-06-01,17831,10,2,12,3,3,3
2023-06-01,136261,1,0,1,1,0,1
2023-06-01,135835,1,0,1,1,0,1
2023-06-01,131241,3,1,4,2,1,2
2023-06-01,136207,5,0,5,2,0,2
2023-06-01,136067,3,0,3,2,0,2
2023-06-01,136065,2,0,2,5,0,5
2023-06-01,136205,0,0,0,5,2,5
2023-06-01,136210,6,13,19,1,1,1
2023-06-01,271917,4,0,4,1,0,1
2023-06-01,136211,1,0,1,1,0,1
2023-06-01,139955,4,1,5,7,2,7
2023-06-01,136091,1,0,1,1,0,1
2023-06-01,136214,14,0,14,1,0,1
2023-06-01,38859,3,0,3,3,0,3
2023-06-01,135828,1,0,1,3,0,3
2023-06-01,135833,1,0,1,3,0,3
2023-06-01,135785,1,0,1,1,0,1
2023-06-01,136219,1,0,1,3,0,3
2023-06-01,55920,4,0,4,2,0,2
2023-06-01,136223,1,0,1,2,0,2
2023-06-01,150749,1,0,1,1,0,1
2023-06-01,136217,3,6,9,2,1,2
2023-06-01,58971,10,2,12,4,3,4
2023-06-01,135183,14,1,15,3,2,3
2023-06-01,136870,3,0,3,2,0,2
2023-06-01,136224,28,9,37,4,1,4
2023-06-01,136218,5,0,5,1,0,1
2023-06-01,141421,1,0,1,3,0,3
2023-06-01,141393,1,0,1,1,0,1
2023-06-01,150774,5,0,5,2,0,2
2023-06-01,137593,2,0,2,1,0,1
2023-06-01,24086,281,0,281,3,0,3
2023-06-01,136230,3,0,3,3,0,3
2023-06-01,135376,9,0,9,2,0,2
2023-06-01,147256,4,1,5,2,1,2
2023-06-01,136070,1,1,2,2,3,3
2023-06-01,134635,2,0,2,2,0,2
2023-06-01,64316,1,0,1,1,0,1
2023-06-01,136234,2,0,2,3,0,3
2023-06-01,136240,1,0,1,1,0,1
2023-06-01,136237,4,1,5,5,1,5
2023-06-01,137995,11,2,13,6,3,7
2023-06-01,133168,4,1,5,1,1,1
2023-06-01,150776,1,0,1,1,0,1
2023-06-01,136279,2,0,2,3,0,3
2023-06-01,136245,1,0,1,3,0,3
2023-06-01,135786,2,0,2,1,0,1
2023-06-01,140433,1,0,1,3,0,3
2023-06-01,136095,2,0,2,3,0,3
2023-06-01,150775,1,0,1,1,0,1
2023-06-01,58487,32,2,34,4,2,4
2023-06-01,136075,4,0,4,2,0,2
2023-06-01,136317,1,0,1,2,0,2
2023-06-01,134945,4,0,4,3,0,3
2023-06-01,135783,3,0,3,1,0,1
2023-06-01,136084,1,0,1,1,0,1
2023-06-01,135831,1,1,2,1,1,1
2023-06-01,135832,1,0,1,2,0,2
2023-06-01,136248,6,1,7,3,1,3
2023-06-01,136074,3,0,3,2,0,2
2023-06-01,136076,4,0,4,1,0,1
2023-06-01,133192,12,0,12,1,0,1
2023-06-01,136252,7,0,7,3,0,3
2023-06-01,150550,1,0,1,1,0,1
2023-06-01,150556,3,0,3,1,0,1
2023-06-01,135787,2,0,2,1,0,1
2023-06-01,136283,2,0,2,4,0,4
2023-06-01,142520,4,6,10,3,2,3
2023-06-01,132964,7,1,8,3,1,3
2023-06-01,136077,1,0,1,3,0,3
2023-06-01,137681,8,1,9,5,1,5
2023-06-01,135788,2,0,2,2,0,2
2023-06-01,137098,13,1,14,3,1,3
2023-06-01,136257,4,0,4,3,0,3
2023-06-01,137138,2,0,2,1,0,1
2023-06-01,136286,6,1,7,2,1,2
2023-06-01,150562,1,0,1,1,0,1
2023-06-01,136260,1,0,1,1,0,1
2023-06-01,136642,5,0,5,4,0,4
2023-06-01,136259,2,0,2,1,0,1
2023-06-01,136313,2,0,2,2,0,2
2023-06-01,136269,1,0,1,1,0,1
2023-06-01,136262,7,2,9,2,1,2
2023-06-01,150593,2,0,2,2,0,2
2023-06-01,134952,1,0,1,1,0,1
2023-06-01,137531,1,1,2,1,1,1
2023-06-01,136266,5,1,6,4,1,4
2023-06-01,136267,4,0,4,4,0,4
2023-06-01,136311,4,1,5,1,1,1
2023-06-01,136277,2,0,2,1,0,1
2023-06-01,136268,3,0,3,1,0,1
2023-06-01,150635,2,0,2,3,0,3
2023-06-01,149078,4,0,4,1,0,1
2023-06-01,136371,4,0,4,1,0,1
2023-06-01,136312,5,2,7,3,2,3
2023-06-01,134612,5,0,5,5,0,5
2023-06-01,136291,3,0,3,1,0,1
2023-06-01,136380,3,1,4,2,1,2
2023-06-01,395776,148,0,148,2,0,2
2023-06-01,150630,1,1,2,1,1,1
2023-06-01,140072,12,2,14,1,1,1
2023-06-01,141174,4,3,7,5,1,5
2023-06-01,139820,1,0,1,1,0,1
2023-06-01,136388,1,0,1,1,0,1
2023-06-01,135105,1,0,1,2,0,2
2023-06-01,136677,3,0,3,1,0,1
2023-06-01,38150,16,3,19,10,1,10
2023-06-01,136079,3,0,3,2,0,2
2023-06-01,136398,2,0,2,1,0,1
2023-06-01,136081,2,0,2,3,0,3
2023-06-01,137087,6,1,7,2,1,2
2023-06-01,136395,10,17,27,3,3,3
2023-06-01,150552,3,0,3,1,0,1
2023-06-01,133169,3,0,3,2,0,2
2023-06-01,45410,13,1,14,10,7,10
2023-06-01,135003,8,0,8,5,0,5
2023-06-01,135634,1,0,1,1,0,1
2023-06-01,136083,2,0,2,1,0,1
2023-06-01,136082,1,0,1,1,0,1
2023-06-01,135222,4,0,4,1,0,1
2023-06-01,136412,4,0,4,1,0,1
2023-06-01,136284,16,1,17,15,1,15
2023-06-01,136404,5,0,5,2,0,2
2023-06-01,135107,4,0,4,2,0,2
2023-06-01,136414,1,0,1,1,0,1
2023-06-01,136406,4,2,6,3,1,3
2023-06-01,18109,8,0,8,1,0,1
2023-06-01,136416,4,1,5,1,2,2
2023-06-01,136085,4,0,4,3,0,3
2023-06-01,136287,8,1,9,2,1,2
2023-06-01,136288,5,0,5,1,0,1
2023-06-01,136419,4,0,4,2,0,2
2023-06-01,17436,11,3,14,3,2,3
2023-06-01,138298,10,2,12,1,1,1
2023-06-01,138299,1,1,2,2,2,2
2023-06-01,136092,4,0,4,3,0,3
2023-06-01,150249,1,1,2,1,1,1
2023-06-01,142541,4,0,4,3,0,3
2023-06-01,136339,6,0,6,2,0,2
2023-06-01,136370,8,0,8,2,0,2
2023-06-01,136424,1,0,1,1,0,1
2023-06-01,141314,5,0,5,2,0,2
2023-06-01,59340,15,1,16,2,1,2
2023-06-01,136425,5,0,5,3,0,3
2023-06-01,38765,6,0,6,3,0,3
2023-06-01,136427,1,0,1,1,0,1
2023-06-01,136539,1,0,1,3,0,3
2023-06-01,23820,15,6,21,6,4,6
2023-06-01,131914,8,0,8,1,0,1
2023-06-01,136087,2,0,2,3,0,3
2023-06-01,150259,1,0,1,1,0,1
2023-06-01,136430,1,0,1,1,0,1
2023-06-01,136292,4,0,4,1,0,1
2023-06-01,136431,1,0,1,2,0,2
2023-06-01,136429,8,2,10,4,2,4
2023-06-01,133501,4,0,4,2,0,2
2023-06-01,134826,1,0,1,1,0,1
2023-06-01,133189,2,1,3,2,1,2
2023-06-01,136088,4,0,4,2,0,2
2023-06-01,135581,16,0,16,1,0,1
2023-06-01,136434,6,0,6,3,0,3
2023-06-01,136435,8,0,8,4,0,4
2023-06-01,18172,1,0,1,1,0,1
2023-06-01,136338,4,0,4,1,0,1
2023-06-01,136438,2,0,2,2,0,2
2023-06-01,136440,1,1,2,1,1,1
2023-06-01,136442,14,0,14,7,0,7
2023-06-01,134917,4,0,4,1,0,1
2023-06-01,131497,3,0,3,1,0,1
2023-06-01,132505,4,0,4,1,0,1
2023-06-01,136336,9,1,10,4,1,4
2023-06-01,136616,1,0,1,1,0,1
2023-06-01,136676,4,0,4,1,0,1
2023-06-01,138280,4,0,4,2,0,2
2023-06-01,149018,2,0,2,2,0,2
2023-06-01,150222,3,0,3,2,0,2
2023-06-01,137185,6,0,6,1,0,1
2023-06-01,133988,2,0,2,1,0,1
2023-06-01,135913,5,0,5,2,0,2
2023-06-01,135909,7,0,7,2,0,2
2023-06-01,136335,4,0,4,3,0,3
2023-06-01,134942,4,3,7,2,2,2
2023-06-01,38562,9,6,15,6,1,7
2023-06-01,136447,1,0,1,2,0,2
2023-06-01,24565,4,1,5,4,1,4
2023-06-01,136450,4,2,6,1,1,1
2023-06-01,136499,2,0,2,5,0,5
2023-06-01,136449,4,0,4,3,0,3
2023-06-01,136093,20,1,21,8,1,8
2023-06-01,136271,6,0,6,2,0,2
2023-06-01,136470,1,0,1,1,0,1
2023-06-01,136456,1,0,1,1,0,1
2023-06-01,136454,5,0,5,1,0,1
2023-06-01,136298,2,0,2,1,0,1
2023-06-01,136090,1,0,1,1,0,1
2023-06-01,139490,14,17,31,5,3,5
2023-06-01,55665,1,0,1,1,0,1
2023-06-01,141816,4,0,4,3,0,3
2023-06-01,136463,4,1,5,2,1,2
2023-06-01,136757,2,0,2,1,0,1
2023-06-01,150044,3,0,3,1,0,1
2023-06-01,136465,2,0,2,1,0,1
2023-06-01,140123,2,0,2,1,0,1
2023-06-01,136332,6,0,6,2,0,2
2023-06-01,58972,11,8,19,2,1,2
2023-06-01,136368,3,1,4,2,1,2
2023-06-01,1007,0,0,0,2,0,2
2023-06-01,136471,2,0,2,5,0,5
2023-06-01,56201,13,1,14,5,3,5
2023-06-01,135911,5,0,5,2,0,2
2023-06-01,136094,4,0,4,3,0,3
2023-06-01,136475,1,1,2,2,1,2
2023-06-01,43181,22,0,22,2,0,2
2023-06-01,61327,7,3,10,5,4,5
2023-06-01,136479,4,0,4,3,0,3
2023-06-01,136096,1,0,1,3,0,3
2023-06-01,136477,5,11,16,1,1,1
2023-06-01,136100,5,0,5,1,0,1
2023-06-01,136115,1,0,1,1,0,1
2023-06-01,136481,8,0,8,3,0,3
2023-06-01,63590,13,0,13,2,0,2
2023-06-01,56099,17,0,17,8,0,8
2023-06-01,147314,5,1,6,3,1,3
2023-06-01,150913,2,0,2,2,0,2
2023-06-01,136099,1,1,2,1,1,1
2023-06-01,136098,1,0,1,1,0,1
2023-06-01,134999,2,0,2,3,0,3
2023-06-01,133005,3,1,4,1,1,2
2023-06-01,18359,1,0,1,3,0,3
2023-06-01,150137,2,2,4,1,1,1
2023-06-01,59129,2,0,2,1,0,1
2023-06-01,63497,10,0,10,2,0,2
2023-06-01,136365,6,0,6,1,0,1
2023-06-01,136297,4,0,4,4,0,4
2023-06-01,136487,3,0,3,1,0,1
2023-06-01,136490,1,0,1,1,0,1
2023-06-01,135425,16,4,20,4,2,4
2023-06-01,150928,2,0,2,1,0,1
2023-06-01,136101,3,0,3,2,0,2
2023-06-01,4822,5,0,5,1,0,1
2023-06-01,150265,3,0,3,2,0,2
2023-06-01,136304,1,0,1,3,0,3
2023-06-01,136497,4,0,4,3,0,3
2023-06-01,136530,7,7,14,1,1,1
2023-06-01,136364,5,0,5,2,0,2
2023-06-01,131915,5,0,5,4,0,4
2023-06-01,38238,1,1,2,3,3,3
2023-06-01,136500,2,0,2,1,0,1
2023-06-01,136362,6,1,7,2,1,2
2023-06-01,134429,3,0,3,1,0,1
2023-06-01,135248,6,1,7,4,1,4
2023-06-01,136300,2,0,2,2,0,2
2023-06-01,136503,1,0,1,1,0,1
2023-06-01,151148,3,0,3,1,0,1
2023-06-01,55599,3,0,3,2,0,2
2023-06-01,136103,4,0,4,3,0,3
2023-06-01,133271,4,2,6,1,1,1
2023-06-01,9288,8,0,8,3,0,3
2023-06-01,135912,2,1,3,2,1,2
2023-06-01,135917,1,0,1,1,0,1
2023-06-01,142453,6,5,11,4,3,4
2023-06-01,136505,1,0,1,1,0,1
2023-06-01,23572,2,0,2,2,0,2
2023-06-01,138086,2,0,2,2,0,2
2023-06-01,131916,11,1,12,2,2,2
2023-06-01,134911,3,1,4,2,1,2
2023-06-01,142379,2,1,3,1,1,1
2023-06-01,136105,5,0,5,1,0,1
2023-06-01,136680,2,0,2,2,0,2
2023-06-01,65528,1,0,1,1,0,1
2023-06-01,133945,3,0,3,1,0,1
2023-06-01,136935,1,0,1,1,0,1
2023-06-01,50193,0,0,0,2,0,2
2023-06-01,150074,2,0,2,1,0,1
2023-06-01,136356,2,1,3,2,1,3
2023-06-01,136294,3,0,3,2,0,2
2023-06-01,136318,4,1,5,2,1,2
2023-06-01,136104,1,0,1,2,0,2
2023-06-01,136361,1,0,1,2,0,2
2023-06-01,136360,3,0,3,1,0,1
2023-06-01,136512,2,0,2,3,0,3
2023-06-01,136587,4,0,4,1,0,1
2023-06-01,38000,6,0,6,5,0,5
2023-06-01,136299,1,0,1,1,0,1
2023-06-01,134311,1,0,1,2,0,2
2023-06-01,150266,1,0,1,2,0,2
2023-06-01,150919,1,0,1,2,0,2
2023-06-01,136319,3,1,4,2,1,2
2023-06-01,150823,1,0,1,1,0,1
2023-06-01,136521,2,0,2,1,0,1
2023-06-01,136522,3,0,3,2,0,2
2023-06-01,150734,1,0,1,4,0,4
2023-06-01,136520,2,0,2,1,0,1
2023-06-01,136524,1,0,1,3,0,3
2023-06-01,135290,2,1,3,3,1,3
2023-06-01,146996,2,0,2,1,0,1
2023-06-01,976,6,3,9,2,2,3
2023-06-01,136303,2,0,2,1,0,1
2023-06-01,150570,1,0,1,3,0,3
2023-06-01,150592,2,0,2,1,0,1
2023-06-01,136531,4,11,15,3,2,3
2023-06-01,136534,7,1,8,3,1,3
2023-06-01,136533,3,3,6,5,3,5
2023-06-01,140939,2,0,2,2,0,2
2023-06-01,132582,1,0,1,1,0,1
2023-06-01,136536,1,0,1,2,0,2
2023-06-01,136700,4,16,20,4,3,4
2023-06-01,136326,2,0,2,1,0,1
2023-06-01,138212,5,0,5,3,0,3
2023-06-01,135038,2,0,2,1,0,1
2023-06-01,136913,1,0,1,1,0,1
2023-06-01,136537,1,0,1,3,0,3
2023-06-01,136109,1,0,1,1,0,1
2023-06-01,136551,1,0,1,1,0,1
2023-06-01,150022,3,1,4,3,1,3
2023-06-01,136305,3,0,3,1,0,1
2023-06-01,135266,7,0,7,2,0,2
2023-06-01,134829,5,0,5,2,0,2
2023-06-01,136552,8,3,11,3,2,3
2023-06-01,136556,3,0,3,1,0,1
2023-06-01,136306,5,2,7,5,3,5
2023-06-01,136679,1,0,1,2,0,2
2023-06-01,136553,1,0,1,1,0,1
2023-06-01,136344,1,0,1,1,0,1
2023-06-01,136573,4,0,4,2,0,2
2023-06-01,136558,4,0,4,1,0,1
2023-06-01,136110,1,0,1,1,0,1
2023-06-01,136562,7,0,7,1,0,1
2023-06-01,136550,4,0,4,2,0,2
2023-06-01,136823,5,0,5,2,0,2
2023-06-01,18278,10,1,11,6,4,7
2023-06-01,136112,1,1,2,1,1,1
2023-06-01,136563,6,0,6,3,0,3
2023-06-01,136343,3,0,3,1,0,1
2023-06-01,150420,1,0,1,1,0,1
2023-06-01,138225,13,4,17,3,2,3
2023-06-01,150780,3,0,3,2,0,2
2023-06-01,59339,3,0,3,2,0,2
2023-06-01,150421,1,0,1,2,0,2
2023-06-01,134785,3,0,3,1,0,1
2023-06-01,136323,6,1,7,1,1,1
2023-06-01,136324,4,3,7,3,3,3
2023-06-01,136575,1,0,1,2,0,2
2023-06-01,136322,4,0,4,2,0,2
2023-06-01,131918,10,1,11,2,2,2
2023-06-01,136577,5,0,5,1,0,1
2023-06-01,136584,2,0,2,1,0,1
2023-06-01,59204,2,3,5,4,1,4
2023-06-01,136598,4,0,4,1,0,1
2023-06-01,141140,2,0,2,2,0,2
2023-06-01,135837,4,0,4,1,0,1
2023-06-01,136585,3,0,3,1,0,1
2023-06-01,134318,5,0,5,4,0,4
2023-06-01,136325,2,0,2,3,0,3
2023-06-01,136592,1,0,1,1,0,1
2023-06-01,150461,1,0,1,1,0,1
2023-06-01,138572,3,0,3,4,0,4
2023-06-01,135341,7,3,10,10,3,10
2023-06-01,150778,1,0,1,1,0,1
2023-06-01,136595,1,0,1,1,0,1
2023-06-01,135060,27,1,28,11,2,11
2023-06-01,149847,1,0,1,1,0,1
2023-06-01,136116,2,0,2,2,0,2
2023-06-01,136599,1,0,1,1,0,1
2023-06-01,137598,7,0,7,1,0,1
2023-06-01,136355,4,0,4,2,0,2
2023-06-01,136357,4,0,4,1,0,1
2023-06-01,136602,2,0,2,2,0,2
2023-06-01,136353,1,0,1,1,0,1
2023-06-01,137575,5,0,5,7,0,7
2023-06-01,138512,1,0,1,1,0,1
2023-06-01,137576,3,1,4,5,2,5
2023-06-01,133429,1,1,2,1,1,1
2023-06-01,136608,2,0,2,3,0,3
2023-06-01,136609,1,0,1,1,0,1
2023-06-01,136117,3,0,3,2,0,2
2023-06-01,59317,4,0,4,3,0,3
2023-06-01,38500,16,9,25,6,2,6
2023-06-01,45722,7,0,7,5,0,5
2023-06-01,141626,2,19,21,12,5,12
2023-06-01,131578,1,1,2,2,1,3
2023-06-01,135916,8,0,8,1,0,1
2023-06-01,131577,2,0,2,1,0,1
2023-06-01,136375,2,1,3,1,1,1
2023-06-01,136613,2,0,2,2,0,2
2023-06-01,149534,1,0,1,1,0,1
2023-06-01,24033,16,0,16,7,0,7
2023-06-01,134013,4,0,4,2,0,2
2023-06-01,136617,5,0,5,2,0,2
2023-06-01,138277,24,11,35,3,1,3
2023-06-01,132723,1,0,1,1,0,1
2023-06-01,150016,3,0,3,1,0,1
2023-06-01,133450,2,0,2,1,0,1
2023-06-01,136128,3,0,3,1,0,1
2023-06-01,136618,2,0,2,1,0,1
2023-06-01,150627,2,0,2,1,0,1
2023-06-01,133440,7,0,7,3,0,3
2023-06-01,136623,1,0,1,1,0,1
2023-06-01,136621,1,1,2,1,1,2
2023-06-01,135337,5,0,5,3,0,3
2023-06-01,136120,1,0,1,2,0,2
2023-06-01,132691,1,0,1,3,0,3
2023-06-01,16392,2,0,2,5,0,5
2023-06-01,136622,2,0,2,1,0,1
2023-06-01,133291,2,0,2,2,0,2
2023-06-01,136726,1,1,2,2,1,2
2023-06-01,136730,1,0,1,1,0,1
2023-06-01,38331,2,1,3,2,1,2
2023-06-01,131519,1,0,1,1,0,1
2023-06-01,136204,0,0,0,6,6,7
2023-06-01,55736,11,2,13,3,3,3
2023-06-01,136735,4,1,5,1,1,1
2023-06-01,136731,1,0,1,1,0,1
2023-06-01,136111,4,0,4,3,0,3
2023-06-01,199707,1,2,3,1,2,2
2023-06-01,136738,2,0,2,3,0,3
2023-06-01,63878,11,1,12,4,1,4
2023-06-01,136741,1,0,1,5,0,5
2023-06-01,150153,3,0,3,3,0,3
2023-06-01,135488,2,0,2,1,0,1
2023-06-01,136711,3,0,3,2,0,2
2023-06-01,141073,4,0,4,4,0,4
2023-06-01,136748,5,0,5,3,0,3
2023-06-01,138934,5,1,6,4,1,4
2023-06-01,136749,7,0,7,7,0,7
2023-06-01,136751,1,0,1,2,0,2
2023-06-01,133477,4,0,4,3,0,3
2023-06-01,136125,2,0,2,3,0,3
2023-06-01,137191,2,0,2,1,0,1
2023-06-01,136761,2,0,2,1,0,1
2023-06-01,136760,1,0,1,1,0,1
2023-06-01,134349,1,0,1,3,0,3
2023-06-01,17985,1,0,1,1,0,1
2023-06-01,136759,7,1,8,3,1,3
2023-06-01,136662,1,0,1,1,0,1
2023-06-01,138136,2,0,2,5,0,5
2023-06-01,131923,10,1,11,3,2,3
2023-06-01,150152,2,0,2,4,0,4
2023-06-01,138909,2,0,2,3,0,3
2023-06-01,136580,1,0,1,1,0,1
2023-06-01,136765,4,0,4,2,0,2
2023-06-01,136764,1,0,1,1,0,1
2023-06-01,136803,5,0,5,3,0,3
2023-06-01,142129,1,0,1,2,0,2
2023-06-01,136126,3,0,3,1,0,1
2023-06-01,136123,2,0,2,2,0,2
2023-06-01,135919,5,0,5,3,0,3
2023-06-01,133679,1,0,1,1,0,1
2023-06-01,63770,10,4,14,3,2,3
2023-06-01,136666,1,0,1,1,0,1
2023-06-01,136772,2,1,3,3,1,3
2023-06-01,135590,4,0,4,1,0,1
2023-06-01,136773,3,1,4,2,1,2
2023-06-01,136781,1,1,2,1,1,1
2023-06-01,136777,2,0,2,4,0,4
2023-06-01,136782,1,0,1,1,0,1
2023-06-01,131567,1,0,1,2,0,2
2023-06-01,136654,4,1,5,4,2,4
2023-06-01,136788,3,0,3,2,0,2
2023-06-01,147182,1,0,1,3,0,3
2023-06-01,38029,8,0,8,4,0,4
2023-06-01,136794,2,0,2,1,0,1
2023-06-01,135744,10,0,10,1,0,1
2023-06-01,136793,6,1,7,1,1,1
2023-06-01,63771,14,8,22,2,3,3
2023-06-01,133468,1,0,1,1,0,1
2023-06-01,17981,8,0,8,6,0,6
2023-06-01,132238,4,0,4,1,0,1
2023-06-01,150427,1,0,1,1,0,1
2023-06-01,136685,3,0,3,4,0,4
2023-06-01,136684,2,0,2,1,0,1
2023-06-01,134153,7,0,7,6,0,6
2023-06-01,136797,2,1,3,5,2,5
2023-06-01,136798,4,0,4,1,0,1
2023-06-01,18117,13,0,13,8,0,8
2023-06-01,136804,1,0,1,1,0,1
2023-06-01,133299,3,0,3,5,0,5
2023-06-01,136802,1,0,1,1,0,1
2023-06-01,136805,3,1,4,5,3,5
2023-06-01,150914,1,0,1,2,0,2
2023-06-01,138645,11,0,11,2,0,2
2023-06-01,136683,1,0,1,2,0,2
2023-06-01,63773,2,2,4,1,1,1
2023-06-01,138494,4,1,5,3,1,3
2023-06-01,136648,2,0,2,2,0,2
2023-06-01,135277,5,1,6,3,1,3
2023-06-01,37916,3,0,3,1,0,1
2023-06-01,136127,4,1,5,2,2,2
2023-06-01,136808,3,0,3,3,0,3
2023-06-01,135850,2,0,2,2,0,2
2023-06-01,137994,2,0,2,3,0,3
2023-06-01,136657,4,0,4,1,0,1
2023-06-01,136833,1,0,1,3,0,3
2023-06-01,136829,1,0,1,1,0,1
2023-06-01,133343,2,0,2,3,0,3
2023-06-01,136656,1,0,1,2,0,2
2023-06-01,58820,10,5,15,8,1,8
2023-06-01,136813,5,0,5,4,0,4
2023-06-01,56153,3,0,3,1,0,1
2023-06-01,136845,3,0,3,1,0,1
2023-06-01,133408,3,1,4,1,2,2
2023-06-01,135555,2,1,3,1,1,1
2023-06-01,136815,3,3,6,2,2,2
2023-06-01,136818,1,0,1,1,0,1
2023-06-01,136819,1,0,1,3,0,3
2023-06-01,140163,3,0,3,1,0,1
2023-06-01,136831,1,0,1,1,0,1
2023-06-01,132869,4,0,4,1,0,1
2023-06-01,136646,4,0,4,1,0,1
2023-06-01,136890,1,0,1,2,0,2
2023-06-01,133196,1,0,1,1,0,1
2023-06-01,134093,1,0,1,1,0,1
2023-06-01,150923,1,0,1,1,0,1
2023-06-01,141846,4,1,5,2,1,2
2023-06-01,147212,2,0,2,1,0,1
2023-06-01,136894,1,0,1,1,0,1
2023-06-01,146792,1,0,1,1,0,1
2023-06-01,150603,2,0,2,1,0,1
2023-06-01,136645,4,0,4,1,0,1
2023-06-01,136130,1,0,1,2,0,2
2023-06-01,136129,1,0,1,1,0,1
2023-06-01,136688,7,0,7,3,0,3
2023-06-01,136702,1,0,1,2,0,2
2023-06-01,136901,2,0,2,3,0,3
2023-06-01,136902,11,0,11,3,0,3
2023-06-01,132836,1,0,1,1,0,1
2023-06-01,136903,2,0,2,1,0,1
2023-06-01,136820,1,0,1,1,0,1
2023-06-01,136828,1,0,1,2,0,2
2023-06-01,136822,1,0,1,2,0,2
2023-06-01,38055,2,0,2,1,0,1
2023-06-01,133728,1,0,1,1,0,1
2023-06-01,136911,1,0,1,3,0,3
2023-06-01,131374,2,0,2,1,0,1
2023-06-01,136625,1,0,1,1,0,1
2023-06-01,135922,5,0,5,1,0,1
2023-06-01,136827,1,0,1,1,0,1
2023-06-01,135714,3,0,3,4,0,4
2023-06-01,137587,2,0,2,1,0,1
2023-06-01,150595,1,0,1,1,0,1
2023-06-01,136909,7,0,7,2,0,2
2023-06-01,136910,4,0,4,2,0,2
2023-06-01,135227,4,0,4,1,0,1
2023-06-01,136912,1,0,1,1,0,1
2023-06-01,136397,3,1,4,1,1,1
2023-06-01,136839,1,0,1,1,0,1
2023-06-01,136377,8,0,8,6,0,6
2023-06-01,136376,4,0,4,1,0,1
2023-06-01,150466,1,0,1,2,0,2
2023-06-01,150495,2,0,2,1,0,1
2023-06-01,136920,2,0,2,1,0,1
2023-06-01,150279,1,1,2,4,1,4
2023-06-01,136919,2,0,2,2,0,2
2023-06-01,140127,2,0,2,3,0,3
2023-06-01,136626,1,0,1,1,0,1
2023-06-01,150723,1,1,2,2,2,2
2023-06-01,136354,6,2,8,2,1,2
2023-06-01,138538,14,2,16,3,1,3
2023-06-01,136926,1,0,1,1,0,1
2023-06-01,136921,1,0,1,1,0,1
2023-06-01,136924,1,0,1,1,0,1
2023-06-01,137083,11,16,27,8,4,8
2023-06-01,140148,2,1,3,2,1,2
2023-06-01,150086,2,0,2,1,0,1
2023-06-01,63772,4,0,4,4,0,4
2023-06-01,136830,2,0,2,3,0,3
2023-06-01,136932,2,0,2,2,0,2
2023-06-01,137272,7,0,7,2,0,2
2023-06-01,136934,1,0,1,2,0,2
2023-06-01,133044,2,1,3,1,1,2
2023-06-01,136690,1,0,1,2,0,2
2023-06-01,136936,1,0,1,2,0,2
2023-06-01,136937,2,0,2,1,0,1
2023-06-01,150315,4,1,5,3,1,3
2023-06-01,135139,53,0,53,5,0,5
2023-06-01,136692,4,0,4,2,0,2
2023-06-01,40300,11,5,16,7,2,7
2023-06-01,136940,2,0,2,1,0,1
2023-06-01,136941,4,23,27,3,2,3
2023-06-01,136649,1,1,2,2,1,2
2023-06-01,150438,1,0,1,1,0,1
2023-06-01,136706,4,0,4,2,0,2
2023-06-01,136667,1,1,2,2,1,2
2023-06-01,150596,2,0,2,2,2,2
2023-06-01,136629,6,1,7,2,1,2
2023-06-01,136857,2,0,2,1,0,1
2023-06-01,136837,2,0,2,2,0,2
2023-06-01,136694,1,0,1,1,0,1
2023-06-01,135923,5,0,5,1,0,1
2023-06-01,131127,14,0,14,7,0,7
2023-06-01,136948,4,6,10,3,1,3
2023-06-01,135924,1,0,1,3,0,3
2023-06-01,136630,2,0,2,3,0,3
2023-06-01,136954,1,0,1,1,0,1
2023-06-01,136951,2,0,2,2,0,2
2023-06-01,136953,1,0,1,2,0,2
2023-06-01,136835,2,2,4,2,2,2
2023-06-01,136957,3,1,4,1,1,1
2023-06-01,34806,1,0,1,1,0,1
2023-06-01,137819,3,0,3,2,0,2
2023-06-01,136651,4,0,4,1,0,1
2023-06-01,136834,1,0,1,3,0,3
2023-06-01,136960,2,0,2,1,0,1
2023-06-01,23729,11,0,11,2,0,2
2023-06-01,135393,3,0,3,1,0,1
2023-06-01,137014,1,0,1,2,0,2
2023-06-01,132371,1,0,1,2,0,2
2023-06-01,140867,8,2,10,2,1,2
2023-06-01,134901,1,0,1,1,0,1
2023-06-01,136962,3,0,3,2,0,2
2023-06-01,135925,5,0,5,2,0,2
2023-06-01,136647,1,0,1,1,0,1
2023-06-01,136841,10,1,11,7,2,7
2023-06-01,136840,5,0,5,2,0,2
2023-06-01,136965,1,1,2,1,1,1
2023-06-01,17911,63,1,64,5,1,5
2023-06-01,149261,2,0,2,3,0,3
2023-06-01,140399,4,2,6,4,1,4
2023-06-01,7717,0,0,0,13,0,13
2023-06-01,136844,1,0,1,1,0,1
2023-06-01,136966,1,1,2,1,1,1
2023-06-01,136983,1,0,1,1,0,1
2023-06-01,136715,1,1,2,1,1,1
2023-06-01,136974,2,0,2,2,0,2
2023-06-01,137050,4,1,5,3,2,3
2023-06-01,136664,4,0,4,1,0,1
2023-06-01,136972,6,1,7,5,2,5
2023-06-01,135926,5,0,5,2,0,2
2023-06-01,139013,3,1,4,1,1,1
2023-06-01,134806,19,4,23,2,2,2
2023-06-01,137077,1,0,1,1,0,1
2023-06-01,133670,1,1,2,1,1,1
2023-06-01,136842,2,2,4,2,3,3
2023-06-01,136632,1,1,2,1,1,1
2023-06-01,135927,1,0,1,2,0,2
2023-06-01,136979,3,0,3,2,0,2
2023-06-01,136980,1,0,1,1,0,1
2023-06-01,136982,1,0,1,1,0,1
2023-06-01,136843,1,0,1,3,0,3
2023-06-01,147259,4,0,4,3,0,3
2023-06-01,134182,1,0,1,1,0,1
2023-06-01,136358,4,0,4,2,0,2
2023-06-01,135860,1,0,1,2,0,2
2023-06-01,150940,3,0,3,1,0,1
2023-06-01,136636,1,0,1,1,0,1
2023-06-01,136669,2,0,2,2,0,2
2023-06-01,137006,1,0,1,1,0,1
2023-06-01,136722,2,0,2,1,0,1
2023-06-01,150930,1,0,1,1,0,1
2023-06-01,150444,1,0,1,1,0,1
2023-06-01,131758,4,0,4,8,0,8
2023-06-01,135466,1,0,1,2,0,2
2023-06-01,136994,55,5,60,4,4,4
2023-06-01,136996,1,0,1,1,0,1
2023-06-01,150468,1,0,1,1,0,1
2023-06-01,136847,4,0,4,3,0,3
2023-06-01,136999,2,0,2,1,0,1
2023-06-01,136998,3,0,3,1,0,1
2023-06-01,150941,3,0,3,2,0,2
2023-06-01,142347,4,1,5,4,3,4
2023-06-01,137004,2,0,2,4,0,4
2023-06-01,58459,2,0,2,1,0,1
2023-06-01,137003,2,0,2,3,0,3
2023-06-01,136849,1,0,1,1,0,1
2023-06-01,137005,3,0,3,1,0,1
2023-06-01,137013,1,0,1,1,0,1
2023-06-01,135496,3,0,3,2,0,2
2023-06-01,136851,3,0,3,1,0,1
2023-06-01,131924,1,1,2,3,1,3
2023-06-01,64271,1,1,2,4,1,4
2023-06-01,136865,2,0,2,3,0,3
2023-06-01,137331,14,2,16,3,1,3
2023-06-01,140388,2,0,2,7,0,7
2023-06-01,150925,2,0,2,1,0,1
2023-06-01,63769,1,1,2,1,1,1
2023-06-01,137016,1,0,1,1,0,1
2023-06-01,136710,1,0,1,1,0,1
2023-06-01,150283,1,0,1,1,0,1
2023-06-01,137023,4,3,7,2,1,2
2023-06-01,137127,25,4,29,4,1,4
2023-06-01,137887,1,0,1,1,0,1
2023-06-01,17412,1,1,2,1,1,1
2023-06-01,136850,4,0,4,1,0,1
2023-06-01,136673,4,0,4,3,0,3
2023-06-01,137152,4,0,4,2,0,2
2023-06-01,136672,4,0,4,1,0,1
2023-06-01,136701,1,0,1,1,0,1
2023-06-01,142465,1,0,1,1,0,1
2023-06-01,136719,4,1,5,1,1,1
2023-06-01,136707,1,1,2,1,1,1
2023-06-01,137025,1,0,1,1,0,1
2023-06-01,55712,2,0,2,4,0,4
2023-06-01,142601,2,0,2,2,0,2
2023-06-01,136856,4,0,4,1,0,1
2023-06-01,136633,4,0,4,3,0,3
2023-06-01,149139,4,1,5,1,1,1
2023-06-01,137030,3,0,3,1,0,1
2023-06-01,137029,5,0,5,3,0,3
2023-06-01,136854,4,0,4,2,0,2
2023-06-01,136852,1,0,1,1,0,1
2023-06-01,136853,1,0,1,1,0,1
2023-06-01,137032,1,0,1,4,0,4
2023-06-01,63603,8,0,8,2,0,2
2023-06-01,137034,5,0,5,2,0,2
2023-06-01,137038,5,0,5,2,0,2
2023-06-01,137039,2,0,2,1,0,1
2023-06-01,137040,3,0,3,2,0,2
2023-06-01,137042,3,0,3,2,0,2
2023-06-01,137036,2,0,2,1,0,1
2023-06-01,137035,1,1,2,1,1,1
2023-06-01,137041,4,8,12,3,3,3
2023-06-01,137044,1,0,1,3,0,3
2023-06-01,137045,2,0,2,3,0,3
2023-06-01,138117,2,1,3,5,2,5
2023-06-01,136862,1,1,2,1,1,1
2023-06-01,138176,1,0,1,2,0,2
2023-06-01,136699,2,1,3,1,1,1
2023-06-01,137049,3,0,3,1,0,1
2023-06-01,136708,5,0,5,2,0,2
2023-06-01,136704,6,1,7,2,1,2
2023-06-01,137084,4,1,5,2,1,2
2023-06-01,136858,1,0,1,1,0,1
2023-06-01,131541,1,0,1,1,0,1
2023-06-01,137052,2,0,2,1,0,1
2023-06-01,137047,4,1,5,1,1,1
2023-06-01,137056,1,0,1,1,0,1
2023-06-01,137058,1,1,2,1,1,1
2023-06-01,138657,1,0,1,5,0,5
2023-06-01,137057,3,0,3,1,0,1
2023-06-01,137059,4,0,4,3,0,3
2023-06-01,137095,2,2,4,7,2,7
2023-06-01,136713,1,0,1,1,0,1
2023-06-01,134372,2,0,2,2,0,2
2023-06-01,133738,2,0,2,1,0,1
2023-06-01,137258,1,0,1,1,0,1
2023-06-01,150467,1,0,1,2,0,2
2023-06-01,136671,4,1,5,3,1,3
2023-06-01,139335,4,6,10,3,2,3
2023-06-01,138818,7,0,7,2,0,2
2023-06-01,136635,2,0,2,2,0,2
2023-06-01,136861,4,0,4,2,0,2
2023-06-01,23747,8,0,8,4,0,4
2023-06-01,136697,6,3,9,4,1,4
2023-06-01,136712,3,0,3,1,0,1
2023-06-01,137633,4,1,5,6,1,6
2023-06-01,136675,1,0,1,1,0,1
2023-06-01,137070,2,0,2,2,0,2
2023-06-01,131202,2,0,2,3,0,3
2023-06-01,137073,1,0,1,1,0,1
2023-06-01,131183,4,16,20,2,1,2
2023-06-01,137074,5,0,5,1,0,1
2023-06-01,135929,5,0,5,3,0,3
2023-06-01,137080,9,1,10,5,2,5
2023-06-01,137079,3,1,4,4,1,5
2023-06-01,136872,2,0,2,4,0,4
2023-06-01,136864,1,0,1,1,0,1
2023-06-01,10215,9,0,9,2,0,2
2023-06-01,38813,7,0,7,3,0,3
2023-06-01,136889,1,0,1,2,0,2
2023-06-01,132978,6,1,7,2,1,2
2023-06-01,136705,1,0,1,1,0,1
2023-06-01,63765,12,1,13,2,1,2
2023-06-01,136871,1,0,1,1,0,1
2023-06-01,137194,1,0,1,1,0,1
2023-06-01,136867,1,0,1,3,0,3
2023-06-01,137189,1,0,1,2,0,2
2023-06-01,137305,2,0,2,2,0,2
2023-06-01,135293,7,0,7,5,0,5
2023-06-01,137192,4,0,4,2,0,2
2023-06-01,135137,2,0,2,1,0,1
2023-06-01,136866,1,0,1,2,0,2
2023-06-01,137196,1,0,1,1,0,1
2023-06-01,137198,2,2,4,3,2,3
2023-06-01,137197,7,0,7,1,0,1
2023-06-01,136869,4,0,4,4,0,4
2023-06-01,136720,2,1,3,2,1,2
2023-06-01,132480,10,0,10,3,0,3
2023-06-01,137584,8,0,8,4,0,4
2023-06-01,135220,8,1,9,2,1,2
2023-06-01,137206,2,0,2,3,0,3
2023-06-01,137205,1,0,1,1,0,1
2023-06-01,137204,3,1,4,1,1,1
2023-06-01,141815,4,1,5,4,1,4
2023-06-01,137209,5,1,6,1,1,1
2023-06-01,142592,1,1,2,1,1,1
2023-06-01,150939,1,0,1,1,0,1
2023-06-01,137495,1,0,1,3,0,3
2023-06-01,137211,2,0,2,3,0,3
2023-06-01,137143,3,0,3,1,0,1
2023-06-01,137165,6,5,11,1,1,1
2023-06-01,136873,12,6,18,4,2,4
2023-06-01,59194,2,3,5,2,3,3
2023-06-01,55925,2,1,3,2,2,2
2023-06-01,137221,3,0,3,2,0,2
2023-06-01,136874,4,1,5,5,2,5
2023-06-01,137226,13,0,13,1,0,1
2023-06-01,150945,2,0,2,1,0,1
2023-06-01,150594,3,0,3,1,0,1
2023-06-01,139538,9,1,10,3,1,3
2023-06-01,136868,4,0,4,2,0,2
2023-06-01,133304,4,5,9,2,2,2
2023-06-01,137100,12,0,12,3,0,3
2023-06-01,136875,2,0,2,1,0,1
2023-06-01,134122,2,0,2,2,0,2
2023-06-01,137225,3,1,4,3,1,3
2023-06-01,137240,1,0,1,1,0,1
2023-06-01,137232,1,0,1,2,0,2
2023-06-01,136882,1,0,1,1,0,1
2023-06-01,137231,1,0,1,1,0,1
2023-06-01,9639,3,1,4,1,1,1
2023-06-01,137234,2,0,2,1,0,1
2023-06-01,137097,4,1,5,2,1,2
2023-06-01,136876,2,0,2,2,0,2
2023-06-01,137243,1,0,1,1,0,1
2023-06-01,136878,2,0,2,1,0,1
2023-06-01,137287,3,0,3,2,0,2
2023-06-01,137244,1,0,1,1,0,1
2023-06-01,137764,4,0,4,1,0,1
2023-06-01,55501,35,22,57,3,2,3
2023-06-01,137239,5,0,5,3,0,3
2023-06-01,136881,1,0,1,2,0,2
2023-06-01,136879,4,0,4,3,0,3
2023-06-01,135719,7,0,7,1,0,1
2023-06-01,136885,4,0,4,4,0,4
2023-06-01,138623,8,0,8,3,0,3
2023-06-01,137245,1,0,1,1,0,1
2023-06-01,137250,1,0,1,2,0,2
2023-06-01,137254,4,0,4,3,0,3
2023-06-01,137252,5,0,5,2,0,2
2023-06-01,137255,2,0,2,2,0,2
2023-06-01,137257,3,1,4,2,2,2
2023-06-01,136883,2,0,2,1,0,1
2023-06-01,131204,1,1,2,1,1,1
2023-06-01,136877,4,0,4,4,0,4
2023-06-01,137261,1,0,1,1,0,1
2023-06-01,137265,2,0,2,2,0,2
2023-06-01,139615,1,0,1,1,0,1
2023-06-01,137262,1,0,1,1,0,1
2023-06-01,135267,6,0,6,2,0,2
2023-06-01,137144,2,0,2,1,0,1
2023-06-01,150825,1,1,2,1,1,1
2023-06-01,137267,3,1,4,3,3,3
2023-06-01,136880,4,0,4,5,0,5
2023-06-01,136886,1,0,1,2,0,2
2023-06-01,137269,1,0,1,3,0,3
2023-06-01,131928,4,0,4,4,0,4
2023-06-01,137157,6,0,6,4,0,4
2023-06-01,137275,3,0,3,1,0,1
2023-06-01,137274,2,0,2,1,0,1
2023-06-01,136888,2,0,2,4,0,4
2023-06-01,137586,4,0,4,1,0,1
2023-06-01,137090,4,1,5,4,1,4
2023-06-01,137276,4,0,4,1,0,1
2023-06-01,135769,2,1,3,3,3,3
2023-06-01,137282,2,0,2,1,0,1
2023-06-01,134750,4,1,5,3,1,3
2023-06-01,137329,7,1,8,5,4,5
2023-06-01,135946,1,0,1,1,0,1
2023-06-01,135933,6,0,6,3,0,3
2023-06-01,137385,11,19,30,3,1,3
2023-06-01,4796,6,0,6,4,0,4
2023-06-01,7586,3,3,6,4,6,9
2023-06-01,135738,12,3,15,2,1,2
2023-06-01,137288,1,0,1,2,0,2
2023-06-01,137156,4,0,4,1,0,1
2023-06-01,137389,1,0,1,1,0,1
2023-06-01,137388,1,0,1,2,0,2
2023-06-01,137437,1,0,1,1,0,1
2023-06-01,137390,1,0,1,1,0,1
2023-06-01,151207,3,0,3,2,0,2
2023-06-01,151361,1,0,1,1,0,1
2023-06-01,137146,7,1,8,1,1,1
2023-06-01,137092,1,0,1,1,0,1
2023-06-01,149596,3,1,4,2,2,3
2023-06-01,140169,1,0,1,1,0,1
2023-06-01,136687,1,0,1,1,0,1
2023-06-01,137151,8,0,8,3,0,3
2023-06-01,137292,6,0,6,3,0,3
2023-06-01,137394,2,1,3,3,1,3
2023-06-01,137396,4,0,4,1,0,1
2023-06-01,137404,5,9,14,4,4,6
2023-06-01,56239,12,0,12,6,0,6
2023-06-01,137296,1,0,1,1,0,1
2023-06-01,137397,1,0,1,1,0,1
2023-06-01,135683,4,0,4,2,0,2
2023-06-01,133731,2,0,2,2,0,2
2023-06-01,137093,12,0,12,5,0,5
2023-06-01,137291,1,0,1,1,0,1
2023-06-01,135447,2,0,2,3,0,3
2023-06-01,135022,3,0,3,1,0,1
2023-06-01,136027,2,0,2,3,0,3
2023-06-01,137142,4,0,4,1,0,1
2023-06-01,147064,2,1,3,2,1,3
2023-06-01,137399,7,0,7,5,0,5
2023-06-01,137416,4,1,5,2,1,2
2023-06-01,150932,1,1,2,1,1,1
2023-06-01,137297,1,1,2,2,2,2
2023-06-01,59188,4,0,4,4,0,4
2023-06-01,139449,6,18,24,4,1,4
2023-06-01,137298,4,0,4,1,0,1
2023-06-01,149322,2,0,2,3,0,3
2023-06-01,18345,12,0,12,13,6,13
2023-06-01,150804,1,0,1,1,0,1
2023-06-01,137094,2,0,2,1,0,1
2023-06-01,137294,1,0,1,1,0,1
2023-06-01,137403,5,1,6,3,1,3
2023-06-01,137677,4,1,5,4,1,4
2023-06-01,137160,3,0,3,3,0,3
2023-06-01,134009,7,0,7,3,0,3
2023-06-01,150944,3,0,3,1,0,1
2023-06-01,137415,1,0,1,2,0,2
2023-06-01,137299,1,0,1,2,0,2
2023-06-01,137300,1,0,1,3,0,3
2023-06-01,135934,1,1,2,1,1,1
2023-06-01,141128,2,0,2,2,0,2
2023-06-01,137421,1,0,1,1,0,1
2023-06-01,137898,1,0,1,2,0,2
2023-06-01,137419,4,0,4,1,0,1
2023-06-01,150799,3,0,3,1,0,1
2023-06-01,134703,2,0,2,1,0,1
2023-06-01,38515,12,0,12,4,0,4
2023-06-01,137102,4,1,5,3,2,3
2023-06-01,137302,1,0,1,1,0,1
2023-06-01,141519,1,1,2,2,1,2
2023-06-01,137159,1,1,2,1,1,1
2023-06-01,137422,1,1,2,1,1,1
2023-06-01,137158,2,1,3,2,1,2
2023-06-01,137153,4,0,4,2,0,2
2023-06-01,137425,5,15,20,4,3,4
2023-06-01,137426,4,0,4,2,0,2
2023-06-01,137103,5,0,5,1,0,1
2023-06-01,150665,1,0,1,2,0,2
2023-06-01,137301,1,0,1,2,0,2
2023-06-01,137432,4,5,9,7,2,7
2023-06-01,137150,2,1,3,1,1,1
2023-06-01,135935,2,0,2,1,0,1
2023-06-01,137431,1,1,2,1,1,1
2023-06-01,18333,3,0,3,1,0,1
2023-06-01,137435,4,0,4,3,0,3
2023-06-01,137433,2,0,2,1,0,1
2023-06-01,137104,1,1,2,1,1,1
2023-06-01,137242,1,0,1,1,0,1
2023-06-01,137506,1,0,1,1,0,1
2023-06-01,137309,2,0,2,2,0,2
2023-06-01,56155,10,1,11,4,1,4
2023-06-01,63885,4,0,4,4,0,4
2023-06-01,137304,1,0,1,1,0,1
2023-06-01,137149,1,0,1,3,0,3
2023-06-01,138276,4,0,4,5,0,5
2023-06-01,133662,10,0,10,4,0,4
2023-06-01,137107,8,1,9,3,1,3
2023-06-01,140454,6,0,6,4,0,4
2023-06-01,142278,2,0,2,2,0,2
2023-06-01,133762,4,0,4,1,0,1
2023-06-01,138477,1,0,1,1,0,1
2023-06-01,139415,6,0,6,5,0,5
2023-06-01,137308,1,0,1,2,0,2
2023-06-01,137312,1,0,1,1,0,1
2023-06-01,137106,4,0,4,1,0,1
2023-06-01,137440,3,0,3,3,0,3
2023-06-01,131929,2,1,3,3,2,3
2023-06-01,45073,1,0,1,1,0,1
2023-06-01,137456,1,0,1,1,0,1
2023-06-01,137457,2,0,2,1,0,1
2023-06-01,46024,6,0,6,4,0,4
2023-06-01,137310,4,0,4,2,0,2
2023-06-01,137446,2,0,2,3,0,3
2023-06-01,150797,1,0,1,1,0,1
2023-06-01,137109,21,1,22,8,1,8
2023-06-01,137311,8,0,8,3,0,3
2023-06-01,135936,1,0,1,1,0,1
2023-06-01,147277,5,1,6,3,2,3
2023-06-01,134790,4,0,4,2,0,2
2023-06-01,135725,4,0,4,1,0,1
2023-06-01,133261,1,0,1,1,0,1
2023-06-01,138769,2,0,2,2,0,2
2023-06-01,134249,10,2,12,3,1,4
2023-06-01,150668,1,0,1,2,0,2
2023-06-01,137313,1,0,1,1,0,1
2023-06-01,137461,1,0,1,1,0,1
2023-06-01,132174,1,0,1,1,0,1
2023-06-01,137316,14,9,23,5,1,5
2023-06-01,17158,16,0,16,10,0,10
2023-06-01,137108,3,0,3,3,0,3
2023-06-01,137181,2,0,2,1,0,1
2023-06-01,141805,3,0,3,4,0,4
2023-06-01,137460,4,0,4,1,0,1
2023-06-01,45491,1,0,1,1,0,1
2023-06-01,14114,2,1,3,23,2,23
2023-06-01,18219,2,0,2,4,0,4
2023-06-01,138610,1,0,1,1,0,1
2023-06-01,132572,1,0,1,1,0,1
2023-06-01,137111,1,0,1,1,0,1
2023-06-01,135819,1,0,1,1,0,1
2023-06-01,137135,8,0,8,2,0,2
2023-06-01,137134,4,0,4,2,0,2
2023-06-01,150934,1,0,1,2,0,2
2023-06-01,150935,2,0,2,1,0,1
2023-06-01,58819,6,1,7,4,2,4
2023-06-01,137314,1,0,1,2,0,2
2023-06-01,137315,2,1,3,1,1,1
2023-06-01,135346,4,1,5,2,1,2
2023-06-01,137129,5,0,5,2,0,2
2023-06-01,136047,2,1,3,2,1,2
2023-06-01,17763,11,0,11,2,0,2
2023-06-01,137466,3,0,3,1,0,1
2023-06-01,137464,1,0,1,1,0,1
2023-06-01,38651,5,1,6,2,2,2
2023-06-01,137465,1,0,1,2,0,2
2023-06-01,137469,1,1,2,1,1,1
2023-06-01,137335,1,0,1,2,0,2
2023-06-01,133237,12,0,12,1,0,1
2023-06-01,137473,3,1,4,1,1,1
2023-06-01,150936,2,0,2,1,0,1
2023-06-01,136652,4,17,21,4,2,4
2023-06-01,137477,1,0,1,1,0,1
2023-06-01,150474,1,0,1,3,0,3
2023-06-01,137133,1,0,1,1,0,1
2023-06-01,140469,7,1,8,7,2,7
2023-06-01,137318,1,0,1,3,0,3
2023-06-01,55402,4,0,4,4,0,4
2023-06-01,137481,1,0,1,1,0,1
2023-06-01,137482,1,0,1,1,0,1
2023-06-01,137480,2,0,2,3,0,3
2023-06-01,137487,5,1,6,3,1,3
2023-06-01,137485,4,0,4,1,0,1
2023-06-01,137488,5,0,5,2,0,2
2023-06-01,59003,4,0,4,1,0,1
2023-06-01,137492,4,0,4,1,0,1
2023-06-01,136917,3,0,3,2,0,2
2023-06-01,134605,1,0,1,1,0,1
2023-06-01,59012,3,1,4,1,1,2
2023-06-01,137494,2,0,2,3,0,3
2023-06-01,137562,3,0,3,2,0,2
2023-06-01,137113,4,0,4,2,0,2
2023-06-01,137496,4,8,12,3,1,3
2023-06-01,147303,3,0,3,2,0,2
2023-06-01,137132,8,1,9,4,1,4
2023-06-01,137180,4,0,4,1,0,1
2023-06-01,139692,3,0,3,1,0,1
2023-06-01,137374,3,0,3,3,0,3
2023-06-01,137115,2,0,2,3,0,3
2023-06-01,137881,1,0,1,1,0,1
2023-06-01,135111,3,0,3,3,0,3
2023-06-01,137176,3,3,6,3,3,3
2023-06-01,137501,1,0,1,1,0,1
2023-06-01,137499,4,0,4,2,0,2
2023-06-01,141524,2,1,3,4,1,4
2023-06-01,137122,4,1,5,2,1,2
2023-06-01,137177,4,0,4,1,0,1
2023-06-01,150808,2,0,2,2,0,2
2023-06-01,137505,4,9,13,3,2,3
2023-06-01,139735,5,1,6,3,1,3
2023-06-01,134242,1,0,1,2,0,2
2023-06-01,132368,3,0,3,3,0,3
2023-06-01,137136,1,0,1,1,0,1
2023-06-01,138926,2,0,2,3,0,3
2023-06-01,142618,2,0,2,1,0,1
2023-06-01,137511,1,0,1,1,0,1
2023-06-01,131264,1,0,1,1,0,1
2023-06-01,137521,2,0,2,2,0,2
2023-06-01,137513,2,0,2,3,0,3
2023-06-01,137514,4,0,4,1,0,1
2023-06-01,137118,7,1,8,4,3,4
2023-06-01,136426,2,0,2,2,0,2
2023-06-01,149951,3,1,4,1,1,1
2023-06-01,137515,5,17,22,2,2,2
2023-06-01,137518,1,0,1,3,0,3
2023-06-01,137319,1,0,1,2,0,2
2023-06-01,137519,2,0,2,2,0,2
2023-06-01,38559,3,0,3,1,0,1
2023-06-01,141461,7,1,8,6,1,6
2023-06-01,139572,2,1,3,3,1,3
2023-06-01,17563,126,2,128,5,2,5
2023-06-01,59323,4,0,4,3,0,3
2023-06-01,137324,4,0,4,4,0,4
2023-06-01,135030,4,0,4,1,0,1
2023-06-01,137525,11,0,11,3,0,3
2023-06-01,137922,21,12,33,15,15,17
2023-06-01,137325,1,0,1,3,0,3
2023-06-01,137323,2,0,2,2,0,2
2023-06-01,149581,2,0,2,3,0,3
2023-06-01,150598,2,0,2,1,0,1
2023-06-01,135939,4,0,4,1,0,1
2023-06-01,135938,5,1,6,3,2,3
2023-06-01,132669,4,7,11,3,2,3
2023-06-01,141243,5,0,5,2,0,2
2023-06-01,137162,2,0,2,1,0,1
2023-06-01,137169,5,1,6,1,1,1
2023-06-01,137124,4,0,4,2,0,2
2023-06-01,137121,4,0,4,1,0,1
2023-06-01,38077,25,17,42,6,4,7
2023-06-01,148989,0,0,0,3,0,3
2023-06-01,150602,2,0,2,1,0,1
2023-06-01,133410,7,0,7,4,0,4
2023-06-01,133211,1,0,1,1,0,1
2023-06-01,137530,4,1,5,4,1,4
2023-06-01,150156,3,1,4,4,1,4
2023-06-01,138701,4,0,4,5,0,5
2023-06-01,137532,4,0,4,4,0,4
2023-06-01,137534,1,0,1,1,0,1
2023-06-01,137173,1,0,1,2,0,2
2023-06-01,137174,4,4,8,1,1,1
2023-06-01,137544,2,0,2,1,0,1
2023-06-01,137128,1,1,2,3,1,3
2023-06-01,137537,1,0,1,2,0,2
2023-06-01,137327,1,1,2,4,2,4
2023-06-01,137542,4,18,22,2,1,2
2023-06-01,137330,2,9,11,2,1,2
2023-06-01,141892,7,12,19,2,1,2
2023-06-01,137334,3,0,3,2,0,2
2023-06-01,135299,2,0,2,4,0,4
2023-06-01,137540,1,0,1,1,0,1
2023-06-01,137541,4,3,7,2,1,2
2023-06-01,55356,2,0,2,1,0,1
2023-06-01,137543,4,0,4,1,0,1
2023-06-01,136437,3,0,3,3,0,3
2023-06-01,136445,3,0,3,3,0,3
2023-06-01,137332,1,0,1,1,0,1
2023-06-01,38526,4,5,9,2,1,2
2023-06-01,135059,2,0,2,3,0,3
2023-06-01,139841,3,0,3,4,0,4
2023-06-01,150744,7,0,7,2,0,2
2023-06-01,137172,2,1,3,1,1,1
2023-06-01,137164,4,0,4,1,0,1
2023-06-01,134077,6,0,6,2,0,2
2023-06-01,7587,0,0,0,3,3,3
2023-06-01,137338,1,1,2,1,1,1
2023-06-01,132946,2,0,2,2,0,2
2023-06-01,139439,1,0,1,1,0,1
2023-06-01,135185,2,0,2,1,0,1
2023-06-01,150476,1,0,1,1,0,1
2023-06-01,137550,3,0,3,2,0,2
2023-06-01,137551,10,0,10,6,0,6
2023-06-01,136107,6,0,6,4,0,4
2023-06-01,134338,2,0,2,2,0,2
2023-06-01,137171,1,0,1,2,0,2
2023-06-01,138165,2,0,2,2,0,2
2023-06-01,149535,2,0,2,3,0,3
2023-06-01,135465,4,6,10,4,1,4
2023-06-01,137342,4,0,4,1,0,1
2023-06-01,59074,3,2,5,3,1,3
2023-06-01,137554,4,1,5,2,1,2
2023-06-01,137553,3,1,4,3,2,3
2023-06-01,135419,6,1,7,5,2,5
2023-06-01,137339,1,0,1,1,0,1
2023-06-01,135696,1,0,1,1,0,1
2023-06-01,134916,4,1,5,2,1,2
2023-06-01,137340,2,0,2,3,0,3
2023-06-01,135755,4,0,4,3,0,3
2023-06-01,150023,1,0,1,1,0,1
2023-06-01,63774,8,4,12,5,1,5
2023-06-01,133329,4,0,4,1,0,1
2023-06-01,135943,4,0,4,2,0,2
2023-06-01,132771,11,0,11,2,0,2
2023-06-01,137561,6,0,6,4,0,4
2023-06-01,138718,6,1,7,2,1,2
2023-06-01,135190,1,0,1,1,0,1
2023-06-01,137604,4,0,4,1,0,1
2023-06-01,38785,11,0,11,3,0,3
2023-06-01,137563,2,0,2,4,0,4
2023-06-01,141590,2,1,3,4,1,4
2023-06-01,149950,2,0,2,1,0,1
2023-06-01,137462,2,0,2,2,0,2
2023-06-01,137568,4,0,4,3,0,3
2023-06-01,137566,4,1,5,2,1,2
2023-06-01,132844,1,0,1,1,0,1
2023-06-01,132554,1,0,1,1,0,1
2023-06-01,137567,6,0,6,2,0,2
2023-06-01,135859,1,1,2,2,1,2
2023-06-01,137703,5,6,11,3,1,3
2023-06-01,137706,6,0,6,2,0,2
2023-06-01,136494,4,0,4,1,0,1
2023-06-01,137570,2,0,2,2,0,2
2023-06-01,139722,3,0,3,4,0,4
2023-06-01,137608,1,0,1,2,0,2
2023-06-01,137347,1,0,1,2,0,2
2023-06-01,137628,4,0,4,2,0,2
2023-06-01,137572,5,0,5,2,0,2
2023-06-01,24263,4,0,4,3,0,3
2023-06-01,134343,4,0,4,1,0,1
2023-06-01,150583,2,0,2,1,0,1
2023-06-01,137578,2,0,2,2,0,2
2023-06-01,137607,1,0,1,1,0,1
2023-06-01,137369,1,0,1,1,0,1
2023-06-01,137579,5,0,5,2,0,2
2023-06-01,137580,5,1,6,1,1,1
2023-06-01,131941,14,0,14,2,0,2
2023-06-01,135408,2,0,2,4,0,4
2023-06-01,137360,1,0,1,3,0,3
2023-06-01,137585,1,0,1,1,0,1
2023-06-01,137964,4,0,4,5,0,5
2023-06-01,137707,8,17,25,2,2,2
2023-06-01,137344,4,0,4,1,0,1
2023-06-01,137349,2,0,2,1,0,1
2023-06-01,137630,4,0,4,2,0,2
2023-06-01,138418,6,1,7,4,2,4
2023-06-01,150607,1,0,1,1,0,1
2023-06-01,137809,1,0,1,1,0,1
2023-06-01,141452,7,0,7,5,0,5
2023-06-01,140674,3,0,3,3,0,3
2023-06-01,137810,1,0,1,1,0,1
2023-06-01,18321,1,0,1,1,0,1
2023-06-01,137351,1,0,1,3,0,3
2023-06-01,135336,1,0,1,4,0,4
2023-06-01,137905,3,0,3,1,0,1
2023-06-01,137710,5,0,5,4,0,4
2023-06-01,141650,2,0,2,1,0,1
2023-06-01,135131,1,0,1,2,0,2
2023-06-01,151084,1,0,1,1,0,1
2023-06-01,137815,4,0,4,3,0,3
2023-06-01,137814,2,0,2,2,0,2
2023-06-01,38303,4,0,4,3,0,3
2023-06-01,23618,5,1,6,4,1,4
2023-06-01,397702,1,0,1,1,0,1
2023-06-01,137816,4,1,5,6,4,6
2023-06-01,137353,1,0,1,1,0,1
2023-06-01,137818,3,0,3,4,0,4
2023-06-01,137606,3,0,3,1,0,1
2023-06-01,137605,1,0,1,1,0,1
2023-06-01,137638,2,0,2,4,0,4
2023-06-01,132593,1,0,1,1,0,1
2023-06-01,137616,4,1,5,2,1,2
2023-06-01,137656,3,0,3,3,0,3
2023-06-01,134920,2,0,2,2,0,2
2023-06-01,137806,2,0,2,3,0,3
2023-06-01,137354,2,0,2,3,0,3
2023-06-01,137632,1,0,1,2,0,2
2023-06-01,137822,1,0,1,1,0,1
2023-06-01,137824,1,0,1,1,0,1
2023-06-01,149925,2,1,3,3,1,3
2023-06-01,137826,2,0,2,2,0,2
2023-06-01,137823,5,0,5,2,0,2
2023-06-01,149765,3,0,3,2,0,2
2023-06-01,137357,1,0,1,1,0,1
2023-06-01,137827,2,1,3,4,1,4
2023-06-01,137825,1,0,1,1,0,1
2023-06-01,150481,1,0,1,3,0,3
2023-06-01,137359,5,0,5,2,0,2
2023-06-01,137828,6,2,8,3,1,3
2023-06-01,138341,66,10,76,2,1,2
2023-06-01,134106,2,0,2,3,0,3
2023-06-01,151043,1,1,2,1,1,1
2023-06-01,9888,5,0,5,2,0,2
2023-06-01,133479,2,0,2,3,0,3
2023-06-01,137836,2,0,2,1,0,1
2023-06-01,9890,15,1,16,3,1,3
2023-06-01,137356,1,0,1,1,0,1
2023-06-01,55550,1,0,1,2,0,2
2023-06-01,137361,1,0,1,2,0,2
2023-06-01,137602,1,0,1,1,0,1
2023-06-01,23920,3,0,3,3,0,3
2023-06-01,137841,4,0,4,4,0,4
2023-06-01,140229,3,0,3,4,0,4
2023-06-01,139294,2,0,2,3,0,3
2023-06-01,137834,2,0,2,2,0,2
2023-06-01,135223,18,1,19,3,1,3
2023-06-01,137843,4,1,5,3,2,3
2023-06-01,137847,3,1,4,5,1,5
2023-06-01,137842,7,0,7,2,0,2
2023-06-01,137852,2,1,3,1,1,1
2023-06-01,138131,7,0,7,3,0,3
2023-06-01,137845,5,1,6,1,1,1
2023-06-01,137853,5,0,5,4,0,4
2023-06-01,137358,3,0,3,3,0,3
2023-06-01,141627,2,0,2,3,0,3
2023-06-01,137615,3,0,3,1,0,1
2023-06-01,133007,18,0,18,3,0,3
2023-06-01,395400,5,1,6,5,4,5
2023-06-01,23676,1,1,2,3,3,3
2023-06-01,137614,1,0,1,1,0,1
2023-06-01,137863,1,0,1,1,0,1
2023-06-01,137861,1,0,1,1,0,1
2023-06-01,131944,3,0,3,3,0,3
2023-06-01,137362,1,0,1,1,0,1
2023-06-01,137634,1,0,1,2,0,2
2023-06-01,138002,1,0,1,2,0,2
2023-06-01,133884,2,0,2,1,0,1
2023-06-01,137862,4,0,4,1,0,1
2023-06-01,137801,1,0,1,3,0,3
2023-06-01,137868,4,0,4,5,0,5
2023-06-01,150828,1,1,2,1,1,1
2023-06-01,137870,2,0,2,3,0,3
2023-06-01,138402,3,0,3,1,0,1
2023-06-01,137590,1,0,1,1,0,1
2023-06-01,135791,6,0,6,1,0,1
2023-06-01,137880,5,9,14,2,1,2
2023-06-01,137876,1,1,2,2,2,2
2023-06-01,150830,1,1,2,1,1,1
2023-06-01,131620,3,0,3,2,0,2
2023-06-01,150959,2,0,2,1,0,1
2023-06-01,137883,6,0,6,2,0,2
2023-06-01,137798,9,2,11,2,1,2
2023-06-01,131619,4,0,4,3,0,3
2023-06-01,135945,4,0,4,1,0,1
2023-06-01,135987,7,3,10,1,1,1
2023-06-01,137364,1,0,1,1,0,1
2023-06-01,137884,5,0,5,4,0,4
2023-06-01,63654,2,0,2,2,0,2
2023-06-01,138787,5,1,6,1,1,1
2023-06-01,137890,1,0,1,1,0,1
2023-06-01,137888,1,0,1,1,0,1
2023-06-01,38799,5,0,5,2,0,2
2023-06-01,137889,4,9,13,1,1,2
2023-06-01,137371,1,0,1,3,0,3
2023-06-01,133415,3,0,3,1,0,1
2023-06-01,133977,3,0,3,1,0,1
2023-06-01,137891,2,0,2,3,0,3
2023-06-01,65020,1,0,1,1,0,1
2023-06-01,137682,4,0,4,1,0,1
2023-06-01,137365,1,0,1,1,0,1
2023-06-01,137368,1,1,2,1,1,1
2023-06-01,137903,1,0,1,1,0,1
2023-06-01,150565,1,0,1,1,0,1
2023-06-01,137945,13,2,15,1,1,2
2023-06-01,139734,5,0,5,3,0,3
2023-06-01,138172,6,0,6,1,0,1
2023-06-01,131623,4,0,4,1,0,1
2023-06-01,150478,1,0,1,1,0,1
2023-06-01,137911,1,0,1,1,0,1
2023-06-01,136280,6,1,7,2,1,2
2023-06-01,137912,3,0,3,1,0,1
2023-06-01,137913,1,1,2,3,1,3
2023-06-01,137916,1,0,1,1,0,1
2023-06-01,137673,1,0,1,2,0,2
2023-06-01,137612,2,1,3,1,1,1
2023-06-01,135561,4,0,4,1,0,1
2023-06-01,149224,2,0,2,4,0,4
2023-06-01,150599,2,0,2,1,0,1
2023-06-01,137610,6,1,7,1,1,1
2023-06-01,137611,3,0,3,3,0,3
2023-06-01,137925,1,1,2,2,2,2
2023-06-01,55855,9,0,9,3,0,3
2023-06-01,65533,0,0,0,4,0,4
2023-06-01,136763,7,0,7,1,0,1
2023-06-01,141974,2,0,2,1,0,1
2023-06-01,134406,2,0,2,2,0,2
2023-06-01,137935,4,70,74,2,2,2
2023-06-01,63986,1,0,1,1,0,1
2023-06-01,134312,8,0,8,3,0,3
2023-06-01,137619,7,0,7,1,0,1
2023-06-01,137932,3,0,3,2,0,2
2023-06-01,137934,3,0,3,2,0,2
2023-06-01,137939,4,0,4,2,0,2
2023-06-01,141283,3,0,3,3,0,3
2023-06-01,137665,1,0,1,1,0,1
2023-06-01,133643,5,0,5,2,0,2
2023-06-01,138883,1,0,1,2,0,2
2023-06-01,137679,4,0,4,1,0,1
2023-06-01,55566,3,0,3,1,0,1
2023-06-01,138085,1,0,1,3,0,3
2023-06-01,137666,2,1,3,2,2,2
2023-06-01,133244,4,0,4,1,0,1
2023-06-01,137788,2,0,2,1,0,1
2023-06-01,137667,4,0,4,1,0,1
2023-06-01,135947,2,0,2,2,2,4
2023-06-01,135948,1,0,1,1,2,2
2023-06-01,137948,1,0,1,2,0,2
2023-06-01,139349,1,0,1,1,0,1
2023-06-01,138588,1,0,1,1,0,1
2023-06-01,138593,1,0,1,1,0,1
2023-06-01,137947,2,0,2,2,0,2
2023-06-01,137372,1,0,1,1,0,1
2023-06-01,137950,2,1,3,1,1,1
2023-06-01,150687,1,0,1,2,0,2
2023-06-01,134152,5,1,6,4,1,5
2023-06-01,131626,6,1,7,1,1,1
2023-06-01,150834,1,1,2,1,1,1
2023-06-01,150835,1,0,1,1,0,1
2023-06-01,137952,5,0,5,2,0,2
2023-06-01,137956,1,0,1,1,0,1
2023-06-01,137957,1,0,1,3,0,3
2023-06-01,137715,4,2,6,2,1,2
2023-06-01,135482,1,0,1,1,0,1
2023-06-01,137961,3,48,51,2,1,2
2023-06-01,131937,19,3,22,4,3,4
2023-06-01,137965,1,0,1,1,0,1
2023-06-01,150203,1,0,1,1,0,1
2023-06-01,137529,2,0,2,2,0,2
2023-06-01,137376,5,1,6,1,1,1
2023-06-01,137963,1,0,1,1,0,1
2023-06-01,137646,1,0,1,1,0,1
2023-06-01,137971,1,1,2,1,1,1
2023-06-01,137622,4,1,5,3,1,3
2023-06-01,137972,2,0,2,2,0,2
2023-06-01,135577,1,0,1,2,0,2
2023-06-01,149953,1,1,2,1,1,1
2023-06-01,24312,3,0,3,1,0,1
2023-06-01,137370,3,1,4,3,1,3
2023-06-01,137623,3,0,3,1,0,1
2023-06-01,137375,2,0,2,5,0,5
2023-06-01,137624,4,0,4,2,0,2
2023-06-01,137976,1,0,1,1,0,1
2023-06-01,137975,4,0,4,1,0,1
2023-06-01,137980,1,0,1,1,0,1
2023-06-01,138326,1,0,1,1,0,1
2023-06-01,138231,2,0,2,3,0,3
2023-06-01,137974,4,0,4,1,0,1
2023-06-01,8360,18,0,18,23,0,23
2023-06-01,137981,2,0,2,1,0,1
2023-06-01,139871,3,1,4,1,1,1
2023-06-01,63782,3,0,3,1,0,1
2023-06-01,137982,1,0,1,1,0,1
2023-06-01,137987,2,1,3,1,1,1
2023-06-01,137985,1,0,1,1,0,1
2023-06-01,138029,3,3,6,2,2,2
2023-06-01,137641,1,0,1,1,0,1
2023-06-01,137378,4,0,4,4,0,4
2023-06-01,137595,4,0,4,1,0,1
2023-06-01,138019,1,0,1,1,0,1
2023-06-01,131936,2,0,2,2,0,2
2023-06-01,137993,1,0,1,1,0,1
2023-06-01,137379,2,0,2,2,0,2
2023-06-01,141639,2,0,2,5,0,5
2023-06-01,141606,2,0,2,6,0,6
2023-06-01,137381,1,0,1,3,0,3
2023-06-01,137642,4,0,4,2,0,2
2023-06-01,24318,11,0,11,1,0,1
2023-06-01,53584,0,0,0,3,0,3
2023-06-01,151045,4,0,4,1,0,1
2023-06-01,151046,2,0,2,1,0,1
2023-06-01,140165,2,0,2,1,0,1
2023-06-01,135841,1,0,1,1,0,1
2023-06-01,138012,1,0,1,1,0,1
2023-06-01,137683,1,0,1,2,0,2
2023-06-01,135179,1,0,1,1,0,1
2023-06-01,137785,4,1,5,2,1,2
2023-06-01,137784,1,0,1,1,0,1
2023-06-01,141253,5,3,8,7,2,7
2023-06-01,133714,1,0,1,1,0,1
2023-06-01,137684,3,1,4,1,1,1
2023-06-01,137648,4,0,4,1,0,1
2023-06-01,137625,1,0,1,1,0,1
2023-06-01,138017,1,0,1,3,0,3
2023-06-01,137649,1,0,1,1,0,1
2023-06-01,138014,3,0,3,3,0,3
2023-06-01,138034,2,1,3,1,1,1
2023-06-01,131939,5,0,5,3,0,3
2023-06-01,138022,4,1,5,3,2,3
2023-06-01,138035,1,0,1,3,0,3
2023-06-01,138028,2,0,2,1,0,1
2023-06-01,140949,6,0,6,2,0,2
2023-06-01,138023,3,0,3,1,0,1
2023-06-01,137639,7,9,16,1,1,1
2023-06-01,141796,5,4,9,3,2,3
2023-06-01,137373,4,0,4,3,0,3
2023-06-01,138025,2,1,3,9,5,12
2023-06-01,140407,5,3,8,13,4,14
2023-06-01,150501,1,0,1,1,0,1
2023-06-01,138447,1,0,1,1,0,1
2023-06-01,138033,4,1,5,3,2,3
2023-06-01,135854,4,0,4,1,0,1
2023-06-01,131283,8,9,17,3,3,3
2023-06-01,134003,1,0,1,1,0,1
2023-06-01,138039,3,1,4,2,1,2
2023-06-01,55559,4,0,4,1,0,1
2023-06-01,137652,2,0,2,2,0,2
2023-06-01,22744,5,0,5,4,0,4
2023-06-01,138040,1,0,1,2,0,2
2023-06-01,138057,1,0,1,1,0,1
2023-06-01,138042,7,0,7,2,0,2
2023-06-01,134572,5,0,5,2,0,2
2023-06-01,134562,7,2,9,5,2,5
2023-06-01,141004,12,0,12,2,0,2
2023-06-01,38633,3,0,3,2,0,2
2023-06-01,134585,2,0,2,1,0,1
2023-06-01,137782,1,0,1,1,0,1
2023-06-01,134883,4,145,149,2,3,3
2023-06-01,138082,2,0,2,3,0,3
2023-06-01,134601,4,0,4,3,0,3
2023-06-01,134573,3,0,3,1,0,1
2023-06-01,137384,1,0,1,1,0,1
2023-06-01,138045,1,0,1,1,0,1
2023-06-01,132515,2,1,3,1,1,1
2023-06-01,146850,2,0,2,2,0,2
2023-06-01,135737,2,0,2,1,0,1
2023-06-01,135048,4,0,4,2,0,2
2023-06-01,137383,2,0,2,3,0,3
2023-06-01,134594,2,0,2,2,0,2
2023-06-01,134592,3,0,3,1,0,1
2023-06-01,137645,6,1,7,3,2,3
2023-06-01,135268,1,1,2,1,1,1
2023-06-01,137668,4,0,4,2,0,2
2023-06-01,139351,3,10,13,2,1,2
2023-06-01,151048,2,0,2,1,0,1
2023-06-01,139771,2,1,3,4,3,4
2023-06-01,134595,4,16,20,1,2,2
2023-06-01,141395,2,1,3,1,1,1
2023-06-01,134596,2,0,2,2,0,2
2023-06-01,138052,1,0,1,1,0,1
2023-06-01,138043,4,10,14,6,2,6
2023-06-01,137660,2,0,2,2,0,2
2023-06-01,138046,1,0,1,1,0,1
2023-06-01,138146,4,0,4,2,0,2
2023-06-01,133257,4,1,5,3,1,3
2023-06-01,134886,10,0,10,3,0,3
2023-06-01,138149,4,2,6,1,1,1
2023-06-01,138147,2,0,2,3,0,3
2023-06-01,138150,4,0,4,3,0,3
2023-06-01,134302,4,0,4,3,0,3
2023-06-01,131275,3,0,3,1,0,1
2023-06-01,138059,1,0,1,1,0,1
2023-06-01,23943,23,1,24,5,1,6
2023-06-01,131478,1,1,2,1,1,1
2023-06-01,134383,1,0,1,1,0,1
2023-06-01,135226,6,1,7,3,1,3
2023-06-01,137669,2,0,2,1,0,1
2023-06-01,138158,1,0,1,1,0,1
2023-06-01,132676,3,0,3,4,0,4
2023-06-01,137655,10,4,14,4,2,4
2023-06-01,151050,3,0,3,2,0,2
2023-06-01,141778,4,2,6,3,1,3
2023-06-01,151054,1,0,1,1,0,1
2023-06-01,150963,2,0,2,1,0,1
2023-06-01,138161,1,0,1,1,0,1
2023-06-01,138163,1,0,1,1,0,1
2023-06-01,149710,1,0,1,3,0,3
2023-06-01,138054,4,0,4,3,0,3
2023-06-01,134922,6,1,7,5,1,5
2023-06-01,138173,1,0,1,1,0,1
2023-06-01,138170,3,0,3,2,0,2
2023-06-01,138171,5,17,22,2,2,2
2023-06-01,138167,4,1,5,1,1,1
2023-06-01,137659,2,0,2,2,0,2
2023-06-01,134891,1,0,1,1,0,1
2023-06-01,139138,4,2,6,8,4,8
2023-06-01,138050,3,0,3,3,0,3
2023-06-01,138202,4,1,5,1,1,2
2023-06-01,138198,4,0,4,3,0,3
2023-06-01,137661,4,2,6,2,2,2
2023-06-01,138189,8,1,9,1,1,1
2023-06-01,138204,2,0,2,1,0,1
2023-06-01,138208,3,0,3,1,0,1
2023-06-01,138199,1,0,1,3,0,3
2023-06-01,138207,1,0,1,1,0,1
2023-06-01,138101,1,0,1,2,0,2
2023-06-01,137662,2,0,2,2,0,2
2023-06-01,133678,3,1,4,2,1,2
2023-06-01,138055,1,0,1,1,0,1
2023-06-01,150836,3,0,3,2,0,2
2023-06-01,136315,1,0,1,1,0,1
2023-06-01,138214,1,0,1,1,0,1
2023-06-01,138213,2,0,2,2,0,2
2023-06-01,138216,1,0,1,1,0,1
2023-06-01,136976,1,0,1,2,0,2
2023-06-01,138215,3,0,3,1,0,1
2023-06-01,147035,3,1,4,1,1,1
2023-06-01,38903,6,0,6,2,0,2
2023-06-01,136659,1,0,1,2,0,2
2023-06-01,136670,4,0,4,1,0,1
2023-06-01,149578,3,0,3,2,0,2
2023-06-01,136174,7,1,8,2,1,2
2023-06-01,138293,2,0,2,1,0,1
2023-06-01,138291,1,0,1,1,0,1
2023-06-01,138218,2,1,3,4,1,4
2023-06-01,135205,1,0,1,2,0,2
2023-06-01,138073,2,0,2,3,0,3
2023-06-01,151057,3,0,3,2,0,2
2023-06-01,150960,3,0,3,1,0,1
2023-06-01,131680,1,0,1,2,0,2
2023-06-01,150838,1,1,2,1,1,1
2023-06-01,142063,3,0,3,2,0,2
2023-06-01,138292,4,0,4,2,0,2
2023-06-01,138258,4,24,28,3,1,3
2023-06-01,9392,2,0,2,2,0,2
2023-06-01,138325,1,0,1,2,0,2
2023-06-01,135130,7,0,7,3,0,3
2023-06-01,138320,7,0,7,2,0,2
2023-06-01,38493,17,2,19,5,3,5
2023-06-01,1440665,1,0,1,1,0,1
2023-06-01,138069,4,0,4,1,0,1
2023-06-01,138071,1,0,1,1,0,1
2023-06-01,138323,3,0,3,1,0,1
2023-06-01,135562,2,10,12,2,2,2
2023-06-01,135554,4,0,4,2,0,2
2023-06-01,138076,2,0,2,3,0,3
2023-06-01,138290,8,0,8,3,0,3
2023-06-01,135207,6,0,6,3,0,3
2023-06-01,150034,1,0,1,2,0,2
2023-06-01,138289,3,0,3,1,0,1
2023-06-01,138221,4,0,4,2,0,2
2023-06-01,138324,1,0,1,1,0,1
2023-06-01,132570,4,0,4,2,0,2
2023-06-01,150499,1,0,1,1,0,1
2023-06-01,138070,3,0,3,3,0,3
2023-06-01,138066,1,1,2,2,1,2
2023-06-01,139200,1,0,1,1,0,1
2023-06-01,138072,4,0,4,2,0,2
2023-06-01,204677,0,0,0,3,0,3
2023-06-01,55901,1,1,2,1,1,1
2023-06-01,24298,9,0,9,4,0,4
2023-06-01,138255,1,0,1,2,0,2
2023-06-01,63776,3,1,4,2,2,2
2023-06-01,63786,1,2,3,2,2,2
2023-06-01,202525,2,2,4,1,1,1
2023-06-01,138329,3,0,3,2,0,2
2023-06-01,134405,3,3,6,1,1,1
2023-06-01,138078,1,0,1,2,0,2
2023-06-01,45668,43,4,47,7,2,7
2023-06-01,138099,1,0,1,1,0,1
2023-06-01,138095,1,0,1,3,0,3
2023-06-01,138389,1,0,1,2,0,2
2023-06-01,149227,2,1,3,1,1,1
2023-06-01,151060,1,0,1,1,0,1
2023-06-01,138382,7,7,14,1,1,1
2023-06-01,138386,2,0,2,1,0,1
2023-06-01,131606,2,0,2,1,0,1
2023-06-01,138385,6,1,7,5,1,5
2023-06-01,135955,1,1,2,2,1,2
2023-06-01,135956,2,0,2,1,0,1
2023-06-01,149547,6,0,6,2,0,2
2023-06-01,138229,5,0,5,1,0,1
2023-06-01,138227,4,0,4,2,0,2
2023-06-01,138388,5,1,6,1,1,1
2023-06-01,137636,2,2,4,2,1,2
2023-06-01,138397,3,0,3,2,0,2
2023-06-01,14630,29,9,38,24,15,28
2023-06-01,138948,3,0,3,2,0,2
2023-06-01,138947,3,0,3,4,0,4
2023-06-01,138232,3,0,3,1,0,1
2023-06-01,138237,1,0,1,1,0,1
2023-06-01,138400,2,0,2,2,0,2
2023-06-01,138088,3,0,3,3,0,3
2023-06-01,133251,4,0,4,2,0,2
2023-06-01,138259,4,0,4,1,0,1
2023-06-01,138260,2,0,2,1,0,1
2023-06-01,138403,4,0,4,3,0,3
2023-06-01,141876,2,0,2,4,0,4
2023-06-01,138411,4,0,4,1,0,1
2023-06-01,151151,2,0,2,1,0,1
2023-06-01,134781,4,0,4,2,0,2
2023-06-01,59169,9,0,9,1,0,1
2023-06-01,138090,4,0,4,2,0,2
2023-06-01,138412,2,0,2,3,0,3
2023-06-01,136824,2,0,2,3,0,3
2023-06-01,150158,1,0,1,4,0,4
2023-06-01,138087,4,1,5,3,1,3
2023-06-01,137854,3,1,4,2,1,2
2023-06-01,138419,3,0,3,2,0,2
2023-06-01,138098,2,0,2,3,0,3
2023-06-01,138301,1,0,1,2,0,2
2023-06-01,138424,2,0,2,3,0,3
2023-06-01,138425,1,0,1,1,0,1
2023-06-01,141526,4,0,4,1,0,1
2023-06-01,138426,1,0,1,1,0,1
2023-06-01,135768,4,0,4,1,0,1
2023-06-01,138302,4,0,4,2,0,2
2023-06-01,138431,4,0,4,2,0,2
2023-06-01,10187,4,0,4,3,0,3
2023-06-01,138270,3,1,4,2,2,3
2023-06-01,138285,1,0,1,2,0,2
2023-06-01,141376,4,0,4,3,0,3
2023-06-01,138102,4,0,4,1,0,1
2023-06-01,138437,7,0,7,2,0,2
2023-06-01,55381,7,0,7,5,0,5
2023-06-01,138443,1,0,1,1,0,1
2023-06-01,138444,6,0,6,3,0,3
2023-06-01,138746,4,0,4,3,0,3
2023-06-01,139088,7,0,7,4,0,4
2023-06-01,138114,2,1,3,1,1,1
2023-06-01,133533,2,0,2,1,0,1
2023-06-01,138105,2,0,2,2,0,2
2023-06-01,138455,2,0,2,1,0,1
2023-06-01,138104,1,0,1,2,0,2
2023-06-01,138453,4,1,5,1,1,1
2023-06-01,65111,2,0,2,1,0,1
2023-06-01,137758,1,3,4,3,2,4
2023-06-01,150001,8,5,13,6,1,6
2023-06-01,138469,1,0,1,1,0,1
2023-06-01,150508,1,0,1,1,0,1
2023-06-01,138468,1,0,1,2,0,2
2023-06-01,138119,5,0,5,7,0,7
2023-06-01,138462,5,0,5,1,0,1
2023-06-01,149550,2,0,2,1,0,1
2023-06-01,138465,4,0,4,4,0,4
2023-06-01,138107,4,0,4,2,0,2
2023-06-01,137020,2,0,2,3,0,3
2023-06-01,138287,2,0,2,1,0,1
2023-06-01,18322,7,0,7,2,0,2
2023-06-01,138242,4,0,4,1,0,1
2023-06-01,138470,2,0,2,3,0,3
2023-06-01,133093,2,0,2,1,0,1
2023-06-01,138626,1,0,1,1,0,1
2023-06-01,55687,2,0,2,1,0,1
2023-06-01,138109,4,1,5,3,1,3
2023-06-01,138472,5,0,5,2,0,2
2023-06-01,137571,5,0,5,1,0,1
2023-06-01,138489,6,0,6,2,0,2
2023-06-01,138473,7,0,7,2,0,2
2023-06-01,138116,4,0,4,2,0,2
2023-06-01,135957,3,1,4,3,1,3
2023-06-01,135958,4,0,4,1,0,1
2023-06-01,135959,4,1,5,1,1,1
2023-06-01,131143,17,1,18,3,2,3
2023-06-01,138282,1,0,1,2,0,2
2023-06-01,139578,1,0,1,3,0,3
2023-06-01,138112,4,1,5,3,1,3
2023-06-01,131943,4,0,4,2,0,2
2023-06-01,138476,2,0,2,1,0,1
2023-06-01,138483,1,0,1,1,0,1
2023-06-01,138484,2,0,2,1,0,1
2023-06-01,138113,2,0,2,3,0,3
2023-06-01,138487,3,0,3,2,0,2
2023-06-01,132130,1,0,1,1,0,1
2023-06-01,138488,3,0,3,3,0,3
2023-06-01,138485,1,0,1,2,0,2
2023-06-01,150978,3,0,3,1,0,1
2023-06-01,131866,3,0,3,1,0,1
2023-06-01,138491,2,0,2,1,0,1
2023-06-01,150503,1,1,2,1,1,1
2023-06-01,138495,7,0,7,1,0,1
2023-06-01,138492,2,0,2,1,0,1
2023-06-01,134645,3,0,3,4,0,4
2023-06-01,138498,1,0,1,1,0,1
2023-06-01,138496,4,0,4,4,0,4
2023-06-01,133318,2,0,2,2,0,2
2023-06-01,135232,11,1,12,5,2,5
2023-06-01,138240,1,1,2,1,1,1
2023-06-01,150638,1,0,1,2,0,2
2023-06-01,138497,4,0,4,1,0,1
2023-06-01,138500,3,0,3,1,0,1
2023-06-01,138504,1,1,2,2,1,2
2023-06-01,138501,4,0,4,2,0,2
2023-06-01,138505,13,17,30,5,4,5
2023-06-01,138236,2,0,2,2,0,2
2023-06-01,131216,4,2,6,2,1,2
2023-06-01,138506,2,0,2,2,0,2
2023-06-01,138509,2,0,2,4,0,4
2023-06-01,135766,1,0,1,3,0,3
2023-06-01,150971,3,0,3,1,0,1
2023-06-01,138511,5,1,6,4,1,4
2023-06-01,58534,2,1,3,3,1,3
2023-06-01,138516,2,1,3,1,1,1
2023-06-01,138245,10,0,10,1,0,1
2023-06-01,135750,10,0,10,1,0,1
2023-06-01,138246,5,0,5,2,0,2
2023-06-01,138248,1,0,1,2,0,2
2023-06-01,138459,2,0,2,3,0,3
2023-06-01,139376,1,0,1,1,0,1
2023-06-01,138247,1,0,1,1,0,1
2023-06-01,138521,3,12,15,1,1,1
2023-06-01,138122,1,0,1,1,0,1
2023-06-01,138519,2,0,2,2,0,2
2023-06-01,138522,4,0,4,2,0,2
2023-06-01,138523,3,0,3,2,0,2
2023-06-01,138279,4,0,4,2,0,2
2023-06-01,135961,1,0,1,1,0,1
2023-06-01,10186,3,0,3,1,0,1
2023-06-01,131635,5,0,5,1,0,1
2023-06-01,139699,2,1,3,1,1,1
2023-06-01,138525,2,0,2,2,0,2
2023-06-01,138529,1,1,2,2,1,2
2023-06-01,138250,1,0,1,2,0,2
2023-06-01,136328,4,2,6,3,1,3
2023-06-01,133225,1,2,3,1,2,2
2023-06-01,134934,1,1,2,2,2,2
2023-06-01,131942,1,0,1,3,0,3
2023-06-01,132295,4,0,4,2,0,2
2023-06-01,138178,4,0,4,1,0,1
2023-06-01,134353,4,0,4,3,0,3
2023-06-01,138058,1,0,1,1,0,1
2023-06-01,7615,1,1,2,1,1,1
2023-06-01,135796,1,0,1,1,0,1
2023-06-01,137671,2,1,3,3,1,3
2023-06-01,135589,4,0,4,2,0,2
2023-06-01,135949,5,0,5,1,0,1
2023-06-01,137664,3,0,3,1,0,1
2023-06-01,151156,2,0,2,1,0,1
2023-06-01,137594,2,1,3,3,1,3
2023-06-01,138183,1,0,1,2,0,2
2023-06-01,138179,12,1,13,2,3,3
2023-06-01,138187,4,0,4,1,0,1
2023-06-01,138185,4,0,4,1,0,1
2023-06-01,57401,1,9,10,1,6,6
2023-06-01,131639,1,0,1,1,0,1
2023-06-01,138065,2,0,2,3,0,3
2023-06-01,135843,1,0,1,3,0,3
2023-06-01,138184,5,1,6,7,2,7
2023-06-01,17613,7,0,7,1,0,1
2023-06-01,137596,2,0,2,1,0,1
2023-06-01,138766,1,0,1,1,0,1
2023-06-01,138061,1,0,1,3,0,3
2023-06-01,138203,1,0,1,1,0,1
2023-06-01,138197,5,0,5,2,0,2
2023-06-01,138192,4,0,4,4,0,4
2023-06-01,139683,3,0,3,7,0,7
2023-06-01,138062,6,0,6,2,0,2
2023-06-01,138209,3,0,3,1,0,1
2023-06-01,137627,4,0,4,1,0,1
2023-06-01,138205,2,0,2,2,0,2
2023-06-01,138093,6,0,6,5,0,5
2023-06-01,138332,1,0,1,1,0,1
2023-06-01,138253,1,0,1,2,0,2
2023-06-01,131630,1,0,1,1,0,1
2023-06-01,138079,4,0,4,1,0,1
2023-06-01,138297,3,0,3,2,0,2
2023-06-01,141536,2,0,2,5,0,5
2023-06-01,134250,2,1,3,2,1,2
2023-06-01,138383,4,0,4,3,0,3
2023-06-01,139977,11,0,11,4,0,4
2023-06-01,150966,3,1,4,1,1,1
2023-06-01,131663,4,1,5,2,1,2
2023-06-01,138300,4,0,4,2,0,2
2023-06-01,138224,2,1,3,2,2,2
2023-06-01,138336,5,16,21,2,1,2
2023-06-01,151077,1,0,1,1,0,1
2023-06-01,150731,1,0,1,1,0,1
2023-06-01,131636,6,1,7,5,2,5
2023-06-01,138340,4,0,4,3,0,3
2023-06-01,138339,1,0,1,2,0,2
2023-06-01,138359,2,1,3,4,2,4
2023-06-01,18030,2,2,4,1,2,3
2023-06-01,138338,4,17,21,2,2,2
2023-06-01,138343,4,0,4,5,0,5
2023-06-01,138083,1,0,1,1,0,1
2023-06-01,150842,2,0,2,2,0,2
2023-06-01,138304,1,0,1,2,0,2
2023-06-01,139028,3,0,3,2,0,2
2023-06-01,138097,1,0,1,3,0,3
2023-06-01,138350,1,0,1,1,0,1
2023-06-01,135953,1,1,2,2,1,2
2023-06-01,135951,26,1,27,1,1,1
2023-06-01,7513,12,0,12,2,0,2
2023-06-01,63910,1,1,2,1,1,1
2023-06-01,139410,2,0,2,1,0,1
2023-06-01,150162,1,1,2,1,1,1
2023-06-01,138080,2,0,2,1,0,1
2023-06-01,136643,3,0,3,1,0,1
2023-06-01,138084,1,0,1,3,0,3
2023-06-01,150160,3,0,3,2,0,2
2023-06-01,138458,2,0,2,3,0,3
2023-06-01,138353,1,0,1,1,0,1
2023-06-01,138502,2,0,2,1,0,1
2023-06-01,9540,2,0,2,1,0,1
2023-06-01,138355,4,0,4,1,0,1
2023-06-01,151184,3,0,3,2,0,2
2023-06-01,135952,4,0,4,4,0,4
2023-06-01,138357,2,0,2,3,0,3
2023-06-01,133528,4,0,4,3,0,3
2023-06-01,138092,1,0,1,1,0,1
2023-06-01,17448,1,0,1,3,0,3
2023-06-01,151183,2,0,2,2,0,2
2023-06-01,59151,5,1,6,5,2,5
2023-06-01,138360,2,0,2,3,0,3
2023-06-01,138361,3,0,3,3,0,3
2023-06-01,138362,5,5,10,5,3,5
2023-06-01,63801,3,1,4,1,2,2
2023-06-01,63800,1,1,2,3,2,3
2023-06-01,151062,0,2,2,3,5,6
2023-06-01,138363,2,0,2,1,0,1
2023-06-01,140932,1,0,1,1,0,1
2023-06-01,139743,1,0,1,2,0,2
2023-06-01,55494,5,0,5,5,0,5
2023-06-01,54470,3,0,3,2,0,2
2023-06-01,135134,1,6,7,1,2,2
2023-06-01,138916,1,0,1,1,0,1
2023-06-01,133218,2,0,2,3,0,3
2023-06-01,2515,4,1,5,7,3,7
2023-06-01,134486,1,0,1,3,0,3
2023-06-01,136527,1,0,1,2,0,2
2023-06-01,138367,2,0,2,2,0,2
2023-06-01,138368,5,16,21,2,1,2
2023-06-01,63488,4,0,4,1,0,1
2023-06-01,138372,1,0,1,1,0,1
2023-06-01,18064,1,0,1,1,0,1
2023-06-01,9910,3,0,3,4,0,4
2023-06-01,134655,8,1,9,5,1,5
2023-06-01,151160,2,0,2,1,0,1
2023-06-01,138526,1,0,1,1,0,1
2023-06-01,138528,5,0,5,4,0,4
2023-06-01,131736,18,1,19,3,1,3
2023-06-01,138125,1,0,1,1,0,1
2023-06-01,139839,2,0,2,2,0,2
2023-06-01,138252,4,0,4,2,0,2
2023-06-01,147243,3,0,3,1,0,1
2023-06-01,138264,1,0,1,1,0,1
2023-06-01,10157,1,0,1,1,0,1
2023-06-01,17602,4,0,4,2,0,2
2023-06-01,150970,3,0,3,1,0,1
2023-06-01,131675,3,15,18,4,11,11
2023-06-01,138123,7,0,7,7,0,7
2023-06-01,135726,4,1,5,2,1,2
2023-06-01,138534,4,1,5,2,1,2
2023-06-01,58469,2,0,2,2,0,2
2023-06-01,138124,1,0,1,1,0,1
2023-06-01,138540,2,0,2,2,0,2
2023-06-01,138539,1,0,1,1,0,1
2023-06-01,59178,2,0,2,1,0,1
2023-06-01,138796,6,0,6,2,0,2
2023-06-01,138316,2,0,2,1,0,1
2023-06-01,138543,2,1,3,4,1,4
2023-06-01,139980,2,1,3,2,1,2
2023-06-01,138272,8,0,8,3,0,3
2023-06-01,138541,2,0,2,3,0,3
2023-06-01,138544,4,0,4,3,0,3
2023-06-01,138550,2,0,2,1,0,1
2023-06-01,138551,2,1,3,1,1,1
2023-06-01,138552,1,1,2,7,4,7
2023-06-01,58418,2,0,2,3,0,3
2023-06-01,138274,3,0,3,3,0,3
2023-06-01,137759,2,0,2,1,0,1
2023-06-01,138557,4,1,5,3,1,3
2023-06-01,138549,6,0,6,3,0,3
2023-06-01,138556,3,1,4,2,1,2
2023-06-01,138127,3,1,4,2,1,2
2023-06-01,133451,4,0,4,3,0,3
2023-06-01,138318,1,1,2,1,1,1
2023-06-01,138129,4,0,4,1,0,1
2023-06-01,136327,2,1,3,2,1,2
2023-06-01,134392,2,2,4,2,2,2
2023-06-01,135413,3,0,3,3,0,3
2023-06-01,138559,6,0,6,2,0,2
2023-06-01,138562,1,0,1,3,0,3
2023-06-01,138563,1,0,1,1,0,1
2023-06-01,138561,4,0,4,3,0,3
2023-06-01,138565,1,0,1,1,0,1
2023-06-01,45527,2,0,2,1,0,1
2023-06-01,138267,5,0,5,2,0,2
2023-06-01,138566,4,0,4,1,0,1
2023-06-01,45325,24,4,28,4,2,4
2023-06-01,138133,1,0,1,1,0,1
2023-06-01,131637,1,0,1,1,0,1
2023-06-01,138275,2,0,2,1,0,1
2023-06-01,138134,4,1,5,3,1,3
2023-06-01,141498,4,0,4,1,0,1
2023-06-01,138567,4,0,4,2,0,2
2023-06-01,138569,3,0,3,2,0,2
2023-06-01,55305,5,0,5,1,0,1
2023-06-01,138310,1,0,1,2,0,2
2023-06-01,138278,4,1,5,2,1,2
2023-06-01,138574,2,1,3,3,1,3
2023-06-01,140107,63,0,63,5,0,5
2023-06-01,138575,4,82,86,1,1,1
2023-06-01,138139,3,0,3,2,0,2
2023-06-01,140429,2,1,3,3,2,3
2023-06-01,141125,2,0,2,5,0,5
2023-06-01,38776,4,0,4,1,0,1
2023-06-01,138578,5,0,5,1,0,1
2023-06-01,133968,14,1,15,2,2,2
2023-06-01,138582,4,0,4,3,0,3
2023-06-01,133037,5,1,6,2,1,2
2023-06-01,138573,2,0,2,1,0,1
2023-06-01,38868,11,0,11,3,0,3
2023-06-01,138581,4,0,4,1,0,1
2023-06-01,138585,1,0,1,2,0,2
2023-06-01,138583,1,0,1,1,0,1
2023-06-01,133191,4,0,4,3,0,3
2023-06-01,134715,13,9,22,3,3,3
2023-06-01,141322,7,1,8,4,1,4
2023-06-01,151214,3,0,3,2,0,2
2023-06-01,135836,4,0,4,3,0,3
2023-06-01,138587,2,0,2,1,0,1
2023-06-01,138590,4,0,4,1,0,1
2023-06-01,18188,3,0,3,5,0,5
2023-06-01,138592,2,0,2,3,0,3
2023-06-01,138142,1,1,2,1,1,1
2023-06-01,138144,1,0,1,1,0,1
2023-06-01,138141,3,0,3,1,0,1
2023-06-01,136003,1,0,1,2,0,2
2023-06-01,136022,4,0,4,1,0,1
2023-06-01,138315,6,1,7,2,1,2
2023-06-01,138613,1,0,1,1,0,1
2023-06-01,138051,1,0,1,1,0,1
2023-06-01,138600,6,0,6,3,0,3
2023-06-01,38447,2,2,4,1,1,1
2023-06-01,138605,2,0,2,1,0,1
2023-06-01,131720,1,0,1,1,0,1
2023-06-01,138143,3,3,6,2,1,3
2023-06-01,138602,1,0,1,1,0,1
2023-06-01,139943,1,0,1,2,0,2
2023-06-01,9729,153,1,154,15,2,15
2023-06-01,45485,4,0,4,2,0,2
2023-06-01,138601,6,0,6,3,0,3
2023-06-01,138606,5,0,5,3,0,3
2023-06-01,138235,6,4,10,1,1,1
2023-06-01,134308,4,0,4,2,0,2
2023-06-01,135715,4,0,4,3,0,3
2023-06-01,131645,12,51,63,3,3,3
2023-06-01,138612,2,0,2,2,0,2
2023-06-01,134870,4,0,4,1,0,1
2023-06-01,138778,2,1,3,1,1,1
2023-06-01,138710,4,0,4,3,0,3
2023-06-01,138614,2,0,2,3,0,3
2023-06-01,138615,1,0,1,3,0,3
2023-06-01,138629,7,0,7,2,0,2
2023-06-01,132129,4,1,5,3,1,3
2023-06-01,138619,1,0,1,2,0,2
2023-06-01,149311,2,0,2,1,0,1
2023-06-01,139673,2,0,2,2,0,2
2023-06-01,132216,1,0,1,1,0,1
2023-06-01,138807,1,0,1,1,0,1
2023-06-01,149768,8,1,9,2,1,2
2023-06-01,138810,4,1,5,3,1,3
2023-06-01,138624,2,1,3,3,1,3
2023-06-01,138622,4,1,5,2,1,2
2023-06-01,138625,7,0,7,3,0,3
2023-06-01,131773,4,0,4,4,0,4
2023-06-01,149942,2,0,2,2,0,2
2023-06-01,138786,4,0,4,2,0,2
2023-06-01,138621,1,1,2,2,2,3
2023-06-01,138781,4,0,4,1,0,1
2023-06-01,138922,1,0,1,1,0,1
2023-06-01,138805,2,0,2,1,0,1
2023-06-01,135962,1,0,1,2,0,2
2023-06-01,138634,2,0,2,2,0,2
2023-06-01,139291,3,0,3,3,0,3
2023-06-01,138812,1,0,1,1,0,1
2023-06-01,138788,3,0,3,4,0,4
2023-06-01,46026,14,0,14,4,0,4
2023-06-01,138636,4,0,4,2,0,2
2023-06-01,138637,5,1,6,5,1,5
2023-06-01,138638,5,2,7,4,1,4
2023-06-01,45658,3,0,3,2,0,2
2023-06-01,138633,4,1,5,1,1,1
2023-06-01,138642,1,0,1,2,0,2
2023-06-01,138639,1,0,1,2,0,2
2023-06-01,18416,0,0,0,2,0,2
2023-06-01,138649,3,7,10,1,1,1
2023-06-01,138651,2,0,2,2,0,2
2023-06-01,138806,5,1,6,3,2,3
2023-06-01,138661,1,0,1,1,0,1
2023-06-01,138782,2,1,3,1,1,1
2023-06-01,141497,4,1,5,1,1,1
2023-06-01,137746,3,0,3,3,0,3
2023-06-01,137745,1,0,1,2,0,2
2023-06-01,138798,4,0,4,1,0,1
2023-06-01,138658,6,0,6,4,0,4
2023-06-01,135405,7,0,7,5,0,5
2023-06-01,138871,8,0,8,3,0,3
2023-06-01,135872,33,1,34,3,1,3
2023-06-01,138653,1,1,2,1,1,2
2023-06-01,138659,4,0,4,2,0,2
2023-06-01,138652,1,1,2,1,1,1
2023-06-01,132531,1,0,1,2,0,2
2023-06-01,138662,1,0,1,1,0,1
2023-06-01,139325,7,0,7,2,0,2
2023-06-01,138665,2,0,2,2,0,2
2023-06-01,138859,1,0,1,1,0,1
2023-06-01,138673,1,0,1,1,0,1
2023-06-01,132824,1,0,1,1,0,1
2023-06-01,138800,7,1,8,2,1,2
2023-06-01,139884,2,0,2,1,0,1
2023-06-01,138783,4,1,5,3,1,3
2023-06-01,138670,5,0,5,3,0,3
2023-06-01,138697,3,0,3,3,0,3
2023-06-01,138671,4,0,4,1,0,1
2023-06-01,59132,2,0,2,2,0,2
2023-06-01,138680,1,0,1,1,0,1
2023-06-01,138696,1,0,1,2,0,2
2023-06-01,138706,4,0,4,2,0,2
2023-06-01,138682,3,0,3,1,0,1
2023-06-01,138683,1,0,1,1,0,1
2023-06-01,135168,3,1,4,1,1,1
2023-06-01,138684,5,1,6,5,1,5
2023-06-01,138908,4,0,4,2,0,2
2023-06-01,138688,3,0,3,3,0,3
2023-06-01,138689,2,0,2,2,0,2
2023-06-01,138616,1,1,2,3,3,3
2023-06-01,138709,3,0,3,2,0,2
2023-06-01,138816,2,0,2,1,0,1
2023-06-01,138576,1,0,1,1,0,1
2023-06-01,138692,4,0,4,1,0,1
2023-06-01,138694,4,0,4,3,0,3
2023-06-01,45801,2,0,2,2,0,2
2023-06-01,17502,2,0,2,1,0,1
2023-06-01,133409,2,0,2,1,0,1
2023-06-01,138784,1,0,1,1,0,1
2023-06-01,138902,1,0,1,1,0,1
2023-06-01,138903,2,0,2,2,0,2
2023-06-01,138904,2,0,2,1,0,1
2023-06-01,138777,1,0,1,1,0,1
2023-06-01,134658,7,0,7,3,0,3
2023-06-01,138825,1,0,1,1,0,1
2023-06-01,24190,7,0,7,4,0,4
2023-06-01,138907,2,0,2,2,0,2
2023-06-01,139583,1,0,1,3,0,3
2023-06-01,150096,1,0,1,1,0,1
2023-06-01,138912,1,1,2,2,1,2
2023-06-01,138824,3,0,3,1,0,1
2023-06-01,138776,2,1,3,1,1,1
2023-06-01,138711,1,0,1,2,0,2
2023-06-01,138906,1,1,2,2,1,2
2023-06-01,18053,7,0,7,1,0,1
2023-06-01,46055,6,0,6,3,0,3
2023-06-01,138743,1,0,1,1,0,1
2023-06-01,138822,2,0,2,1,0,1
2023-06-01,136272,7,2,9,2,1,2
2023-06-01,138917,2,0,2,2,0,2
2023-06-01,138921,1,0,1,1,0,1
2023-06-01,151093,1,0,1,1,0,1
2023-06-01,151327,3,0,3,1,0,1
2023-06-01,150035,1,0,1,1,0,1
2023-06-01,138924,1,0,1,1,0,1
2023-06-01,24302,2,1,3,1,1,1
2023-06-01,138747,1,0,1,1,0,1
2023-06-01,131642,14,6,20,2,2,3
2023-06-01,147026,3,0,3,1,0,1
2023-06-01,139282,3,0,3,2,0,2
2023-06-01,138734,5,1,6,1,1,2
2023-06-01,138933,1,0,1,1,0,1
2023-06-01,138745,2,0,2,1,0,1
2023-06-01,139707,1,0,1,1,0,1
2023-06-01,138940,1,0,1,3,0,3
2023-06-01,138941,1,0,1,3,0,3
2023-06-01,138839,4,0,4,6,0,6
2023-06-01,138832,3,0,3,1,0,1
2023-06-01,138830,2,0,2,1,0,1
2023-06-01,138945,2,0,2,3,0,3
2023-06-01,139310,1,0,1,1,0,1
2023-06-01,138943,5,0,5,1,0,1
2023-06-01,138853,1,0,1,1,0,1
2023-06-01,138837,3,0,3,2,0,2
2023-06-01,138944,2,0,2,1,0,1
2023-06-01,138849,2,0,2,1,0,1
2023-06-01,138994,3,0,3,3,0,3
2023-06-01,23999,2,0,2,2,0,2
2023-06-01,138953,1,0,1,1,0,1
2023-06-01,138954,1,0,1,1,0,1
2023-06-01,139600,0,0,0,5,0,5
2023-06-01,139809,3,0,3,1,0,1
2023-06-01,138956,1,0,1,2,0,2
2023-06-01,138957,1,0,1,3,0,3
2023-06-01,138836,1,0,1,2,0,2
2023-06-01,138961,3,0,3,3,0,3
2023-06-01,135969,2,0,2,1,0,1
2023-06-01,138962,2,0,2,3,0,3
2023-06-01,138964,5,0,5,1,0,1
2023-06-01,138969,1,0,1,1,0,1
2023-06-01,138970,1,0,1,3,0,3
2023-06-01,138967,1,0,1,2,0,2
2023-06-01,132972,4,2,6,4,4,4
2023-06-01,138719,1,0,1,1,0,1
2023-06-01,142128,1,0,1,1,0,1
2023-06-01,151318,3,1,4,2,1,2
2023-06-01,131949,3,1,4,3,3,3
2023-06-01,131945,1,0,1,3,0,3
2023-06-01,138973,2,1,3,6,2,7
2023-06-01,138977,1,0,1,3,0,3
2023-06-01,138976,1,0,1,3,0,3
2023-06-01,138833,2,0,2,1,0,1
2023-06-01,138752,2,0,2,2,0,2
2023-06-01,139946,3,0,3,3,0,3
2023-06-01,138835,1,0,1,2,0,2
2023-06-01,138751,4,0,4,3,0,3
2023-06-01,138983,3,0,3,3,0,3
2023-06-01,135745,1,0,1,1,0,1
2023-06-01,138988,1,0,1,4,0,4
2023-06-01,139084,2,1,3,2,2,3
2023-06-01,138720,6,0,6,2,0,2
2023-06-01,138985,4,0,4,2,0,2
2023-06-01,138733,1,0,1,1,0,1
2023-06-01,138843,2,1,3,1,1,1
2023-06-01,138996,1,0,1,1,0,1
2023-06-01,138842,5,0,5,3,0,3
2023-06-01,138845,1,0,1,1,0,1
2023-06-01,136439,1,0,1,1,0,1
2023-06-01,138999,2,0,2,2,0,2
2023-06-01,139000,1,0,1,3,0,3
2023-06-01,131655,3,2,5,2,1,2
2023-06-01,139002,1,1,2,1,1,2
2023-06-01,138726,3,1,4,2,2,2
2023-06-01,139417,2,3,5,4,2,4
2023-06-01,132690,3,0,3,3,0,3
2023-06-01,139004,3,0,3,2,0,2
2023-06-01,139012,2,1,3,2,1,2
2023-06-01,138851,1,1,2,1,1,1
2023-06-01,139005,2,2,4,4,4,4
2023-06-01,24511,1,1,2,1,1,1
2023-06-01,138785,2,0,2,3,0,3
2023-06-01,138735,4,0,4,1,0,1
2023-06-01,139014,2,0,2,2,0,2
2023-06-01,140635,3,0,3,4,0,4
2023-06-01,139011,1,0,1,5,0,5
2023-06-01,138850,1,0,1,1,0,1
2023-06-01,139008,2,2,4,2,2,2
2023-06-01,149058,1,9,10,2,2,2
2023-06-01,139042,1,3,4,1,1,1
2023-06-01,139020,1,0,1,1,0,1
2023-06-01,135363,5,0,5,2,0,2
2023-06-01,139924,3,1,4,2,1,2
2023-06-01,139024,1,0,1,1,0,1
2023-06-01,139026,3,0,3,3,0,3
2023-06-01,139027,4,0,4,3,0,3
2023-06-01,139030,3,0,3,1,0,1
2023-06-01,139032,2,0,2,1,0,1
2023-06-01,139033,3,0,3,2,0,2
2023-06-01,135428,1,0,1,1,0,1
2023-06-01,138772,2,1,3,2,1,2
2023-06-01,139034,11,0,11,1,0,1
2023-06-01,139036,2,0,2,3,0,3
2023-06-01,136379,2,0,2,3,0,3
2023-06-01,138727,5,0,5,3,0,3
2023-06-01,139037,1,0,1,1,0,1
2023-06-01,132169,3,0,3,1,0,1
2023-06-01,138852,1,0,1,1,0,1
2023-06-01,139038,1,0,1,1,0,1
2023-06-01,139039,3,0,3,2,0,2
2023-06-01,138854,4,1,5,8,2,8
2023-06-01,150129,2,0,2,2,0,2
2023-06-01,139043,9,0,9,1,0,1
2023-06-01,139044,1,0,1,1,0,1
2023-06-01,139041,2,0,2,2,0,2
2023-06-01,149258,3,0,3,3,0,3
2023-06-01,133242,2,0,2,2,0,2
2023-06-01,135217,3,1,4,4,1,4
2023-06-01,137155,1,0,1,1,0,1
2023-06-01,139048,3,0,3,2,0,2
2023-06-01,139053,4,0,4,5,0,5
2023-06-01,150170,2,0,2,2,0,2
2023-06-01,10123,1,0,1,1,0,1
2023-06-01,135971,1,0,1,2,0,2
2023-06-01,135972,1,1,2,2,1,2
2023-06-01,139052,2,17,19,1,1,1
2023-06-01,139060,2,0,2,1,0,1
2023-06-01,132655,2,0,2,3,0,3
2023-06-01,138878,1,0,1,2,0,2
2023-06-01,138860,5,0,5,4,0,4
2023-06-01,138731,5,1,6,3,2,4
2023-06-01,400441,2,0,2,1,0,1
2023-06-01,135973,1,1,2,1,1,1
2023-06-01,140807,8,1,9,1,1,1
2023-06-01,138732,1,0,1,1,0,1
2023-06-01,139067,1,0,1,1,0,1
2023-06-01,139069,1,0,1,1,0,1
2023-06-01,138760,3,0,3,1,0,1
2023-06-01,139063,1,0,1,1,0,1
2023-06-01,139074,1,2,3,7,2,8
2023-06-01,138767,4,0,4,1,0,1
2023-06-01,23954,6,0,6,8,0,8
2023-06-01,17844,2,0,2,2,0,2
2023-06-01,17580,1,0,1,2,0,2
2023-06-01,54201,4,42,46,5,19,19
2023-06-01,139240,1,1,2,1,1,1
2023-06-01,138858,2,0,2,1,0,1
2023-06-01,133510,2,0,2,1,0,1
2023-06-01,138862,2,0,2,2,0,2
2023-06-01,139071,3,0,3,1,0,1
2023-06-01,139077,4,0,4,4,0,4
2023-06-01,63780,1,1,2,2,1,2
2023-06-01,139082,1,0,1,1,0,1
2023-06-01,45259,2,1,3,7,3,8
2023-06-01,138893,1,0,1,2,0,2
2023-06-01,135002,4,0,4,3,0,3
2023-06-01,139521,1,1,2,4,1,4
2023-06-01,138736,3,0,3,2,0,2
2023-06-01,150439,1,0,1,1,0,1
2023-06-01,139193,1,0,1,1,0,1
2023-06-01,149964,3,0,3,3,0,3
2023-06-01,134841,8,0,8,4,0,4
2023-06-01,149965,2,0,2,2,0,2
2023-06-01,139087,2,0,2,2,0,2
2023-06-01,139196,1,0,1,1,0,1
2023-06-01,135974,1,0,1,1,0,1
2023-06-01,139197,3,1,4,1,1,1
2023-06-01,138863,2,0,2,1,0,1
2023-06-01,139090,1,1,2,1,1,1
2023-06-01,138864,2,1,3,2,2,2
2023-06-01,139219,3,0,3,1,0,1
2023-06-01,137871,2,0,2,3,0,3
2023-06-01,138844,1,0,1,2,0,2
2023-06-01,139250,2,1,3,1,1,1
2023-06-01,138739,1,0,1,2,0,2
2023-06-01,138901,1,0,1,1,0,1
2023-06-01,138768,1,0,1,3,0,3
2023-06-01,134894,1,0,1,2,0,2
2023-06-01,139202,3,0,3,1,0,1
2023-06-01,134868,3,3,6,3,5,5
2023-06-01,139206,1,0,1,1,0,1
2023-06-01,150513,2,0,2,3,0,3
2023-06-01,24222,10,0,10,5,0,5
2023-06-01,17616,4,0,4,2,0,2
2023-06-01,138773,2,0,2,2,0,2
2023-06-01,138741,4,0,4,1,0,1
2023-06-01,141818,3,1,4,1,1,2
2023-06-01,138750,2,0,2,1,0,1
2023-06-01,139214,1,0,1,1,0,1
2023-06-01,139217,2,0,2,2,0,2
2023-06-01,133308,1,0,1,1,0,1
2023-06-01,63779,1,0,1,2,0,2
2023-06-01,131651,8,0,8,3,0,3
2023-06-01,133592,2,0,2,2,0,2
2023-06-01,138865,7,0,7,5,0,5
2023-06-01,135781,2,16,18,3,2,5
2023-06-01,139213,2,0,2,4,0,4
2023-06-01,139221,1,1,2,1,1,1
2023-06-01,139222,1,0,1,2,0,2
2023-06-01,139223,2,0,2,1,0,1
2023-06-01,139224,3,0,3,1,0,1
2023-06-01,139256,2,0,2,1,0,1
2023-06-01,139225,1,1,2,9,3,10
2023-06-01,135977,1,0,1,1,0,1
2023-06-01,24144,4,2,6,1,1,1
2023-06-01,147001,1,0,1,1,0,1
2023-06-01,134356,2,5,7,2,3,3
2023-06-01,17605,2,0,2,1,0,1
2023-06-01,138755,2,0,2,2,0,2
2023-06-01,138897,1,0,1,1,0,1
2023-06-01,139227,2,0,2,2,0,2
2023-06-01,146931,2,143,145,2,1,3
2023-06-01,138882,1,0,1,1,0,1
2023-06-01,139234,1,0,1,1,0,1
2023-06-01,135978,1,0,1,1,0,1
2023-06-01,135980,2,1,3,2,1,2
2023-06-01,150083,2,0,2,1,0,1
2023-06-01,138756,3,0,3,3,0,3
2023-06-01,139237,1,0,1,1,0,1
2023-06-01,138868,3,0,3,1,0,1
2023-06-01,137839,2,0,2,1,0,1
2023-06-01,132143,1,0,1,1,0,1
2023-06-01,139241,1,0,1,1,0,1
2023-06-01,139239,3,0,3,1,0,1
2023-06-01,139236,3,0,3,2,0,2
2023-06-01,138891,2,1,3,3,1,3
2023-06-01,138873,1,0,1,3,0,3
2023-06-01,132290,2,0,2,2,0,2
2023-06-01,139246,1,0,1,1,0,1
2023-06-01,139245,3,1,4,5,2,5
2023-06-01,138876,2,1,3,1,1,2
2023-06-01,139244,1,0,1,2,0,2
2023-06-01,139230,1,0,1,2,0,2
2023-06-01,139251,3,1,4,2,1,2
2023-06-01,139253,4,0,4,2,0,2
2023-06-01,138875,2,0,2,4,0,4
2023-06-01,139255,2,0,2,1,0,1
2023-06-01,58768,11,7,18,4,2,4
2023-06-01,131982,2,1,3,2,2,2
2023-06-01,139260,1,1,2,1,1,1
2023-06-01,134964,1,0,1,3,0,3
2023-06-01,138758,2,0,2,1,0,1
2023-06-01,138866,3,2,5,8,5,8
2023-06-01,139261,3,0,3,1,0,1
2023-06-01,138261,2,0,2,1,0,1
2023-06-01,138545,5,0,5,3,0,3
2023-06-01,135642,1,0,1,2,0,2
2023-06-01,136391,1,0,1,1,0,1
2023-06-01,139262,1,0,1,1,0,1
2023-06-01,139266,2,0,2,1,0,1
2023-06-01,138765,1,1,2,1,1,1
2023-06-01,139276,2,0,2,3,0,3
2023-06-01,139271,1,0,1,1,0,1
2023-06-01,139273,1,0,1,1,0,1
2023-06-01,141398,3,0,3,2,0,2
2023-06-01,139270,1,0,1,1,0,1
2023-06-01,139279,1,1,2,2,1,2
2023-06-01,139280,3,0,3,2,0,2
2023-06-01,139278,1,0,1,1,0,1
2023-06-01,133702,2,0,2,1,0,1
2023-06-01,138880,1,0,1,1,0,1
2023-06-01,138761,2,0,2,1,0,1
2023-06-01,151197,1,0,1,2,0,2
2023-06-01,139695,1,0,1,1,0,1
2023-06-01,139694,1,0,1,1,0,1
2023-06-01,134656,2,0,2,3,0,3
2023-06-01,139284,3,0,3,1,0,1
2023-06-01,139283,3,0,3,1,0,1
2023-06-01,139290,1,0,1,2,0,2
2023-06-01,139288,1,1,2,1,1,1
2023-06-01,139292,3,0,3,3,0,3
2023-06-01,139289,1,0,1,2,0,2
2023-06-01,139287,2,2,4,1,1,1
2023-06-01,138660,2,0,2,2,0,2
2023-06-01,139285,3,0,3,5,0,5
2023-06-01,139293,2,0,2,1,0,1
2023-06-01,138762,3,1,4,1,1,1
2023-06-01,139304,1,0,1,1,0,1
2023-06-01,138801,2,1,3,1,1,1
2023-06-01,139300,2,1,3,1,1,1
2023-06-01,139302,2,1,3,1,1,1
2023-06-01,139301,2,2,4,6,4,6
2023-06-01,139296,1,0,1,1,0,1
2023-06-01,139303,1,0,1,1,0,1
2023-06-01,9693,10,0,10,2,0,2
2023-06-01,138887,3,1,4,3,2,3
2023-06-01,138791,2,0,2,1,0,1
2023-06-01,139313,2,0,2,2,0,2
2023-06-01,139315,1,0,1,1,0,1
2023-06-01,137503,3,0,3,2,0,2
2023-06-01,139314,2,0,2,1,0,1
2023-06-01,23827,4,1,5,5,2,5
2023-06-01,140682,1,0,1,1,0,1
2023-06-01,138894,3,0,3,1,0,1
2023-06-01,139320,1,0,1,2,0,2
2023-06-01,132872,1,0,1,1,0,1
2023-06-01,134359,3,0,3,3,0,3
2023-06-01,131955,3,0,3,2,0,2
2023-06-01,133693,1,0,1,1,0,1
2023-06-01,135847,3,0,3,2,0,2
2023-06-01,138895,3,0,3,2,0,2
2023-06-01,139326,2,0,2,3,0,3
2023-06-01,139327,13,0,13,2,0,2
2023-06-01,138892,2,0,2,1,0,1
2023-06-01,139331,2,3,5,1,1,1
2023-06-01,150590,1,0,1,1,0,1
2023-06-01,132999,2,0,2,1,0,1
2023-06-01,131966,2,0,2,3,0,3
2023-06-01,17931,9,1,10,4,3,4
2023-06-01,138794,1,0,1,1,0,1
2023-06-01,135287,2,0,2,1,0,1
2023-06-01,134943,6,0,6,3,0,3
2023-06-01,140525,4,0,4,2,0,2
2023-06-01,139339,4,0,4,1,0,1
2023-06-01,139333,1,0,1,2,0,2
2023-06-01,139338,2,0,2,3,0,3
2023-06-01,137617,2,0,2,2,0,2
2023-06-01,139343,2,0,2,1,0,1
2023-06-01,140818,1,1,2,1,1,1
2023-06-01,138890,2,0,2,2,0,2
2023-06-01,138898,2,0,2,1,0,1
2023-06-01,138896,1,0,1,1,0,1
2023-06-01,134924,2,0,2,2,0,2
2023-06-01,141114,2,1,3,5,2,6
2023-06-01,150519,1,0,1,1,0,1
2023-06-01,141441,1,1,2,3,1,3
2023-06-01,139682,1,0,1,1,0,1
2023-06-01,139356,1,0,1,1,0,1
2023-06-01,139357,1,0,1,1,0,1
2023-06-01,131847,1,0,1,1,0,1
2023-06-01,136644,3,1,4,4,2,4
2023-06-01,139463,1,0,1,3,0,3
2023-06-01,139466,1,1,2,1,1,1
2023-06-01,147050,4,1,5,4,1,4
2023-06-01,139642,1,0,1,1,0,1
2023-06-01,139464,3,0,3,3,0,3
2023-06-01,139467,2,0,2,3,0,3
2023-06-01,56035,16,0,16,7,0,7
2023-06-01,139930,1,0,1,1,0,1
2023-06-01,139473,1,0,1,2,0,2
2023-06-01,136977,1,1,2,1,1,1
2023-06-01,136508,1,0,1,2,0,2
2023-06-01,136529,1,0,1,1,0,1
2023-06-01,135177,4,14,18,3,3,3
2023-06-01,139363,2,0,2,1,0,1
2023-06-01,139577,2,0,2,3,0,3
2023-06-01,139366,3,1,4,1,1,1
2023-06-01,139364,2,1,3,4,1,4
2023-06-01,136347,1,0,1,1,0,1
2023-06-01,139367,1,1,2,3,1,3
2023-06-01,134914,2,0,2,3,0,3
2023-06-01,139365,3,0,3,2,0,2
2023-06-01,139581,1,0,1,1,0,1
2023-06-01,139579,1,0,1,1,0,1
2023-06-01,150164,3,0,3,2,0,2
2023-06-01,139582,1,0,1,1,0,1
2023-06-01,139588,2,1,3,2,2,3
2023-06-01,18268,9,1,10,7,3,7
2023-06-01,136285,2,16,18,5,3,5
2023-06-01,131952,5,0,5,2,0,2
2023-06-01,139375,1,0,1,1,0,1
2023-06-01,133725,3,1,4,2,1,2
2023-06-01,45264,3,0,3,4,0,4
2023-06-01,135982,2,0,2,2,0,2
2023-06-01,139371,2,0,2,3,0,3
2023-06-01,139590,3,5,8,3,2,3
2023-06-01,139595,2,0,2,1,0,1
2023-06-01,135584,1,0,1,2,0,2
2023-06-01,139599,1,0,1,2,0,2
2023-06-01,139605,4,0,4,1,0,1
2023-06-01,139369,2,0,2,2,0,2
2023-06-01,139372,1,0,1,1,0,1
2023-06-01,139520,2,0,2,2,0,2
2023-06-01,139602,2,4,6,3,1,3
2023-06-01,139575,3,0,3,2,0,2
2023-06-01,139603,4,0,4,1,0,1
2023-06-01,139480,1,0,1,4,0,4
2023-06-01,139604,3,0,3,3,0,3
2023-06-01,139368,2,0,2,1,0,1
2023-06-01,139370,5,1,6,1,1,1
2023-06-01,56006,4,2,6,6,4,6
2023-06-01,133400,1,0,1,1,0,1
2023-06-01,139477,1,0,1,1,0,1
2023-06-01,139524,2,0,2,1,0,1
2023-06-01,139522,1,0,1,2,0,2
2023-06-01,139614,1,0,1,1,0,1
2023-06-01,131957,5,1,6,1,1,1
2023-06-01,139547,2,0,2,1,0,1
2023-06-01,135986,3,1,4,1,1,1
2023-06-01,45532,6,0,6,3,0,3
2023-06-01,139478,2,0,2,2,0,2
2023-06-01,139182,1,0,1,2,0,2
2023-06-01,139479,1,0,1,2,0,2
2023-06-01,133675,0,0,0,2,0,2
2023-06-01,142454,6,2,8,2,1,2
2023-06-01,139631,1,0,1,2,0,2
2023-06-01,139622,1,0,1,1,0,1
2023-06-01,139632,1,1,2,2,1,2
2023-06-01,139627,1,0,1,1,0,1
2023-06-01,139635,2,0,2,1,0,1
2023-06-01,139629,2,0,2,3,0,3
2023-06-01,139377,2,0,2,1,0,1
2023-06-01,139379,2,0,2,1,0,1
2023-06-01,139378,3,1,4,1,1,1
2023-06-01,136746,2,0,2,1,0,1
2023-06-01,139387,2,0,2,2,0,2
2023-06-01,139651,1,0,1,1,0,1
2023-06-01,139383,1,0,1,1,0,1
2023-06-01,139630,1,0,1,1,0,1
2023-06-01,136766,2,0,2,1,0,1
2023-06-01,139384,1,0,1,1,0,1
2023-06-01,139633,3,0,3,3,0,3
2023-06-01,139636,1,1,2,2,2,2
2023-06-01,138433,3,2,5,3,2,3
2023-06-01,139382,2,0,2,3,0,3
2023-06-01,59158,4,0,4,4,0,4
2023-06-01,139380,2,0,2,2,0,2
2023-06-01,139386,2,0,2,1,0,1
2023-06-01,139643,2,0,2,2,0,2
2023-06-01,139385,1,0,1,1,0,1
2023-06-01,139483,1,0,1,1,0,1
2023-06-01,139404,3,1,4,1,1,1
2023-06-01,139484,2,2,4,1,1,1
2023-06-01,139428,4,1,5,9,1,9
2023-06-01,139405,1,0,1,1,0,1
2023-06-01,139431,1,0,1,1,0,1
2023-06-01,139647,2,0,2,2,0,2
2023-06-01,139486,1,0,1,1,0,1
2023-06-01,139650,2,0,2,1,0,1
2023-06-01,38313,9,0,9,3,0,3
2023-06-01,139652,3,0,3,1,0,1
2023-06-01,139669,2,0,2,2,0,2
2023-06-01,139655,2,1,3,1,1,1
2023-06-01,139389,3,0,3,1,0,1
2023-06-01,38393,1,0,1,1,0,1
2023-06-01,139488,1,0,1,1,0,1
2023-06-01,139666,1,0,1,1,0,1
2023-06-01,139667,6,0,6,3,0,3
2023-06-01,139668,2,0,2,2,0,2
2023-06-01,136167,10,34,44,2,3,3
2023-06-01,139665,1,0,1,1,0,1
2023-06-01,139392,2,0,2,1,0,1
2023-06-01,133838,8,0,8,3,0,3
2023-06-01,139395,2,0,2,1,0,1
2023-06-01,140115,3,0,3,1,0,1
2023-06-01,139517,1,0,1,1,0,1
2023-06-01,139671,1,1,2,2,1,2
2023-06-01,139670,3,0,3,2,0,2
2023-06-01,139675,2,0,2,2,0,2
2023-06-01,139394,3,0,3,1,0,1
2023-06-01,63781,2,1,3,1,1,1
2023-06-01,135988,2,0,2,2,0,2
2023-06-01,139518,6,0,6,1,0,1
2023-06-01,139679,1,0,1,1,0,1
2023-06-01,139680,2,0,2,2,0,2
2023-06-01,139402,2,0,2,1,0,1
2023-06-01,139403,1,0,1,1,0,1
2023-06-01,139684,2,0,2,1,0,1
2023-06-01,139681,1,0,1,2,0,2
2023-06-01,139489,1,0,1,2,0,2
2023-06-01,139688,2,0,2,3,0,3
2023-06-01,139400,2,0,2,2,0,2
2023-06-01,135728,1,0,1,1,0,1
2023-06-01,9628,4,0,4,2,0,2
2023-06-01,139689,3,1,4,1,2,2
2023-06-01,139700,2,0,2,2,0,2
2023-06-01,139409,2,0,2,4,0,4
2023-06-01,139406,1,0,1,1,0,1
2023-06-01,139698,1,0,1,1,0,1
2023-06-01,135989,1,1,2,1,1,1
2023-06-01,139697,2,0,2,1,0,1
2023-06-01,139696,1,0,1,1,0,1
2023-06-01,139701,2,0,2,2,0,2
2023-06-01,132935,4,0,4,3,0,3
2023-06-01,139412,1,0,1,1,0,1
2023-06-01,139703,1,0,1,1,0,1
2023-06-01,139408,2,0,2,2,0,2
2023-06-01,139708,2,0,2,1,0,1
2023-06-01,150165,2,1,3,1,1,1
2023-06-01,139709,1,0,1,1,0,1
2023-06-01,141209,1,0,1,1,0,1
2023-06-01,139711,3,0,3,1,0,1
2023-06-01,139716,2,0,2,3,0,3
2023-06-01,139414,1,0,1,2,0,2
2023-06-01,139718,2,0,2,1,0,1
2023-06-01,139418,3,0,3,2,0,2
2023-06-01,139423,1,0,1,1,0,1
2023-06-01,139723,1,1,2,3,2,3
2023-06-01,139491,3,0,3,1,0,1
2023-06-01,139493,2,0,2,2,0,2
2023-06-01,38106,2,0,2,1,0,1
2023-06-01,131666,3,0,3,2,0,2
2023-06-01,149250,2,0,2,3,0,3
2023-06-01,132977,3,0,3,1,0,1
2023-06-01,139424,1,0,1,1,0,1
2023-06-01,139724,1,0,1,1,0,1
2023-06-01,147171,8,1,9,1,1,1
2023-06-01,64027,4,0,4,3,0,3
2023-06-01,141083,2,0,2,4,0,4
2023-06-01,140472,2,0,2,3,0,3
2023-06-01,139728,1,0,1,1,0,1
2023-06-01,139726,3,2,5,1,1,1
2023-06-01,139419,2,1,3,2,1,2
2023-06-01,55333,6,0,6,4,0,4
2023-06-01,139731,1,0,1,1,0,1
2023-06-01,139179,1,1,2,2,1,2
2023-06-01,139730,1,0,1,1,0,1
2023-06-01,139178,1,1,2,2,1,2
2023-06-01,46065,3,0,3,2,0,2
2023-06-01,139422,1,0,1,1,0,1
2023-06-01,131396,6,0,6,1,0,1
2023-06-01,150724,1,0,1,1,0,1
2023-06-01,139425,3,0,3,3,0,3
2023-06-01,141607,8,1,9,7,1,7
2023-06-01,135734,2,0,2,2,0,2
2023-06-01,139737,1,0,1,1,0,1
2023-06-01,133852,3,0,3,4,0,4
2023-06-01,139736,5,1,6,5,1,5
2023-06-01,139740,1,0,1,2,0,2
2023-06-01,139421,2,1,3,2,1,2
2023-06-01,140222,1,0,1,1,0,1
2023-06-01,139741,3,0,3,1,0,1
2023-06-01,209650,1,4,5,6,12,13
2023-06-01,139494,1,0,1,3,0,3
2023-06-01,139739,10,0,10,1,0,1
2023-06-01,131958,6,1,7,10,8,12
2023-06-01,139747,1,0,1,1,0,1
2023-06-01,139748,1,0,1,1,0,1
2023-06-01,139433,3,0,3,1,0,1
2023-06-01,139429,1,0,1,1,0,1
2023-06-01,139426,1,0,1,2,0,2
2023-06-01,56113,2,0,2,2,0,2
2023-06-01,139756,1,0,1,1,0,1
2023-06-01,135991,1,0,1,2,0,2
2023-06-01,139752,3,1,4,3,1,3
2023-06-01,139755,2,0,2,2,0,2
2023-06-01,139758,3,0,3,1,0,1
2023-06-01,139495,1,1,2,2,1,3
2023-06-01,139761,2,0,2,4,0,4
2023-06-01,134634,2,0,2,1,0,1
2023-06-01,139757,2,0,2,1,0,1
2023-06-01,139762,3,0,3,1,0,1
2023-06-01,139895,1,0,1,2,0,2
2023-06-01,151166,1,0,1,2,0,2
2023-06-01,139539,3,1,4,2,1,3
2023-06-01,139766,2,1,3,3,2,3
2023-06-01,139497,2,0,2,1,0,1
2023-06-01,139770,1,0,1,1,0,1
2023-06-01,146985,1,0,1,2,0,2
2023-06-01,139435,2,0,2,1,0,1
2023-06-01,139540,1,0,1,3,0,3
2023-06-01,139769,2,0,2,2,0,2
2023-06-01,139438,2,0,2,1,0,1
2023-06-01,4195,16,0,16,12,0,12
2023-06-01,139498,2,0,2,2,0,2
2023-06-01,139777,2,0,2,2,0,2
2023-06-01,139778,1,0,1,1,0,1
2023-06-01,139441,1,0,1,1,0,1
2023-06-01,139148,2,0,2,2,0,2
2023-06-01,139780,2,0,2,3,0,3
2023-06-01,139957,2,0,2,3,0,3
2023-06-01,139783,1,0,1,2,0,2
2023-06-01,139455,3,0,3,1,0,1
2023-06-01,139514,3,0,3,2,0,2
2023-06-01,139788,1,0,1,2,0,2
2023-06-01,139786,2,1,3,2,2,2
2023-06-01,135994,1,1,2,1,1,1
2023-06-01,139790,1,0,1,2,0,2
2023-06-01,139440,3,0,3,1,0,1
2023-06-01,139451,3,0,3,2,0,2
2023-06-01,139792,3,0,3,1,0,1
2023-06-01,139806,1,0,1,2,0,2
2023-06-01,139793,3,0,3,3,0,3
2023-06-01,139445,2,0,2,2,0,2
2023-06-01,139794,1,0,1,2,0,2
2023-06-01,139500,1,0,1,1,0,1
2023-06-01,139799,1,0,1,1,0,1
2023-06-01,139442,2,0,2,4,0,4
2023-06-01,139443,1,0,1,2,0,2
2023-06-01,139446,4,0,4,5,0,5
2023-06-01,139502,1,0,1,1,0,1
2023-06-01,139808,2,0,2,1,0,1
2023-06-01,139807,2,0,2,3,0,3
2023-06-01,139804,1,0,1,1,0,1
2023-06-01,139447,1,0,1,1,0,1
2023-06-01,142122,3,0,3,3,0,3
2023-06-01,139813,2,0,2,2,0,2
2023-06-01,140008,2,0,2,2,0,2
2023-06-01,139815,3,0,3,2,0,2
2023-06-01,139501,3,0,3,1,0,1
2023-06-01,133697,2,1,3,2,1,2
2023-06-01,139535,1,0,1,1,0,1
2023-06-01,139448,1,0,1,2,0,2
2023-06-01,139822,1,0,1,2,0,2
2023-06-01,139450,3,1,4,1,1,1
2023-06-01,139831,25,20,45,10,9,11
2023-06-01,139872,3,0,3,1,0,1
2023-06-01,139825,2,0,2,1,0,1
2023-06-01,9683,2,0,2,2,0,2
2023-06-01,139830,3,0,3,3,0,3
2023-06-01,139453,1,0,1,3,0,3
2023-06-01,139456,10,0,10,4,0,4
2023-06-01,150010,2,0,2,1,0,1
2023-06-01,139834,2,0,2,3,0,3
2023-06-01,139837,2,0,2,2,0,2
2023-06-01,58439,2,1,3,7,2,7
2023-06-01,139454,1,0,1,1,0,1
2023-06-01,139835,3,0,3,1,0,1
2023-06-01,131124,1,1,2,2,2,2
2023-06-01,139536,1,0,1,2,0,2
2023-06-01,139526,2,0,2,3,0,3
2023-06-01,139832,2,0,2,3,0,3
2023-06-01,139527,1,0,1,1,0,1
2023-06-01,139843,1,0,1,1,0,1
2023-06-01,139836,3,0,3,1,0,1
2023-06-01,139854,3,0,3,2,0,2
2023-06-01,134382,1,0,1,3,0,3
2023-06-01,135997,1,0,1,1,0,1
2023-06-01,135998,1,0,1,1,0,1
2023-06-01,131366,7,1,8,1,1,1
2023-06-01,139845,1,0,1,3,0,3
2023-06-01,139984,2,0,2,2,0,2
2023-06-01,139459,2,0,2,3,0,3
2023-06-01,139826,2,1,3,1,1,1
2023-06-01,139870,5,3,8,4,1,4
2023-06-01,139844,2,0,2,3,0,3
2023-06-01,139848,1,0,1,3,0,3
2023-06-01,139850,2,0,2,3,0,3
2023-06-01,140381,1,0,1,1,0,1
2023-06-01,139458,1,0,1,1,0,1
2023-06-01,139852,1,0,1,1,0,1
2023-06-01,139935,1,0,1,2,0,2
2023-06-01,139457,6,1,7,3,1,3
2023-06-01,139849,3,1,4,1,1,1
2023-06-01,139857,1,0,1,2,0,2
2023-06-01,139932,1,0,1,1,0,1
2023-06-01,55531,4,0,4,2,0,2
2023-06-01,139858,3,0,3,2,0,2
2023-06-01,139864,1,0,1,1,0,1
2023-06-01,139868,1,0,1,2,0,2
2023-06-01,139863,2,0,2,1,0,1
2023-06-01,139865,2,0,2,2,0,2
2023-06-01,38825,3,0,3,4,0,4
2023-06-01,134492,2,0,2,1,0,1
2023-06-01,139948,1,0,1,3,0,3
2023-06-01,139869,1,0,1,1,0,1
2023-06-01,139549,2,0,2,2,0,2
2023-06-01,139876,1,0,1,2,0,2
2023-06-01,140114,2,0,2,1,0,1
2023-06-01,150619,1,1,2,1,1,1
2023-06-01,149123,1,1,2,1,1,1
2023-06-01,139530,2,1,3,2,1,3
2023-06-01,139940,2,0,2,1,0,1
2023-06-01,139879,20,16,36,4,3,4
2023-06-01,139885,1,0,1,1,0,1
2023-06-01,139902,3,0,3,1,0,1
2023-06-01,139881,1,1,2,1,1,1
2023-06-01,139891,1,0,1,1,0,1
2023-06-01,139892,1,1,2,1,1,1
2023-06-01,139889,1,1,2,1,1,1
2023-06-01,139890,2,0,2,2,0,2
2023-06-01,139939,1,0,1,1,0,1
2023-06-01,139510,1,0,1,1,0,1
2023-06-01,9636,1,0,1,1,0,1
2023-06-01,139906,2,0,2,3,0,3
2023-06-01,139941,2,0,2,1,0,1
2023-06-01,139942,1,0,1,1,0,1
2023-06-01,139900,2,0,2,2,0,2
2023-06-01,24567,17,1,18,5,1,5
2023-06-01,131667,1,2,3,1,2,2
2023-06-01,131671,2,0,2,2,0,2
2023-06-01,139507,2,0,2,1,0,1
2023-06-01,133289,1,0,1,1,0,1
2023-06-01,139904,4,2,6,2,1,2
2023-06-01,141799,7,1,8,3,1,3
2023-06-01,139509,2,0,2,1,0,1
2023-06-01,139508,4,1,5,2,1,2
2023-06-01,133667,1,0,1,1,0,1
2023-06-01,139554,2,0,2,1,0,1
2023-06-01,139529,2,0,2,2,0,2
2023-06-01,139531,2,1,3,3,2,3
2023-06-01,139909,1,1,2,2,2,2
2023-06-01,139916,2,0,2,2,0,2
2023-06-01,139903,1,1,2,1,1,1
2023-06-01,139911,1,0,1,3,0,3
2023-06-01,139945,2,0,2,2,0,2
2023-06-01,18041,4,11,15,5,1,5
2023-06-01,139919,2,0,2,3,0,3
2023-06-01,140621,1,0,1,2,0,2
2023-06-01,139913,1,0,1,1,0,1
2023-06-01,131129,2,0,2,1,0,1
2023-06-01,139553,2,0,2,2,0,2
2023-06-01,139915,3,17,20,1,1,1
2023-06-01,139925,1,0,1,1,0,1
2023-06-01,139917,1,0,1,2,0,2
2023-06-01,38017,17,0,17,6,0,6
2023-06-01,139674,1,0,1,1,0,1
2023-06-01,139552,1,0,1,1,0,1
2023-06-01,139950,1,0,1,2,0,2
2023-06-01,17769,43,0,43,2,0,2
2023-06-01,139953,2,0,2,2,0,2
2023-06-01,139958,2,0,2,3,0,3
2023-06-01,140045,3,0,3,5,2,5
2023-06-01,139551,2,0,2,2,0,2
2023-06-01,139960,1,0,1,1,0,1
2023-06-01,139959,1,0,1,1,0,1
2023-06-01,139516,2,2,4,2,2,3
2023-06-01,139533,1,0,1,2,0,2
2023-06-01,131350,1,1,2,2,1,2
2023-06-01,139927,1,0,1,2,0,2
2023-06-01,139928,2,0,2,3,0,3
2023-06-01,139565,3,0,3,1,0,1
2023-06-01,149972,1,0,1,1,0,1
2023-06-01,139962,3,0,3,3,0,3
2023-06-01,139112,1,1,2,1,1,1
2023-06-01,150046,8,1,9,2,2,2
2023-06-01,131677,6,0,6,4,0,4
2023-06-01,139963,3,2,5,3,3,3
2023-06-01,140033,1,0,1,3,0,3
2023-06-01,138281,2,0,2,1,0,1
2023-06-01,140037,3,1,4,2,2,2
2023-06-01,140073,2,0,2,2,0,2
2023-06-01,139557,2,0,2,1,0,1
2023-06-01,132985,2,0,2,1,0,1
2023-06-01,140041,1,0,1,1,0,1
2023-06-01,150655,1,0,1,2,0,2
2023-06-01,140040,2,0,2,1,0,1
2023-06-01,132523,1,0,1,1,0,1
2023-06-01,139568,1,0,1,3,0,3
2023-06-01,150544,1,0,1,1,0,1
2023-06-01,139979,1,0,1,2,0,2
2023-06-01,139969,3,0,3,1,0,1
2023-06-01,140065,2,0,2,1,0,1
2023-06-01,140050,2,1,3,1,1,1
2023-06-01,140387,1,0,1,1,0,1
2023-06-01,140054,2,0,2,1,0,1
2023-06-01,38157,2,1,3,3,1,3
2023-06-01,139971,3,0,3,3,0,3
2023-06-01,140055,2,0,2,1,0,1
2023-06-01,140010,1,0,1,1,0,1
2023-06-01,139973,1,0,1,1,0,1
2023-06-01,139559,2,1,3,2,1,2
2023-06-01,139974,1,0,1,1,0,1
2023-06-01,139987,2,0,2,3,0,3
2023-06-01,140064,1,0,1,1,0,1
2023-06-01,140066,2,0,2,2,0,2
2023-06-01,140063,2,0,2,2,0,2
2023-06-01,140069,2,1,3,2,2,2
2023-06-01,140068,3,2,5,3,2,3
2023-06-01,140070,1,1,2,3,2,3
2023-06-01,139985,1,0,1,1,0,1
2023-06-01,139978,3,1,4,2,2,2
2023-06-01,139981,5,1,6,4,2,5
2023-06-01,140071,2,0,2,3,0,3
2023-06-01,140012,2,0,2,2,0,2
2023-06-01,140540,1,0,1,3,0,3
2023-06-01,140074,1,0,1,1,0,1
2023-06-01,139564,2,0,2,2,0,2
2023-06-01,135615,5,0,5,2,0,2
2023-06-01,140076,2,0,2,3,0,3
2023-06-01,24527,14,8,22,4,2,4
2023-06-01,139983,3,1,4,3,1,3
2023-06-01,140080,3,0,3,3,0,3
2023-06-01,140086,1,0,1,1,0,1
2023-06-01,135740,1,0,1,2,0,2
2023-06-01,134315,2,0,2,1,0,1
2023-06-01,140084,1,0,1,1,0,1
2023-06-01,140002,1,0,1,1,0,1
2023-06-01,140001,1,1,2,2,2,2
2023-06-01,140087,2,0,2,3,0,3
2023-06-01,139986,3,0,3,1,0,1
2023-06-01,140089,1,0,1,2,0,2
2023-06-01,140085,3,0,3,1,0,1
2023-06-01,139558,2,0,2,1,0,1
2023-06-01,140090,2,0,2,2,0,2
2023-06-01,139988,2,1,3,3,1,3
2023-06-01,140088,1,0,1,2,0,2
2023-06-01,140091,2,1,3,1,1,2
2023-06-01,140092,1,0,1,1,0,1
2023-06-01,140094,1,0,1,1,0,1
2023-06-01,9326,33,2,35,6,1,6
2023-06-01,46032,5,0,5,1,0,1
2023-06-01,139993,2,0,2,1,0,1
2023-06-01,140093,3,0,3,2,0,2
2023-06-01,133658,1,1,2,2,1,2
2023-06-01,136653,2,0,2,1,0,1
2023-06-01,140097,1,0,1,1,0,1
2023-06-01,140101,1,0,1,1,0,1
2023-06-01,140100,2,0,2,1,0,1
2023-06-01,141127,4,1,5,1,1,1
2023-06-01,138222,1,0,1,3,0,3
2023-06-01,140159,2,1,3,1,1,1
2023-06-01,140103,2,0,2,2,0,2
2023-06-01,140210,3,0,3,2,0,2
2023-06-01,131376,1,0,1,2,0,2
2023-06-01,140218,2,0,2,1,0,1
2023-06-01,147273,2,1,3,3,1,3
2023-06-01,133280,2,0,2,2,0,2
2023-06-01,140213,2,0,2,1,0,1
2023-06-01,140215,2,0,2,2,0,2
2023-06-01,140216,1,0,1,1,0,1
2023-06-01,134880,4,1,5,3,1,3
2023-06-01,134651,6,1,7,2,1,2
2023-06-01,139995,1,1,2,3,3,3
2023-06-01,140003,1,0,1,1,0,1
2023-06-01,139996,1,0,1,2,0,2
2023-06-01,140007,2,0,2,3,0,3
2023-06-01,139998,2,0,2,3,0,3
2023-06-01,139997,3,0,3,5,0,5
2023-06-01,134320,2,0,2,1,0,1
2023-06-01,140004,3,1,4,4,1,4
2023-06-01,14004,0,0,0,3,0,3
2023-06-01,140225,2,0,2,1,0,1
2023-06-01,140226,2,0,2,3,0,3
2023-06-01,140231,2,0,2,4,0,4
2023-06-01,140230,1,0,1,3,0,3
2023-06-01,131197,2,0,2,2,0,2
2023-06-01,132054,3,0,3,5,0,5
2023-06-01,132269,2,1,3,2,1,2
2023-06-01,140006,1,0,1,2,0,2
2023-06-01,132481,2,0,2,3,0,3
2023-06-01,132906,2,1,3,1,1,1
2023-06-01,133537,1,0,1,1,0,1
2023-06-01,134241,3,0,3,2,0,2
2023-06-01,139569,1,0,1,3,0,3
2023-06-01,132492,2,0,2,2,0,2
2023-06-01,134780,1,0,1,2,0,2
2023-06-01,134737,1,1,2,1,1,1
2023-06-01,134546,1,0,1,1,0,1
2023-06-01,140009,3,0,3,3,0,3
2023-06-01,140025,1,0,1,2,0,2
2023-06-01,149124,1,0,1,1,0,1
2023-06-01,136586,3,0,3,3,0,3
2023-06-01,142647,2,0,2,1,0,1
2023-06-01,136929,3,0,3,1,0,1
2023-06-01,136985,1,0,1,2,0,2
2023-06-01,136986,2,0,2,2,0,2
2023-06-01,150526,1,0,1,2,0,2
2023-06-01,140014,1,0,1,1,0,1
2023-06-01,208932,2,0,2,4,0,4
2023-06-01,140018,3,0,3,3,0,3
2023-06-01,137067,2,0,2,1,0,1
2023-06-01,137000,4,1,5,3,1,3
2023-06-01,137018,1,0,1,2,0,2
2023-06-01,132139,2,1,3,4,2,4
2023-06-01,131678,2,0,2,2,0,2
2023-06-01,134896,2,0,2,2,0,2
2023-06-01,134025,1,0,1,1,0,1
2023-06-01,140015,1,0,1,1,0,1
2023-06-01,137033,3,1,4,2,1,2
2023-06-01,22900,6,0,6,3,0,3
2023-06-01,140020,2,0,2,1,0,1
2023-06-01,140013,2,0,2,2,0,2
2023-06-01,137405,1,0,1,2,0,2
2023-06-01,149125,1,0,1,1,0,1
2023-06-01,136771,1,0,1,1,0,1
2023-06-01,132922,1,0,1,1,0,1
2023-06-01,140243,3,0,3,4,0,4
2023-06-01,140240,1,0,1,2,0,2
2023-06-01,140242,2,0,2,1,0,1
2023-06-01,140380,3,0,3,1,0,1
2023-06-01,140241,3,0,3,3,0,3
2023-06-01,24529,4,0,4,4,0,4
2023-06-01,140385,1,0,1,2,0,2
2023-06-01,140019,1,0,1,1,0,1
2023-06-01,140268,1,0,1,2,0,2
2023-06-01,141055,2,0,2,1,0,1
2023-06-01,140023,2,0,2,4,0,4
2023-06-01,140110,1,1,2,2,1,2
2023-06-01,140154,2,0,2,1,0,1
2023-06-01,134292,1,0,1,2,0,2
2023-06-01,140288,1,0,1,1,0,1
2023-06-01,140021,1,0,1,1,0,1
2023-06-01,140287,2,0,2,3,0,3
2023-06-01,23726,1,1,2,1,1,1
2023-06-01,140304,1,0,1,1,0,1
2023-06-01,140024,1,0,1,3,0,3
2023-06-01,9833,1,0,1,1,0,1
2023-06-01,140022,1,0,1,1,0,1
2023-06-01,140156,2,1,3,1,1,1
2023-06-01,140321,3,1,4,4,3,4
2023-06-01,140746,1,1,2,1,1,1
2023-06-01,131382,2,0,2,1,0,1
2023-06-01,140157,2,0,2,1,0,1
2023-06-01,140026,1,0,1,1,0,1
2023-06-01,134837,2,0,2,2,0,2
2023-06-01,140173,2,0,2,1,0,1
2023-06-01,140158,4,1,5,2,1,2
2023-06-01,139768,1,0,1,1,0,1
2023-06-01,140030,1,0,1,1,0,1
2023-06-01,140324,3,0,3,2,0,2
2023-06-01,140325,2,0,2,1,0,1
2023-06-01,140029,1,0,1,1,0,1
2023-06-01,140386,1,0,1,3,0,3
2023-06-01,132666,2,0,2,1,0,1
2023-06-01,7616,24,1,25,5,2,5
2023-06-01,140382,1,0,1,1,0,1
2023-06-01,149973,1,0,1,1,0,1
2023-06-01,140503,1,0,1,3,0,3
2023-06-01,140384,3,0,3,2,0,2
2023-06-01,142552,4,0,4,2,0,2
2023-06-01,131409,3,1,4,3,1,3
2023-06-01,135902,2,1,3,3,1,3
2023-06-01,140501,1,0,1,3,0,3
2023-06-01,140502,2,0,2,3,0,3
2023-06-01,140526,1,0,1,1,0,1
2023-06-01,140523,3,0,3,1,0,1
2023-06-01,140524,2,0,2,1,0,1
2023-06-01,140398,1,0,1,1,0,1
2023-06-01,139154,2,1,3,2,2,2
2023-06-01,140541,2,0,2,2,0,2
2023-06-01,141161,2,0,2,1,0,1
2023-06-01,140390,3,0,3,3,0,3
2023-06-01,140539,3,0,3,3,0,3
2023-06-01,140546,3,0,3,1,0,1
2023-06-01,147282,4,1,5,3,1,3
2023-06-01,140544,3,0,3,1,0,1
2023-06-01,138471,1,0,1,1,0,1
2023-06-01,138974,1,0,1,2,0,2
2023-06-01,140631,1,0,1,2,0,2
2023-06-01,138013,2,0,2,3,0,3
2023-06-01,140552,3,0,3,3,0,3
2023-06-01,136012,2,0,2,2,0,2
2023-06-01,137849,1,0,1,2,0,2
2023-06-01,140575,2,0,2,1,0,1
2023-06-01,140576,11,1,12,1,1,1
2023-06-01,140577,9,1,10,8,1,8
2023-06-01,140581,1,0,1,1,0,1
2023-06-01,140392,1,0,1,2,0,2
2023-06-01,140395,3,2,5,1,1,1
2023-06-01,56224,8,1,9,1,1,1
2023-06-01,140579,2,0,2,1,0,1
2023-06-01,140397,1,0,1,1,0,1
2023-06-01,140431,1,0,1,1,0,1
2023-06-01,17874,1,0,1,1,0,1
2023-06-01,140585,2,0,2,2,0,2
2023-06-01,140394,1,0,1,2,0,2
2023-06-01,38572,2,0,2,4,0,4
2023-06-01,140396,2,0,2,1,0,1
2023-06-01,140587,1,0,1,1,0,1
2023-06-01,140591,1,0,1,3,0,3
2023-06-01,140670,1,0,1,3,0,3
2023-06-01,140672,1,0,1,1,0,1
2023-06-01,140593,1,0,1,5,0,5
2023-06-01,140598,2,0,2,2,0,2
2023-06-01,140401,5,0,5,3,0,3
2023-06-01,140601,1,0,1,2,0,2
2023-06-01,140402,2,1,3,3,1,3
2023-06-01,140602,3,3,6,1,1,1
2023-06-01,131679,3,0,3,2,0,2
2023-06-01,140605,1,0,1,1,0,1
2023-06-01,135904,1,0,1,3,0,3
2023-06-01,140608,2,0,2,2,0,2
2023-06-01,135910,1,0,1,1,0,1
2023-06-01,140614,2,0,2,2,0,2
2023-06-01,150974,1,0,1,1,0,1
2023-06-01,140611,3,0,3,1,0,1
2023-06-01,140612,3,23,26,2,1,2
2023-06-01,140617,2,0,2,1,0,1
2023-06-01,140616,1,0,1,3,0,3
2023-06-01,140406,1,0,1,1,0,1
2023-06-01,140113,7,1,8,1,1,1
2023-06-01,141124,1,0,1,1,0,1
2023-06-01,140404,6,0,6,3,0,3
2023-06-01,150532,1,0,1,1,0,1
2023-06-01,140619,4,0,4,1,0,1
2023-06-01,140413,2,1,3,3,2,3
2023-06-01,142150,3,0,3,3,0,3
2023-06-01,131344,3,0,3,1,0,1
2023-06-01,63739,4,3,7,1,1,1
2023-06-01,140625,2,0,2,1,0,1
2023-06-01,140410,1,0,1,2,0,2
2023-06-01,140436,1,0,1,1,0,1
2023-06-01,140409,2,0,2,4,0,4
2023-06-01,150084,1,0,1,1,0,1
2023-06-01,140643,1,0,1,3,0,3
2023-06-01,140637,11,6,17,3,3,4
2023-06-01,137475,1,0,1,1,0,1
2023-06-01,63500,2,0,2,1,0,1
2023-06-01,141222,1,0,1,1,0,1
2023-06-01,17538,20,0,20,5,0,5
2023-06-01,140644,2,1,3,3,2,3
2023-06-01,150078,2,0,2,1,0,1
2023-06-01,140428,1,0,1,1,0,1
2023-06-01,139068,1,0,1,3,0,3
2023-06-01,140659,2,1,3,2,1,2
2023-06-01,140664,1,0,1,2,0,2
2023-06-01,13360,12,0,12,9,0,9
2023-06-01,149623,3,1,4,2,1,2
2023-06-01,150534,1,0,1,1,0,1
2023-06-01,140668,2,0,2,2,0,2
2023-06-01,140667,1,0,1,1,0,1
2023-06-01,140671,1,1,2,1,1,1
2023-06-01,140160,2,0,2,1,0,1
2023-06-01,150533,1,0,1,2,0,2
2023-06-01,140633,1,0,1,3,0,3
2023-06-01,140425,1,0,1,1,0,1
2023-06-01,140678,1,0,1,2,0,2
2023-06-01,140415,1,0,1,1,0,1
2023-06-01,139054,1,1,2,3,3,4
2023-06-01,140669,3,0,3,3,0,3
2023-06-01,140685,1,0,1,1,0,1
2023-06-01,140422,1,0,1,2,0,2
2023-06-01,140424,1,0,1,1,0,1
2023-06-01,141574,4,1,5,1,1,1
2023-06-01,140689,1,0,1,2,0,2
2023-06-01,140118,1,0,1,1,0,1
2023-06-01,137930,12,0,12,5,0,5
2023-06-01,23907,6,1,7,1,1,1
2023-06-01,140167,2,0,2,2,0,2
2023-06-01,140695,1,1,2,1,1,1
2023-06-01,140119,2,0,2,1,0,1
2023-06-01,140120,6,0,6,1,0,1
2023-06-01,142559,2,0,2,2,0,2
2023-06-01,140697,1,0,1,1,0,1
2023-06-01,38245,2,0,2,1,0,1
2023-06-01,38734,1,0,1,3,0,3
2023-06-01,140437,2,0,2,1,0,1
2023-06-01,140703,1,0,1,1,0,1
2023-06-01,140699,2,1,3,3,1,3
2023-06-01,139512,2,0,2,2,0,2
2023-06-01,140583,2,2,4,2,2,3
2023-06-01,140427,1,0,1,4,0,4
2023-06-01,140426,1,0,1,1,0,1
2023-06-01,140705,3,0,3,2,0,2
2023-06-01,140710,1,0,1,3,0,3
2023-06-01,140711,2,0,2,3,0,3
2023-06-01,140713,1,0,1,1,0,1
2023-06-01,141629,1,0,1,1,0,1
2023-06-01,141766,4,0,4,3,0,3
2023-06-01,140712,3,1,4,4,1,4
2023-06-01,140718,1,1,2,1,1,1
2023-06-01,135301,2,0,2,2,0,2
2023-06-01,140198,2,0,2,1,0,1
2023-06-01,140740,1,0,1,1,0,1
2023-06-01,140739,3,0,3,3,0,3
2023-06-01,141052,1,1,2,2,2,2
2023-06-01,140725,1,0,1,1,0,1
2023-06-01,140723,1,0,1,1,0,1
2023-06-01,140734,1,1,2,1,1,1
2023-06-01,135789,1,0,1,2,0,2
2023-06-01,140430,1,0,1,2,0,2
2023-06-01,140736,1,1,2,5,3,6
2023-06-01,140122,1,0,1,1,0,1
2023-06-01,140442,3,1,4,3,5,5
2023-06-01,140735,1,0,1,1,0,1
2023-06-01,140924,1,1,2,1,1,2
2023-06-01,136513,3,0,3,4,0,4
2023-06-01,140843,1,0,1,1,0,1
2023-06-01,140845,1,0,1,2,0,2
2023-06-01,140851,1,0,1,3,0,3
2023-06-01,141205,1,0,1,1,0,1
2023-06-01,17955,11,1,12,4,4,4
2023-06-01,140850,2,0,2,1,0,1
2023-06-01,140989,3,0,3,1,0,1
2023-06-01,140864,1,0,1,1,0,1
2023-06-01,140865,2,0,2,2,0,2
2023-06-01,141555,2,1,3,1,1,1
2023-06-01,140742,3,0,3,3,0,3
2023-06-01,150037,1,0,1,1,0,1
2023-06-01,140870,1,0,1,1,0,1
2023-06-01,38074,2,1,3,3,3,3
2023-06-01,140186,1,0,1,1,0,1
2023-06-01,140871,2,0,2,4,0,4
2023-06-01,139139,3,1,4,2,1,2
2023-06-01,24369,8,0,8,2,2,3
2023-06-01,24226,10,1,11,3,2,4
2023-06-01,140885,4,0,4,1,0,1
2023-06-01,140874,1,1,2,1,1,1
2023-06-01,17415,1,1,2,4,1,4
2023-06-01,134098,1,2,3,1,2,2
2023-06-01,140880,1,0,1,1,0,1
2023-06-01,140877,1,0,1,2,0,2
2023-06-01,140878,3,1,4,3,1,3
2023-06-01,140927,3,0,3,2,0,2
2023-06-01,140879,3,0,3,1,0,1
2023-06-01,38038,4,1,5,3,1,3
2023-06-01,140887,3,0,3,3,0,3
2023-06-01,140446,2,0,2,1,0,1
2023-06-01,140888,3,4,7,1,1,1
2023-06-01,140448,2,0,2,3,0,3
2023-06-01,140455,1,0,1,1,0,1
2023-06-01,140891,1,0,1,2,0,2
2023-06-01,7590,63,5,68,5,1,5
2023-06-01,141000,3,0,3,5,0,5
2023-06-01,140899,1,0,1,1,0,1
2023-06-01,140898,2,0,2,2,0,2
2023-06-01,140896,1,1,2,3,1,3
2023-06-01,140452,2,0,2,2,0,2
2023-06-01,140444,2,0,2,1,0,1
2023-06-01,55591,2,0,2,3,0,3
2023-06-01,140904,1,0,1,1,0,1
2023-06-01,140906,2,0,2,3,0,3
2023-06-01,140901,2,0,2,3,0,3
2023-06-01,140905,1,1,2,6,3,6
2023-06-01,140162,2,0,2,2,0,2
2023-06-01,136254,1,0,1,1,0,1
2023-06-01,140456,3,0,3,2,0,2
2023-06-01,135072,1,0,1,1,0,1
2023-06-01,63763,1,0,1,1,0,1
2023-06-01,140908,1,0,1,1,0,1
2023-06-01,140459,1,0,1,1,0,1
2023-06-01,140458,1,0,1,3,0,3
2023-06-01,140912,2,0,2,3,0,3
2023-06-01,140910,3,0,3,2,0,2
2023-06-01,140460,2,1,3,2,1,2
2023-06-01,133578,1,0,1,1,0,1
2023-06-01,140916,3,0,3,3,0,3
2023-06-01,132786,2,0,2,3,0,3
2023-06-01,140917,2,0,2,1,0,1
2023-06-01,140918,1,1,2,1,1,1
2023-06-01,140462,1,0,1,2,0,2
2023-06-01,140923,1,0,1,1,0,1
2023-06-01,140463,1,1,2,2,1,2
2023-06-01,140464,3,1,4,2,1,2
2023-06-01,133284,2,0,2,1,0,1
2023-06-01,138792,2,0,2,1,0,1
2023-06-01,140467,2,1,3,1,1,1
2023-06-01,140933,1,1,2,1,1,1
2023-06-01,140930,2,0,2,2,0,2
2023-06-01,140941,1,1,2,1,1,1
2023-06-01,140944,1,1,2,2,2,2
2023-06-01,140164,2,1,3,2,1,2
2023-06-01,140940,3,0,3,4,0,4
2023-06-01,140950,1,0,1,2,0,2
2023-06-01,140124,1,0,1,2,0,2
2023-06-01,140954,2,1,3,2,1,2
2023-06-01,140956,3,0,3,1,0,1
2023-06-01,140948,2,0,2,1,0,1
2023-06-01,140957,2,0,2,3,0,3
2023-06-01,131953,3,0,3,2,0,2
2023-06-01,7516,9,1,10,6,4,7
2023-06-01,131970,3,1,4,2,2,2
2023-06-01,140962,2,0,2,2,0,2
2023-06-01,140963,3,0,3,2,0,2
2023-06-01,140745,1,0,1,1,0,1
2023-06-01,140129,2,1,3,2,2,2
2023-06-01,138001,2,0,2,2,0,2
2023-06-01,140966,2,1,3,2,1,2
2023-06-01,140968,3,0,3,1,0,1
2023-06-01,140967,2,0,2,3,0,3
2023-06-01,45477,10,1,11,1,1,1
2023-06-01,140475,2,0,2,3,0,3
2023-06-01,140476,2,0,2,4,0,4
2023-06-01,45553,1,1,2,2,1,2
2023-06-01,140133,4,0,4,2,0,2
2023-06-01,140973,1,1,2,1,1,1
2023-06-01,140971,1,1,2,1,1,1
2023-06-01,140980,1,0,1,2,0,2
2023-06-01,135404,1,1,2,2,1,2
2023-06-01,140478,2,0,2,3,0,3
2023-06-01,141002,1,0,1,3,0,3
2023-06-01,139141,1,1,2,2,1,2
2023-06-01,139136,1,2,3,2,1,2
2023-06-01,135335,1,0,1,1,0,1
2023-06-01,140479,2,5,7,4,4,4
2023-06-01,133690,2,0,2,1,0,1
2023-06-01,140137,2,1,3,2,1,2
2023-06-01,140983,2,0,2,3,0,3
2023-06-01,140480,2,0,2,3,0,3
2023-06-01,45815,42,4,46,6,3,6
2023-06-01,140481,3,0,3,4,0,4
2023-06-01,140985,1,0,1,2,0,2
2023-06-01,140986,1,0,1,1,0,1
2023-06-01,140801,1,0,1,1,0,1
2023-06-01,140994,1,1,2,4,1,4
2023-06-01,140993,2,0,2,2,0,2
2023-06-01,140995,2,0,2,3,0,3
2023-06-01,140992,1,0,1,2,0,2
2023-06-01,137719,1,0,1,1,0,1
2023-06-01,141054,2,0,2,1,0,1
2023-06-01,141068,1,0,1,1,0,1
2023-06-01,140762,1,0,1,1,0,1
2023-06-01,131705,2,0,2,2,0,2
2023-06-01,140748,1,1,2,2,2,2
2023-06-01,141003,3,0,3,2,0,2
2023-06-01,141008,1,0,1,1,0,1
2023-06-01,136121,4,1,5,3,2,3
2023-06-01,141015,3,2,5,2,2,2
2023-06-01,141018,1,0,1,3,0,3
2023-06-01,134528,1,0,1,2,0,2
2023-06-01,134903,4,0,4,3,0,3
2023-06-01,140199,1,0,1,1,0,1
2023-06-01,141029,1,0,1,1,0,1
2023-06-01,141024,2,0,2,2,0,2
2023-06-01,141032,3,0,3,3,0,3
2023-06-01,141074,2,0,2,1,0,1
2023-06-01,141057,1,0,1,1,0,1
2023-06-01,141033,2,0,2,2,0,2
2023-06-01,141066,1,0,1,1,0,1
2023-06-01,141048,1,0,1,1,0,1
2023-06-01,141036,1,0,1,2,0,2
2023-06-01,140201,4,1,5,2,1,2
2023-06-01,141038,2,0,2,2,0,2
2023-06-01,141042,1,0,1,2,0,2
2023-06-01,141050,1,0,1,3,0,3
2023-06-01,141049,3,0,3,3,0,3
2023-06-01,135525,2,0,2,4,0,4
2023-06-01,132897,2,0,2,3,0,3
2023-06-01,141046,1,0,1,3,0,3
2023-06-01,141621,4,1,5,3,1,3
2023-06-01,17823,2,1,3,4,2,4
2023-06-01,141149,1,0,1,2,0,2
2023-06-01,138230,1,1,2,2,2,2
2023-06-01,9389,25,0,25,2,0,2
2023-06-01,140750,3,0,3,1,0,1
2023-06-01,141152,3,1,4,2,2,2
2023-06-01,141153,4,1,5,1,1,1
2023-06-01,132900,1,0,1,1,0,1
2023-06-01,141154,1,0,1,2,0,2
2023-06-01,137918,2,0,2,2,0,2
2023-06-01,141053,1,0,1,1,0,1
2023-06-01,140180,2,0,2,1,0,1
2023-06-01,141156,2,0,2,1,0,1
2023-06-01,141155,1,1,2,2,1,2
2023-06-01,141159,28,0,28,3,0,3
2023-06-01,141675,1,0,1,4,0,4
2023-06-01,141059,1,0,1,1,0,1
2023-06-01,9,9,1,10,8,2,8
2023-06-01,141480,7,0,7,2,0,2
2023-06-01,140200,1,0,1,1,0,1
2023-06-01,141165,1,0,1,1,0,1
2023-06-01,141163,2,2,4,2,2,2
2023-06-01,141061,1,0,1,1,0,1
2023-06-01,141164,1,0,1,1,0,1
2023-06-01,140187,1,0,1,1,0,1
2023-06-01,141166,2,1,3,2,1,2
2023-06-01,141060,1,0,1,2,0,2
2023-06-01,141064,2,0,2,3,0,3
2023-06-01,141065,3,0,3,3,0,3
2023-06-01,141178,2,0,2,2,2,3
2023-06-01,56196,3,0,3,1,0,1
2023-06-01,141181,1,0,1,2,0,2
2023-06-01,141067,2,0,2,3,0,3
2023-06-01,141069,1,0,1,1,0,1
2023-06-01,140151,2,1,3,1,1,1
2023-06-01,141071,3,0,3,4,0,4
2023-06-01,134997,1,0,1,1,0,1
2023-06-01,136691,2,0,2,1,0,1
2023-06-01,141529,4,1,5,2,1,2
2023-06-01,141184,3,2,5,2,2,2
2023-06-01,141076,2,1,3,4,1,4
2023-06-01,141075,2,0,2,1,0,1
2023-06-01,140204,3,0,3,2,0,2
2023-06-01,140751,1,1,2,1,1,1
2023-06-01,136289,2,1,3,2,2,2
2023-06-01,137086,1,0,1,1,0,1
2023-06-01,141187,1,0,1,3,0,3
2023-06-01,141078,2,1,3,3,1,3
2023-06-01,17884,10,0,10,1,0,1
2023-06-01,141185,2,0,2,3,0,3
2023-06-01,140757,1,0,1,1,0,1
2023-06-01,141077,4,1,5,3,1,3
2023-06-01,141196,1,1,2,1,1,1
2023-06-01,134450,15,4,19,2,2,2
2023-06-01,141195,3,0,3,1,0,1
2023-06-01,141194,2,1,3,2,2,2
2023-06-01,140140,6,0,6,1,0,1
2023-06-01,141198,2,0,2,3,0,3
2023-06-01,141081,2,1,3,4,1,4
2023-06-01,45291,8,0,8,2,0,2
2023-06-01,141082,3,1,4,6,4,7
2023-06-01,141203,3,1,4,1,1,1
2023-06-01,141204,1,0,1,2,0,2
2023-06-01,141206,2,1,3,1,1,1
2023-06-01,141084,2,0,2,2,0,2
2023-06-01,141085,1,0,1,2,0,2
2023-06-01,141086,1,0,1,1,0,1
2023-06-01,141087,1,1,2,2,1,2
2023-06-01,140188,2,0,2,1,0,1
2023-06-01,134005,2,0,2,2,0,2
2023-06-01,140197,2,9,11,1,1,1
2023-06-01,141202,2,6,8,3,2,3
2023-06-01,141219,3,1,4,2,1,2
2023-06-01,141089,1,0,1,1,0,1
2023-06-01,141207,1,0,1,1,0,1
2023-06-01,141088,1,0,1,1,0,1
2023-06-01,140195,1,0,1,1,0,1
2023-06-01,139563,2,0,2,2,0,2
2023-06-01,141208,3,0,3,3,0,3
2023-06-01,141091,1,0,1,2,0,2
2023-06-01,141211,1,0,1,2,0,2
2023-06-01,141090,2,0,2,1,0,1
2023-06-01,142057,2,0,2,2,0,2
2023-06-01,141212,17,0,17,1,0,1
2023-06-01,140205,2,1,3,1,1,1
2023-06-01,149883,4,0,4,3,0,3
2023-06-01,140189,3,1,4,2,2,3
2023-06-01,141093,2,0,2,2,0,2
2023-06-01,150291,3,0,3,3,0,3
2023-06-01,141214,2,1,3,2,1,2
2023-06-01,141215,2,0,2,1,0,1
2023-06-01,141216,5,0,5,5,0,5
2023-06-01,141218,1,1,2,1,1,1
2023-06-01,134228,2,1,3,3,2,3
2023-06-01,141217,2,0,2,3,0,3
2023-06-01,141356,2,0,2,2,0,2
2023-06-01,141220,1,0,1,1,0,1
2023-06-01,140192,1,0,1,1,0,1
2023-06-01,141224,2,0,2,1,0,1
2023-06-01,141228,1,0,1,1,0,1
2023-06-01,141225,3,3,6,3,3,3
2023-06-01,141229,1,0,1,1,0,1
2023-06-01,132758,2,0,2,1,0,1
2023-06-01,140191,2,0,2,1,0,1
2023-06-01,141854,2,0,2,1,0,1
2023-06-01,134904,2,0,2,1,0,1
2023-06-01,141095,1,0,1,3,0,3
2023-06-01,141227,3,0,3,2,0,2
2023-06-01,141231,2,1,3,1,1,1
2023-06-01,141097,3,0,3,2,0,2
2023-06-01,141098,2,0,2,3,0,3
2023-06-01,141099,1,0,1,1,0,1
2023-06-01,141101,1,0,1,2,0,2
2023-06-01,133770,2,0,2,1,0,1
2023-06-01,141234,1,0,1,2,0,2
2023-06-01,141235,1,0,1,1,0,1
2023-06-01,141103,2,0,2,2,0,2
2023-06-01,141104,1,0,1,1,0,1
2023-06-01,141236,2,0,2,1,0,1
2023-06-01,141106,1,0,1,1,0,1
2023-06-01,135867,2,0,2,1,0,1
2023-06-01,149215,1,0,1,1,0,1
2023-06-01,141105,1,0,1,3,0,3
2023-06-01,141107,4,2,6,2,1,2
2023-06-01,149625,2,0,2,2,0,2
2023-06-01,141109,3,0,3,1,0,1
2023-06-01,141240,1,0,1,1,0,1
2023-06-01,135303,1,0,1,2,0,2
2023-06-01,132877,1,0,1,1,0,1
2023-06-01,141110,2,1,3,1,1,1
2023-06-01,134185,1,0,1,1,0,1
2023-06-01,149976,2,0,2,2,0,2
2023-06-01,139570,2,0,2,1,0,1
2023-06-01,141345,1,0,1,3,0,3
2023-06-01,141355,1,0,1,1,0,1
2023-06-01,141347,1,0,1,1,0,1
2023-06-01,141351,2,0,2,3,0,3
2023-06-01,141346,3,0,3,3,0,3
2023-06-01,38070,1,0,1,1,0,1
2023-06-01,141116,1,0,1,1,0,1
2023-06-01,141353,3,0,3,1,0,1
2023-06-01,18250,5,4,9,3,4,5
2023-06-01,132926,1,0,1,2,0,2
2023-06-01,146908,7,1,8,1,1,1
2023-06-01,141241,1,1,2,1,1,1
2023-06-01,141360,3,0,3,5,0,5
2023-06-01,141120,2,10,12,2,1,2
2023-06-01,134274,2,0,2,1,0,1
2023-06-01,141361,7,0,7,2,0,2
2023-06-01,131972,1,0,1,1,0,1
2023-06-01,131973,1,0,1,2,0,2
2023-06-01,141246,1,0,1,1,0,1
2023-06-01,55342,2,0,2,1,0,1
2023-06-01,141323,2,0,2,1,0,1
2023-06-01,141122,2,1,3,1,1,1
2023-06-01,132403,4,0,4,3,0,3
2023-06-01,141371,2,2,4,2,2,2
2023-06-01,141375,3,0,3,1,0,1
2023-06-01,141369,3,0,3,4,0,4
2023-06-01,149118,1,0,1,1,0,1
2023-06-01,141249,1,0,1,1,0,1
2023-06-01,141248,2,0,2,1,0,1
2023-06-01,141379,1,0,1,2,0,2
2023-06-01,139347,1,0,1,1,0,1
2023-06-01,63784,1,1,2,2,2,2
2023-06-01,7492,3,3,6,2,2,2
2023-06-01,150341,2,0,2,3,0,3
2023-06-01,141377,1,0,1,1,0,1
2023-06-01,141385,2,0,2,2,0,2
2023-06-01,141386,2,0,2,2,0,2
2023-06-01,58515,2,0,2,2,0,2
2023-06-01,141389,4,1,5,3,2,3
2023-06-01,141392,1,0,1,2,0,2
2023-06-01,141583,2,0,2,3,0,3
2023-06-01,141608,1,0,1,1,0,1
2023-06-01,141123,2,0,2,5,0,5
2023-06-01,141394,1,0,1,4,0,4
2023-06-01,18214,12,0,12,10,0,10
2023-06-01,139751,1,0,1,1,0,1
2023-06-01,135384,2,0,2,3,0,3
2023-06-01,38614,10,16,26,4,3,4
2023-06-01,141287,1,0,1,1,0,1
2023-06-01,141340,3,0,3,2,0,2
2023-06-01,141308,3,0,3,2,0,2
2023-06-01,141261,2,0,2,1,0,1
2023-06-01,141403,2,2,4,3,2,3
2023-06-01,9913,11,1,12,2,2,2
2023-06-01,141339,4,1,5,4,2,4
2023-06-01,141338,2,0,2,1,0,1
2023-06-01,141399,3,0,3,2,0,2
2023-06-01,141402,1,0,1,1,0,1
2023-06-01,141401,2,0,2,1,0,1
2023-06-01,141404,2,1,3,3,1,3
2023-06-01,141256,1,0,1,2,0,2
2023-06-01,141130,2,0,2,2,0,2
2023-06-01,141587,2,0,2,1,0,1
2023-06-01,141129,2,0,2,2,0,2
2023-06-01,45317,8,1,9,2,1,2
2023-06-01,141309,1,1,2,2,1,2
2023-06-01,140175,1,0,1,2,0,2
2023-06-01,141406,1,0,1,2,0,2
2023-06-01,138321,1,0,1,1,0,1
2023-06-01,141410,1,0,1,1,0,1
2023-06-01,141411,3,1,4,1,1,1
2023-06-01,141311,1,0,1,1,0,1
2023-06-01,141412,2,1,3,2,1,2
2023-06-01,141285,1,0,1,2,0,2
2023-06-01,141332,1,0,1,1,0,1
2023-06-01,141131,1,1,2,1,1,1
2023-06-01,141254,3,1,4,2,2,2
2023-06-01,132058,1,0,1,2,0,2
2023-06-01,141281,2,0,2,1,0,1
2023-06-01,141413,1,1,2,1,1,1
2023-06-01,141258,1,0,1,1,0,1
2023-06-01,141264,2,0,2,1,0,1
2023-06-01,141133,1,1,2,2,1,2
2023-06-01,141135,1,0,1,1,0,1
2023-06-01,137978,3,0,3,2,0,2
2023-06-01,141416,2,0,2,3,0,3
2023-06-01,141417,1,0,1,2,0,2
2023-06-01,141146,2,0,2,4,0,4
2023-06-01,141418,1,0,1,2,0,2
2023-06-01,150045,4,2,6,2,1,2
2023-06-01,141310,2,0,2,1,0,1
2023-06-01,38230,1,9,10,3,7,7
2023-06-01,137490,1,3,4,1,3,4
2023-06-01,141420,3,0,3,3,0,3
2023-06-01,141422,3,0,3,3,0,3
2023-06-01,141132,2,0,2,1,0,1
2023-06-01,151189,1,0,1,1,0,1
2023-06-01,141255,1,0,1,3,0,3
2023-06-01,141427,2,0,2,3,0,3
2023-06-01,141134,2,1,3,2,1,2
2023-06-01,17174,2,0,2,3,0,3
2023-06-01,141423,3,0,3,2,0,2
2023-06-01,132202,1,1,2,1,1,1
2023-06-01,141434,1,0,1,1,0,1
2023-06-01,141424,2,1,3,2,1,2
2023-06-01,140758,1,1,2,1,2,2
2023-06-01,138955,2,0,2,1,0,1
2023-06-01,17893,4,1,5,2,1,2
2023-06-01,141266,3,1,4,2,1,2
2023-06-01,141276,3,0,3,3,0,3
2023-06-01,141265,6,1,7,3,1,3
2023-06-01,141262,2,0,2,2,0,2
2023-06-01,135944,15,1,16,4,1,4
2023-06-01,140761,2,0,2,2,0,2
2023-06-01,141591,2,0,2,1,0,1
2023-06-01,141433,3,1,4,2,1,2
2023-06-01,141432,2,0,2,1,0,1
2023-06-01,141138,1,0,1,2,0,2
2023-06-01,141431,1,0,1,1,0,1
2023-06-01,141436,1,0,1,1,0,1
2023-06-01,141139,2,0,2,2,0,2
2023-06-01,140206,1,0,1,1,0,1
2023-06-01,150571,1,0,1,1,0,1
2023-06-01,134918,4,1,5,4,2,4
2023-06-01,141318,2,0,2,1,0,1
2023-06-01,141269,2,0,2,2,0,2
2023-06-01,141334,4,0,4,2,0,2
2023-06-01,139818,1,0,1,2,0,2
2023-06-01,142320,1,0,1,1,0,1
2023-06-01,141602,2,0,2,1,0,1
2023-06-01,139816,2,0,2,2,0,2
2023-06-01,38856,1,1,2,1,3,3
2023-06-01,141443,3,0,3,1,0,1
2023-06-01,141444,1,1,2,1,1,2
2023-06-01,131977,1,0,1,1,0,1
2023-06-01,141315,2,0,2,2,0,2
2023-06-01,141330,1,0,1,3,0,3
2023-06-01,141317,3,1,4,5,2,5
2023-06-01,141296,2,0,2,1,0,1
2023-06-01,141447,1,0,1,1,0,1
2023-06-01,141290,2,0,2,3,0,3
2023-06-01,58963,4,0,4,1,0,1
2023-06-01,141448,1,0,1,2,0,2
2023-06-01,38839,1,0,1,1,0,1
2023-06-01,141453,1,0,1,1,0,1
2023-06-01,141293,2,0,2,3,0,3
2023-06-01,141292,2,0,2,1,0,1
2023-06-01,141462,2,1,3,2,1,2
2023-06-01,141473,2,0,2,3,0,3
2023-06-01,141475,3,1,4,2,1,2
2023-06-01,149320,1,0,1,3,0,3
2023-06-01,140470,2,1,3,6,2,6
2023-06-01,134643,6,0,6,6,0,6
2023-06-01,133677,2,0,2,2,0,2
2023-06-01,141305,2,0,2,1,0,1
2023-06-01,141270,1,0,1,2,0,2
2023-06-01,141268,1,0,1,1,0,1
2023-06-01,141474,6,0,6,2,0,2
2023-06-01,141144,2,0,2,1,0,1
2023-06-01,141147,2,0,2,2,0,2
2023-06-01,141457,1,0,1,1,0,1
2023-06-01,141294,1,0,1,1,0,1
2023-06-01,141263,2,0,2,1,0,1
2023-06-01,141286,3,0,3,1,0,1
2023-06-01,141303,4,1,5,1,1,1
2023-06-01,141528,1,0,1,1,0,1
2023-06-01,140722,1,0,1,1,0,1
2023-06-01,141460,2,0,2,2,0,2
2023-06-01,151359,3,0,3,3,0,3
2023-06-01,140764,1,0,1,1,0,1
2023-06-01,140765,3,1,4,2,2,2
2023-06-01,141456,2,1,3,2,1,2
2023-06-01,141458,1,0,1,1,0,1
2023-06-01,141624,2,0,2,1,0,1
2023-06-01,141578,1,0,1,2,0,2
2023-06-01,141459,3,0,3,1,0,1
2023-06-01,141273,2,1,3,1,1,1
2023-06-01,150634,1,0,1,1,0,1
2023-06-01,141584,1,0,1,1,0,1
2023-06-01,141596,3,1,4,2,2,2
2023-06-01,141659,2,0,2,1,0,1
2023-06-01,141295,1,0,1,1,0,1
2023-06-01,141580,2,0,2,3,0,3
2023-06-01,134456,2,0,2,3,0,3
2023-06-01,134467,1,0,1,1,0,1
2023-06-01,134455,3,0,3,2,0,2
2023-06-01,141579,2,0,2,2,0,2
2023-06-01,134458,2,1,3,1,1,1
2023-06-01,141335,2,0,2,1,0,1
2023-06-01,137101,5,0,5,1,0,1
2023-06-01,134457,1,0,1,2,0,2
2023-06-01,150183,1,1,2,1,1,1
2023-06-01,141300,2,0,2,1,0,1
2023-06-01,134459,2,0,2,1,0,1
2023-06-01,141641,1,0,1,1,0,1
2023-06-01,141589,1,0,1,1,0,1
2023-06-01,141306,1,0,1,1,0,1
2023-06-01,134462,3,0,3,2,0,2
2023-06-01,141288,1,1,2,2,2,2
2023-06-01,134475,3,0,3,1,0,1
2023-06-01,132987,2,0,2,3,0,3
2023-06-01,141588,1,1,2,2,2,2
2023-06-01,134461,2,2,4,2,2,2
2023-06-01,150025,1,0,1,1,0,1
2023-06-01,141199,1,0,1,1,0,1
2023-06-01,141576,1,1,2,1,1,1
2023-06-01,141603,1,0,1,1,0,1
2023-06-01,134035,1,0,1,1,0,1
2023-06-01,141485,2,0,2,1,0,1
2023-06-01,147133,2,0,2,3,0,3
2023-06-01,141594,2,0,2,3,0,3
2023-06-01,134472,1,0,1,1,0,1
2023-06-01,141304,2,1,3,2,1,2
2023-06-01,134468,2,0,2,2,0,2
2023-06-01,141302,2,0,2,1,0,1
2023-06-01,134313,2,0,2,1,0,1
2023-06-01,141592,3,1,4,1,1,1
2023-06-01,150208,2,0,2,2,0,2
2023-06-01,142394,5,1,6,4,1,4
2023-06-01,141495,1,0,1,1,0,1
2023-06-01,141476,2,0,2,2,0,2
2023-06-01,150543,1,0,1,3,0,3
2023-06-01,141600,1,0,1,4,0,4
2023-06-01,141595,2,0,2,2,0,2
2023-06-01,135182,4,0,4,1,0,1
2023-06-01,141477,1,0,1,1,0,1
2023-06-01,141509,3,0,3,3,0,3
2023-06-01,141478,1,0,1,1,0,1
2023-06-01,131652,1,0,1,1,0,1
2023-06-01,38842,2,0,2,1,0,1
2023-06-01,141481,1,0,1,1,0,1
2023-06-01,141515,1,0,1,1,0,1
2023-06-01,140768,1,1,2,2,1,2
2023-06-01,134479,1,0,1,1,0,1
2023-06-01,141730,1,0,1,1,0,1
2023-06-01,134480,1,0,1,1,0,1
2023-06-01,151215,2,0,2,1,0,1
2023-06-01,140769,1,0,1,1,0,1
2023-06-01,149145,1,0,1,2,0,2
2023-06-01,141488,1,0,1,2,0,2
2023-06-01,150611,1,0,1,2,0,2
2023-06-01,140770,6,2,8,3,1,3
2023-06-01,141512,2,0,2,1,0,1
2023-06-01,134493,1,0,1,1,0,1
2023-06-01,134489,4,1,5,2,1,2
2023-06-01,141510,2,1,3,2,1,2
2023-06-01,134498,1,0,1,1,0,1
2023-06-01,141517,1,0,1,2,0,2
2023-06-01,134497,3,0,3,3,0,3
2023-06-01,38156,9,14,23,3,3,3
2023-06-01,141508,2,0,2,1,0,1
2023-06-01,134499,2,0,2,2,0,2
2023-06-01,134502,1,0,1,1,0,1
2023-06-01,141611,1,0,1,2,0,2
2023-06-01,141687,1,0,1,2,0,2
2023-06-01,131683,2,0,2,2,0,2
2023-06-01,141516,2,0,2,1,0,1
2023-06-01,141813,3,0,3,1,0,1
2023-06-01,134505,3,20,23,2,2,2
2023-06-01,134506,1,0,1,1,0,1
2023-06-01,141696,1,0,1,1,0,1
2023-06-01,141912,1,0,1,3,0,3
2023-06-01,141618,2,1,3,2,1,2
2023-06-01,141615,2,0,2,3,0,3
2023-06-01,141612,2,0,2,1,0,1
2023-06-01,140774,1,0,1,1,0,1
2023-06-01,140775,3,2,5,1,1,1
2023-06-01,141613,3,1,4,3,2,3
2023-06-01,59282,12,1,13,5,2,5
2023-06-01,150465,1,0,1,1,0,1
2023-06-01,138041,3,0,3,2,0,2
2023-06-01,141614,2,0,2,2,0,2
2023-06-01,141628,1,0,1,1,0,1
2023-06-01,141617,1,0,1,1,0,1
2023-06-01,138406,2,0,2,2,0,2
2023-06-01,138452,2,0,2,2,0,2
2023-06-01,141625,1,0,1,1,0,1
2023-06-01,141616,2,0,2,2,0,2
2023-06-01,139886,2,0,2,1,0,1
2023-06-01,140803,13,1,14,1,1,2
2023-06-01,141463,2,0,2,2,0,2
2023-06-01,141623,2,0,2,1,0,1
2023-06-01,141633,1,0,1,1,0,1
2023-06-01,141622,2,0,2,1,0,1
2023-06-01,141620,1,0,1,3,0,3
2023-06-01,141700,1,0,1,2,0,2
2023-06-01,45663,5,0,5,5,0,5
2023-06-01,55319,2,0,2,3,0,3
2023-06-01,140781,2,0,2,1,0,1
2023-06-01,141465,2,0,2,2,0,2
2023-06-01,18225,10,3,13,3,3,3
2023-06-01,141885,1,0,1,1,0,1
2023-06-01,141657,1,0,1,3,0,3
2023-06-01,141471,1,0,1,1,0,1
2023-06-01,141538,2,0,2,1,0,1
2023-06-01,132104,2,0,2,2,0,2
2023-06-01,141676,3,2,5,2,2,3
2023-06-01,2500,5,1,6,20,16,23
2023-06-01,141682,1,1,2,1,1,1
2023-06-01,141678,2,0,2,3,0,3
2023-06-01,141686,2,0,2,3,0,3
2023-06-01,141684,1,0,1,1,0,1
2023-06-01,141635,1,0,1,1,0,1
2023-06-01,141634,2,0,2,3,0,3
2023-06-01,141688,1,0,1,1,0,1
2023-06-01,141691,2,0,2,1,0,1
2023-06-01,141636,2,1,3,2,1,2
2023-06-01,141638,1,0,1,3,0,3
2023-06-01,141640,1,1,2,1,1,1
2023-06-01,65379,1,0,1,1,0,1
2023-06-01,141637,1,0,1,3,0,3
2023-06-01,141655,1,0,1,2,0,2
2023-06-01,151196,1,0,1,1,0,1
2023-06-01,141717,2,0,2,1,0,1
2023-06-01,141736,1,0,1,1,0,1
2023-06-01,141647,1,0,1,3,0,3
2023-06-01,141693,2,0,2,1,0,1
2023-06-01,141645,2,0,2,4,0,4
2023-06-01,141649,1,0,1,1,0,1
2023-06-01,141701,2,0,2,3,0,3
2023-06-01,141648,2,0,2,1,0,1
2023-06-01,141492,2,1,3,3,1,3
2023-06-01,141643,1,0,1,1,0,1
2023-06-01,141644,1,0,1,3,0,3
2023-06-01,141646,2,0,2,1,0,1
2023-06-01,141507,1,0,1,1,0,1
2023-06-01,141704,1,1,2,1,1,2
2023-06-01,63894,1,0,1,2,0,2
2023-06-01,147160,2,0,2,1,0,1
2023-06-01,141653,1,0,1,3,0,3
2023-06-01,148997,2,0,2,2,0,2
2023-06-01,141685,1,0,1,1,0,1
2023-06-01,24060,9,1,10,2,1,2
2023-06-01,141707,3,0,3,2,0,2
2023-06-01,141652,1,0,1,1,0,1
2023-06-01,141893,3,0,3,1,0,1
2023-06-01,141489,2,0,2,2,0,2
2023-06-01,141710,1,1,2,1,1,1
2023-06-01,141709,2,1,3,2,2,3
2023-06-01,137428,2,0,2,1,0,1
2023-06-01,142014,3,1,4,7,4,7
2023-06-01,142020,5,1,6,2,1,2
2023-06-01,141741,1,0,1,1,0,1
2023-06-01,141384,1,0,1,1,0,1
2023-06-01,141654,1,0,1,1,0,1
2023-06-01,141656,2,0,2,1,0,1
2023-06-01,141660,1,0,1,1,0,1
2023-06-01,141719,1,0,1,1,0,1
2023-06-01,141530,1,0,1,1,0,1
2023-06-01,141533,1,0,1,1,0,1
2023-06-01,131798,2,0,2,1,0,1
2023-06-01,141729,3,0,3,2,0,2
2023-06-01,141532,2,1,3,2,1,2
2023-06-01,149199,2,0,2,2,0,2
2023-06-01,141564,2,2,4,2,2,2
2023-06-01,141522,2,0,2,2,0,2
2023-06-01,141525,1,0,1,3,0,3
2023-06-01,141553,3,0,3,2,0,2
2023-06-01,141727,1,1,2,1,1,1
2023-06-01,141565,2,1,3,1,2,2
2023-06-01,141726,2,0,2,2,0,2
2023-06-01,141566,3,0,3,1,0,1
2023-06-01,134248,2,0,2,3,0,3
2023-06-01,141665,3,0,3,2,0,2
2023-06-01,141728,1,0,1,4,0,4
2023-06-01,132800,3,0,3,1,0,1
2023-06-01,141667,1,1,2,2,2,2
2023-06-01,141732,3,8,11,1,1,1
2023-06-01,141669,3,0,3,1,0,1
2023-06-01,133128,2,0,2,1,0,1
2023-06-01,136991,2,0,2,3,0,3
2023-06-01,138159,3,0,3,3,0,3
2023-06-01,141733,1,0,1,1,0,1
2023-06-01,55672,2,0,2,5,0,5
2023-06-01,141672,1,0,1,1,0,1
2023-06-01,141666,1,0,1,2,0,2
2023-06-01,131984,1,1,2,1,1,1
2023-06-01,131983,1,0,1,2,0,2
2023-06-01,141734,2,0,2,1,0,1
2023-06-01,141541,1,0,1,1,0,1
2023-06-01,141889,1,0,1,3,0,3
2023-06-01,141567,4,0,4,1,0,1
2023-06-01,141542,2,0,2,1,0,1
2023-06-01,141523,1,0,1,1,0,1
2023-06-01,141897,3,0,3,2,0,2
2023-06-01,135983,3,0,3,1,0,1
2023-06-01,141890,1,0,1,3,0,3
2023-06-01,141881,1,0,1,3,0,3
2023-06-01,141740,3,0,3,3,0,3
2023-06-01,141547,2,0,2,1,0,1
2023-06-01,141752,2,0,2,1,0,1
2023-06-01,142477,4,0,4,2,0,2
2023-06-01,45353,6,0,6,3,0,3
2023-06-01,134951,1,0,1,1,0,1
2023-06-01,138408,3,0,3,1,0,1
2023-06-01,38204,4,0,4,6,0,6
2023-06-01,141764,1,0,1,2,0,2
2023-06-01,141674,2,1,3,3,2,3
2023-06-01,141743,2,0,2,2,0,2
2023-06-01,141552,2,0,2,2,0,2
2023-06-01,141744,3,0,3,3,0,3
2023-06-01,141442,0,0,0,3,0,3
2023-06-01,134860,4,0,4,2,0,2
2023-06-01,141673,2,0,2,3,0,3
2023-06-01,141571,2,0,2,1,0,1
2023-06-01,149615,2,0,2,3,0,3
2023-06-01,141551,1,0,1,1,0,1
2023-06-01,141930,2,0,2,2,0,2
2023-06-01,141549,3,1,4,2,2,2
2023-06-01,141544,1,0,1,1,0,1
2023-06-01,141745,2,1,3,3,1,3
2023-06-01,140791,1,0,1,1,0,1
2023-06-01,139855,4,0,4,3,0,3
2023-06-01,140786,1,1,2,2,1,2
2023-06-01,141550,3,0,3,4,0,4
2023-06-01,141902,3,0,3,4,0,4
2023-06-01,141901,2,0,2,1,0,1
2023-06-01,141754,2,0,2,3,0,3
2023-06-01,141573,1,0,1,2,0,2
2023-06-01,141757,7,0,7,2,0,2
2023-06-01,142126,1,0,1,1,0,1
2023-06-01,141761,8,0,8,1,0,1
2023-06-01,141753,1,1,2,1,1,1
2023-06-01,141769,1,0,1,1,0,1
2023-06-01,141891,3,0,3,2,0,2
2023-06-01,141767,6,2,8,3,3,3
2023-06-01,134276,1,1,2,2,2,2
2023-06-01,141863,2,0,2,2,0,2
2023-06-01,141559,3,0,3,1,0,1
2023-06-01,141788,2,0,2,1,0,1
2023-06-01,141560,2,0,2,2,0,2
2023-06-01,141789,3,0,3,1,0,1
2023-06-01,141773,1,0,1,1,0,1
2023-06-01,140787,2,1,3,1,1,1
2023-06-01,141774,2,0,2,2,0,2
2023-06-01,141780,1,0,1,1,0,1
2023-06-01,141896,2,0,2,3,0,3
2023-06-01,141895,3,0,3,1,0,1
2023-06-01,141907,3,1,4,2,1,2
2023-06-01,141506,2,0,2,1,0,1
2023-06-01,141782,2,0,2,3,0,3
2023-06-01,141887,2,0,2,4,0,4
2023-06-01,141561,2,0,2,2,0,2
2023-06-01,132746,2,1,3,2,1,2
2023-06-01,141988,3,1,4,2,2,2
2023-06-01,141884,1,1,2,1,1,1
2023-06-01,142000,2,0,2,1,0,1
2023-06-01,141990,1,0,1,3,0,3
2023-06-01,139481,1,0,1,1,0,1
2023-06-01,141787,1,0,1,1,0,1
2023-06-01,141879,1,0,1,1,0,1
2023-06-01,141992,1,0,1,3,0,3
2023-06-01,140796,1,0,1,1,0,1
2023-06-01,141991,2,0,2,2,0,2
2023-06-01,141786,1,0,1,1,0,1
2023-06-01,141997,2,0,2,1,0,1
2023-06-01,141993,1,1,2,1,1,1
2023-06-01,141903,2,0,2,2,0,2
2023-06-01,141910,3,0,3,3,0,3
2023-06-01,141999,1,1,2,1,1,1
2023-06-01,167001,0,0,0,2,0,2
2023-06-01,141904,1,0,1,1,0,1
2023-06-01,131931,5,0,5,4,0,4
2023-06-01,134650,2,0,2,2,0,2
2023-06-01,142002,59,0,59,4,0,4
2023-06-01,141906,1,0,1,1,0,1
2023-06-01,141905,2,0,2,4,0,4
2023-06-01,136906,1,1,2,1,1,1
2023-06-01,142006,2,1,3,1,1,1
2023-06-01,142004,1,0,1,1,0,1
2023-06-01,131297,1,0,1,2,0,2
2023-06-01,142003,3,0,3,2,0,2
2023-06-01,140789,1,0,1,1,0,1
2023-06-01,141820,1,0,1,2,0,2
2023-06-01,141819,2,0,2,1,0,1
2023-06-01,137069,1,0,1,3,0,3
2023-06-01,142009,3,1,4,3,1,3
2023-06-01,141909,3,0,3,2,0,2
2023-06-01,141880,1,0,1,1,0,1
2023-06-01,142008,2,0,2,1,0,1
2023-06-01,133325,1,0,1,1,0,1
2023-06-01,135193,4,1,5,4,1,4
2023-06-01,134693,3,0,3,2,0,2
2023-06-01,147089,2,0,2,3,0,3
2023-06-01,141911,1,0,1,1,0,1
2023-06-01,141794,1,0,1,3,0,3
2023-06-01,142012,3,0,3,1,0,1
2023-06-01,141801,2,0,2,3,0,3
2023-06-01,141938,3,0,3,1,0,1
2023-06-01,141939,2,1,3,2,1,2
2023-06-01,141793,1,0,1,1,0,1
2023-06-01,141869,2,0,2,1,0,1
2023-06-01,141868,1,1,2,1,2,2
2023-06-01,141917,1,0,1,1,0,1
2023-06-01,141913,3,0,3,1,0,1
2023-06-01,142015,3,4,7,2,1,2
2023-06-01,141916,1,0,1,2,0,2
2023-06-01,38215,1,1,2,2,2,2
2023-06-01,142016,3,0,3,1,0,1
2023-06-01,149127,1,1,2,1,1,1
2023-06-01,141874,1,0,1,1,0,1
2023-06-01,141927,2,0,2,1,0,1
2023-06-01,64063,5,5,10,3,1,3
2023-06-01,142018,1,0,1,1,0,1
2023-06-01,141914,2,0,2,1,0,1
2023-06-01,141791,1,0,1,1,0,1
2023-06-01,141797,2,0,2,1,0,1
2023-06-01,141798,1,0,1,1,0,1
2023-06-01,142022,1,1,2,1,1,1
2023-06-01,141783,2,0,2,2,0,2
2023-06-01,141814,1,0,1,2,0,2
2023-06-01,142021,2,0,2,3,0,3
2023-06-01,136256,2,0,2,3,0,3
2023-06-01,142024,1,1,2,1,1,1
2023-06-01,142029,3,1,4,3,1,3
2023-06-01,141870,1,0,1,2,0,2
2023-06-01,141872,2,0,2,1,0,1
2023-06-01,141873,4,0,4,1,0,1
2023-06-01,141806,3,0,3,1,0,1
2023-06-01,141853,9,0,9,1,0,1
2023-06-01,141866,2,1,3,2,1,2
2023-06-01,142037,1,1,2,2,1,2
2023-06-01,141864,1,1,2,4,2,4
2023-06-01,149549,3,0,3,3,0,3
2023-06-01,142042,1,0,1,1,0,1
2023-06-01,45513,4,0,4,3,0,3
2023-06-01,142040,2,1,3,1,1,1
2023-06-01,141858,2,0,2,1,0,1
2023-06-01,138618,3,0,3,2,0,2
2023-06-01,141926,1,0,1,1,0,1
2023-06-01,141920,2,0,2,3,0,3
2023-06-01,141922,1,0,1,3,0,3
2023-06-01,141965,1,0,1,3,0,3
2023-06-01,141921,2,0,2,2,0,2
2023-06-01,146956,2,0,2,1,0,1
2023-06-01,136275,2,0,2,3,0,3
2023-06-01,134168,1,0,1,2,0,2
2023-06-01,141804,6,0,6,2,0,2
2023-06-01,141807,2,0,2,2,0,2
2023-06-01,142049,1,1,2,3,1,3
2023-06-01,141213,1,0,1,2,0,2
2023-06-01,138913,2,0,2,2,0,2
2023-06-01,142053,1,1,2,1,1,1
2023-06-01,142050,2,13,15,2,1,2
2023-06-01,142051,1,0,1,1,0,1
2023-06-01,142052,2,1,3,1,1,1
2023-06-01,141948,1,0,1,1,0,1
2023-06-01,141070,1,0,1,1,0,1
2023-06-01,141937,2,1,3,2,1,2
2023-06-01,141960,1,0,1,2,0,2
2023-06-01,141928,1,0,1,1,0,1
2023-06-01,142059,1,1,2,2,2,2
2023-06-01,141931,1,0,1,1,0,1
2023-06-01,141978,2,0,2,3,0,3
2023-06-01,137186,2,0,2,3,0,3
2023-06-01,142054,3,0,3,2,0,2
2023-06-01,142056,2,0,2,2,0,2
2023-06-01,141929,2,0,2,4,0,4
2023-06-01,142058,3,0,3,3,0,3
2023-06-01,139691,1,1,2,2,1,2
2023-06-01,141935,1,0,1,1,0,1
2023-06-01,141936,1,0,1,2,0,2
2023-06-01,132294,1,0,1,2,0,2
2023-06-01,137213,2,0,2,3,0,3
2023-06-01,137441,2,0,2,1,0,1
2023-06-01,142304,1,0,1,1,0,1
2023-06-01,141933,1,0,1,1,0,1
2023-06-01,142027,2,0,2,4,0,4
2023-06-01,142060,3,1,4,3,1,3
2023-06-01,141973,1,0,1,1,0,1
2023-06-01,142028,1,0,1,2,0,2
2023-06-01,141941,2,0,2,4,0,4
2023-06-01,134136,1,0,1,3,0,3
2023-06-01,142279,1,0,1,1,0,1
2023-06-01,142065,3,1,4,1,1,1
2023-06-01,141943,2,0,2,2,0,2
2023-06-01,141848,1,0,1,2,0,2
2023-06-01,142064,2,1,3,2,1,2
2023-06-01,142066,2,0,2,2,0,2
2023-06-01,141945,1,0,1,1,0,1
2023-06-01,141947,3,0,3,3,0,3
2023-06-01,142116,1,1,2,2,1,2
2023-06-01,141944,1,0,1,1,0,1
2023-06-01,142114,1,0,1,1,0,1
2023-06-01,140799,2,2,4,1,1,1
2023-06-01,142119,1,0,1,1,0,1
2023-06-01,24380,10,0,10,1,0,1
2023-06-01,141951,1,0,1,3,0,3
2023-06-01,142125,1,1,2,2,1,2
2023-06-01,142120,2,1,3,1,1,1
2023-06-01,141955,2,0,2,2,0,2
2023-06-01,141952,2,0,2,2,0,2
2023-06-01,141953,1,0,1,3,0,3
2023-06-01,141950,1,0,1,1,0,1
2023-06-01,137010,2,0,2,3,0,3
2023-06-01,142123,3,0,3,1,0,1
2023-06-01,142124,2,0,2,1,0,1
2023-06-01,142131,2,0,2,3,0,3
2023-06-01,142134,1,0,1,2,0,2
2023-06-01,141862,2,0,2,2,0,2
2023-06-01,141961,2,0,2,2,0,2
2023-06-01,142136,1,0,1,2,0,2
2023-06-01,142137,1,0,1,1,0,1
2023-06-01,142139,1,0,1,1,0,1
2023-06-01,141957,2,0,2,3,0,3
2023-06-01,17607,8,0,8,1,0,1
2023-06-01,141958,1,0,1,1,0,1
2023-06-01,141959,3,0,3,3,0,3
2023-06-01,211041,2,2,4,6,5,8
2023-06-01,209244,1,0,1,1,0,1
2023-06-01,140600,1,0,1,1,0,1
2023-06-01,142146,2,0,2,6,0,6
2023-06-01,142151,1,0,1,1,0,1
2023-06-01,142149,2,0,2,1,0,1
2023-06-01,141969,2,0,2,1,0,1
2023-06-01,61228,1,0,1,1,0,1
2023-06-01,142153,3,1,4,2,1,3
2023-06-01,141967,1,0,1,1,0,1
2023-06-01,142274,1,0,1,1,0,1
2023-06-01,139720,2,0,2,1,0,1
2023-06-01,142157,1,0,1,2,0,2
2023-06-01,142159,1,0,1,2,0,2
2023-06-01,141977,1,0,1,1,0,1
2023-06-01,141972,1,0,1,1,0,1
2023-06-01,142160,3,0,3,8,0,8
2023-06-01,142162,1,0,1,2,0,2
2023-06-01,131986,3,1,4,3,2,3
2023-06-01,45679,1,2,3,3,3,4
2023-06-01,142269,2,0,2,1,0,1
2023-06-01,38854,1,1,2,1,1,1
2023-06-01,141824,2,0,2,1,0,1
2023-06-01,135021,1,1,2,1,1,1
2023-06-01,150458,3,0,3,1,0,1
2023-06-01,137230,1,0,1,1,0,1
2023-06-01,141982,2,0,2,1,0,1
2023-06-01,141975,2,0,2,4,0,4
2023-06-01,141823,2,0,2,2,0,2
2023-06-01,141827,1,0,1,1,0,1
2023-06-01,141857,1,0,1,1,0,1
2023-06-01,137398,2,0,2,2,0,2
2023-06-01,142283,1,0,1,1,0,1
2023-06-01,141981,3,0,3,3,0,3
2023-06-01,141976,1,0,1,1,0,1
2023-06-01,142285,1,0,1,1,0,1
2023-06-01,142288,1,1,2,1,1,1
2023-06-01,142287,3,0,3,1,0,1
2023-06-01,135378,2,0,2,2,0,2
2023-06-01,141534,1,0,1,1,0,1
2023-06-01,141878,2,1,3,1,1,1
2023-06-01,135321,2,0,2,4,0,4
2023-06-01,142293,2,0,2,1,0,1
2023-06-01,141803,5,0,5,1,0,1
2023-06-01,142325,4,0,4,2,0,2
2023-06-01,141826,1,0,1,1,0,1
2023-06-01,138929,3,0,3,3,0,3
2023-06-01,142294,1,0,1,1,0,1
2023-06-01,141984,3,1,4,3,1,3
2023-06-01,141825,2,0,2,2,0,2
2023-06-01,150082,6,0,6,1,0,1
2023-06-01,142297,1,1,2,1,1,1
2023-06-01,142296,3,0,3,2,0,2
2023-06-01,142298,1,1,2,1,1,1
2023-06-01,140833,1,1,2,1,1,1
2023-06-01,63790,1,1,2,1,1,1
2023-06-01,141822,1,1,2,2,1,2
2023-06-01,142367,1,0,1,2,0,2
2023-06-01,141986,3,0,3,2,0,2
2023-06-01,142323,1,0,1,1,0,1
2023-06-01,141843,1,0,1,3,0,3
2023-06-01,141835,6,0,6,1,0,1
2023-06-01,141844,2,1,3,2,1,2
2023-06-01,141837,2,0,2,2,0,2
2023-06-01,141832,1,0,1,2,0,2
2023-06-01,9267,1,1,2,1,1,1
2023-06-01,138910,2,0,2,1,0,1
2023-06-01,140125,6,0,6,1,0,1
2023-06-01,142407,1,0,1,1,0,1
2023-06-01,142414,3,0,3,3,0,3
2023-06-01,133961,2,0,2,3,0,3
2023-06-01,142415,1,0,1,1,0,1
2023-06-01,142416,1,0,1,3,0,3
2023-06-01,142417,1,0,1,3,0,3
2023-06-01,142329,1,0,1,1,0,1
2023-06-01,142305,2,0,2,2,0,2
2023-06-01,142312,1,0,1,1,0,1
2023-06-01,142314,1,0,1,1,0,1
2023-06-01,141865,3,1,4,3,1,3
2023-06-01,142424,2,0,2,4,0,4
2023-06-01,142421,2,0,2,1,0,1
2023-06-01,142426,2,0,2,1,0,1
2023-06-01,140806,3,0,3,3,0,3
2023-06-01,135981,2,3,5,1,1,1
2023-06-01,149143,1,0,1,1,0,1
2023-06-01,140814,2,1,3,1,1,1
2023-06-01,141836,6,0,6,1,0,1
2023-06-01,142430,1,0,1,2,0,2
2023-06-01,142428,2,0,2,1,0,1
2023-06-01,56311,8,0,8,4,0,4
2023-06-01,141842,1,0,1,2,0,2
2023-06-01,141840,1,1,2,2,1,2
2023-06-01,138918,3,0,3,2,0,2
2023-06-01,142436,1,0,1,1,0,1
2023-06-01,140719,1,0,1,6,0,6
2023-06-01,141856,2,0,2,2,0,2
2023-06-01,140809,3,1,4,2,2,2
2023-06-01,135747,2,0,2,1,0,1
2023-06-01,38588,1,0,1,1,0,1
2023-06-01,142350,1,0,1,1,0,1
2023-06-01,142315,2,0,2,3,0,3
2023-06-01,142311,3,0,3,1,0,1
2023-06-01,142313,1,0,1,1,0,1
2023-06-01,142317,2,1,3,1,1,1
2023-06-01,142316,1,0,1,3,0,3
2023-06-01,147236,4,2,6,4,1,4
2023-06-01,177236,1,0,1,1,0,1
2023-06-01,142318,1,0,1,2,0,2
2023-06-01,150654,1,0,1,2,0,2
2023-06-01,142435,2,2,4,1,1,1
2023-06-01,142487,1,0,1,1,0,1
2023-06-01,142539,1,1,2,3,1,3
2023-06-01,142492,1,0,1,1,0,1
2023-06-01,142321,2,0,2,3,0,3
2023-06-01,142322,1,0,1,3,0,3
2023-06-01,142319,2,0,2,2,0,2
2023-06-01,142324,1,0,1,1,0,1
2023-06-01,142336,1,0,1,1,0,1
2023-06-01,146860,2,0,2,2,0,2
2023-06-01,142542,1,0,1,1,0,1
2023-06-01,142461,1,1,2,3,2,4
2023-06-01,142459,2,0,2,1,0,1
2023-06-01,150629,1,0,1,1,0,1
2023-06-01,142535,2,16,18,2,2,2
2023-06-01,142464,1,0,1,1,0,1
2023-06-01,136045,1,0,1,1,0,1
2023-06-01,142446,1,1,2,1,1,1
2023-06-01,139003,3,0,3,3,0,3
2023-06-01,149660,3,1,4,4,2,4
2023-06-01,142547,2,0,2,3,0,3
2023-06-01,142499,2,0,2,1,0,1
2023-06-01,142445,3,0,3,1,0,1
2023-06-01,142441,1,0,1,2,0,2
2023-06-01,142506,1,1,2,1,1,1
2023-06-01,142439,3,1,4,2,2,3
2023-06-01,142334,1,1,2,1,1,1
2023-06-01,142330,1,0,1,1,0,1
2023-06-01,142357,1,0,1,2,0,2
2023-06-01,142327,3,0,3,3,0,3
2023-06-01,142507,1,1,2,1,1,1
2023-06-01,142326,2,0,2,1,0,1
2023-06-01,142346,2,0,2,3,0,3
2023-06-01,142335,3,0,3,3,0,3
2023-06-01,142333,2,0,2,2,0,2
2023-06-01,140817,2,2,4,1,1,1
2023-06-01,136559,1,0,1,1,0,1
2023-06-01,142332,2,1,3,2,1,2
2023-06-01,147100,1,0,1,2,0,2
2023-06-01,142391,1,0,1,1,0,1
2023-06-01,38853,1,0,1,1,0,1
2023-06-01,142344,1,1,2,1,1,1
2023-06-01,146845,1,0,1,2,0,2
2023-06-01,146746,1,0,1,1,0,1
2023-06-01,142555,1,0,1,1,0,1
2023-06-01,142349,1,0,1,1,0,1
2023-06-01,134283,3,0,3,2,0,2
2023-06-01,140177,2,1,3,1,1,1
2023-06-01,150075,1,0,1,1,0,1
2023-06-01,142494,2,1,3,1,1,1
2023-06-01,142557,2,0,2,3,0,3
2023-06-01,142558,2,0,2,3,0,3
2023-06-01,142493,1,0,1,1,0,1
2023-06-01,142342,2,1,3,1,1,1
2023-06-01,142340,2,0,2,2,0,2
2023-06-01,142341,3,0,3,2,0,2
2023-06-01,142338,3,0,3,3,0,3
2023-06-01,142343,3,0,3,3,0,3
2023-06-01,63791,1,1,2,1,1,1
2023-06-01,140811,2,0,2,1,0,1
2023-06-01,136742,1,1,2,1,1,1
2023-06-01,142490,2,0,2,1,0,1
2023-06-01,148993,2,0,2,1,0,1
2023-06-01,142498,2,0,2,1,0,1
2023-06-01,142509,2,0,2,2,0,2
2023-06-01,142443,1,1,2,1,1,2
2023-06-01,142571,2,0,2,2,0,2
2023-06-01,136432,1,0,1,1,0,1
2023-06-01,142348,1,1,2,2,1,2
2023-06-01,142356,1,1,2,3,1,3
2023-06-01,142351,1,0,1,3,0,3
2023-06-01,147112,1,0,1,1,0,1
2023-06-01,38852,1,0,1,2,0,2
2023-06-01,142363,1,0,1,1,0,1
2023-06-01,142362,2,0,2,3,0,3
2023-06-01,142534,2,0,2,1,0,1
2023-06-01,142533,1,0,1,1,0,1
2023-06-01,142579,1,0,1,3,0,3
2023-06-01,142508,1,1,2,1,1,1
2023-06-01,142581,2,0,2,3,0,3
2023-06-01,142359,1,0,1,1,0,1
2023-06-01,142585,1,0,1,1,0,1
2023-06-01,142361,2,0,2,2,0,2
2023-06-01,142504,1,0,1,1,0,1
2023-06-01,133223,1,0,1,1,0,1
2023-06-01,142503,2,0,2,2,0,2
2023-06-01,142468,2,0,2,3,0,3
2023-06-01,142470,8,9,17,2,2,2
2023-06-01,134046,2,0,2,1,0,1
2023-06-01,142515,1,0,1,1,0,1
2023-06-01,142449,2,0,2,2,0,2
2023-06-01,210488,1,0,1,1,0,1
2023-06-01,142606,1,0,1,1,0,1
2023-06-01,142471,1,1,2,1,1,1
2023-06-01,149332,1,0,1,1,0,1
2023-06-01,142455,2,0,2,1,0,1
2023-06-01,138693,1,0,1,1,0,1
2023-06-01,142368,1,1,2,1,1,1
2023-06-01,151329,1,0,1,1,0,1
2023-06-01,142364,2,3,5,1,1,1
2023-06-01,142518,1,0,1,1,0,1
2023-06-01,149228,2,0,2,2,0,2
2023-06-01,131988,1,1,2,2,1,2
2023-06-01,139204,1,0,1,1,0,1
2023-06-01,142526,1,0,1,1,0,1
2023-06-01,138524,1,1,2,2,2,2
2023-06-01,139781,1,0,1,1,0,1
2023-06-01,142593,2,0,2,3,0,3
2023-06-01,136519,1,0,1,2,0,2
2023-06-01,142596,1,0,1,4,0,4
2023-06-01,138713,3,1,4,2,1,2
2023-06-01,142524,1,1,2,2,1,2
2023-06-01,142479,2,1,3,1,1,1
2023-06-01,142481,1,0,1,2,0,2
2023-06-01,142607,1,0,1,1,0,1
2023-06-01,142595,2,0,2,3,0,3
2023-06-01,142600,3,1,4,1,1,1
2023-06-01,142485,1,1,2,2,1,2
2023-06-01,135098,1,0,1,1,0,1
2023-06-01,142365,1,0,1,2,0,2
2023-06-01,142610,1,0,1,1,0,1
2023-06-01,142476,2,0,2,1,0,1
2023-06-01,150464,1,0,1,1,0,1
2023-06-01,142613,1,0,1,1,0,1
2023-06-01,142447,2,0,2,1,0,1
2023-06-01,142605,3,0,3,1,0,1
2023-06-01,142612,2,1,3,1,1,1
2023-06-01,63965,6,0,6,1,0,1
2023-06-01,142611,2,0,2,1,0,1
2023-06-01,146842,6,0,6,3,0,3
2023-06-01,133292,2,0,2,1,0,1
2023-06-01,147228,1,0,1,1,0,1
2023-06-01,142621,1,0,1,1,0,1
2023-06-01,147226,2,1,3,3,1,3
2023-06-01,150740,1,0,1,2,0,2
2023-06-01,142615,1,0,1,1,0,1
2023-06-01,142616,3,1,4,9,10,17
2023-06-01,142513,2,0,2,4,0,4
2023-06-01,146921,2,0,2,1,0,1
2023-06-01,142531,2,0,2,1,0,1
2023-06-01,142483,1,0,1,1,0,1
2023-06-01,55899,6,2,8,2,2,2
2023-06-01,147174,2,1,3,3,2,3
2023-06-01,399686,10,10,20,1,1,1
2023-06-01,142619,3,0,3,2,0,2
2023-06-01,142623,2,0,2,2,0,2
2023-06-01,142450,2,1,3,1,1,1
2023-06-01,142628,1,0,1,1,0,1
2023-06-01,147194,5,0,5,1,0,1
2023-06-01,142484,5,0,5,1,0,1
2023-06-01,45574,2,0,2,3,0,3
2023-06-01,142627,2,1,3,3,1,3
2023-06-01,142626,3,0,3,1,0,1
2023-06-01,146852,2,0,2,2,0,2
2023-06-01,146941,2,0,2,1,0,1
2023-06-01,149551,3,0,3,2,0,2
2023-06-01,146879,1,0,1,3,0,3
2023-06-01,142392,1,0,1,1,0,1
2023-06-01,142373,2,0,2,2,0,2
2023-06-01,142478,1,0,1,1,0,1
2023-06-01,140819,1,1,2,1,1,1
2023-06-01,135990,1,0,1,1,0,1
2023-06-01,150030,7,0,7,1,0,1
2023-06-01,140822,19,1,20,1,1,1
2023-06-01,142529,3,1,4,1,1,1
2023-06-01,142451,4,7,11,3,3,3
2023-06-01,146920,2,0,2,1,0,1
2023-06-01,146881,1,0,1,2,0,2
2023-06-01,142633,2,0,2,3,0,3
2023-06-01,142639,3,0,3,1,0,1
2023-06-01,142643,4,0,4,5,0,5
2023-06-01,146914,2,0,2,1,0,1
2023-06-01,146922,1,0,1,1,0,1
2023-06-01,147080,1,0,1,1,0,1
2023-06-01,142375,2,0,2,4,0,4
2023-06-01,146945,2,0,2,2,0,2
2023-06-01,139543,2,1,3,2,1,2
2023-06-01,135127,2,0,2,2,0,2
2023-06-01,146926,1,0,1,1,0,1
2023-06-01,146928,1,0,1,2,0,2
2023-06-01,146924,2,1,3,1,1,1
2023-06-01,146847,2,0,2,1,0,1
2023-06-01,142644,3,0,3,3,0,3
2023-06-01,140823,1,1,2,1,1,1
2023-06-01,131801,6,0,6,1,0,1
2023-06-01,146946,2,0,2,2,0,2
2023-06-01,38771,17,0,17,4,0,4
2023-06-01,142649,1,0,1,1,0,1
2023-06-01,142390,2,0,2,1,0,1
2023-06-01,142377,2,0,2,3,0,3
2023-06-01,146851,1,0,1,3,0,3
2023-06-01,146948,1,0,1,2,0,2
2023-06-01,135597,2,0,2,2,0,2
2023-06-01,23632,2,0,2,2,0,2
2023-06-01,142380,1,0,1,1,0,1
2023-06-01,146925,1,0,1,1,0,1
2023-06-01,146918,1,1,2,1,1,1
2023-06-01,146917,2,0,2,3,0,3
2023-06-01,136428,2,0,2,3,0,3
2023-06-01,146949,1,0,1,1,0,1
2023-06-01,142381,2,0,2,2,0,2
2023-06-01,142382,4,4,8,4,1,4
2023-06-01,142383,3,0,3,2,0,2
2023-06-01,142388,2,0,2,2,0,2
2023-06-01,147127,1,0,1,1,0,1
2023-06-01,142387,2,0,2,3,0,3
2023-06-01,147077,1,0,1,1,0,1
2023-06-01,146953,1,0,1,1,0,1
2023-06-01,142393,1,0,1,3,0,3
2023-06-01,142385,1,0,1,1,0,1
2023-06-01,146957,2,0,2,3,0,3
2023-06-01,146936,2,1,3,2,1,2
2023-06-01,146853,1,0,1,1,0,1
2023-06-01,140824,1,1,2,1,1,1
2023-06-01,142386,2,0,2,3,0,3
2023-06-01,146961,6,4,10,8,4,10
2023-06-01,146944,2,1,3,3,1,3
2023-06-01,146930,2,1,3,2,1,2
2023-06-01,146929,1,0,1,1,0,1
2023-06-01,147076,2,0,2,2,0,2
2023-06-01,150043,1,0,1,1,0,1
2023-06-01,146963,3,1,4,1,1,1
2023-06-01,146967,1,0,1,1,0,1
2023-06-01,147069,1,0,1,1,0,1
2023-06-01,146962,2,0,2,1,0,1
2023-06-01,133434,2,1,3,7,5,7
2023-06-01,147136,1,0,1,2,0,2
2023-06-01,146988,2,1,3,3,2,3
2023-06-01,147070,3,0,3,2,0,2
2023-06-01,142395,1,0,1,1,0,1
2023-06-01,142398,2,1,3,4,2,4
2023-06-01,140305,1,0,1,1,0,1
2023-06-01,18428,2,0,2,2,0,2
2023-06-01,147289,1,0,1,1,0,1
2023-06-01,150134,1,0,1,3,0,3
2023-06-01,23669,3,0,3,4,0,4
2023-06-01,146990,2,0,2,2,0,2
2023-06-01,147068,1,0,1,3,0,3
2023-06-01,142389,2,1,3,1,1,1
2023-06-01,146877,1,0,1,1,0,1
2023-06-01,146942,1,1,2,2,1,2
2023-06-01,142396,2,0,2,2,0,2
2023-06-01,147088,1,0,1,1,0,1
2023-06-01,146855,1,1,2,2,1,2
2023-06-01,147000,1,0,1,1,0,1
2023-06-01,142400,2,1,3,2,1,2
2023-06-01,147008,1,0,1,1,0,1
2023-06-01,146876,1,0,1,3,0,3
2023-06-01,146884,3,1,4,3,1,3
2023-06-01,141556,2,0,2,3,0,3
2023-06-01,135334,1,0,1,1,0,1
2023-06-01,147007,3,0,3,1,0,1
2023-06-01,149098,1,0,1,1,0,1
2023-06-01,142401,2,1,3,5,2,5
2023-06-01,147086,2,0,2,1,0,1
2023-06-01,147072,3,0,3,3,0,3
2023-06-01,147011,3,0,3,2,0,2
2023-06-01,147017,3,1,4,1,1,1
2023-06-01,147014,2,0,2,4,0,4
2023-06-01,147018,1,0,1,1,0,1
2023-06-01,131990,1,1,2,1,1,1
2023-06-01,146864,1,1,2,1,1,1
2023-06-01,135308,2,0,2,1,0,1
2023-06-01,146890,1,0,1,2,0,2
2023-06-01,146886,2,1,3,2,1,2
2023-06-01,147022,3,0,3,3,0,3
2023-06-01,133099,3,0,3,2,0,2
2023-06-01,146894,2,0,2,3,0,3
2023-06-01,147037,1,0,1,1,0,1
2023-06-01,147030,1,1,2,1,1,1
2023-06-01,147029,3,0,3,3,0,3
2023-06-01,147031,2,0,2,1,0,1
2023-06-01,147113,2,0,2,2,0,2
2023-06-01,147092,1,0,1,1,0,1
2023-06-01,147039,1,1,2,3,3,5
2023-06-01,146866,2,0,2,1,0,1
2023-06-01,131242,2,0,2,1,0,1
2023-06-01,146863,3,1,4,2,1,2
2023-06-01,9920,1,0,1,1,0,1
2023-06-01,146867,2,0,2,1,0,1
2023-06-01,147033,3,0,3,1,0,1
2023-06-01,147042,2,0,2,1,0,1
2023-06-01,150140,1,0,1,1,0,1
2023-06-01,142530,1,0,1,1,0,1
2023-06-01,147040,2,0,2,1,0,1
2023-06-01,146869,3,1,4,1,1,1
2023-06-01,146915,2,0,2,2,0,2
2023-06-01,146870,1,0,1,2,0,2
2023-06-01,146868,2,0,2,1,0,1
2023-06-01,147078,2,0,2,2,0,2
2023-06-01,147090,3,0,3,1,0,1
2023-06-01,16999,5,0,5,6,0,6
2023-06-01,147052,1,0,1,1,0,1
2023-06-01,24537,7,0,7,2,0,2
2023-06-01,147081,3,1,4,1,1,1
2023-06-01,146875,1,0,1,1,0,1
2023-06-01,147053,2,0,2,3,0,3
2023-06-01,147180,3,0,3,3,0,3
2023-06-01,138186,6,0,6,1,0,1
2023-06-01,147055,1,0,1,2,0,2
2023-06-01,147056,1,0,1,2,0,2
2023-06-01,146907,1,0,1,2,0,2
2023-06-01,146896,1,0,1,1,0,1
2023-06-01,146898,2,0,2,1,0,1
2023-06-01,147205,3,0,3,1,0,1
2023-06-01,146900,2,1,3,1,1,1
2023-06-01,138234,1,0,1,1,0,1
2023-06-01,147091,1,0,1,2,0,2
2023-06-01,146911,2,0,2,2,0,2
2023-06-01,140826,1,1,2,1,1,1
2023-06-01,147061,1,0,1,2,0,2
2023-06-01,147062,1,0,1,3,0,3
2023-06-01,136984,1,1,2,1,1,1
2023-06-01,147063,2,0,2,1,0,1
2023-06-01,149043,1,0,1,3,0,3
2023-06-01,147065,3,0,3,2,0,2
2023-06-01,147177,2,1,3,2,1,2
2023-06-01,147178,1,1,2,2,2,2
2023-06-01,147170,2,0,2,2,0,2
2023-06-01,149352,2,1,3,2,1,2
2023-06-01,147093,3,0,3,1,0,1
2023-06-01,134011,1,0,1,2,0,2
2023-06-01,147175,2,0,2,2,0,2
2023-06-01,146901,2,0,2,1,0,1
2023-06-01,146912,2,0,2,1,0,1
2023-06-01,147179,2,0,2,2,0,2
2023-06-01,132767,1,1,2,1,2,2
2023-06-01,7676,11,2,13,1,1,1
2023-06-01,147095,2,0,2,1,0,1
2023-06-01,147184,3,1,4,2,1,2
2023-06-01,135731,2,0,2,1,0,1
2023-06-01,147189,1,0,1,2,0,2
2023-06-01,147190,1,0,1,1,0,1
2023-06-01,9818,1,1,2,3,1,3
2023-06-01,147292,2,0,2,2,0,2
2023-06-01,147294,3,0,3,3,0,3
2023-06-01,133719,1,0,1,1,0,1
2023-06-01,147290,1,0,1,1,0,1
2023-06-01,147193,2,0,2,3,0,3
2023-06-01,147097,3,1,4,4,3,4
2023-06-01,147096,2,0,2,2,0,2
2023-06-01,150079,2,1,3,3,1,3
2023-06-01,147295,1,0,1,1,0,1
2023-06-01,147298,3,0,3,2,0,2
2023-06-01,147192,1,0,1,1,0,1
2023-06-01,147305,2,1,3,3,1,3
2023-06-01,147283,2,0,2,1,0,1
2023-06-01,147304,2,2,4,3,4,5
2023-06-01,147104,1,0,1,1,0,1
2023-06-01,147101,2,0,2,3,0,3
2023-06-01,147107,3,1,4,5,3,5
2023-06-01,147306,1,0,1,2,0,2
2023-06-01,138032,2,3,5,2,2,2
2023-06-01,150671,1,1,2,1,1,1
2023-06-01,147310,2,0,2,1,0,1
2023-06-01,147313,3,0,3,3,0,3
2023-06-01,147315,2,0,2,2,0,2
2023-06-01,149794,2,2,4,2,2,2
2023-06-01,140829,3,0,3,1,0,1
2023-06-01,147103,1,0,1,1,0,1
2023-06-01,148794,1,0,1,2,0,2
2023-06-01,141359,1,0,1,1,0,1
2023-06-01,141357,3,0,3,3,0,3
2023-06-01,147105,3,0,3,2,0,2
2023-06-01,147106,2,0,2,4,0,4
2023-06-01,150644,1,0,1,1,0,1
2023-06-01,135206,8,1,9,4,1,4
2023-06-01,148974,1,0,1,1,0,1
2023-06-01,148975,2,0,2,2,0,2
2023-06-01,147199,1,0,1,1,0,1
2023-06-01,147201,2,1,3,2,1,2
2023-06-01,147216,2,0,2,1,0,1
2023-06-01,148976,1,0,1,1,0,1
2023-06-01,146972,1,1,2,2,2,2
2023-06-01,45232,22,0,22,2,0,2
2023-06-01,150349,1,0,1,2,0,2
2023-06-01,147109,2,0,2,3,0,3
2023-06-01,147225,2,0,2,2,0,2
2023-06-01,133266,2,1,3,2,1,2
2023-06-01,147239,1,0,1,1,0,1
2023-06-01,147117,2,0,2,2,0,2
2023-06-01,148985,1,0,1,2,0,2
2023-06-01,147144,1,0,1,1,0,1
2023-06-01,148979,1,0,1,1,0,1
2023-06-01,147207,1,0,1,1,0,1
2023-06-01,149216,1,0,1,1,0,1
2023-06-01,146974,1,1,2,5,4,5
2023-06-01,147111,2,0,2,1,0,1
2023-06-01,134357,1,0,1,1,0,1
2023-06-01,148988,1,0,1,1,0,1
2023-06-01,136496,1,1,2,1,1,1
2023-06-01,137078,2,0,2,3,0,3
2023-06-01,148986,3,0,3,1,0,1
2023-06-01,147209,2,16,18,2,1,2
2023-06-01,140830,1,0,1,1,0,1
2023-06-01,147120,3,0,3,2,0,2
2023-06-01,147237,1,0,1,1,0,1
2023-06-01,148992,1,1,2,1,1,1
2023-06-01,149187,8,1,9,1,1,1
2023-06-01,2923,29,0,29,5,0,5
2023-06-01,149363,1,0,1,2,0,2
2023-06-01,140831,1,0,1,1,0,1
2023-06-01,131812,2,1,3,1,1,1
2023-06-01,147118,2,0,2,3,0,3
2023-06-01,147119,1,0,1,3,0,3
2023-06-01,147125,1,0,1,1,0,1
2023-06-01,147124,2,1,3,2,1,2
2023-06-01,149001,1,1,2,1,1,1
2023-06-01,212806,2,1,3,1,4,4
2023-06-01,147121,2,1,3,3,1,3
2023-06-01,147122,2,0,2,3,0,3
2023-06-01,147123,2,0,2,1,0,1
2023-06-01,136997,3,0,3,1,0,1
2023-06-01,140834,1,1,2,1,1,1
2023-06-01,149000,1,0,1,1,0,1
2023-06-01,149009,3,0,3,3,0,3
2023-06-01,147220,2,0,2,1,0,1
2023-06-01,149005,1,1,2,2,1,2
2023-06-01,149006,2,0,2,1,0,1
2023-06-01,147128,3,0,3,3,0,3
2023-06-01,147231,2,0,2,1,0,1
2023-06-01,38291,3,0,3,3,0,3
2023-06-01,147246,2,0,2,3,0,3
2023-06-01,147130,1,0,1,1,0,1
2023-06-01,147129,1,1,2,1,1,1
2023-06-01,147247,1,0,1,1,0,1
2023-06-01,147232,1,0,1,1,0,1
2023-06-01,149016,2,0,2,4,0,4
2023-06-01,149012,2,0,2,1,0,1
2023-06-01,149015,3,0,3,3,0,3
2023-06-01,149011,2,0,2,3,0,3
2023-06-01,140683,2,0,2,3,0,3
2023-06-01,147141,2,0,2,2,0,2
2023-06-01,147131,2,1,3,4,3,5
2023-06-01,149344,2,1,3,1,1,1
2023-06-01,139710,2,0,2,1,0,1
2023-06-01,150040,1,1,2,1,1,1
2023-06-01,149017,1,0,1,3,0,3
2023-06-01,137973,2,0,2,1,0,1
2023-06-01,141924,1,0,1,2,0,2
2023-06-01,147257,1,0,1,1,0,1
2023-06-01,147255,1,0,1,1,0,1
2023-06-01,149019,2,1,3,3,1,3
2023-06-01,147132,2,0,2,4,0,4
2023-06-01,147278,2,0,2,2,0,2
2023-06-01,147234,2,0,2,1,0,1
2023-06-01,7603,1,1,2,2,2,3
2023-06-01,138181,1,6,7,1,4,4
2023-06-01,147134,2,0,2,1,0,1
2023-06-01,149022,3,0,3,1,0,1
2023-06-01,147213,2,0,2,2,0,2
2023-06-01,132584,3,0,3,1,0,1
2023-06-01,149026,1,1,2,1,1,1
2023-06-01,149025,1,1,2,1,1,1
2023-06-01,149027,1,0,1,1,0,1
2023-06-01,147154,2,1,3,3,2,3
2023-06-01,147251,2,0,2,1,0,1
2023-06-01,147222,1,0,1,1,0,1
2023-06-01,147279,3,1,4,3,1,3
2023-06-01,137434,3,0,3,1,0,1
2023-06-01,149023,2,0,2,2,0,2
2023-06-01,149028,3,0,3,1,0,1
2023-06-01,147143,2,0,2,1,0,1
2023-06-01,134323,2,0,2,4,0,4
2023-06-01,147254,3,1,4,2,1,2
2023-06-01,147140,3,0,3,1,0,1
2023-06-01,147164,2,0,2,2,0,2
2023-06-01,147138,2,0,2,4,0,4
2023-06-01,147253,2,0,2,1,0,1
2023-06-01,146758,1,0,1,3,0,3
2023-06-01,38042,3,0,3,1,0,1
2023-06-01,149033,1,0,1,1,0,1
2023-06-01,135906,1,1,2,1,1,1
2023-06-01,147260,3,0,3,1,0,1
2023-06-01,149034,3,0,3,1,0,1
2023-06-01,149035,3,0,3,3,0,3
2023-06-01,147152,3,0,3,1,0,1
2023-06-01,147142,1,0,1,1,0,1
2023-06-01,149253,1,0,1,1,0,1
2023-06-01,147271,3,0,3,1,0,1
2023-06-01,147258,1,0,1,2,0,2
2023-06-01,149037,1,1,2,1,1,1
2023-06-01,149039,1,0,1,1,0,1
2023-06-01,149041,1,0,1,2,0,2
2023-06-01,149042,4,2,6,5,4,5
2023-06-01,149047,1,0,1,1,0,1
2023-06-01,134840,12,4,16,7,2,7
2023-06-01,149038,2,0,2,1,0,1
2023-06-01,147145,3,0,3,3,0,3
2023-06-01,147150,3,0,3,1,0,1
2023-06-01,149049,1,0,1,1,0,1
2023-06-01,131948,1,0,1,2,0,2
2023-06-01,149048,2,1,3,2,1,2
2023-06-01,149050,2,0,2,2,0,2
2023-06-01,149051,3,5,8,1,1,1
2023-06-01,149055,1,0,1,1,0,1
2023-06-01,147157,2,0,2,2,0,2
2023-06-01,150682,2,0,2,1,0,1
2023-06-01,149062,1,1,2,1,1,1
2023-06-01,147263,2,0,2,1,0,1
2023-06-01,149060,3,0,3,2,0,2
2023-06-01,65531,0,0,0,2,0,2
2023-06-01,147167,1,0,1,2,0,2
2023-06-01,147159,1,0,1,1,0,1
2023-06-01,45926,4,2,6,8,4,8
2023-06-01,139873,2,1,3,2,1,2
2023-06-01,149063,1,1,2,1,1,1
2023-06-01,149162,1,0,1,2,0,2
2023-06-01,141446,1,0,1,2,0,2
2023-06-01,149065,1,0,1,1,0,1
2023-06-01,147264,2,0,2,2,0,2
2023-06-01,149168,3,0,3,1,0,1
2023-06-01,149353,2,1,3,3,3,3
2023-06-01,136956,2,1,3,1,1,1
2023-06-01,147227,1,0,1,1,0,1
2023-06-01,149427,1,0,1,3,0,3
2023-06-01,149171,1,0,1,1,0,1
2023-06-01,149169,2,0,2,2,0,2
2023-06-01,149173,2,0,2,2,0,2
2023-06-01,149170,3,0,3,3,0,3
2023-06-01,149177,3,0,3,3,0,3
2023-06-01,147161,1,0,1,1,0,1
2023-06-01,149179,1,1,2,2,1,2
2023-06-01,147163,2,0,2,3,0,3
2023-06-01,149281,3,0,3,1,0,1
2023-06-01,149197,2,0,2,1,0,1
2023-06-01,149295,2,0,2,3,0,3
2023-06-01,149181,2,0,2,1,0,1
2023-06-01,134906,2,0,2,1,0,1
2023-06-01,149328,1,0,1,3,0,3
2023-06-01,149182,2,1,3,1,1,1
2023-06-01,149287,2,0,2,1,0,1
2023-06-01,38777,0,0,0,2,0,2
2023-06-01,147168,1,0,1,1,0,1
2023-06-01,147165,3,0,3,4,0,4
2023-06-01,149294,3,3,6,2,1,3
2023-06-01,149319,1,0,1,3,0,3
2023-06-01,149200,1,0,1,1,0,1
2023-06-01,149289,2,0,2,1,0,1
2023-06-01,139461,1,0,1,1,0,1
2023-06-01,149293,2,0,2,1,0,1
2023-06-01,63897,2,0,2,2,0,2
2023-06-01,136511,1,0,1,3,0,3
2023-06-01,149321,2,0,2,1,0,1
2023-06-01,149316,2,0,2,3,0,3
2023-06-01,149195,2,0,2,1,0,1
2023-06-01,149194,2,1,3,1,1,1
2023-06-01,149193,1,0,1,1,0,1
2023-06-01,149303,3,0,3,2,0,2
2023-06-01,132008,2,0,2,1,0,1
2023-06-01,149183,2,0,2,1,0,1
2023-06-01,149318,3,0,3,1,0,1
2023-06-01,149362,1,0,1,2,0,2
2023-06-01,149306,2,1,3,2,1,2
2023-06-01,149307,1,0,1,1,0,1
2023-06-01,140106,1,0,1,2,0,2
2023-06-01,7607,1,1,2,1,1,2
2023-06-01,141830,12,0,12,1,0,1
2023-06-01,149189,2,0,2,2,0,2
2023-06-01,149188,2,0,2,1,0,1
2023-06-01,149246,1,0,1,1,0,1
2023-06-01,149310,2,0,2,1,0,1
2023-06-01,149211,2,0,2,1,0,1
2023-06-01,149208,2,0,2,1,0,1
2023-06-01,149184,2,0,2,1,0,1
2023-06-01,149340,3,0,3,2,0,2
2023-06-01,149330,2,1,3,1,1,1
2023-06-01,149324,2,1,3,1,1,1
2023-06-01,149241,2,0,2,2,0,2
2023-06-01,149185,1,0,1,1,0,1
2023-06-01,149325,2,0,2,3,0,3
2023-06-01,149312,2,0,2,2,0,2
2023-06-01,149309,1,0,1,1,0,1
2023-06-01,149206,1,0,1,2,0,2
2023-06-01,149429,1,0,1,1,0,1
2023-06-01,149186,1,0,1,2,0,2
2023-06-01,139329,1,0,1,1,0,1
2023-06-01,149414,2,0,2,3,0,3
2023-06-01,149326,1,0,1,1,0,1
2023-06-01,149385,2,0,2,4,0,4
2023-06-01,149323,1,0,1,1,0,1
2023-06-01,149334,2,0,2,1,0,1
2023-06-01,149415,3,0,3,3,0,3
2023-06-01,139641,1,0,1,2,0,2
2023-06-01,149204,2,0,2,2,0,2
2023-06-01,149202,2,0,2,3,0,3
2023-06-01,149214,2,1,3,2,1,2
2023-06-01,149221,2,0,2,1,0,1
2023-06-01,149264,2,0,2,2,0,2
2023-06-01,149339,1,0,1,2,0,2
2023-06-01,149248,3,9,12,3,1,3
2023-06-01,149421,1,1,2,2,1,2
2023-06-01,149333,2,0,2,2,0,2
2023-06-01,212358,1,2,3,2,1,2
2023-06-01,208137,1,1,2,1,1,2
2023-06-01,149329,1,0,1,2,0,2
2023-06-01,151332,1,1,2,4,3,4
2023-06-01,149245,1,0,1,2,0,2
2023-06-01,149223,2,0,2,2,0,2
2023-06-01,149217,1,0,1,1,0,1
2023-06-01,149425,1,0,1,1,0,1
2023-06-01,149335,3,1,4,2,2,2
2023-06-01,149337,1,0,1,3,0,3
2023-06-01,149346,1,0,1,1,0,1
2023-06-01,149341,1,0,1,1,0,1
2023-06-01,149336,2,0,2,1,0,1
2023-06-01,149431,1,0,1,3,0,3
2023-06-01,149342,1,0,1,1,0,1
2023-06-01,149220,1,0,1,1,0,1
2023-06-01,132930,10,0,10,1,0,1
2023-06-01,149222,2,1,3,1,1,1
2023-06-01,149251,2,1,3,2,1,2
2023-06-01,149432,2,0,2,2,0,2
2023-06-01,133994,6,0,6,1,0,1
2023-06-01,150091,10,0,10,1,0,1
2023-06-01,149436,1,0,1,2,0,2
2023-06-01,149437,2,0,2,1,0,1
2023-06-01,149433,3,1,4,1,1,1
2023-06-01,149441,1,0,1,2,0,2
2023-06-01,149442,2,0,2,2,0,2
2023-06-01,136351,1,0,1,2,0,2
2023-06-01,149445,2,0,2,2,0,2
2023-06-01,149438,1,0,1,2,0,2
2023-06-01,140044,2,0,2,3,0,3
2023-06-01,137015,1,0,1,1,0,1
2023-06-01,63793,1,1,2,1,1,1
2023-06-01,149219,2,1,3,2,1,2
2023-06-01,149357,3,0,3,2,0,2
2023-06-01,149345,1,0,1,3,0,3
2023-06-01,149451,2,0,2,2,0,2
2023-06-01,149449,1,0,1,2,0,2
2023-06-01,139208,1,0,1,1,0,1
2023-06-01,149446,1,1,2,3,1,3
2023-06-01,149452,3,0,3,1,0,1
2023-06-01,149375,3,1,4,1,1,1
2023-06-01,149347,3,1,4,1,1,1
2023-06-01,149255,1,0,1,1,0,1
2023-06-01,136367,8,0,8,1,0,1
2023-06-01,149453,2,1,3,3,1,3
2023-06-01,149454,1,0,1,1,0,1
2023-06-01,149455,3,0,3,2,0,2
2023-06-01,149381,2,0,2,3,0,3
2023-06-01,149350,2,1,3,1,1,1
2023-06-01,63893,3,0,3,1,0,1
2023-06-01,135186,2,1,3,1,1,1
2023-06-01,136278,2,1,3,2,1,3
2023-06-01,135403,1,0,1,1,0,1
2023-06-01,133766,2,0,2,3,0,3
2023-06-01,139611,1,5,6,1,1,1
2023-06-01,149262,1,0,1,1,0,1
2023-06-01,149358,1,0,1,1,0,1
2023-06-01,149074,3,0,3,1,0,1
2023-06-01,149271,5,0,5,1,0,1
2023-06-01,132989,14,0,14,3,0,3
2023-06-01,149473,2,0,2,3,0,3
2023-06-01,149474,1,0,1,2,0,2
2023-06-01,149359,3,0,3,5,0,5
2023-06-01,149360,2,0,2,1,0,1
2023-06-01,149374,3,0,3,3,0,3
2023-06-01,146979,6,1,7,4,1,4
2023-06-01,149077,1,0,1,1,0,1
2023-06-01,149076,1,0,1,1,0,1
2023-06-01,149377,1,0,1,2,0,2
2023-06-01,149365,2,0,2,1,0,1
2023-06-01,150036,10,0,10,1,0,1
2023-06-01,149366,1,0,1,1,0,1
2023-06-01,149369,2,0,2,3,0,3
2023-06-01,149368,1,0,1,2,0,2
2023-06-01,138958,3,1,4,2,1,2
2023-06-01,149483,1,0,1,2,0,2
2023-06-01,149479,3,1,4,1,1,1
2023-06-01,149480,1,0,1,2,0,2
2023-06-01,134049,1,1,2,3,2,3
2023-06-01,149484,1,0,1,1,0,1
2023-06-01,62417,4,0,4,2,0,2
2023-06-01,149371,3,0,3,3,0,3
2023-06-01,149372,1,0,1,4,0,4
2023-06-01,149373,2,0,2,1,0,1
2023-06-01,149486,2,0,2,1,0,1
2023-06-01,133591,2,0,2,2,0,2
2023-06-01,149266,2,0,2,1,0,1
2023-06-01,149267,2,0,2,1,0,1
2023-06-01,136641,2,0,2,3,0,3
2023-06-01,139544,1,0,1,2,0,2
2023-06-01,150579,2,0,2,2,0,2
2023-06-01,149491,2,0,2,1,0,1
2023-06-01,149487,3,0,3,1,0,1
2023-06-01,149489,1,0,1,2,0,2
2023-06-01,149490,1,0,1,1,0,1
2023-06-01,151149,2,1,3,1,1,2
2023-06-01,138992,1,0,1,2,0,2
2023-06-01,149492,2,0,2,2,0,2
2023-06-01,149493,1,0,1,1,0,1
2023-06-01,149494,1,0,1,1,0,1
2023-06-01,133705,1,0,1,1,0,1
2023-06-01,149269,1,0,1,1,0,1
2023-06-01,149610,2,0,2,2,0,2
2023-06-01,149230,2,0,2,1,0,1
2023-06-01,149233,1,0,1,1,0,1
2023-06-01,149498,1,0,1,2,0,2
2023-06-01,149499,2,0,2,2,0,2
2023-06-01,149497,2,0,2,3,0,3
2023-06-01,149501,3,0,3,1,0,1
2023-06-01,149378,1,0,1,1,0,1
2023-06-01,149392,2,0,2,1,0,1
2023-06-01,149702,1,0,1,1,0,1
2023-06-01,149229,1,0,1,2,0,2
2023-06-01,150604,5,0,5,1,0,1
2023-06-01,135776,4,0,4,1,0,1
2023-06-01,133710,2,0,2,1,0,1
2023-06-01,149504,2,0,2,2,0,2
2023-06-01,149505,2,0,2,2,0,2
2023-06-01,137588,2,0,2,1,0,1
2023-06-01,136316,2,0,2,2,0,2
2023-06-01,137658,2,0,2,1,0,1
2023-06-01,135759,1,0,1,2,0,2
2023-06-01,149508,3,0,3,1,0,1
2023-06-01,149384,1,0,1,1,0,1
2023-06-01,138432,1,0,1,1,0,1
2023-06-01,149383,2,0,2,1,0,1
2023-06-01,149270,1,0,1,1,0,1
2023-06-01,149541,2,1,3,1,1,1
2023-06-01,135221,2,0,2,1,0,1
2023-06-01,134337,19,0,19,1,0,1
2023-06-01,149514,2,0,2,2,0,2
2023-06-01,149513,4,1,5,8,3,9
2023-06-01,149234,1,0,1,1,0,1
2023-06-01,149533,1,0,1,2,0,2
2023-06-01,136340,2,0,2,2,0,2
2023-06-01,132601,2,0,2,3,0,3
2023-06-01,149391,2,0,2,2,0,2
2023-06-01,149236,1,0,1,1,0,1
2023-06-01,149235,4,0,4,4,0,4
2023-06-01,134721,1,0,1,1,0,1
2023-06-01,149232,1,0,1,2,0,2
2023-06-01,146822,1,0,1,1,0,1
2023-06-01,149399,2,0,2,1,0,1
2023-06-01,149395,3,0,3,3,0,3
2023-06-01,149400,1,0,1,1,0,1
2023-06-01,149388,2,0,2,3,0,3
2023-06-01,149079,1,1,2,1,1,1
2023-06-01,149276,2,0,2,1,0,1
2023-06-01,149393,1,0,1,1,0,1
2023-06-01,149402,1,0,1,1,0,1
2023-06-01,149394,2,0,2,1,0,1
2023-06-01,149517,2,0,2,2,0,2
2023-06-01,149408,1,0,1,1,0,1
2023-06-01,149398,2,0,2,1,0,1
2023-06-01,149665,3,0,3,2,0,2
2023-06-01,149401,3,0,3,3,0,3
2023-06-01,149397,1,0,1,1,0,1
2023-06-01,149406,1,0,1,1,0,1
2023-06-01,150623,2,0,2,2,0,2
2023-06-01,139515,2,0,2,3,0,3
2023-06-01,138228,2,0,2,1,0,1
2023-06-01,135765,1,0,1,2,0,2
2023-06-01,149521,2,0,2,2,0,2
2023-06-01,149277,3,1,4,1,1,1
2023-06-01,135774,2,1,3,1,1,1
2023-06-01,149526,1,1,2,1,1,1
2023-06-01,141275,2,0,2,1,0,1
2023-06-01,149411,1,0,1,2,0,2
2023-06-01,149605,2,0,2,1,0,1
2023-06-01,149524,3,0,3,1,0,1
2023-06-01,149523,2,0,2,2,0,2
2023-06-01,149531,2,0,2,1,0,1
2023-06-01,134087,1,0,1,1,0,1
2023-06-01,140889,2,1,3,1,1,2
2023-06-01,140727,1,0,1,1,0,1
2023-06-01,140622,1,0,1,1,0,1
2023-06-01,136723,2,0,2,2,0,2
2023-06-01,141737,3,0,3,2,0,2
2023-06-01,149537,1,0,1,1,0,1
2023-06-01,149629,1,0,1,2,0,2
2023-06-01,149413,1,0,1,1,0,1
2023-06-01,149407,3,1,4,1,1,1
2023-06-01,149404,2,0,2,1,0,1
2023-06-01,149633,2,0,2,2,0,2
2023-06-01,149630,3,0,3,2,0,2
2023-06-01,149602,2,0,2,3,0,3
2023-06-01,139560,17,0,17,3,0,3
2023-06-01,149604,2,0,2,1,0,1
2023-06-01,141259,2,1,3,3,1,3
2023-06-01,149405,2,0,2,1,0,1
2023-06-01,7609,2,0,2,2,0,2
2023-06-01,7653,2,0,2,2,0,2
2023-06-01,149638,1,0,1,1,0,1
2023-06-01,149528,3,0,3,2,0,2
2023-06-01,149529,2,0,2,1,0,1
2023-06-01,149679,1,0,1,3,0,3
2023-06-01,149509,1,1,2,1,1,1
2023-06-01,149603,2,0,2,3,0,3
2023-06-01,149670,4,1,5,3,1,3
2023-06-01,149643,2,0,2,1,0,1
2023-06-01,149146,1,0,1,1,0,1
2023-06-01,149080,1,0,1,2,0,2
2023-06-01,149644,2,0,2,3,0,3
2023-06-01,4253296504,1,0,1,1,0,1
2023-06-01,132490,2,0,2,2,0,2
2023-06-01,136964,2,0,2,1,0,1
2023-06-01,149082,1,0,1,1,0,1
2023-06-01,149573,2,0,2,1,0,1
2023-06-01,133226,1,0,1,1,0,1
2023-06-01,149645,3,0,3,1,0,1
2023-06-01,149544,2,0,2,1,0,1
2023-06-01,149611,3,0,3,3,0,3
2023-06-01,138153,1,0,1,2,0,2
2023-06-01,149668,1,0,1,3,0,3
2023-06-01,139355,1,0,1,1,0,1
2023-06-01,146980,1,1,2,3,2,3
2023-06-01,149536,4,1,5,2,2,2
2023-06-01,149708,1,0,1,1,0,1
2023-06-01,149715,1,1,2,1,1,1
2023-06-01,149315,2,0,2,3,0,3
2023-06-01,149675,3,1,4,4,2,4
2023-06-01,142384,2,0,2,3,0,3
2023-06-01,149647,1,1,2,4,1,4
2023-06-01,149538,1,0,1,1,0,1
2023-06-01,149648,1,0,1,1,0,1
2023-06-01,146817,2,0,2,1,0,1
2023-06-01,149672,2,1,3,2,1,2
2023-06-01,149667,1,0,1,1,0,1
2023-06-01,149664,1,0,1,2,0,2
2023-06-01,149674,1,0,1,1,0,1
2023-06-01,149682,2,0,2,1,0,1
2023-06-01,133963,1,0,1,1,0,1
2023-06-01,150020,2,1,3,2,1,2
2023-06-01,139218,3,7,10,1,1,1
2023-06-01,149649,2,0,2,2,0,2
2023-06-01,7387,9,2,11,1,1,1
2023-06-01,149608,1,0,1,1,0,1
2023-06-01,149663,3,0,3,1,0,1
2023-06-01,149705,2,0,2,2,0,2
2023-06-01,149085,1,1,2,1,2,2
2023-06-01,149680,1,0,1,2,0,2
2023-06-01,136451,1,0,1,2,0,2
2023-06-01,149572,1,0,1,1,0,1
2023-06-01,149652,3,0,3,2,0,2
2023-06-01,149553,2,0,2,1,0,1
2023-06-01,138306,1,0,1,1,0,1
2023-06-01,149542,1,0,1,2,0,2
2023-06-01,149661,1,0,1,1,0,1
2023-06-01,149653,2,0,2,3,0,3
2023-06-01,149655,1,0,1,2,0,2
2023-06-01,149676,1,0,1,3,0,3
2023-06-01,149961,1,0,1,1,0,1
2023-06-01,133987,1,0,1,1,0,1
2023-06-01,140139,11,0,11,1,0,1
2023-06-01,149546,1,1,2,3,2,3
2023-06-01,149540,1,0,1,1,0,1
2023-06-01,149658,2,0,2,2,0,2
2023-06-01,149657,1,0,1,1,0,1
2023-06-01,138548,1,0,1,2,0,2
2023-06-01,134424,1,0,1,1,0,1
2023-06-01,149552,1,0,1,1,0,1
2023-06-01,149709,1,0,1,1,0,1
2023-06-01,63895,2,0,2,1,0,1
2023-06-01,149681,1,0,1,2,0,2
2023-06-01,149673,2,0,2,1,0,1
2023-06-01,149671,2,0,2,1,0,1
2023-06-01,149669,1,0,1,1,0,1
2023-06-01,149545,1,0,1,1,0,1
2023-06-01,149559,1,0,1,1,0,1
2023-06-01,149557,1,1,2,1,1,1
2023-06-01,55940,1,0,1,2,0,2
2023-06-01,136681,2,0,2,1,0,1
2023-06-01,134939,2,0,2,1,0,1
2023-06-01,149882,2,0,2,1,0,1
2023-06-01,149766,3,1,4,2,1,2
2023-06-01,149659,3,0,3,2,0,2
2023-06-01,134614,2,0,2,3,0,3
2023-06-01,133355,2,0,2,4,0,4
2023-06-01,150064,1,0,1,1,0,1
2023-06-01,149539,1,0,1,2,0,2
2023-06-01,138987,1,1,2,3,1,3
2023-06-01,149771,1,0,1,1,0,1
2023-06-01,149607,1,0,1,1,0,1
2023-06-01,149617,2,1,3,1,1,1
2023-06-01,149769,1,0,1,1,0,1
2023-06-01,149770,3,0,3,1,0,1
2023-06-01,149689,2,0,2,1,0,1
2023-06-01,149688,2,0,2,1,0,1
2023-06-01,149685,1,0,1,2,0,2
2023-06-01,140172,2,0,2,1,0,1
2023-06-01,149774,3,1,4,1,1,1
2023-06-01,149775,2,0,2,1,0,1
2023-06-01,149093,1,1,2,1,1,1
2023-06-01,149694,2,0,2,1,0,1
2023-06-01,149690,2,2,4,1,1,1
2023-06-01,149616,2,0,2,1,0,1
2023-06-01,149777,3,0,3,2,0,2
2023-06-01,132073,2,0,2,3,0,3
2023-06-01,38141,1,0,1,1,0,1
2023-06-01,149692,2,0,2,4,0,4
2023-06-01,149132,1,1,2,1,1,1
2023-06-01,137640,1,0,1,2,0,2
2023-06-01,149614,1,0,1,1,0,1
2023-06-01,149788,1,0,1,1,0,1
2023-06-01,141020,1,0,1,1,0,1
2023-06-01,149785,1,0,1,3,0,3
2023-06-01,149717,2,0,2,1,0,1
2023-06-01,149707,4,0,4,5,0,5
2023-06-01,149697,3,0,3,3,0,3
2023-06-01,149740,3,0,3,2,0,2
2023-06-01,149693,2,8,10,2,1,2
2023-06-01,149696,1,1,2,2,1,2
2023-06-01,133209,3,0,3,1,0,1
2023-06-01,136789,1,0,1,1,0,1
2023-06-01,58543,4,47,51,1,2,2
2023-06-01,149792,2,0,2,1,0,1
2023-06-01,149791,3,0,3,2,0,2
2023-06-01,137424,3,0,3,1,0,1
2023-06-01,150062,1,0,1,1,0,1
2023-06-01,135325,1,1,2,1,1,1
2023-06-01,18423,1,1,2,1,1,2
2023-06-01,139846,3,1,4,2,1,2
2023-06-01,149094,2,0,2,1,0,1
2023-06-01,149096,3,1,4,4,1,4
2023-06-01,149698,1,0,1,2,0,2
2023-06-01,149699,1,0,1,1,0,1
2023-06-01,131832,2,0,2,3,0,3
2023-06-01,149571,1,0,1,1,0,1
2023-06-01,149099,1,0,1,1,0,1
2023-06-01,149100,1,0,1,2,0,2
2023-06-01,149928,1,0,1,2,0,2
2023-06-01,149713,1,0,1,1,0,1
2023-06-01,149712,3,1,4,1,1,2
2023-06-01,149721,3,0,3,2,0,2
2023-06-01,149706,1,0,1,1,0,1
2023-06-01,149723,1,0,1,2,0,2
2023-06-01,149802,3,1,4,2,1,2
2023-06-01,149716,1,0,1,1,0,1
2023-06-01,149714,1,1,2,2,1,2
2023-06-01,149806,3,0,3,2,0,2
2023-06-01,149809,2,0,2,3,0,3
2023-06-01,149613,1,0,1,2,0,2
2023-06-01,149586,2,1,3,1,1,1
2023-06-01,149810,3,9,12,3,1,3
2023-06-01,149811,2,1,3,1,1,2
2023-06-01,149815,2,0,2,3,0,3
2023-06-01,149101,1,1,2,1,1,1
2023-06-01,149102,1,1,2,1,1,1
2023-06-01,149816,3,1,4,1,1,1
2023-06-01,149817,1,0,1,1,0,1
2023-06-01,150546,1,0,1,1,0,1
2023-06-01,149819,2,0,2,2,0,2
2023-06-01,149576,1,0,1,1,0,1
2023-06-01,149564,1,0,1,1,0,1
2023-06-01,131304,3,0,3,1,0,1
2023-06-01,149825,1,0,1,1,0,1
2023-06-01,149822,3,0,3,1,0,1
2023-06-01,149820,1,0,1,1,0,1
2023-06-01,131833,1,0,1,2,0,2
2023-06-01,149827,1,0,1,1,0,1
2023-06-01,149574,2,0,2,3,0,3
2023-06-01,141321,2,0,2,1,0,1
2023-06-01,149575,1,0,1,1,0,1
2023-06-01,149568,1,1,2,1,1,1
2023-06-01,149566,1,0,1,1,0,1
2023-06-01,149718,1,0,1,3,0,3
2023-06-01,149949,1,0,1,1,0,1
2023-06-01,149889,1,0,1,1,0,1
2023-06-01,149722,1,0,1,1,0,1
2023-06-01,142017,1,1,2,2,2,2
2023-06-01,140686,1,0,1,1,0,1
2023-06-01,135164,1,0,1,1,0,1
2023-06-01,149720,2,0,2,3,0,3
2023-06-01,132049,3,0,3,1,0,1
2023-06-01,140505,1,1,2,1,1,1
2023-06-01,141223,1,0,1,1,0,1
2023-06-01,149831,2,0,2,3,0,3
2023-06-01,63795,1,1,2,2,2,2
2023-06-01,63794,1,1,2,1,1,1
2023-06-01,137168,2,0,2,1,0,1
2023-06-01,149832,1,0,1,2,0,2
2023-06-01,137065,1,0,1,2,0,2
2023-06-01,149744,2,1,3,1,1,2
2023-06-01,149897,3,1,4,1,1,1
2023-06-01,133981,3,0,3,2,0,2
2023-06-01,10225,32,0,32,4,0,4
2023-06-01,149834,1,0,1,1,0,1
2023-06-01,149582,2,0,2,3,0,3
2023-06-01,149558,2,0,2,2,0,2
2023-06-01,134017,1,0,1,2,0,2
2023-06-01,147250,3,1,4,1,1,1
2023-06-01,149727,1,0,1,1,0,1
2023-06-01,149729,1,0,1,1,0,1
2023-06-01,149728,2,0,2,2,0,2
2023-06-01,149488,1,1,2,1,1,1
2023-06-01,149841,1,1,2,1,1,1
2023-06-01,149836,1,0,1,2,0,2
2023-06-01,149730,1,0,1,2,0,2
2023-06-01,149732,1,0,1,1,0,1
2023-06-01,133715,1,0,1,1,0,1
2023-06-01,149843,3,0,3,2,0,2
2023-06-01,133222,1,0,1,1,0,1
2023-06-01,149105,1,0,1,1,0,1
2023-06-01,55315,3,0,3,5,0,5
2023-06-01,149848,2,17,19,4,1,4
2023-06-01,149846,1,0,1,1,0,1
2023-06-01,133265,1,0,1,2,0,2
2023-06-01,134851,2,0,2,1,0,1
2023-06-01,149731,1,0,1,1,0,1
2023-06-01,149745,1,0,1,1,0,1
2023-06-01,149735,1,1,2,2,1,2
2023-06-01,149851,1,0,1,3,0,3
2023-06-01,149107,1,1,2,1,1,1
2023-06-01,149725,1,0,1,1,0,1
2023-06-01,149736,2,0,2,3,0,3
2023-06-01,149734,2,0,2,1,0,1
2023-06-01,134368,1,0,1,3,0,3
2023-06-01,136307,2,1,3,2,1,2
2023-06-01,149854,3,1,4,2,1,2
2023-06-01,150154,1,1,2,1,1,1
2023-06-01,149595,2,0,2,1,0,1
2023-06-01,149856,1,0,1,1,0,1
2023-06-01,149908,1,0,1,1,0,1
2023-06-01,149109,1,0,1,2,0,2
2023-06-01,149737,3,0,3,2,0,2
2023-06-01,149880,2,0,2,3,0,3
2023-06-01,149984,1,0,1,1,0,1
2023-06-01,149859,1,0,1,1,0,1
2023-06-01,149554,1,0,1,1,0,1
2023-06-01,149741,1,0,1,1,0,1
2023-06-01,135236,3,0,3,1,0,1
2023-06-01,149742,2,0,2,2,0,2
2023-06-01,149746,2,0,2,1,0,1
2023-06-01,149860,2,0,2,3,0,3
2023-06-01,56144,2,0,2,3,0,3
2023-06-01,149584,1,1,2,2,1,2
2023-06-01,149583,2,0,2,1,0,1
2023-06-01,132765,2,1,3,2,2,2
2023-06-01,149748,2,0,2,2,0,2
2023-06-01,149863,2,0,2,1,0,1
2023-06-01,149749,2,1,3,2,1,2
2023-06-01,149753,1,0,1,1,0,1
2023-06-01,135090,2,0,2,2,0,2
2023-06-01,149878,2,0,2,1,0,1
2023-06-01,141380,2,0,2,2,0,2
2023-06-01,150041,1,0,1,1,0,1
2023-06-01,149752,2,0,2,3,0,3
2023-06-01,137493,3,0,3,1,0,1
2023-06-01,146814,1,0,1,2,0,2
2023-06-01,139064,3,1,4,2,1,2
2023-06-01,149866,3,7,10,1,2,2
2023-06-01,149865,2,0,2,2,0,2
2023-06-01,149754,2,0,2,3,0,3
2023-06-01,133368,2,0,2,3,0,3
2023-06-01,149593,1,0,1,1,0,1
2023-06-01,149561,1,1,2,1,1,1
2023-06-01,142469,1,0,1,2,0,2
2023-06-01,131156,1,1,2,4,1,4
2023-06-01,146981,3,3,6,5,5,6
2023-06-01,208171,3,4,7,5,3,5
2023-06-01,149585,1,0,1,1,0,1
2023-06-01,149912,1,0,1,1,0,1
2023-06-01,149886,3,0,3,3,0,3
2023-06-01,149624,1,0,1,1,0,1
2023-06-01,140646,1,1,2,1,1,1
2023-06-01,149868,3,0,3,1,0,1
2023-06-01,149881,2,1,3,1,1,1
2023-06-01,149871,1,0,1,1,0,1
2023-06-01,149873,2,0,2,2,0,2
2023-06-01,149870,1,0,1,1,0,1
2023-06-01,149874,1,0,1,1,0,1
2023-06-01,149980,2,0,2,3,0,3
2023-06-01,149927,1,0,1,1,0,1
2023-06-01,149983,3,1,4,3,2,3
2023-06-01,149888,2,0,2,4,0,4
2023-06-01,150247,1,0,1,2,0,2
2023-06-01,149895,2,0,2,1,0,1
2023-06-01,149915,1,0,1,2,0,2
2023-06-01,149981,2,1,3,2,1,2
2023-06-01,150042,2,0,2,1,0,1
2023-06-01,21537,3,0,3,4,0,4
2023-06-01,149986,1,0,1,1,0,1
2023-06-01,149588,2,1,3,3,1,3
2023-06-01,149948,1,0,1,1,0,1
2023-06-01,149902,2,0,2,1,0,1
2023-06-01,149985,3,0,3,2,0,2
2023-06-01,149988,3,0,3,2,0,2
2023-06-01,149987,2,0,2,2,0,2
2023-06-01,149893,2,0,2,1,0,1
2023-06-01,149589,1,0,1,1,0,1
2023-06-01,140166,1,0,1,1,0,1
2023-06-01,149901,2,0,2,1,0,1
2023-06-01,149898,2,0,2,2,0,2
2023-06-01,149900,1,0,1,1,0,1
2023-06-01,149989,1,0,1,1,0,1
2023-06-01,149990,2,0,2,1,0,1
2023-06-01,149991,2,0,2,1,0,1
2023-06-01,149911,3,0,3,2,0,2
2023-06-01,149995,1,0,1,1,0,1
2023-06-01,132875,2,1,3,1,2,2
2023-06-01,149997,1,1,2,1,1,1
2023-06-01,149998,1,0,1,2,0,2
2023-06-01,149591,1,1,2,2,2,2
2023-06-01,150551,1,0,1,1,0,1
2023-06-01,149903,2,0,2,2,0,2
2023-06-01,149904,1,0,1,1,0,1
2023-06-01,146982,1,0,1,1,0,1
2023-06-01,149907,2,0,2,2,0,2
2023-06-01,23852,1,0,1,1,0,1
2023-06-01,146812,3,3,6,2,2,2
2023-06-01,150003,1,1,2,1,1,1
2023-06-01,147267,1,0,1,2,0,2
2023-06-01,150004,1,1,2,1,1,1
2023-06-01,150002,3,0,3,1,0,1
2023-06-01,150005,2,0,2,1,0,1
2023-06-01,150000,2,1,3,5,2,5
2023-06-01,150111,1,0,1,1,0,1
2023-06-01,149116,1,0,1,1,0,1
2023-06-01,149784,1,0,1,1,0,1
2023-06-01,150115,1,0,1,1,0,1
2023-06-01,150114,2,0,2,1,0,1
2023-06-01,149921,1,0,1,1,0,1
2023-06-01,21789,45,0,45,8,0,8
2023-06-01,150113,1,1,2,1,1,1
2023-06-01,150052,1,0,1,1,0,1
2023-06-01,150009,2,0,2,3,0,3
2023-06-01,150116,1,0,1,1,0,1
2023-06-01,150118,1,0,1,1,0,1
2023-06-01,150053,2,0,2,1,0,1
2023-06-01,133962,3,0,3,2,0,2
2023-06-01,134746,2,0,2,2,0,2
2023-06-01,149923,1,0,1,1,0,1
2023-06-01,150050,2,1,3,3,1,3
2023-06-01,150048,2,0,2,1,0,1
2023-06-01,149913,1,0,1,1,0,1
2023-06-01,149909,2,0,2,2,0,2
2023-06-01,150018,1,0,1,1,0,1
2023-06-01,17425,0,0,0,5,3,5
2023-06-01,133193,9,21,30,1,1,1
2023-06-01,150121,1,0,1,1,0,1
2023-06-01,149910,1,0,1,1,0,1
2023-06-01,136727,1,1,2,1,1,1
2023-06-01,150125,1,1,2,2,2,2
2023-06-01,150123,2,0,2,2,0,2
2023-06-01,150007,2,1,3,2,1,2
2023-06-01,150098,2,0,2,1,0,1
2023-06-01,149412,1,0,1,1,0,1
2023-06-01,150080,1,0,1,1,0,1
2023-06-01,133656,2,0,2,1,0,1
2023-06-01,146771,1,1,2,1,1,1
2023-06-01,134213,1,0,1,1,0,1
2023-06-01,150126,1,0,1,2,0,2
2023-06-01,137846,3,0,3,1,0,1
2023-06-01,149917,2,0,2,1,0,1
2023-06-01,138030,2,0,2,1,0,1
2023-06-01,149932,1,0,1,1,0,1
2023-06-01,149920,1,1,2,2,2,2
2023-06-01,150024,1,0,1,1,0,1
2023-06-01,150011,2,0,2,2,0,2
2023-06-01,150028,2,0,2,1,0,1
2023-06-01,137817,1,0,1,2,0,2
2023-06-01,149922,1,0,1,1,0,1
2023-06-01,149926,2,0,2,1,0,1
2023-06-01,150054,1,0,1,1,0,1
2023-06-01,149946,1,0,1,1,0,1
2023-06-01,140267,2,0,2,3,0,3
2023-06-01,150131,3,1,4,1,1,1
2023-06-01,140269,2,0,2,1,0,1
2023-06-01,150133,2,0,2,2,0,2
2023-06-01,133992,1,0,1,1,0,1
2023-06-01,149933,1,0,1,1,0,1
2023-06-01,150135,2,0,2,2,0,2
2023-06-01,150132,2,0,2,3,0,3
2023-06-01,150066,1,0,1,1,0,1
2023-06-01,149934,2,0,2,2,0,2
2023-06-01,150019,1,0,1,1,0,1
2023-06-01,150055,1,0,1,1,0,1
2023-06-01,149929,2,0,2,2,0,2
2023-06-01,149930,2,0,2,3,0,3
2023-06-01,150142,2,0,2,2,0,2
2023-06-01,149940,1,0,1,1,0,1
2023-06-01,149943,2,0,2,1,0,1
2023-06-01,24126,11,0,11,4,0,4
2023-06-01,134300,4,0,4,2,0,2
2023-06-01,23788,21,0,21,1,0,1
2023-06-01,150917,1,0,1,1,0,1
2023-06-01,133615,4,0,4,6,0,6
2023-06-01,134328,1,0,1,1,0,1
2023-06-01,150549,1,1,2,2,2,2
2023-06-01,64008,1,0,1,2,0,2
2023-06-01,59187,3,0,3,1,0,1
2023-06-01,64015,2,0,2,1,0,1
2023-06-01,150168,1,0,1,3,0,3
2023-06-01,134436,2,0,2,1,0,1
2023-06-01,134427,1,0,1,1,0,1
2023-06-01,133844,1,0,1,1,0,1
2023-06-01,134430,1,0,1,2,0,2
2023-06-01,134608,5,0,5,3,0,3
2023-06-01,133640,1,0,1,1,0,1
2023-06-01,135157,1,0,1,1,0,1
2023-06-01,135285,1,0,1,1,0,1
2023-06-01,134434,1,0,1,1,0,1
2023-06-01,64012,4,0,4,3,0,3
2023-06-01,7565,85,1,86,5,2,5
2023-06-01,17976,33,0,33,8,0,8
2023-06-01,134256,3,0,3,1,0,1
2023-06-01,134556,1,0,1,1,0,1
2023-06-01,134251,1,0,1,2,0,2
2023-06-01,149971,1,0,1,2,0,2
2023-06-01,45162,2,0,2,1,0,1
2023-06-01,134257,4,1,5,2,2,2
2023-06-01,134449,2,0,2,3,0,3
2023-06-01,150102,4,0,4,1,0,1
2023-06-01,131255,3,0,3,4,0,4
2023-06-01,134452,2,0,2,1,0,1
2023-06-01,135963,2,1,3,3,1,3
2023-06-01,137643,1,0,1,1,0,1
2023-06-01,134523,1,0,1,1,0,1
2023-06-01,9701,3,0,3,1,0,1
2023-06-01,133122,4,0,4,1,0,1
2023-06-01,134280,2,0,2,2,0,2
2023-06-01,137251,1,0,1,1,0,1
2023-06-01,55683,2,1,3,1,2,3
2023-06-01,134554,5,0,5,1,0,1
2023-06-01,134270,4,0,4,2,0,2
2023-06-01,134271,5,0,5,3,0,3
2023-06-01,64058,1,0,1,1,0,1
2023-06-01,134340,4,1,5,3,2,3
2023-06-01,134981,3,2,5,2,1,2
2023-06-01,46047,5,17,22,3,3,3
2023-06-01,134676,2,6,8,2,1,2
2023-06-01,134678,1,0,1,1,0,1
2023-06-01,140827,1,0,1,1,0,1
2023-06-01,63740,1,0,1,1,0,1
2023-06-01,138283,3,0,3,3,0,3
2023-06-01,134686,2,0,2,3,0,3
2023-06-01,150921,1,0,1,1,0,1
2023-06-01,131438,3,0,3,4,0,4
2023-06-01,150171,1,0,1,1,0,1
2023-06-01,134261,2,0,2,1,0,1
2023-06-01,150200,3,0,3,2,0,2
2023-06-01,38549,3,1,4,3,1,3
2023-06-01,58606,4,0,4,2,0,2
2023-06-01,135497,1,0,1,1,0,1
2023-06-01,134284,1,0,1,3,0,3
2023-06-01,134285,1,0,1,1,0,1
2023-06-01,150211,3,0,3,1,0,1
2023-06-01,150951,1,0,1,2,0,2
2023-06-01,134695,2,1,3,2,1,2
2023-06-01,64056,2,1,3,1,1,1
2023-06-01,134344,1,0,1,3,0,3
2023-06-01,150647,1,0,1,1,0,1
2023-06-01,134317,12,0,12,1,0,1
2023-06-01,131439,5,0,5,3,0,3
2023-06-01,131437,4,0,4,1,0,1
2023-06-01,134260,4,0,4,2,0,2
2023-06-01,150782,1,0,1,1,0,1
2023-06-01,134709,1,0,1,1,0,1
2023-06-01,134747,1,0,1,1,0,1
2023-06-01,134621,1,0,1,2,0,2
2023-06-01,149128,3,0,3,2,0,2
2023-06-01,134623,4,1,5,2,2,2
2023-06-01,135327,5,0,5,1,0,1
2023-06-01,134714,4,0,4,3,0,3
2023-06-01,134716,1,0,1,1,0,1
2023-06-01,137418,1,0,1,1,0,1
2023-06-01,137420,1,0,1,1,0,1
2023-06-01,134723,1,1,2,1,2,2
2023-06-01,134258,8,0,8,2,0,2
2023-06-01,64044,2,0,2,3,0,3
2023-06-01,150946,1,0,1,1,0,1
2023-06-01,64046,3,0,3,2,0,2
2023-06-01,141397,2,1,3,3,2,3
2023-06-01,45426,3,0,3,1,0,1
2023-06-01,134722,2,0,2,2,0,2
2023-06-01,38541,3,0,3,4,0,4
2023-06-01,138148,1,1,2,1,1,1
2023-06-01,134267,2,0,2,1,0,1
2023-06-01,9655,15,0,15,4,0,4
2023-06-01,134728,4,0,4,2,0,2
2023-06-01,134730,1,0,1,1,0,1
2023-06-01,134733,1,0,1,1,0,1
2023-06-01,134624,1,0,1,1,0,1
2023-06-01,64053,4,0,4,2,0,2
2023-06-01,131905,3,1,4,1,1,1
2023-06-01,134740,8,0,8,2,0,2
2023-06-01,134744,1,0,1,1,0,1
2023-06-01,63738,1,0,1,1,0,1
2023-06-01,63756,3,0,3,1,0,1
2023-06-01,63734,1,1,2,1,1,1
2023-06-01,132015,4,0,4,2,0,2
2023-06-01,140051,2,0,2,2,0,2
2023-06-01,150924,1,0,1,2,0,2
2023-06-01,9353,3,0,3,3,0,3
2023-06-01,37906,1,1,2,4,2,4
2023-06-01,151095,1,1,2,1,1,1
2023-06-01,134749,9,0,9,4,0,4
2023-06-01,134797,5,0,5,1,0,1
2023-06-01,134803,6,0,6,2,0,2
2023-06-01,131599,6,0,6,5,0,5
2023-06-01,134334,7,1,8,1,1,1
2023-06-01,134633,7,1,8,2,1,2
2023-06-01,134295,5,0,5,2,0,2
2023-06-01,134335,1,0,1,1,0,1
2023-06-01,136717,3,1,4,2,1,2
2023-06-01,136180,5,0,5,4,0,4
2023-06-01,134620,2,0,2,1,0,1
2023-06-01,150196,1,0,1,2,0,2
2023-06-01,150926,1,0,1,1,0,1
2023-06-01,59189,5,1,6,2,1,2
2023-06-01,141271,3,0,3,3,0,3
2023-06-01,134842,3,0,3,3,0,3
2023-06-01,138870,1,0,1,1,0,1
2023-06-01,64074,4,16,20,4,2,4
2023-06-01,134845,1,0,1,1,0,1
2023-06-01,134333,2,0,2,3,0,3
2023-06-01,63561,2,0,2,2,0,2
2023-06-01,134847,6,0,6,1,0,1
2023-06-01,150920,1,0,1,2,0,2
2023-06-01,150371,2,0,2,1,0,1
2023-06-01,150176,1,0,1,2,0,2
2023-06-01,63689,12,2,14,1,2,3
2023-06-01,134969,1,0,1,2,0,2
2023-06-01,136590,1,0,1,3,0,3
2023-06-01,137507,1,0,1,1,0,1
2023-06-01,134976,10,0,10,2,0,2
2023-06-01,134980,5,2,7,7,4,7
2023-06-01,134878,4,0,4,1,0,1
2023-06-01,134873,2,0,2,2,0,2
2023-06-01,134887,4,0,4,2,0,2
2023-06-01,134983,8,0,8,1,0,1
2023-06-01,134986,1,1,2,1,1,1
2023-06-01,134995,4,12,16,1,1,1
2023-06-01,134988,2,0,2,1,0,1
2023-06-01,134990,7,0,7,4,0,4
2023-06-01,56214,4,1,5,1,1,1
2023-06-01,134859,2,0,2,1,0,1
2023-06-01,135015,2,0,2,5,0,5
2023-06-01,150175,1,0,1,2,0,2
2023-06-01,64076,1,0,1,1,0,1
2023-06-01,137747,2,0,2,1,0,1
2023-06-01,134639,3,0,3,1,0,1
2023-06-01,135009,2,0,2,1,0,1
2023-06-01,134998,1,0,1,3,0,3
2023-06-01,134641,1,0,1,2,0,2
2023-06-01,135557,1,0,1,2,0,2
2023-06-01,135900,1,1,2,2,2,2
2023-06-01,63732,5,0,5,1,0,1
2023-06-01,134861,4,1,5,2,1,2
2023-06-01,134850,4,0,4,3,0,3
2023-06-01,64077,2,0,2,1,0,1
2023-06-01,134852,6,0,6,1,0,1
2023-06-01,134854,5,1,6,1,2,2
2023-06-01,135012,3,0,3,1,0,1
2023-06-01,131906,1,0,1,3,0,3
2023-06-01,135014,3,1,4,2,1,2
2023-06-01,135018,1,0,1,1,0,1
2023-06-01,150640,1,0,1,1,0,1
2023-06-01,135023,13,1,14,1,1,1
2023-06-01,134938,1,0,1,2,0,2
2023-06-01,45990,3,0,3,1,0,1
2023-06-01,134930,2,0,2,1,0,1
2023-06-01,134931,1,0,1,2,0,2
2023-06-01,134936,4,0,4,1,0,1
2023-06-01,135032,3,0,3,2,0,2
2023-06-01,135033,4,0,4,3,0,3
2023-06-01,9789,2,0,2,2,0,2
2023-06-01,135034,10,0,10,1,0,1
2023-06-01,63733,7,0,7,2,2,3
2023-06-01,63735,4,0,4,1,0,1
2023-06-01,136363,4,0,4,1,0,1
2023-06-01,134874,8,0,8,2,0,2
2023-06-01,135037,3,0,3,3,0,3
2023-06-01,141010,1,0,1,2,0,2
2023-06-01,7477,143,11,154,5,1,6
2023-06-01,134862,4,0,4,3,0,3
2023-06-01,135040,1,0,1,2,0,2
2023-06-01,150648,1,0,1,2,0,2
2023-06-01,63736,1,0,1,2,0,2
2023-06-01,138220,4,0,4,1,0,1
2023-06-01,135087,1,0,1,1,0,1
2023-06-01,135043,4,0,4,1,0,1
2023-06-01,135044,1,0,1,1,0,1
2023-06-01,132781,4,0,4,2,0,2
2023-06-01,135050,1,0,1,1,0,1
2023-06-01,134875,2,1,3,2,1,2
2023-06-01,134897,4,0,4,1,0,1
2023-06-01,134381,1,0,1,2,0,2
2023-06-01,134644,2,0,2,2,0,2
2023-06-01,135066,1,0,1,2,0,2
2023-06-01,135065,4,0,4,1,0,1
2023-06-01,133311,1,0,1,1,0,1
2023-06-01,46059,4,0,4,3,0,3
2023-06-01,134648,4,0,4,3,0,3
2023-06-01,135071,8,1,9,1,1,1
2023-06-01,38034,3,0,3,3,0,3
2023-06-01,147183,2,2,4,2,2,2
2023-06-01,134649,1,0,1,1,0,1
2023-06-01,135359,3,0,3,3,0,3
2023-06-01,135082,1,0,1,3,0,3
2023-06-01,135088,1,0,1,1,0,1
2023-06-01,23664,28,1,29,5,2,5
2023-06-01,135326,1,0,1,1,0,1
2023-06-01,137271,1,1,2,1,1,1
2023-06-01,134659,1,0,1,3,0,3
2023-06-01,134652,1,0,1,1,0,1
2023-06-01,134653,1,0,1,1,0,1
2023-06-01,150927,1,0,1,1,0,1
2023-06-01,135100,4,0,4,3,0,3
2023-06-01,134892,3,0,3,1,0,1
2023-06-01,55654,1,1,2,2,1,3
2023-06-01,150182,1,0,1,1,0,1
2023-06-01,135106,1,11,12,1,1,1
2023-06-01,133201,4,0,4,4,0,4
2023-06-01,135108,2,0,2,2,0,2
2023-06-01,151356,1,0,1,1,0,1
2023-06-01,9558,12,7,19,9,6,9
2023-06-01,135118,1,0,1,1,0,1
2023-06-01,135115,4,0,4,2,0,2
2023-06-01,135121,1,0,1,2,0,2
2023-06-01,45665,7,1,8,6,1,6
2023-06-01,17440,7,0,7,3,0,3
2023-06-01,140952,2,0,2,2,0,2
2023-06-01,62651,18,3,21,1,1,1
2023-06-01,135123,4,0,4,4,0,4
2023-06-01,135122,3,0,3,1,0,1
2023-06-01,134900,3,0,3,1,0,1
2023-06-01,135469,1,0,1,1,0,1
2023-06-01,64092,6,0,6,4,0,4
2023-06-01,24524,1,0,1,1,0,1
2023-06-01,150286,1,1,2,3,2,3
2023-06-01,64024,4,0,4,3,0,3
2023-06-01,55354,12,2,14,1,1,1
2023-06-01,135142,1,0,1,3,0,3
2023-06-01,150796,1,1,2,2,2,2
2023-06-01,135140,7,0,7,5,0,5
2023-06-01,150943,1,0,1,1,0,1
2023-06-01,135270,1,0,1,1,0,1
2023-06-01,150933,1,0,1,1,0,1
2023-06-01,135153,1,0,1,1,0,1
2023-06-01,135691,4,0,4,1,0,1
2023-06-01,135154,3,0,3,1,0,1
2023-06-01,150193,2,0,2,2,0,2
2023-06-01,135155,10,0,10,1,0,1
2023-06-01,63505,1,0,1,1,0,1
2023-06-01,18282,12,1,13,4,4,5
2023-06-01,134905,4,1,5,1,1,1
2023-06-01,135320,1,0,1,1,0,1
2023-06-01,134660,1,0,1,1,0,1
2023-06-01,135467,1,0,1,2,0,2
2023-06-01,203554,5,0,5,5,0,5
2023-06-01,135160,1,0,1,1,0,1
2023-06-01,135165,1,0,1,1,0,1
2023-06-01,45318,1,0,1,1,0,1
2023-06-01,151114,1,1,2,1,1,1
2023-06-01,135166,1,0,1,2,0,2
2023-06-01,134975,1,0,1,1,0,1
2023-06-01,135255,2,0,2,1,0,1
2023-06-01,150952,1,0,1,1,0,1
2023-06-01,63752,1,1,2,1,1,1
2023-06-01,45852,8,0,8,8,0,8
2023-06-01,133118,13,1,14,1,1,1
2023-06-01,139110,4,0,4,3,0,3
2023-06-01,132956,4,0,4,2,0,2
2023-06-01,134910,4,0,4,5,0,5
2023-06-01,17456,4,0,4,1,0,1
2023-06-01,134909,4,2,6,4,2,4
2023-06-01,131954,4,1,5,3,3,4
2023-06-01,138312,4,0,4,3,0,3
2023-06-01,135289,1,0,1,1,0,1
2023-06-01,135288,1,0,1,1,0,1
2023-06-01,135224,4,0,4,1,0,1
2023-06-01,135291,1,0,1,1,0,1
2023-06-01,150938,1,0,1,1,0,1
2023-06-01,135294,2,0,2,1,0,1
2023-06-01,135170,2,0,2,2,0,2
2023-06-01,149259,1,0,1,1,0,1
2023-06-01,64026,1,0,1,1,0,1
2023-06-01,59157,1,0,1,1,0,1
2023-06-01,134661,1,0,1,2,0,2
2023-06-01,38756,3,0,3,1,0,1
2023-06-01,138889,1,0,1,1,0,1
2023-06-01,135209,1,0,1,1,0,1
2023-06-01,59321,3,0,3,3,0,3
2023-06-01,135298,5,0,5,3,0,3
2023-06-01,135297,2,0,2,2,0,2
2023-06-01,45424,15,0,15,3,0,3
2023-06-01,135242,4,0,4,1,0,1
2023-06-01,135310,8,11,19,3,3,3
2023-06-01,135311,6,0,6,1,0,1
2023-06-01,135317,1,0,1,1,0,1
2023-06-01,150809,1,0,1,1,0,1
2023-06-01,38517,5,0,5,2,0,2
2023-06-01,135319,4,0,4,1,0,1
2023-06-01,135332,1,0,1,1,0,1
2023-06-01,135461,1,0,1,2,0,2
2023-06-01,135328,4,1,5,4,1,4
2023-06-01,135678,1,0,1,1,0,1
2023-06-01,135339,6,0,6,1,0,1
2023-06-01,150299,3,1,4,1,1,1
2023-06-01,64029,4,0,4,3,0,3
2023-06-01,134908,1,0,1,1,0,1
2023-06-01,55822,3,1,4,3,1,3
2023-06-01,135344,2,0,2,2,0,2
2023-06-01,135347,1,0,1,3,0,3
2023-06-01,135351,8,0,8,1,0,1
2023-06-01,135353,8,0,8,3,0,3
2023-06-01,64030,1,0,1,2,0,2
2023-06-01,135439,3,0,3,3,0,3
2023-06-01,64032,1,0,1,1,0,1
2023-06-01,64031,2,0,2,1,0,1
2023-06-01,135313,1,0,1,1,0,1
2023-06-01,135361,2,0,2,1,0,1
2023-06-01,136187,1,0,1,1,0,1
2023-06-01,150969,1,0,1,1,0,1
2023-06-01,150303,1,0,1,2,0,2
2023-06-01,18070,5,1,6,7,6,7
2023-06-01,135323,5,0,5,4,0,4
2023-06-01,135368,1,0,1,1,0,1
2023-06-01,135172,1,0,1,1,0,1
2023-06-01,135264,1,0,1,1,0,1
2023-06-01,17837,34,0,34,4,0,4
2023-06-01,135171,2,0,2,3,0,3
2023-06-01,135370,5,1,6,1,1,1
2023-06-01,135371,10,2,12,2,1,2
2023-06-01,135173,2,0,2,2,0,2
2023-06-01,212939,3,0,3,2,0,2
2023-06-01,135263,1,0,1,3,0,3
2023-06-01,10121,1,0,1,2,0,2
2023-06-01,136314,2,0,2,2,0,2
2023-06-01,135197,2,0,2,2,0,2
2023-06-01,63499,1,0,1,1,0,1
2023-06-01,135174,1,0,1,2,0,2
2023-06-01,132936,1,1,2,1,1,1
2023-06-01,63744,1,0,1,1,0,1
2023-06-01,13821,15,0,15,10,0,10
2023-06-01,135385,1,0,1,1,0,1
2023-06-01,23575,16,0,16,5,0,5
2023-06-01,38682,2,0,2,1,0,1
2023-06-01,135180,4,1,5,3,1,3
2023-06-01,135396,2,0,2,1,0,1
2023-06-01,133393,7,0,7,2,0,2
2023-06-01,150302,2,0,2,1,0,1
2023-06-01,135184,3,0,3,1,0,1
2023-06-01,133354,6,0,6,4,0,4
2023-06-01,150304,3,0,3,1,0,1
2023-06-01,135261,8,0,8,1,0,1
2023-06-01,9459,52,0,52,2,0,2
2023-06-01,135416,1,0,1,2,0,2
2023-06-01,138091,1,0,1,2,0,2
2023-06-01,135194,2,0,2,1,0,1
2023-06-01,54054,4,2,6,9,5,10
2023-06-01,133023,4,0,4,5,0,5
2023-06-01,135440,1,0,1,3,0,3
2023-06-01,213268,1,1,2,1,1,1
2023-06-01,9554,1,0,1,1,0,1
2023-06-01,63742,1,0,1,2,0,2
2023-06-01,135442,1,0,1,1,0,1
2023-06-01,135441,2,0,2,1,0,1
2023-06-01,135494,2,0,2,2,0,2
2023-06-01,135397,2,0,2,3,0,3
2023-06-01,135243,1,0,1,1,0,1
2023-06-01,135245,4,0,4,3,0,3
2023-06-01,150199,2,0,2,3,0,3
2023-06-01,63746,5,0,5,1,0,1
2023-06-01,63743,3,0,3,5,0,5
2023-06-01,135446,2,0,2,2,0,2
2023-06-01,135251,2,0,2,1,0,1
2023-06-01,135545,1,0,1,1,0,1
2023-06-01,135238,1,0,1,3,0,3
2023-06-01,135517,5,0,5,2,0,2
2023-06-01,55311,2,0,2,3,0,3
2023-06-01,63751,4,0,4,3,0,3
2023-06-01,56056,2,0,2,3,0,3
2023-06-01,135524,5,2,7,2,1,2
2023-06-01,135527,4,0,4,3,0,3
2023-06-01,135551,1,1,2,2,2,2
2023-06-01,131605,1,1,2,1,2,2
2023-06-01,25687,8,0,8,7,0,7
2023-06-01,59254,4,0,4,1,0,1
2023-06-01,133204,1,0,1,2,0,2
2023-06-01,132961,4,0,4,2,0,2
2023-06-01,1342922,0,0,0,1,0,1
2023-06-01,17635,17,1,18,4,3,4
2023-06-01,133212,1,0,1,1,0,1
2023-06-01,149631,1,0,1,2,0,2
2023-06-01,150197,1,0,1,2,0,2
2023-06-01,133216,1,0,1,1,0,1
2023-06-01,45696,2,0,2,2,0,2
2023-06-01,133618,2,0,2,2,0,2
2023-06-01,132516,2,0,2,1,0,1
2023-06-01,136518,64,0,64,6,0,6
2023-06-01,133974,1,0,1,2,0,2
2023-06-01,58498,2,0,2,2,0,2
2023-06-01,133331,4,0,4,4,0,4
2023-06-01,59160,1,0,1,1,0,1
2023-06-01,133088,2,0,2,2,0,2
2023-06-01,133087,1,0,1,2,0,2
2023-06-01,133860,5,0,5,3,0,3
2023-06-01,58789,4,0,4,1,0,1
2023-06-01,58530,12,0,12,4,0,4
2023-06-01,59356,1,0,1,2,0,2
2023-06-01,133370,2,0,2,1,0,1
2023-06-01,131463,2,0,2,1,0,1
2023-06-01,131398,4,0,4,3,0,3
2023-06-01,26178,9,0,9,6,0,6
2023-06-01,133371,1,0,1,1,0,1
2023-06-01,133377,4,0,4,2,0,2
2023-06-01,133394,2,1,3,3,1,3
2023-06-01,131895,1,1,2,1,1,1
2023-06-01,45620,5,0,5,3,0,3
2023-06-01,131405,3,0,3,1,0,1
2023-06-01,133134,3,0,3,2,0,2
2023-06-01,135024,1,0,1,3,0,3
2023-06-01,59275,1,0,1,1,0,1
2023-06-01,133345,1,0,1,1,0,1
2023-06-01,59276,4,1,5,4,1,4
2023-06-01,58722,1,0,1,1,0,1
2023-06-01,133396,2,0,2,3,0,3
2023-06-01,38722,2,0,2,2,0,2
2023-06-01,55343,2,0,2,2,0,2
2023-06-01,133391,1,0,1,1,0,1
2023-06-01,133202,4,0,4,2,0,2
2023-06-01,131589,2,1,3,3,2,3
2023-06-01,45858,1,0,1,1,0,1
2023-06-01,133556,3,1,4,1,1,1
2023-06-01,133285,8,0,8,3,0,3
2023-06-01,58880,1,0,1,1,0,1
2023-06-01,133411,3,0,3,1,0,1
2023-06-01,131590,3,2,5,2,2,2
2023-06-01,133413,1,0,1,1,0,1
2023-06-01,133195,1,0,1,2,0,2
2023-06-01,45146,8,0,8,3,0,3
2023-06-01,59279,4,0,4,3,0,3
2023-06-01,59332,4,1,5,2,1,2
2023-06-01,133282,1,0,1,2,0,2
2023-06-01,131401,1,0,1,2,0,2
2023-06-01,10,0,0,0,2,0,2
2023-06-01,59280,3,0,3,3,0,3
2023-06-01,59242,2,0,2,3,0,3
2023-06-01,133288,2,0,2,1,0,1
2023-06-01,203786,3,0,3,1,0,1
2023-06-01,59261,1,2,3,1,1,1
2023-06-01,394298,5,2,7,2,2,2
2023-06-01,133422,1,0,1,1,0,1
2023-06-01,38823,6,0,6,5,0,5
2023-06-01,133430,4,0,4,4,0,4
2023-06-01,133431,4,0,4,1,0,1
2023-06-01,64005,1,0,1,1,0,1
2023-06-01,133435,3,0,3,1,0,1
2023-06-01,131587,2,4,6,2,2,2
2023-06-01,133281,4,0,4,1,0,1
2023-06-01,135885,1,1,2,1,1,1
2023-06-01,137893,1,0,1,1,0,1
2023-06-01,133238,1,0,1,2,0,2
2023-06-01,133438,3,0,3,2,0,2
2023-06-01,133089,1,1,2,3,2,3
2023-06-01,132053,3,0,3,3,0,3
2023-06-01,133346,2,0,2,3,0,3
2023-06-01,6424,1,0,1,1,0,1
2023-06-01,59342,10,0,10,2,0,2
2023-06-01,133449,3,0,3,1,0,1
2023-06-01,131588,3,5,8,3,3,3
2023-06-01,202421,6,1,7,1,1,1
2023-06-01,133453,1,0,1,1,0,1
2023-06-01,131404,1,0,1,1,0,1
2023-06-01,131734,3,0,3,2,0,2
2023-06-01,18378,2,0,2,3,0,3
2023-06-01,399440,3,1,4,2,1,2
2023-06-01,55953,3,0,3,4,0,4
2023-06-01,133456,2,1,3,1,1,1
2023-06-01,140344,2,0,2,1,0,1
2023-06-01,9795,1,0,1,3,0,3
2023-06-01,150961,1,0,1,2,0,2
2023-06-01,151081,1,0,1,1,0,1
2023-06-01,45925,15,0,15,3,0,3
2023-06-01,204136,7,2,9,2,1,2
2023-06-01,134819,1,1,2,1,1,2
2023-06-01,134822,1,1,2,3,1,3
2023-06-01,133233,1,0,1,2,0,2
2023-06-01,59093,2,1,3,4,2,4
2023-06-01,59353,5,0,5,4,0,4
2023-06-01,135039,1,0,1,1,0,1
2023-06-01,133349,3,0,3,1,0,1
2023-06-01,133470,3,0,3,2,0,2
2023-06-01,133471,3,0,3,2,0,2
2023-06-01,59355,4,0,4,1,0,1
2023-06-01,133235,2,0,2,1,0,1
2023-06-01,30613,2,0,2,2,0,2
2023-06-01,45724,8,1,9,3,1,3
2023-06-01,59366,1,0,1,1,0,1
2023-06-01,59361,1,0,1,1,0,1
2023-06-01,49596,7,0,7,1,0,1
2023-06-01,43233,1,0,1,1,0,1
2023-06-01,7479,33,0,33,4,0,4
2023-06-01,131407,1,0,1,1,0,1
2023-06-01,134507,2,0,2,1,0,1
2023-06-01,133236,1,0,1,1,0,1
2023-06-01,133461,1,0,1,1,0,1
2023-06-01,59365,7,0,7,5,0,5
2023-06-01,133491,1,0,1,1,0,1
2023-06-01,133498,4,1,5,4,3,5
2023-06-01,55845,2,0,2,2,0,2
2023-06-01,131408,3,0,3,2,0,2
2023-06-01,131411,1,0,1,1,0,1
2023-06-01,133500,5,0,5,3,0,3
2023-06-01,59368,1,1,2,1,1,1
2023-06-01,150308,2,0,2,2,0,2
2023-06-01,131168,2,0,2,2,0,2
2023-06-01,210110,2,0,2,1,0,1
2023-06-01,61112,1,2,3,1,1,2
2023-06-01,59193,1,0,1,1,0,1
2023-06-01,38330,3,0,3,1,0,1
2023-06-01,133509,2,0,2,1,0,1
2023-06-01,59370,3,0,3,1,0,1
2023-06-01,23735,13,0,13,2,0,2
2023-06-01,133357,1,0,1,3,0,3
2023-06-01,133230,3,0,3,3,0,3
2023-06-01,63840,1,0,1,2,0,2
2023-06-01,63696,2,0,2,1,0,1
2023-06-01,63697,1,0,1,1,0,1
2023-06-01,9263,2,0,2,5,0,5
2023-06-01,133084,3,0,3,4,0,4
2023-06-01,133249,3,1,4,2,1,2
2023-06-01,133535,1,0,1,1,0,1
2023-06-01,133520,1,0,1,3,0,3
2023-06-01,151064,1,0,1,1,0,1
2023-06-01,135099,1,0,1,2,0,2
2023-06-01,133546,1,0,1,1,0,1
2023-06-01,45938,9,3,12,3,1,3
2023-06-01,150306,3,0,3,1,0,1
2023-06-01,133317,8,1,9,3,1,3
2023-06-01,133541,1,0,1,1,0,1
2023-06-01,149130,3,0,3,1,0,1
2023-06-01,149131,2,0,2,1,0,1
2023-06-01,59349,2,1,3,1,1,1
2023-06-01,59097,3,0,3,5,0,5
2023-06-01,131581,2,0,2,3,0,3
2023-06-01,38767,7,1,8,3,1,3
2023-06-01,24172,1,0,1,3,0,3
2023-06-01,133955,11,0,11,2,0,2
2023-06-01,23659,14,1,15,1,1,1
2023-06-01,133553,1,0,1,1,0,1
2023-06-01,56210,1,0,1,3,0,3
2023-06-01,59009,6,0,6,2,0,2
2023-06-01,59381,2,0,2,2,0,2
2023-06-01,134463,1,0,1,3,0,3
2023-06-01,45720,2,0,2,2,0,2
2023-06-01,63886,1,0,1,1,0,1
2023-06-01,146995,1,0,1,1,0,1
2023-06-01,7712,5,1,6,3,1,3
2023-06-01,133588,1,0,1,2,0,2
2023-06-01,27568,1,1,2,1,1,1
2023-06-01,131412,4,0,4,3,0,3
2023-06-01,133587,1,0,1,2,0,2
2023-06-01,133582,1,0,1,1,0,1
2023-06-01,53580,1,0,1,1,0,1
2023-06-01,55854,5,0,5,3,0,3
2023-06-01,133312,1,0,1,1,0,1
2023-06-01,133600,1,0,1,1,0,1
2023-06-01,133603,1,0,1,1,0,1
2023-06-01,133259,1,0,1,2,0,2
2023-06-01,133604,1,0,1,1,0,1
2023-06-01,10200,3,0,3,1,0,1
2023-06-01,59073,3,3,6,2,5,5
2023-06-01,133313,1,0,1,1,0,1
2023-06-01,133262,2,0,2,4,0,4
2023-06-01,133616,1,1,2,2,1,2
2023-06-01,131413,5,0,5,3,0,3
2023-06-01,131417,4,0,4,1,0,1
2023-06-01,134985,1,0,1,1,0,1
2023-06-01,149167,1,0,1,1,0,1
2023-06-01,63519,1,0,1,1,0,1
2023-06-01,37922,6,1,7,3,1,3
2023-06-01,9974,4,0,4,2,0,2
2023-06-01,131419,4,0,4,1,0,1
2023-06-01,133609,1,0,1,1,0,1
2023-06-01,24536,9,1,10,3,1,3
2023-06-01,131719,1,0,1,1,0,1
2023-06-01,58414,5,0,5,1,0,1
2023-06-01,133740,1,0,1,1,0,1
2023-06-01,55715,5,0,5,1,0,1
2023-06-01,17589,101,0,101,3,0,3
2023-06-01,38319,2,0,2,1,0,1
2023-06-01,135670,2,0,2,2,0,2
2023-06-01,132555,1,0,1,1,0,1
2023-06-01,132986,4,1,5,2,1,2
2023-06-01,38258,6,4,10,2,2,2
2023-06-01,133028,2,0,2,2,0,2
2023-06-01,8,11,0,11,4,0,4
2023-06-01,133052,1,0,1,1,0,1
2023-06-01,133048,1,0,1,1,0,1
2023-06-01,133055,1,0,1,2,0,2
2023-06-01,133051,1,0,1,3,0,3
2023-06-01,134433,9,1,10,5,1,5
2023-06-01,133062,2,0,2,1,0,1
2023-06-01,150564,1,1,2,1,1,1
2023-06-01,132678,4,0,4,4,0,4
2023-06-01,40654,5,0,5,3,0,3
2023-06-01,133046,1,0,1,1,0,1
2023-06-01,132984,1,0,1,1,0,1
2023-06-01,131389,3,0,3,2,0,2
2023-06-01,133094,1,0,1,3,0,3
2023-06-01,38891,12,0,12,6,0,6
2023-06-01,37907,3,0,3,1,0,1
2023-06-01,45481,4,0,4,1,0,1
2023-06-01,9934,31,0,31,3,0,3
2023-06-01,131390,5,0,5,2,0,2
2023-06-01,131403,1,0,1,2,0,2
2023-06-01,134642,2,0,2,2,0,2
2023-06-01,64294,11,0,11,8,0,8
2023-06-01,58822,2,0,2,2,0,2
2023-06-01,133475,3,1,4,2,1,2
2023-06-01,132310,1,0,1,1,0,1
2023-06-01,133137,4,0,4,1,0,1
2023-06-01,132957,2,0,2,2,0,2
2023-06-01,58852,2,0,2,1,0,1
2023-06-01,133102,1,0,1,1,0,1
2023-06-01,59207,1,0,1,2,0,2
2023-06-01,55757,2,0,2,3,0,3
2023-06-01,132991,1,0,1,3,0,3
2023-06-01,38826,3,1,4,5,3,5
2023-06-01,133108,1,0,1,1,0,1
2023-06-01,133143,1,0,1,3,0,3
2023-06-01,133187,5,1,6,3,1,3
2023-06-01,131394,1,0,1,1,0,1
2023-06-01,59209,4,0,4,3,0,3
2023-06-01,59131,1,0,1,2,0,2
2023-06-01,150787,1,1,2,1,1,2
2023-06-01,10038,1,0,1,2,0,2
2023-06-01,131391,4,0,4,1,0,1
2023-06-01,132948,2,0,2,3,0,3
2023-06-01,132981,1,0,1,3,0,3
2023-06-01,200,1,0,1,2,0,2
2023-06-01,132995,1,0,1,1,0,1
2023-06-01,137953,1,0,1,2,0,2
2023-06-01,58757,4,0,4,2,0,2
2023-06-01,132527,6,0,6,1,0,1
2023-06-01,151188,1,1,2,2,2,3
2023-06-01,132509,4,0,4,1,0,1
2023-06-01,150309,3,1,4,2,1,2
2023-06-01,55764,2,0,2,3,0,3
2023-06-01,132512,1,0,1,2,0,2
2023-06-01,131253,1,0,1,3,0,3
2023-06-01,132532,1,0,1,1,0,1
2023-06-01,132533,1,0,1,5,0,5
2023-06-01,131759,4,0,4,3,0,3
2023-06-01,132534,3,0,3,4,0,4
2023-06-01,198198,3,0,3,1,0,1
2023-06-01,131761,1,0,1,2,0,2
2023-06-01,58795,1,0,1,1,0,1
2023-06-01,132520,1,0,1,2,0,2
2023-06-01,132519,6,1,7,1,1,1
2023-06-01,7754,17,0,17,9,0,9
2023-06-01,132535,8,0,8,1,0,1
2023-06-01,131763,1,0,1,1,0,1
2023-06-01,132587,1,0,1,1,0,1
2023-06-01,38457,20,0,20,2,0,2
2023-06-01,58800,4,1,5,2,1,2
2023-06-01,141715,1,0,1,1,0,1
2023-06-01,46056,3,0,3,5,0,5
2023-06-01,55982,1,0,1,2,0,2
2023-06-01,132575,1,0,1,1,0,1
2023-06-01,132578,1,0,1,2,0,2
2023-06-01,58759,1,0,1,2,0,2
2023-06-01,134244,1,0,1,1,0,1
2023-06-01,134839,1,1,2,1,1,1
2023-06-01,38058,9,0,9,4,0,4
2023-06-01,132549,2,0,2,1,0,1
2023-06-01,132542,4,1,5,1,1,1
2023-06-01,131440,2,0,2,1,0,1
2023-06-01,45531,0,0,0,2,0,2
2023-06-01,4647,8,1,9,1,1,1
2023-06-01,4653,1,0,1,1,0,1
2023-06-01,9479,3,0,3,3,0,3
2023-06-01,38678,10,0,10,1,0,1
2023-06-01,56302,1,0,1,2,0,2
2023-06-01,150213,2,0,2,3,0,3
2023-06-01,45594,14,0,14,2,0,2
2023-06-01,55479,2,1,3,3,3,3
2023-06-01,56243,1,0,1,1,0,1
2023-06-01,58383,1,0,1,2,0,2
2023-06-01,17929,10,2,12,5,2,5
2023-06-01,132022,4,1,5,2,2,3
2023-06-01,132017,1,0,1,1,0,1
2023-06-01,45243,8,0,8,3,0,3
2023-06-01,56270,5,0,5,6,0,6
2023-06-01,132020,1,1,2,3,1,3
2023-06-01,58485,3,1,4,2,1,2
2023-06-01,58491,1,0,1,1,0,1
2023-06-01,58604,1,0,1,1,0,1
2023-06-01,133101,1,13,14,4,2,4
2023-06-01,140840,1,2,3,4,2,4
2023-06-01,132125,1,1,2,1,1,1
2023-06-01,10118,73,18,91,8,4,8
2023-06-01,17794,14,0,14,2,0,2
2023-06-01,131181,2,0,2,3,0,3
2023-06-01,132136,1,0,1,2,0,2
2023-06-01,58561,1,0,1,1,0,1
2023-06-01,138331,3,0,3,2,0,2
2023-06-01,58516,1,1,2,3,1,3
2023-06-01,56202,6,0,6,1,0,1
2023-06-01,55971,1,0,1,2,0,2
2023-06-01,38498,4,0,4,5,0,5
2023-06-01,133050,4,0,4,2,0,2
2023-06-01,140610,5,0,5,3,0,3
2023-06-01,58521,57,8,65,2,1,2
2023-06-01,133151,1,0,1,1,0,1
2023-06-01,58522,1,1,2,3,2,3
2023-06-01,55629,2,0,2,2,0,2
2023-06-01,132299,3,0,3,1,0,1
2023-06-01,58527,3,0,3,2,0,2
2023-06-01,132141,1,0,1,1,0,1
2023-06-01,132658,1,0,1,1,0,1
2023-06-01,58928,2,0,2,2,0,2
2023-06-01,133417,2,0,2,2,0,2
2023-06-01,150678,0,0,0,3,0,3
2023-06-01,138531,1,0,1,1,0,1
2023-06-01,137999,2,0,2,1,0,1
2023-06-01,38862,6,0,6,6,0,6
2023-06-01,58869,2,2,4,1,1,1
2023-06-01,142625,2,0,2,1,0,1
2023-06-01,131381,2,0,2,2,0,2
2023-06-01,131380,5,0,5,3,0,3
2023-06-01,24459,5,2,7,3,3,3
2023-06-01,58926,4,0,4,3,0,3
2023-06-01,132763,2,0,2,2,0,2
2023-06-01,150206,3,0,3,1,0,1
2023-06-01,58935,1,0,1,2,0,2
2023-06-01,38583,5,0,5,6,0,6
2023-06-01,58894,1,0,1,6,0,6
2023-06-01,45154,3,0,3,3,0,3
2023-06-01,132661,1,0,1,1,0,1
2023-06-01,132914,1,0,1,1,0,1
2023-06-01,131387,2,0,2,2,0,2
2023-06-01,150311,1,1,2,1,1,1
2023-06-01,132835,3,0,3,4,0,4
2023-06-01,131198,2,1,3,1,1,1
2023-06-01,58902,4,0,4,5,0,5
2023-06-01,134795,7,1,8,1,1,1
2023-06-01,137941,1,1,2,1,1,1
2023-06-01,55729,3,0,3,3,0,3
2023-06-01,150310,3,0,3,3,0,3
2023-06-01,58974,2,0,2,3,0,3
2023-06-01,38437,4,1,5,3,3,3
2023-06-01,133047,2,0,2,2,0,2
2023-06-01,133019,1,0,1,2,0,2
2023-06-01,58984,4,0,4,1,0,1
2023-06-01,136547,9,1,10,3,2,3
2023-06-01,132943,1,0,1,2,0,2
2023-06-01,133025,1,0,1,1,0,1
2023-06-01,140842,2,0,2,1,0,1
2023-06-01,45677,4,1,5,4,2,4
2023-06-01,133897,2,0,2,2,0,2
2023-06-01,151321,1,0,1,2,0,2
2023-06-01,133053,1,0,1,1,0,1
2023-06-01,58818,5,0,5,4,0,4
2023-06-01,133002,2,0,2,3,0,3
2023-06-01,58982,5,1,6,1,1,1
2023-06-01,58850,4,0,4,4,0,4
2023-06-01,132944,10,0,10,2,0,2
2023-06-01,133034,5,1,6,3,1,3
2023-06-01,135016,3,0,3,2,0,2
2023-06-01,133129,1,0,1,1,0,1
2023-06-01,9794,29,1,30,3,3,4
2023-06-01,59137,2,0,2,1,0,1
2023-06-01,150991,1,0,1,1,0,1
2023-06-01,134885,8,0,8,2,0,2
2023-06-01,133138,2,0,2,1,0,1
2023-06-01,10085,16,0,16,1,0,1
2023-06-01,45596,5,0,5,4,0,4
2023-06-01,11174,6,0,6,6,0,6
2023-06-01,133465,2,1,3,2,1,2
2023-06-01,59138,1,0,1,2,0,2
2023-06-01,133335,1,0,1,1,0,1
2023-06-01,133146,1,0,1,3,0,3
2023-06-01,4786,4,0,4,2,0,2
2023-06-01,131601,3,0,3,1,0,1
2023-06-01,134971,9,0,9,2,0,2
2023-06-01,132950,1,0,1,3,0,3
2023-06-01,59330,1,0,1,1,0,1
2023-06-01,133154,1,0,1,1,0,1
2023-06-01,133155,3,3,6,1,1,1
2023-06-01,18353,22,8,30,5,2,5
2023-06-01,22071,11,0,11,7,0,7
2023-06-01,133163,2,0,2,3,0,3
2023-06-01,133161,3,0,3,2,0,2
2023-06-01,59142,1,0,1,2,0,2
2023-06-01,133133,1,0,1,1,0,1
2023-06-01,150989,1,0,1,1,0,1
2023-06-01,132979,1,0,1,1,0,1
2023-06-01,17428,33,3,36,8,4,11
2023-06-01,18244,14,0,14,1,0,1
2023-06-01,132588,9,0,9,2,0,2
2023-06-01,63992,1,0,1,1,0,1
2023-06-01,131397,1,0,1,1,0,1
2023-06-01,133173,1,1,2,1,1,1
2023-06-01,132938,4,0,4,1,0,1
2023-06-01,46017,2,0,2,2,0,2
2023-06-01,133228,3,0,3,3,0,3
2023-06-01,133177,1,0,1,1,0,1
2023-06-01,133179,5,0,5,1,0,1
2023-06-01,133194,1,0,1,1,0,1
2023-06-01,133186,1,0,1,1,0,1
2023-06-01,132965,5,0,5,2,0,2
2023-06-01,151176,1,0,1,1,0,1
2023-06-01,59258,2,1,3,3,2,3
2023-06-01,133095,1,0,1,1,0,1
2023-06-01,133082,4,0,4,1,0,1
2023-06-01,133416,1,0,1,1,0,1
2023-06-01,59156,2,0,2,1,0,1
2023-06-01,9937,11,0,11,1,0,1
2023-06-01,132970,1,0,1,2,0,2
2023-06-01,59263,3,0,3,2,0,2
2023-06-01,59352,2,0,2,2,0,2
2023-06-01,28573,1864,1881,3745,5,4,6
2023-06-01,13843,1,0,1,3,0,3
2023-06-01,395945,1,0,1,2,0,2
2023-06-01,60790,2,2,4,3,3,4
2023-06-01,26111,8,0,8,3,0,3
2023-06-01,19365,1,0,1,1,0,1
2023-06-01,20333,8,0,8,4,0,4
2023-06-01,397329,1,0,1,1,0,1
2023-06-01,27640,4,0,4,3,0,3
2023-06-01,22857,6,0,6,3,0,3
2023-06-01,396873,2,0,2,2,0,2
2023-06-01,14296,1,1,2,1,1,1
2023-06-01,54755,24,0,24,1,0,1
2023-06-01,46886,24,1,25,1,1,1
2023-06-01,54874,1,1,2,2,3,3
2023-06-01,970,1,1,2,2,3,3
2023-06-01,21957,1,4,5,1,1,1
2023-06-01,49592,1,0,1,1,0,1
2023-06-01,36019,1,0,1,1,0,1
2023-06-01,54456,8,5,13,2,1,2
2023-06-01,6209,7,0,7,5,0,5
2023-06-01,63060,7,1,8,4,2,4
2023-06-01,30493,3,0,3,2,0,2
2023-06-01,36077,7,0,7,2,0,2
2023-06-01,393499,4,0,4,2,0,2
2023-06-01,21748,9,0,9,3,0,3
2023-06-01,35204,2,1,3,1,1,1
2023-06-01,31110,1,0,1,1,0,1
2023-06-01,14333,5,1,6,6,2,6
2023-06-01,30455,15,3,18,2,2,2
2023-06-01,395737,2,0,2,1,0,1
2023-06-01,393653,5,0,5,2,0,2
2023-06-01,10916,1,0,1,2,0,2
2023-06-01,394637,1,1,2,1,1,1
2023-06-01,397128,4,0,4,1,0,1
2023-06-01,399111,1,0,1,1,0,1
2023-06-01,399044,1,0,1,1,0,1
2023-06-01,399395,0,0,0,2,0,2
2023-06-01,40720,3,0,3,1,0,1
2023-06-01,394198,1,0,1,2,0,2
2023-06-01,400331,4,0,4,2,0,2
2023-06-01,12125,2,0,2,3,0,3
2023-06-01,30385,3,0,3,3,0,3
2023-06-01,54271,3,0,3,1,0,1
2023-06-01,395458,1,0,1,2,0,2
2023-06-01,396386,1,0,1,2,0,2
2023-06-01,395677,6,0,6,3,0,3
2023-06-01,33247,7,0,7,5,0,5
2023-06-01,41264,53,0,53,13,0,13
2023-06-01,36385,1,1,2,9,6,9
2023-06-01,395973,32,35,67,4,3,4
2023-06-01,6561,10,0,10,3,0,3
2023-06-01,62664,6,0,6,2,0,2
2023-06-01,400690,5,0,5,1,0,1
2023-06-01,396191,5,0,5,1,0,1
2023-06-01,18140,1,0,1,1,0,1
2023-06-01,63092,1,0,1,1,0,1
2023-06-01,32829,9,0,9,3,0,3
2023-06-01,64245,14,5,19,4,3,5
2023-06-01,23254,1,0,1,2,0,2
2023-06-01,1832,2,0,2,2,0,2
2023-06-01,399081,1,1,2,3,1,3
2023-06-01,399268,5,0,5,3,0,3
2023-06-01,36468,1,0,1,1,0,1
2023-06-01,27531,3,1,4,2,3,3
2023-06-01,20100,8,0,8,5,0,5
2023-06-01,16738,5,0,5,2,0,2
2023-06-01,10946,1,0,1,1,0,1
2023-06-01,22322,12,0,12,3,0,3
2023-06-01,54359,3,1,4,2,2,2
2023-06-01,55220,1,0,1,1,0,1
2023-06-01,63068,3,0,3,2,0,2
2023-06-01,393586,7,0,7,2,0,2
2023-06-01,40400,4,0,4,3,0,3
2023-06-01,22466,1,0,1,1,0,1
2023-06-01,399917,4,0,4,2,0,2
2023-06-01,395771,2,0,2,2,0,2
2023-06-01,13404,1,0,1,3,0,3
2023-06-01,14622,1,0,1,3,0,3
2023-06-01,54180,1,0,1,1,0,1
2023-06-01,23187,1,0,1,2,0,2
2023-06-01,398878,2,0,2,2,0,2
2023-06-01,63285,1,0,1,2,0,2
2023-06-01,23188,7,0,7,5,0,5
2023-06-01,19874,4,0,4,6,0,6
2023-06-01,393518,2,0,2,4,0,4
2023-06-01,30406,3,0,3,1,0,1
2023-06-01,63123,3,0,3,3,0,3
2023-06-01,46399,5,0,5,1,0,1
2023-06-01,393565,1,0,1,1,0,1
2023-06-01,11668,14,0,14,2,0,2
2023-06-01,396194,3,0,3,3,0,3
2023-06-01,27580,3,2,5,3,3,4
2023-06-01,36203,2,0,2,1,0,1
2023-06-01,11407,1,0,1,1,0,1
2023-06-01,54842,1,0,1,1,0,1
2023-06-01,64257,3,0,3,2,0,2
2023-06-01,26021,1,3,4,1,1,1
2023-06-01,62947,25,1,26,2,1,2
2023-06-01,33504,3,0,3,2,0,2
2023-06-01,36167,1,0,1,1,0,1
2023-06-01,11727,5,0,5,2,0,2
2023-06-01,17210,26,3,29,8,4,8
2023-06-01,14382,8,1,9,4,5,5
2023-06-01,11324,4,0,4,2,0,2
2023-06-01,63089,7,0,7,1,0,1
2023-06-01,36829,5,6,11,2,2,2
2023-06-01,400161,2,0,2,1,0,1
2023-06-01,204353,14,0,14,2,0,2
2023-06-01,46469,5,0,5,3,0,3
2023-06-01,396318,2,0,2,1,0,1
2023-06-01,397039,1,0,1,1,0,1
2023-06-01,396125,7,0,7,6,0,6
2023-06-01,394344,3,1,4,1,1,1
2023-06-01,15094,2,2,4,1,1,1
2023-06-01,397168,21,1,22,2,2,2
2023-06-01,46190,1,0,1,1,0,1
2023-06-01,398852,2,1,3,3,1,3
2023-06-01,399078,1,2,3,4,2,4
2023-06-01,400152,1,0,1,2,0,2
2023-06-01,1062,2,0,2,1,0,1
2023-06-01,137280,57,3,60,14,6,15
2023-06-01,393620,1,0,1,2,0,2
2023-06-01,19764,6,1,7,1,2,2
2023-06-01,399022,1,0,1,1,0,1
2023-06-01,398965,2,0,2,3,0,3
2023-06-01,30034,1,0,1,2,0,2
2023-06-01,398874,1,0,1,1,0,1
2023-06-01,57156,1,2,3,4,5,6
2023-06-01,23423,19,1,20,4,1,4
2023-06-01,19168,1,1,2,1,1,1
2023-06-01,63172,1,0,1,1,0,1
2023-06-01,394176,1,0,1,4,0,4
2023-06-01,14790,1,0,1,3,0,3
2023-06-01,54911,1,0,1,1,0,1
2023-06-01,13534,2,0,2,3,0,3
2023-06-01,28509,450,36,486,9,4,9
2023-06-01,399296,18,1,19,1,1,1
2023-06-01,142617,1,0,1,1,0,1
2023-06-01,395379,2,0,2,3,0,3
2023-06-01,13439,1,0,1,1,0,1
2023-06-01,397942,1,7,8,2,4,5
2023-06-01,398090,5,0,5,2,0,2
2023-06-01,63267,11,1,12,2,2,2
2023-06-01,31764,8,2,10,2,2,2
2023-06-01,2568,12,0,12,4,0,4
2023-06-01,33512,8,0,8,5,0,5
2023-06-01,63090,1,0,1,1,0,1
2023-06-01,14137,4,0,4,2,0,2
2023-06-01,398407,1,0,1,1,0,1
2023-06-01,606,5,0,5,2,0,2
2023-06-01,19974,1,0,1,1,0,1
2023-06-01,19912,1,0,1,1,0,1
2023-06-01,6462,1,4,5,3,1,3
2023-06-01,53484,5,0,5,3,0,3
2023-06-01,27179,2,0,2,1,0,1
2023-06-01,11862,6,0,6,3,0,3
2023-06-01,397330,1,0,1,1,0,1
2023-06-01,393778,1,0,1,2,0,2
2023-06-01,397907,1,0,1,1,0,1
2023-06-01,18656,6,0,6,5,0,5
2023-06-01,393595,4,0,4,1,0,1
2023-06-01,396317,5,0,5,3,0,3
2023-06-01,62466,1,0,1,1,0,1
2023-06-01,395204,2,0,2,3,0,3
2023-06-01,53349,4,0,4,3,0,3
2023-06-01,393725,2,0,2,2,0,2
2023-06-01,53930,6,0,6,4,0,4
2023-06-01,396298,6,6,12,4,4,4
2023-06-01,25754,12,0,12,4,0,4
2023-06-01,395291,3,0,3,3,0,3
2023-06-01,393608,3,0,3,2,0,2
2023-06-01,63177,1,0,1,2,0,2
2023-06-01,395710,1,0,1,1,0,1
2023-06-01,63196,1,0,1,1,0,1
2023-06-01,11756,2,0,2,3,0,3
2023-06-01,40193,10,7,17,2,2,2
2023-06-01,393587,3,0,3,4,0,4
2023-06-01,36422,1,0,1,2,0,2
2023-06-01,36270,1,0,1,2,0,2
2023-06-01,33529,1,0,1,2,0,2
2023-06-01,396367,14,4,18,4,4,4
2023-06-01,397768,1,0,1,2,0,2
2023-06-01,15248,5,10,15,5,7,7
2023-06-01,399573,1,0,1,3,0,3
2023-06-01,397098,1,0,1,2,0,2
2023-06-01,20327,1,0,1,1,0,1
2023-06-01,31980,1,0,1,2,0,2
2023-06-01,6188,4,2,6,3,3,4
2023-06-01,26490,2,0,2,1,0,1
2023-06-01,63154,4,5,9,3,2,3
2023-06-01,63190,6,0,6,3,0,3
2023-06-01,393761,1,0,1,2,0,2
2023-06-01,16995,1,0,1,2,0,2
2023-06-01,33615,5,0,5,4,0,4
2023-06-01,25851,2,2,4,3,2,3
2023-06-01,46598,13,0,13,3,0,3
2023-06-01,33029,10,1,11,3,1,3
2023-06-01,33213,8,0,8,2,0,2
2023-06-01,13921,1,0,1,1,0,1
2023-06-01,46353,9,1,10,5,5,6
2023-06-01,53893,1,1,2,2,3,3
2023-06-01,211675,1,1,2,1,2,2
2023-06-01,26327,4,0,4,4,0,4
2023-06-01,395324,1,0,1,2,0,2
2023-06-01,55145,15,0,15,3,0,3
2023-06-01,14588,5,0,5,1,0,1
2023-06-01,393686,8,0,8,1,0,1
2023-06-01,14143,8,0,8,1,0,1
2023-06-01,18907,2,1,3,2,1,2
2023-06-01,36644,4,0,4,3,0,3
2023-06-01,32931,7,5,12,3,6,6
2023-06-01,54555,4,1,5,1,1,2
2023-06-01,36436,9,3,12,5,2,5
2023-06-01,63214,2,0,2,3,0,3
2023-06-01,14410,8,1,9,3,2,3
2023-06-01,19084,48,0,48,1,0,1
2023-06-01,399142,1,0,1,3,0,3
2023-06-01,399206,1,0,1,3,0,3
2023-06-01,398911,1,0,1,1,0,1
2023-06-01,399030,2,0,2,3,0,3
2023-06-01,399563,1,0,1,1,0,1
2023-06-01,399069,4,0,4,1,0,1
2023-06-01,399430,2,0,2,1,0,1
2023-06-01,398995,4,0,4,3,0,3
2023-06-01,399321,1,0,1,1,0,1
2023-06-01,400049,1,0,1,1,0,1
2023-06-01,22682,6,0,6,1,0,1
2023-06-01,31914,8,1,9,6,2,6
2023-06-01,14485,7,0,7,1,0,1
2023-06-01,398748,2,14,16,2,1,2
2023-06-01,46505,1,1,2,2,2,2
2023-06-01,395828,1,0,1,3,0,3
2023-06-01,396333,1,0,1,1,0,1
2023-06-01,30541,1,0,1,3,0,3
2023-06-01,36358,1,0,1,1,0,1
2023-06-01,395749,1,1,2,3,1,3
2023-06-01,400260,1,1,2,1,1,1
2023-06-01,399059,1,0,1,1,0,1
2023-06-01,400378,1,0,1,1,0,1
2023-06-01,12167,4,2,6,4,1,4
2023-06-01,33607,1,0,1,1,0,1
2023-06-01,393891,7,15,22,7,3,7
2023-06-01,397750,1,4,5,1,1,1
2023-06-01,397664,1,0,1,2,0,2
2023-06-01,394064,2,0,2,3,0,3
2023-06-01,14735,2,0,2,4,0,4
2023-06-01,399300,2,0,2,1,0,1
2023-06-01,265919,8,6,14,5,2,6
2023-06-01,400833,2,0,2,1,0,1
2023-06-01,272524,1,1,2,1,1,1
2023-06-01,272210,1,0,1,1,0,1
2023-06-01,19181,7,2,9,1,1,1
2023-06-01,204769,4,0,4,3,0,3
2023-06-01,199218,1,0,1,1,0,1
2023-06-01,393678,2,0,2,3,0,3
2023-06-01,393905,3,1,4,1,1,1
2023-06-01,63274,2,0,2,2,0,2
2023-06-01,396018,5,0,5,1,0,1
2023-06-01,14603,2,0,2,2,0,2
2023-06-01,399291,2,0,2,1,0,1
2023-06-01,21811,1,0,1,1,0,1
2023-06-01,30139,1,0,1,1,0,1
2023-06-01,397476,2,0,2,2,0,2
2023-06-01,397669,1,0,1,3,0,3
2023-06-01,32236,2,0,2,3,0,3
2023-06-01,11622,1,0,1,1,0,1
2023-06-01,396525,1,0,1,3,0,3
2023-06-01,394472,1,0,1,1,0,1
2023-06-01,36601,3,1,4,2,2,2
2023-06-01,399901,1,0,1,1,0,1
2023-06-01,16616,1,0,1,1,0,1
2023-06-01,201170,1,1,2,3,3,3
2023-06-01,393667,5,4,9,5,3,5
2023-06-01,63299,5,0,5,2,0,2
2023-06-01,33532,1,0,1,2,0,2
2023-06-01,63210,5,1,6,4,1,4
2023-06-01,16803,3,0,3,4,0,4
2023-06-01,25774,4,0,4,1,0,1
2023-06-01,14869,1,0,1,1,0,1
2023-06-01,63258,5,0,5,2,0,2
2023-06-01,40966,10,0,10,4,0,4
2023-06-01,63287,6,0,6,6,0,6
2023-06-01,393445,8,1,9,3,1,3
2023-06-01,393735,5,0,5,2,0,2
2023-06-01,393682,4,1,5,3,2,4
2023-06-01,21925,3,0,3,2,0,2
2023-06-01,11333,23,0,23,5,0,5
2023-06-01,63313,1,1,2,1,1,1
2023-06-01,63447,4,3,7,2,2,2
2023-06-01,33381,1,0,1,1,0,1
2023-06-01,20063,2,0,2,3,0,3
2023-06-01,396082,3,0,3,1,0,1
2023-06-01,396369,2,0,2,1,0,1
2023-06-01,206834,3,1,4,1,1,1
2023-06-01,395558,4,1,5,3,2,3
2023-06-01,14401,2,1,3,1,1,1
2023-06-01,399883,1,1,2,1,1,1
2023-06-01,399560,1,0,1,2,0,2
2023-06-01,394690,2,0,2,4,0,4
2023-06-01,399098,2,0,2,2,0,2
2023-06-01,398538,2,0,2,1,0,1
2023-06-01,205196,6,0,6,1,0,1
2023-06-01,23024,113,0,113,3,0,3
2023-06-01,394607,2,0,2,3,0,3
2023-06-01,26826,2,0,2,2,0,2
2023-06-01,30580,2,0,2,2,0,2
2023-06-01,53839,2,0,2,2,0,2
2023-06-01,399617,1,0,1,1,0,1
2023-06-01,47038,24,0,24,4,0,4
2023-06-01,25814,1,0,1,1,0,1
2023-06-01,399384,1,0,1,2,0,2
2023-06-01,14770,3,2,5,3,2,3
2023-06-01,399360,4,0,4,2,0,2
2023-06-01,399653,1,0,1,1,0,1
2023-06-01,400101,2,0,2,4,0,4
2023-06-01,399681,1,0,1,1,0,1
2023-06-01,200525,3,0,3,1,0,1
2023-06-01,399872,1,0,1,3,0,3
2023-06-01,16635,1,1,2,1,1,1
2023-06-01,399833,4,0,4,1,0,1
2023-06-01,4267,0,0,0,2,0,2
2023-06-01,12228,2,0,2,1,0,1
2023-06-01,13891,1,0,1,1,0,1
2023-06-01,63425,1,0,1,2,0,2
2023-06-01,3043,2,1,3,4,3,4
2023-06-01,397449,1,1,2,1,1,2
2023-06-01,394737,4,17,21,1,1,1
2023-06-01,36260,1,0,1,2,0,2
2023-06-01,397986,8,0,8,2,0,2
2023-06-01,13499,14,0,14,10,0,10
2023-06-01,20061,4,2,6,1,1,1
2023-06-01,63324,1,0,1,1,0,1
2023-06-01,399041,1,0,1,2,0,2
2023-06-01,394277,4,1,5,1,1,1
2023-06-01,63389,1,0,1,3,0,3
2023-06-01,393460,7,0,7,4,0,4
2023-06-01,393496,3,0,3,2,0,2
2023-06-01,13583,1,0,1,4,0,4
2023-06-01,396252,1,0,1,1,0,1
2023-06-01,400287,1,0,1,2,0,2
2023-06-01,46555,16,0,16,4,0,4
2023-06-01,46867,14,0,14,4,0,4
2023-06-01,15190,3,0,3,6,0,6
2023-06-01,395508,2,0,2,1,0,1
2023-06-01,53594,4,0,4,6,0,6
2023-06-01,393464,2,0,2,2,0,2
2023-06-01,63428,2,0,2,2,0,2
2023-06-01,26779,5,0,5,4,0,4
2023-06-01,26197,4,1,5,1,1,1
2023-06-01,36121,2,0,2,1,0,1
2023-06-01,63486,3,0,3,1,0,1
2023-06-01,37526,12,0,12,1,0,1
2023-06-01,37697,3,1,4,10,3,11
2023-06-01,37489,3,0,3,3,0,3
2023-06-01,37487,1,0,1,1,0,1
2023-06-01,56173,25,6,31,1,1,1
2023-06-01,38365,115,11,126,6,6,8
2023-06-01,140345,26,204,230,1,17,17
2023-06-01,141679,9,3,12,1,1,1
2023-06-01,23675,13,0,13,2,0,2
2023-06-01,131586,4,1,5,2,1,2
2023-06-01,138169,7,6,13,1,1,1
2023-06-01,134419,47,39,86,1,1,1
2023-06-01,148969,2,4,6,1,1,1
2023-06-01,149837,1,4,5,1,1,1
2023-06-01,131819,3,0,3,2,0,2
2023-06-01,17834,8,0,8,3,0,3
2023-06-01,9959,17,0,17,5,0,5
2023-06-01,10309,12,0,12,3,0,3
2023-06-01,20190,1,0,1,1,0,1
2023-06-01,29855,2,0,2,3,0,3
2023-06-01,29865,1,0,1,1,0,1
2023-06-01,13510,2,0,2,3,0,3
2023-06-01,40857,4,0,4,3,0,3
2023-06-01,32801,1,0,1,1,0,1
2023-06-01,19572,3,0,3,3,0,3
2023-06-01,21792,1,0,1,2,0,2
2023-06-01,19944,2,0,2,2,0,2
2023-06-01,54515,1,0,1,2,0,2
2023-06-01,14787,4,0,4,3,0,3
2023-06-01,54542,3,0,3,1,0,1
2023-06-01,25724,1,0,1,1,0,1
2023-06-01,399421,1,0,1,1,0,1
2023-06-01,27289,2,0,2,1,0,1
2023-06-01,395911,4,0,4,2,0,2
2023-06-01,54423,1,0,1,1,0,1
2023-06-01,27291,1,0,1,1,0,1
2023-06-01,54493,1,0,1,1,0,1
2023-06-01,54737,1,0,1,1,0,1
2023-06-01,36124,6,0,6,3,0,3
2023-06-01,62796,1,0,1,1,0,1
2023-06-01,64011,9,27,36,2,1,2
2023-06-01,13965,3,2,5,2,2,2
2023-06-01,40642,2,0,2,2,0,2
2023-06-01,2732,3,1,4,2,2,2
2023-06-01,1830,2,0,2,3,0,3
2023-06-01,60924,25,3,28,15,9,16
2023-06-01,39962,8,1,9,3,1,3
2023-06-01,399554,2,1,3,2,1,2
2023-06-01,33294,3,0,3,2,0,2
2023-06-01,396934,1,0,1,3,0,3
2023-06-01,398771,2,0,2,4,0,4
2023-06-01,53406,1,0,1,1,0,1
2023-06-01,63014,1,0,1,5,0,5
2023-06-01,19903,11,0,11,1,0,1
2023-06-01,400309,3,0,3,3,0,3
2023-06-01,18549,2,0,2,1,0,1
2023-06-01,20118,1,0,1,1,0,1
2023-06-01,30438,2,1,3,2,1,2
2023-06-01,13844,1,0,1,3,0,3
2023-06-01,11070,16,0,16,1,0,1
2023-06-01,19799,5,0,5,1,0,1
2023-06-01,396004,4,0,4,1,0,1
2023-06-01,398252,3,0,3,2,0,2
2023-06-01,393856,41,0,41,3,0,3
2023-06-01,21921,2,0,2,2,0,2
2023-06-01,398073,2,0,2,1,0,1
2023-06-01,396348,1,0,1,2,0,2
2023-06-01,206695,1,0,1,1,0,1
2023-06-01,397850,1,0,1,1,0,1
2023-06-01,1087,1,0,1,1,0,1
2023-06-01,398313,1,0,1,2,0,2
2023-06-01,398414,1,0,1,1,0,1
2023-06-01,23317,4,0,4,1,0,1
2023-06-01,53940,2,0,2,2,0,2
2023-06-01,12060,1,0,1,1,0,1
2023-06-01,46701,4,1,5,3,1,3
2023-06-01,13953,1,1,2,2,1,2
2023-06-01,33515,2,0,2,2,0,2
2023-06-01,13909,5,0,5,2,0,2
2023-06-01,53782,3,0,3,4,0,4
2023-06-01,54044,12,1,13,5,1,5
2023-06-01,396447,6,0,6,2,0,2
2023-06-01,1631,2,0,2,2,0,2
2023-06-01,63368,7,0,7,1,0,1
2023-06-01,26427,3,0,3,3,0,3
2023-06-01,395831,43,14,57,6,8,8
2023-06-01,19413,10,1,11,1,1,1
2023-06-01,394855,3,2,5,2,2,2
2023-06-01,54084,1,0,1,2,0,2
2023-06-01,22282,9,0,9,4,0,4
2023-06-01,33425,17,0,17,7,0,7
2023-06-01,65532,8,0,8,1,0,1
2023-06-01,23476,2,0,2,1,0,1
2023-06-01,400860,1,0,1,1,0,1
2023-06-01,272605,1,18,19,1,1,1
2023-06-01,14413,12,9,21,6,5,6
2023-06-01,55163,3,1,4,1,1,1
2023-06-01,40793,3,1,4,1,1,1
2023-06-01,549,7,2,9,23,6,23
2023-06-01,11851,1,0,1,3,0,3
2023-06-01,18577,6,0,6,2,0,2
2023-06-01,40773,5,1,6,4,1,4
2023-06-01,32431,1,0,1,2,0,2
2023-06-01,27371,1,0,1,1,0,1
2023-06-01,62345,1,0,1,2,0,2
2023-06-01,49733,1,0,1,3,0,3
2023-06-01,8226,3,1,4,1,2,2
2023-06-01,196655,4,1,5,2,2,2
2023-06-01,39250,1,0,1,1,0,1
2023-06-01,34246,5,0,5,3,0,3
2023-06-01,49845,1,0,1,1,0,1
2023-06-01,203270,1,0,1,1,0,1
2023-06-01,38912,1,0,1,1,0,1
2023-06-01,200630,1,0,1,3,0,3
2023-06-01,50031,1,1,2,3,4,4
2023-06-01,56900,1,0,1,1,0,1
2023-06-01,198017,1,0,1,1,0,1
2023-06-01,49942,1,0,1,1,0,1
2023-06-01,60274,4,0,4,5,0,5
2023-06-01,39221,3,2,5,3,2,3
2023-06-01,196815,1,0,1,1,0,1
2023-06-01,209611,2,0,2,1,0,1
2023-06-01,50217,1,1,2,1,1,1
2023-06-01,208323,1,1,2,2,2,2
2023-06-01,24725,4,4,8,5,4,7
2023-06-01,29067,6,7,13,7,9,11
2023-06-01,59747,0,1,1,7,3,7
2023-06-01,15887,8,0,8,2,0,2
2023-06-01,50170,3,0,3,1,0,1
2023-06-01,25358,4,1,5,7,2,7
2023-06-01,200359,3,0,3,1,0,1
2023-06-01,213053,2,0,2,1,0,1
2023-06-01,212302,1,1,2,1,1,1
2023-06-01,196847,2,0,2,1,0,1
2023-06-01,197079,3,0,3,1,0,1
2023-06-01,209609,1,0,1,1,0,1
2023-06-01,39602,3,1,4,2,1,2
2023-06-01,50202,4,0,4,3,0,3
2023-06-01,212610,2,0,2,3,0,3
2023-06-01,50307,1,1,2,1,1,1
2023-06-01,47260,1,0,1,1,0,1
2023-06-01,50163,1,1,2,3,1,3
2023-06-01,31572,6,0,6,6,0,6
2023-06-01,196956,1,0,1,2,0,2
2023-06-01,201336,5,0,5,3,0,3
2023-06-01,49767,2,1,3,1,1,1
2023-06-01,198972,7,0,7,2,0,2
2023-06-01,8328,7,1,8,6,4,6
2023-06-01,49823,10,0,10,10,0,10
2023-06-01,49863,5,0,5,5,0,5
2023-06-01,50040,2,0,2,2,0,2
2023-06-01,210298,1,0,1,1,0,1
2023-06-01,210309,1,0,1,2,0,2
2023-06-01,47706,4,0,4,2,0,2
2023-06-01,203883,1,0,1,4,0,4
2023-06-01,196843,2,1,3,6,1,7
2023-06-01,51336,22,0,22,5,0,5
2023-06-01,204179,1,1,2,3,2,3
2023-06-01,206874,8,0,8,3,0,3
2023-06-01,41976,17,0,17,2,0,2
2023-06-01,8478,2,1,3,4,1,4
2023-06-01,50975,1,0,1,3,0,3
2023-06-01,197834,6,0,6,1,0,1
2023-06-01,48887,23,2,25,3,1,3
2023-06-01,47139,25,0,25,2,0,2
2023-06-01,59931,20,0,20,1,0,1
2023-06-01,34331,1,0,1,1,0,1
2023-06-01,213306,5,0,5,9,0,9
2023-06-01,206580,2,0,2,2,0,2
2023-06-01,198371,13,8,21,5,1,5
2023-06-01,206034,1,0,1,1,0,1
2023-06-01,204753,1,0,1,1,0,1
2023-06-01,50063,3,0,3,1,0,1
2023-06-01,39060,3,0,3,1,0,1
2023-06-01,49099,2,0,2,1,0,1
2023-06-01,50086,7,0,7,4,0,4
2023-06-01,204332,4,0,4,5,0,5
2023-06-01,50259,1,0,1,1,0,1
2023-06-01,50269,4,0,4,2,0,2
2023-06-01,42511,4,0,4,3,0,3
2023-06-01,50342,8,0,8,2,0,2
2023-06-01,43661,2,0,2,1,0,1
2023-06-01,50365,5,0,5,6,0,6
2023-06-01,32614,8,1,9,4,1,4
2023-06-01,50366,5,0,5,1,0,1
2023-06-01,212176,1,0,1,3,0,3
2023-06-01,48896,3,1,4,6,2,6
2023-06-01,196891,2,0,2,1,0,1
2023-06-01,50419,1,1,2,1,1,1
2023-06-01,50442,4,0,4,1,0,1
2023-06-01,50471,1,0,1,3,0,3
2023-06-01,60706,6,3,9,3,1,3
2023-06-01,39590,1,0,1,1,0,1
2023-06-01,51497,5,0,5,2,0,2
2023-06-01,49614,1,0,1,1,0,1
2023-06-01,60588,8,0,8,1,0,1
2023-06-01,50977,6,0,6,8,0,8
2023-06-01,210592,1,0,1,1,0,1
2023-06-01,210483,1,1,2,3,3,3
2023-06-01,210602,3,0,3,1,0,1
2023-06-01,210598,1,0,1,1,0,1
2023-06-01,210511,2,0,2,1,0,1
2023-06-01,212756,1,0,1,1,0,1
2023-06-01,207548,1,0,1,2,0,2
2023-06-01,203968,2,1,3,7,6,8
2023-06-01,50530,15,0,15,1,0,1
2023-06-01,209362,1,0,1,1,0,1
2023-06-01,8628,1,0,1,1,0,1
2023-06-01,209156,1,0,1,1,0,1
2023-06-01,41292,1,0,1,2,0,2
2023-06-01,21415,10,0,10,2,0,2
2023-06-01,49872,2,0,2,1,0,1
2023-06-01,39368,10,0,10,1,0,1
2023-06-01,200586,1,1,2,1,1,1
2023-06-01,210703,1,0,1,1,0,1
2023-06-01,199297,1,0,1,1,0,1
2023-06-01,61248,2,0,2,1,0,1
2023-06-01,58056,1,0,1,6,0,6
2023-06-01,15751,7,1,8,1,1,1
2023-06-01,203567,2,0,2,1,0,1
2023-06-01,204210,2,3,5,2,4,4
2023-06-01,50013,4,0,4,2,0,2
2023-06-01,47849,3,0,3,1,0,1
2023-06-01,51420,16,0,16,3,0,3
2023-06-01,201515,1,0,1,2,0,2
2023-06-01,60913,1,0,1,2,0,2
2023-06-01,199658,1,0,1,2,0,2
2023-06-01,25108,5,1,6,5,1,5
2023-06-01,50999,5,4,9,6,3,6
2023-06-01,35540,2,1,3,1,1,1
2023-06-01,50239,1,0,1,3,0,3
2023-06-01,50240,1,0,1,1,0,1
2023-06-01,210246,6,0,6,4,0,4
2023-06-01,50383,1,0,1,1,0,1
2023-06-01,38971,2,0,2,4,0,4
2023-06-01,50439,3,0,3,2,0,2
2023-06-01,50672,1,0,1,3,0,3
2023-06-01,208041,5,3,8,2,2,2
2023-06-01,207287,1,0,1,1,0,1
2023-06-01,50771,1,0,1,6,0,6
2023-06-01,50600,1,0,1,2,0,2
2023-06-01,50604,1,0,1,1,0,1
2023-06-01,50661,5,0,5,6,0,6
2023-06-01,50620,2,1,3,4,3,4
2023-06-01,50760,1,0,1,1,0,1
2023-06-01,50639,9,0,9,1,0,1
2023-06-01,50732,1,0,1,1,0,1
2023-06-01,199543,2,0,2,3,0,3
2023-06-01,199105,1,0,1,1,0,1
2023-06-01,197738,3,0,3,2,0,2
2023-06-01,198277,8,0,8,4,0,4
2023-06-01,25526,3,1,4,2,1,2
2023-06-01,50698,9,3,12,7,6,8
2023-06-01,198213,8,0,8,6,0,6
2023-06-01,25096,1,0,1,1,0,1
2023-06-01,39544,4,0,4,1,0,1
2023-06-01,202236,3,1,4,1,1,1
2023-06-01,202246,2,9,11,2,2,2
2023-06-01,206460,19,0,19,6,0,6
2023-06-01,50602,1,0,1,1,0,1
2023-06-01,50537,9,1,10,2,1,2
2023-06-01,20545,21,1,22,4,1,4
2023-06-01,47575,1,0,1,2,0,2
2023-06-01,29289,1,0,1,1,0,1
2023-06-01,204286,1,0,1,1,0,1
2023-06-01,50568,1,0,1,2,0,2
2023-06-01,20877,1,0,1,1,0,1
2023-06-01,28699,1,0,1,1,0,1
2023-06-01,196961,5,0,5,1,0,1
2023-06-01,48539,5,0,5,1,0,1
2023-06-01,34529,1,0,1,3,0,3
2023-06-01,202477,1,0,1,1,0,1
2023-06-01,57428,3,0,3,2,0,2
2023-06-01,41951,13,0,13,4,0,4
2023-06-01,50610,1,0,1,3,0,3
2023-06-01,199665,1,1,2,4,3,4
2023-06-01,203353,1,0,1,3,0,3
2023-06-01,196943,1,1,2,1,1,1
2023-06-01,64426,2,0,2,3,0,3
2023-06-01,25264,8,0,8,2,0,2
2023-06-01,196747,7,0,7,1,0,1
2023-06-01,196903,1,0,1,2,0,2
2023-06-01,210295,1,0,1,1,0,1
2023-06-01,200680,2,0,2,3,0,3
2023-06-01,210301,2,0,2,2,0,2
2023-06-01,196740,16,0,16,3,0,3
2023-06-01,196786,1,0,1,1,0,1
2023-06-01,197197,1,1,2,4,1,4
2023-06-01,61028,1,0,1,1,0,1
2023-06-01,60980,1,0,1,1,0,1
2023-06-01,51997,10,0,10,1,0,1
2023-06-01,200634,1,0,1,4,0,4
2023-06-01,34771,33,0,33,1,0,1
2023-06-01,50591,11,0,11,1,0,1
2023-06-01,44882,3,1,4,4,3,7
2023-06-01,61296,2,1,3,5,2,5
2023-06-01,51457,4,0,4,1,0,1
2023-06-01,8477,9,0,9,1,0,1
2023-06-01,197095,1,0,1,2,0,2
2023-06-01,196865,5,0,5,2,0,2
2023-06-01,196684,1,0,1,1,0,1
2023-06-01,201225,3,0,3,4,0,4
2023-06-01,50287,2,1,3,4,1,4
2023-06-01,50234,1,0,1,3,0,3
2023-06-01,50235,5,0,5,3,0,3
2023-06-01,60968,1,0,1,3,0,3
2023-06-01,57810,1,0,1,2,0,2
2023-06-01,15478,1,0,1,1,0,1
2023-06-01,51464,5,0,5,4,0,4
2023-06-01,50270,3,2,5,2,2,2
2023-06-01,56474,14,0,14,7,0,7
2023-06-01,212694,2,1,3,6,3,6
2023-06-01,50301,3,0,3,1,0,1
2023-06-01,196873,1,0,1,1,0,1
2023-06-01,196874,14,0,14,2,0,2
2023-06-01,196892,9,0,9,3,0,3
2023-06-01,58082,2,0,2,7,0,7
2023-06-01,50332,1,1,2,1,1,1
2023-06-01,50343,7,3,10,2,1,2
2023-06-01,50348,1,1,2,3,1,3
2023-06-01,51056,2,0,2,3,0,3
2023-06-01,42002,3,0,3,1,0,1
2023-06-01,41578,1,0,1,2,0,2
2023-06-01,59916,1,0,1,3,0,3
2023-06-01,50367,2,0,2,2,0,2
2023-06-01,196894,1,0,1,1,0,1
2023-06-01,50768,1,0,1,1,0,1
2023-06-01,50417,1,0,1,2,0,2
2023-06-01,204884,2,0,2,2,0,2
2023-06-01,212462,5,0,5,1,0,1
2023-06-01,205086,5,0,5,2,0,2
2023-06-01,56551,1,0,1,2,0,2
2023-06-01,28863,5,0,5,1,0,1
2023-06-01,44335,5,1,6,1,1,1
2023-06-01,200059,2,1,3,1,1,1
2023-06-01,9202,3,0,3,3,0,3
2023-06-01,50484,1,0,1,1,0,1
2023-06-01,8747,1,0,1,1,0,1
2023-06-01,51607,2,0,2,1,0,1
2023-06-01,42726,9,0,9,3,0,3
2023-06-01,31183,1,0,1,2,0,2
2023-06-01,198819,1,0,1,2,0,2
2023-06-01,211567,6,0,6,1,0,1
2023-06-01,39604,3,0,3,3,0,3
2023-06-01,211391,3,0,3,4,0,4
2023-06-01,50314,7,0,7,5,0,5
2023-06-01,46354,3,0,3,3,0,3
2023-06-01,198960,1,0,1,1,0,1
2023-06-01,198350,1,0,1,3,0,3
2023-06-01,50691,2,0,2,3,0,3
2023-06-01,51238,1,0,1,3,0,3
2023-06-01,50753,1,0,1,3,0,3
2023-06-01,60513,1,0,1,3,0,3
2023-06-01,50443,1,0,1,3,0,3
2023-06-01,199811,6,2,8,5,4,5
2023-06-01,202306,1,1,2,2,3,4
2023-06-01,50449,2,0,2,2,0,2
2023-06-01,48574,3,0,3,1,0,1
2023-06-01,43510,16,0,16,2,0,2
2023-06-01,34949,63,0,63,2,0,2
2023-06-01,39286,4,0,4,2,0,2
2023-06-01,212712,1,0,1,1,0,1
2023-06-01,207532,2,0,2,4,0,4
2023-06-01,210195,1,0,1,1,0,1
2023-06-01,209078,2,0,2,1,0,1
2023-06-01,207387,1,0,1,3,0,3
2023-06-01,202873,1,0,1,1,0,1
2023-06-01,202963,2,0,2,1,0,1
2023-06-01,203002,1,0,1,1,0,1
2023-06-01,201497,1,0,1,1,0,1
2023-06-01,200204,1,0,1,1,0,1
2023-06-01,41500,1,0,1,1,0,1
2023-06-01,209343,2,0,2,3,0,3
2023-06-01,209546,1,0,1,1,0,1
2023-06-01,209751,1,0,1,1,0,1
2023-06-01,60567,6,2,8,1,1,1
2023-06-01,8200,14,0,14,3,0,3
2023-06-01,15868,4,0,4,3,0,3
2023-06-01,200466,1,0,1,1,0,1
2023-06-01,200722,1,0,1,3,0,3
2023-06-01,51011,3,1,4,4,2,4
2023-06-01,51267,1,0,1,3,0,3
2023-06-01,202764,2,0,2,1,0,1
2023-06-01,205646,1,0,1,2,0,2
2023-06-01,200803,1,0,1,2,0,2
2023-06-01,49490,2,2,4,5,4,5
2023-06-01,201009,1,0,1,3,0,3
2023-06-01,201131,1,0,1,2,0,2
2023-06-01,200734,1,0,1,3,0,3
2023-06-01,51084,1,0,1,1,0,1
2023-06-01,201297,1,0,1,2,0,2
2023-06-01,201296,2,1,3,1,1,1
2023-06-01,44834,4,0,4,1,0,1
2023-06-01,201496,1,0,1,1,0,1
2023-06-01,9426,84,0,84,4,0,4
2023-06-01,23791,6,1,7,1,1,1
2023-06-01,17994,1,0,1,1,0,1
2023-06-01,9757,63,0,63,2,0,2
2023-06-01,24175,12,1,13,3,3,3
2023-06-01,45546,7,0,7,4,0,4
2023-06-01,59011,10,0,10,1,0,1
2023-06-01,56504,3,2,5,4,2,4
2023-06-01,64067,1,0,1,4,0,4
2023-06-01,400609,1,0,1,2,0,2
2023-06-01,131174,1,0,1,1,0,1
2023-06-01,24206,8,4,12,1,3,4
2023-06-01,134162,2,0,2,1,0,1
2023-06-01,150124,1,0,1,1,0,1
2023-06-01,137919,2,0,2,2,0,2
2023-06-01,140706,2,0,2,1,0,1
2023-06-01,45254,3,0,3,3,0,3
2023-06-01,7654,25,1,26,4,1,4
2023-06-01,17427,2,0,2,3,0,3
2023-06-01,45781,6,4,10,1,1,1
2023-06-01,17648,20,1,21,3,1,3
2023-06-01,7682,6,1,7,9,3,11
2023-06-01,45113,5,0,5,1,0,1
2023-06-01,7622,1,0,1,1,0,1
2023-06-01,45991,5,1,6,1,1,1
2023-06-01,45752,9,0,9,1,0,1
2023-06-01,45742,7,0,7,2,0,2
2023-06-01,135398,5,0,5,1,0,1
2023-06-01,131089,1,0,1,1,0,1
2023-06-01,38228,3,2,5,3,1,3
2023-06-01,38652,1,1,2,2,2,2
2023-06-01,134974,7,0,7,3,0,3
2023-06-01,17845,17,0,17,2,0,2
2023-06-01,56277,2,0,2,3,0,3
2023-06-01,132493,2,0,2,2,0,2
2023-06-01,45807,3,0,3,4,0,4
2023-06-01,55451,5,3,8,3,2,3
2023-06-01,132225,17,0,17,1,0,1
2023-06-01,134438,2,0,2,3,0,3
2023-06-01,24344,3,0,3,1,0,1
2023-06-01,133907,2,0,2,1,0,1
2023-06-01,132605,1,0,1,1,0,1
2023-06-01,134095,3,0,3,3,0,3
2023-06-01,132821,2,0,2,3,0,3
2023-06-01,133761,2,1,3,3,1,3
2023-06-01,132545,2,0,2,2,0,2
2023-06-01,9339,2,0,2,2,0,2
2023-06-01,134682,2,0,2,3,0,3
2023-06-01,133376,2,0,2,3,0,3
2023-06-01,55476,4,3,7,4,2,4
2023-06-01,133529,2,0,2,3,0,3
2023-06-01,7664,2,1,3,3,2,3
2023-06-01,24548,1,0,1,1,0,1
2023-06-01,140265,33,122,155,1,1,1
2023-06-01,140276,45,4,49,1,1,1
2023-06-01,140279,44,0,44,1,0,1
2023-06-01,65534,4,2,6,1,2,3
2023-06-01,58444,1,0,1,1,0,1
2023-06-01,18120,4,0,4,4,0,4
2023-06-01,45744,3,0,3,1,0,1
2023-06-01,64093,3,0,3,2,0,2
2023-06-01,17667,2,0,2,3,0,3
2023-06-01,140105,14,11,25,1,1,1
2023-06-01,45894,29,2,31,2,1,2
2023-06-01,55691,3,0,3,2,0,2
2023-06-01,45348,6,0,6,1,0,1
2023-06-01,59348,4,0,4,1,0,1
2023-06-01,45622,11,0,11,2,0,2
2023-06-01,17724,15,0,15,1,0,1
2023-06-01,38616,23,0,23,3,0,3
2023-06-01,23639,13,1,14,3,3,3
2023-06-01,55673,3,0,3,2,0,2
2023-06-01,24507,9,0,9,8,0,8
2023-06-01,38342,7,1,8,2,1,2
2023-06-01,133717,1,0,1,1,0,1
2023-06-01,138982,10,4,14,1,1,1
2023-06-01,131285,5,24,29,1,15,15
2023-06-01,45396,3,1,4,4,2,4
2023-06-01,46044,4,1,5,1,1,1
2023-06-01,134181,2,0,2,1,0,1
2023-06-01,38580,5,0,5,3,0,3
2023-06-01,58448,4,8,12,2,1,2
2023-06-01,58536,8,5,13,5,2,7
2023-06-01,19174,9,0,9,4,0,4
2023-06-01,58811,6,4,10,3,1,3
2023-06-01,45539,9,0,9,1,0,1
2023-06-01,131804,1,0,1,2,0,2
2023-06-01,45593,1,0,1,3,0,3
2023-06-01,38482,86,0,86,1,0,1
2023-06-01,17897,14,5,19,1,1,1
2023-06-01,45985,31,0,31,1,0,1
2023-06-01,38224,26,0,26,1,0,1
2023-06-01,45761,13,0,13,3,0,3
2023-06-01,45542,15,0,15,2,0,2
2023-06-01,4202202305,0,0,0,3,0,3
2023-06-01,4202202331,1,0,1,1,0,1
2023-06-01,18401,23,0,23,3,0,3
2023-06-01,45708,8,0,8,4,0,4
2023-06-01,46000,2,0,2,2,0,2
2023-06-01,45993,2,0,2,2,0,2
2023-06-01,45391,2,0,2,2,0,2
2023-06-01,45403,31,0,31,1,0,1
2023-06-01,139350,2,0,2,2,0,2
2023-06-01,64254,0,0,0,1,0,1
2023-06-01,4797,9,0,9,5,0,5
2023-06-01,131212,1,0,1,1,0,1
2023-06-01,24081,4,0,4,3,0,3
2023-06-01,132206,4,0,4,2,0,2
2023-06-01,38103,11,0,11,1,0,1
2023-06-01,17416,6,1,7,2,2,2
2023-06-01,17885,129,0,129,3,0,3
2023-06-01,10059,0,0,0,2,0,2
2023-06-01,18228,2,1,3,1,1,1
2023-06-01,45457,2,0,2,1,0,1
2023-06-01,55951,4,1,5,4,1,4
2023-06-01,137693,172,16,188,1,16,16
2023-06-01,45461,4,1,5,1,1,1
2023-06-01,45716,6,0,6,2,0,2
2023-06-01,131600,12,4,16,1,1,1
2023-06-01,24133,0,0,0,5,0,5
2023-06-01,38642,1,0,1,2,0,2
2023-06-01,45496,1,0,1,5,0,5
2023-06-01,393467,5,0,5,3,0,3
2023-06-01,45486,1,0,1,2,0,2
2023-06-01,45505,2,0,2,1,0,1
2023-06-01,138378,2,0,2,1,0,1
2023-06-01,45224,60,2,62,2,2,3
2023-06-01,38294,1,0,1,3,0,3
2023-06-01,55956,2,0,2,2,0,2
2023-06-01,24424,19,5,24,3,2,4
2023-06-01,38260,15,0,15,5,0,5
2023-06-01,55622,14,0,14,2,0,2
2023-06-01,18158,9,0,9,3,0,3
2023-06-01,18026,17,0,17,4,0,4
2023-06-01,18176,53,0,53,1,0,1
2023-06-01,55626,13,0,13,3,0,3
2023-06-01,9870,50,0,50,1,0,1
2023-06-01,17950,2,0,2,3,0,3
2023-06-01,24147,20,0,20,2,0,2
2023-06-01,63838,11,8,19,1,1,1
2023-06-01,141739,9,0,9,1,0,1
2023-06-01,131660,4,4,8,3,3,3
2023-06-01,10126,10,2,12,1,1,1
2023-06-01,132158,1,2,3,1,1,2
2023-06-01,38766,7,1,8,2,1,2
2023-06-01,17741,2,0,2,1,0,1
2023-06-01,45219,7,0,7,3,0,3
2023-06-01,56282,4,0,4,2,0,2
2023-06-01,24276,6,0,6,1,0,1
2023-06-01,45379,7,0,7,3,0,3
2023-06-01,10053,20,0,20,2,0,2
2023-06-01,9962,19,0,19,2,0,2
2023-06-01,10088,82,0,82,3,0,3
2023-06-01,131822,51,0,51,1,0,1
2023-06-01,17862,34,0,34,4,0,4
2023-06-01,18028,16,0,16,3,0,3
2023-06-01,38695,21,0,21,2,0,2
2023-06-01,2563,3,0,3,2,0,2
2023-06-01,9949,25,0,25,3,0,3
2023-06-01,18034,10,0,10,2,0,2
2023-06-01,23569,12,0,12,2,0,2
2023-06-01,9868,13,0,13,3,0,3
2023-06-01,55616,11,0,11,3,0,3
2023-06-01,38105,70,0,70,2,0,2
2023-06-01,9643,3,0,3,2,0,2
2023-06-01,24572,4,1,5,6,4,6
2023-06-01,133107,13,0,13,2,0,2
2023-06-01,133027,2,0,2,1,0,1
2023-06-01,38138,4,2,6,4,1,4
2023-06-01,9892,24,5,29,2,2,2
2023-06-01,58732,3,0,3,1,0,1
2023-06-01,38770,5,0,5,2,0,2
2023-06-01,45280,32,2,34,1,1,1
2023-06-01,133378,3,1,4,3,1,3
2023-06-01,38772,4,0,4,2,0,2
2023-06-01,38773,3,0,3,1,0,1
2023-06-01,17895,54,0,54,6,0,6
2023-06-01,45246,6,0,6,6,0,6
2023-06-01,17671,41,0,41,3,0,3
2023-06-01,24525,18,0,18,1,0,1
2023-06-01,55632,18,0,18,1,0,1
2023-06-01,24349,8,1,9,1,2,3
2023-06-01,55927,1,0,1,3,0,3
2023-06-01,37897,2,1,3,1,1,1
2023-06-01,134933,2,1,3,1,2,2
2023-06-01,133543,1,8,9,4,1,4
2023-06-01,45276,10,12,22,4,1,4
2023-06-01,146984,1,2,3,1,2,2
2023-06-01,7521,8,1,9,6,4,6
2023-06-01,38644,1,1,2,2,1,2
2023-06-01,131079,1,1,2,1,1,1
2023-06-01,18239,14,1,15,2,1,2
2023-06-01,56060,2,0,2,2,0,2
2023-06-01,38420,4,0,4,3,0,3
2023-06-01,9529,1,0,1,1,0,1
2023-06-01,23972,1,0,1,1,0,1
2023-06-01,9843,4,0,4,2,0,2
2023-06-01,131883,3,0,3,1,0,1
2023-06-01,56123,1,1,2,5,3,5
2023-06-01,7687,286,1,287,5,3,5
2023-06-01,139856,1,0,1,1,0,1
2023-06-01,10195,5,0,5,2,0,2
2023-06-01,9686,8,0,8,4,0,4
2023-06-01,17886,4,2,6,2,1,2
2023-06-01,24353,6,0,6,1,0,1
2023-06-01,24277,4,1,5,2,2,2
2023-06-01,23785,3,0,3,2,0,2
2023-06-01,38547,12,3,15,2,1,2
2023-06-01,58518,4,0,4,1,0,1
2023-06-01,58517,3,0,3,1,0,1
2023-06-01,58520,2,0,2,1,0,1
2023-06-01,137692,17,38,55,1,1,1
2023-06-01,140636,98,62,160,1,1,1
2023-06-01,132029,17,1,18,3,2,3
2023-06-01,10004,10,1,11,5,3,5
2023-06-01,55414,8,0,8,2,0,2
2023-06-01,38710,86,0,86,2,0,2
2023-06-01,45509,1,0,1,1,0,1
2023-06-01,17937,3,1,4,2,1,2
2023-06-01,9593,1,0,1,4,0,4
2023-06-01,55872,24,0,24,3,0,3
2023-06-01,55340,12,5,17,3,1,3
2023-06-01,38488,8,1,9,2,1,2
2023-06-01,138991,5,6,11,1,1,1
2023-06-01,38162,11,0,11,2,0,2
2023-06-01,17445,3,0,3,3,0,3
2023-06-01,30821,7,0,7,3,0,3
2023-06-01,9298,22,0,22,3,0,3
2023-06-01,38363,25,0,25,2,0,2
2023-06-01,38379,9,0,9,3,0,3
2023-06-01,137346,5,1,6,2,1,2
2023-06-01,45212,1,0,1,1,0,1
2023-06-01,7714,6,0,6,3,0,3
2023-06-01,4259840080,2,0,2,2,0,2
2023-06-01,65523,1,0,1,1,0,1
2023-06-01,38577,2,0,2,3,0,3
2023-06-01,23908,24,0,24,5,0,5
2023-06-01,17649,7,1,8,1,1,1
2023-06-01,141013,1,1,2,3,3,3
2023-06-01,45327,8,0,8,1,0,1
2023-06-01,38502,6,0,6,3,0,3
2023-06-01,17817,24,0,24,6,0,6
2023-06-01,132209,4,0,4,2,0,2
2023-06-01,23582,20,0,20,3,0,3
2023-06-01,9323,96,0,96,2,0,2
2023-06-01,38433,2,0,2,2,0,2
2023-06-01,38671,10,0,10,2,0,2
2023-06-01,9948,2,0,2,2,0,2
2023-06-01,45366,7,0,7,2,0,2
2023-06-01,140707,13,10,23,1,1,1
2023-06-01,137539,1,1,2,1,1,1
2023-06-01,45918,4,1,5,2,1,2
2023-06-01,45248,3,0,3,1,0,1
2023-06-01,45785,17,1,18,6,1,6
2023-06-01,4819,1,1,2,1,1,1
2023-06-01,63515,2,7,9,4,4,4
2023-06-01,10081,2,0,2,1,0,1
2023-06-01,136274,1,0,1,1,0,1
2023-06-01,24023,5,2,7,6,2,7
2023-06-01,137699,3,0,3,1,0,1
2023-06-01,45661,9,0,9,4,0,4
2023-06-01,55454,3,1,4,1,1,1
2023-06-01,10023,4,0,4,1,0,1
2023-06-01,149298,1,0,1,1,0,1
2023-06-01,17975,17,0,17,7,0,7
2023-06-01,133214,1,0,1,1,0,1
2023-06-01,59316,1,0,1,1,0,1
2023-06-01,55322,1,0,1,2,0,2
2023-06-01,46030,19,0,19,1,0,1
2023-06-01,38501,2,0,2,1,0,1
2023-06-01,38556,2,0,2,1,0,1
2023-06-01,9785,9,1,10,5,1,6
2023-06-01,131691,5,0,5,1,0,1
2023-06-01,38346,9,0,9,1,0,1
2023-06-01,24134,13,0,13,3,0,3
2023-06-01,9809,37,0,37,6,0,6
2023-06-01,38321,2,0,2,2,0,2
2023-06-01,45941,1,0,1,1,0,1
2023-06-01,24093,19,0,19,2,0,2
2023-06-01,7631,11,0,11,3,0,3
2023-06-01,24129,11,0,11,1,0,1
2023-06-01,9754,16,0,16,1,0,1
2023-06-01,9691,13,0,13,1,0,1
2023-06-01,18329,12,0,12,1,0,1
2023-06-01,23570,59,0,59,2,0,2
2023-06-01,10071,10,0,10,1,0,1
2023-06-01,18320,12,0,12,1,0,1
2023-06-01,18038,13,0,13,2,0,2
2023-06-01,7621,4,0,4,1,0,1
2023-06-01,45843,2,0,2,1,0,1
2023-06-01,17505,20,0,20,2,0,2
2023-06-01,63648,9,0,9,3,0,3
2023-06-01,55745,4,0,4,1,0,1
2023-06-01,133174,1,0,1,1,0,1
2023-06-01,17969,47,0,47,3,0,3
2023-06-01,132437,1,0,1,1,0,1
2023-06-01,146809,1,0,1,1,0,1
2023-06-01,38523,7,0,7,4,0,4
2023-06-01,55895,1,1,2,1,1,1
2023-06-01,23861,6,0,6,1,0,1
2023-06-01,56234,4,0,4,2,0,2
2023-06-01,38248,17,4,21,4,1,4
2023-06-01,45273,4,0,4,4,0,4
2023-06-01,45501,2,2,4,1,1,1
2023-06-01,23879,1,1,2,2,1,2
2023-06-01,10229,22,5,27,3,3,3
2023-06-01,23666,48,0,48,2,0,2
2023-06-01,38720,1,0,1,1,0,1
2023-06-01,38624,2,0,2,5,0,5
2023-06-01,46029,8,0,8,2,0,2
2023-06-01,134496,1,0,1,1,0,1
2023-06-01,206782,2,1,3,2,4,5
2023-06-01,131131,1,1,2,1,1,1
2023-06-01,131122,1,1,2,2,1,2
2023-06-01,131123,1,1,2,2,1,2
2023-06-01,24066,2,2,4,4,3,4
2023-06-01,23962,1,1,2,1,1,1
2023-06-01,138407,37,0,37,1,0,1
2023-06-01,65549,1,0,1,1,0,1
2023-06-01,58649,1,1,2,1,1,1
2023-06-01,135161,22,3,25,3,2,3
2023-06-01,135511,1,0,1,3,2,3
2023-06-01,24395,54,0,54,5,0,5
2023-06-01,18008,5,0,5,2,0,2
2023-06-01,63502,1,0,1,2,0,2
2023-06-01,38743,5,1,6,3,1,3
2023-06-01,6695,0,0,0,2,0,2
2023-06-01,23844,28,1,29,3,1,3
2023-06-01,137412,1,3,4,1,1,1
2023-06-01,18000,18,0,18,3,0,3
2023-06-01,38829,14,0,14,1,0,1
2023-06-01,10159,31,0,31,2,0,2
2023-06-01,10179,4,0,4,2,0,2
2023-06-01,131815,1,0,1,3,0,3
2023-06-01,131811,1,0,1,1,0,1
2023-06-01,9571,2,0,2,2,0,2
2023-06-01,38802,5,0,5,1,0,1
2023-06-01,63673,16,0,16,4,0,4
2023-06-01,38793,22,1,23,2,1,2
2023-06-01,136887,1,0,1,1,0,1
2023-06-01,55419,1,0,1,1,0,1
2023-06-01,55527,1,0,1,3,0,3
2023-06-01,37930,0,0,0,2,0,2
2023-06-01,58581,3,0,3,2,0,2
2023-06-01,132604,2,0,2,3,0,3
2023-06-01,132801,1,0,1,1,0,1
2023-06-01,18257,2,1,3,2,2,2
2023-06-01,59045,12,1,13,2,2,2
2023-06-01,45368,2,0,2,3,0,3
2023-06-01,38255,0,1,1,2,3970,3970
2023-06-01,38272,1,1,2,1,24,24
2023-06-01,24278,2,1,3,2,2,4
2023-06-01,58683,5,2,7,1,1,1
2023-06-01,24530,24,0,24,4,0,4
2023-06-01,137471,4,0,4,1,0,1
2023-06-01,23854,5,0,5,5,0,5
2023-06-01,132912,1,0,1,2,0,2
2023-06-01,38832,5,0,5,5,0,5
2023-06-01,133599,1,0,1,1,0,1
2023-06-01,55393,2,0,2,1,0,1
2023-06-01,38380,1,0,1,2,0,2
2023-06-01,132788,1,0,1,1,0,1
2023-06-01,24216,1,0,1,2,0,2
2023-06-01,38304,2,0,2,2,0,2
2023-06-01,23553,8,0,8,1,0,1
2023-06-01,38372,8,10,18,3,1,3
2023-06-01,38367,1,1,2,1,1,2
2023-06-01,10109,7,0,7,1,0,1
2023-06-01,38375,8,0,8,4,0,4
2023-06-01,131562,41,0,41,1,0,1
2023-06-01,17556,2,6,8,1,1,1
2023-06-01,58692,1,0,1,3,0,3
2023-06-01,55498,3,1,4,2,1,2
2023-06-01,55932,2,0,2,3,0,3
2023-06-01,55844,2,2,4,2,2,3
2023-06-01,55461,51,0,51,1,0,1
2023-06-01,38357,1,0,1,1,0,1
2023-06-01,9621,11,1,12,4,4,5
2023-06-01,23887,8,0,8,3,0,3
2023-06-01,23892,1,0,1,2,0,2
2023-06-01,65128,0,0,0,3,0,3
2023-06-01,65200,2,0,2,2,0,2
2023-06-01,140662,3,0,3,2,0,2
2023-06-01,18218,15,0,15,5,0,5
2023-06-01,9615,10,0,10,5,0,5
2023-06-01,38627,11,0,11,2,0,2
2023-06-01,45669,318,49,367,3,1,3
2023-06-01,24041,1,0,1,1,0,1
2023-06-01,132716,2,0,2,2,0,2
2023-06-01,139040,2,0,2,3,0,3
2023-06-01,134625,0,0,0,3,0,3
2023-06-01,137977,2,0,2,3,0,3
2023-06-01,138691,2,0,2,3,0,3
2023-06-01,45595,7,0,7,1,0,1
2023-06-01,10230,3,1,4,1,1,1
2023-06-01,18293,3,1,4,1,1,1
2023-06-01,38032,3,1,4,1,1,1
2023-06-01,24376,3,1,4,1,1,1
2023-06-01,38033,3,1,4,1,1,1
2023-06-01,23790,2,0,2,1,0,1
2023-06-01,18373,3,0,3,3,0,3
2023-06-01,17859,8,0,8,2,0,2
2023-06-01,10193,2,0,2,3,0,3
2023-06-01,45968,2,0,2,3,0,3
2023-06-01,64957,1,0,1,1,0,1
2023-06-01,45136,1,0,1,1,0,1
2023-06-01,38476,7,0,7,4,0,4
2023-06-01,24427,31,0,31,3,0,3
2023-06-01,23784,8,0,8,1,0,1
2023-06-01,133104,2,1,3,2,1,2
2023-06-01,45148,11,1,12,5,1,5
2023-06-01,137794,0,0,0,2,0,2
2023-06-01,56095,1,0,1,2,0,2
2023-06-01,38445,1,0,1,1,0,1
2023-06-01,23689,4,0,4,3,0,3
2023-06-01,17894,21,1,22,1,1,1
2023-06-01,45832,1,0,1,1,0,1
2023-06-01,38764,8,0,8,5,0,5
2023-06-01,38015,8,0,8,1,0,1
2023-06-01,38174,18,0,18,3,0,3
2023-06-01,38796,4,3,7,1,1,1
2023-06-01,18118,31,0,31,3,0,3
2023-06-01,17977,2,0,2,1,0,1
2023-06-01,24430,56,0,56,3,0,3
2023-06-01,9761,21,0,21,4,0,4
2023-06-01,138654,16,5,21,4,1,4
2023-06-01,17550,2,0,2,2,0,2
2023-06-01,24207,89,0,89,14,0,14
2023-06-01,17717,0,0,0,5,3,5
2023-06-01,1659,52,1,53,2,1,2
2023-06-01,17716,4,0,4,4,0,4
2023-06-01,18185,1,0,1,5,2,5
2023-06-01,131150,5,0,5,1,0,1
2023-06-01,9916,9,1,10,1,1,1
2023-06-01,18047,2,0,2,3,0,3
2023-06-01,139099,14,0,14,1,0,1
2023-06-01,23853,61,2,63,3,2,3
2023-06-01,135887,948,4,952,1,1,1
2023-06-01,10139,198,23,221,2,2,2
2023-06-01,140886,11,1,12,1,1,1
2023-06-01,146998,1,0,1,1,0,1
2023-06-01,58844,1,0,1,1,0,1
2023-06-01,38715,2,0,2,1,0,1
2023-06-01,7625,27,1,28,1,1,1
2023-06-01,18223,4,0,4,2,0,2
2023-06-01,9856,7,0,7,2,0,2
2023-06-01,9322,9,0,9,2,0,2
2023-06-01,38364,27,1,28,1,1,1
2023-06-01,23776,2,1,3,3,3,3
2023-06-01,38761,8,1,9,2,2,2
2023-06-01,133419,9,0,9,1,0,1
2023-06-01,38869,1,0,1,1,0,1
2023-06-01,38491,3,0,3,2,0,2
2023-06-01,55732,4,0,4,1,0,1
2023-06-01,210083,7,13,20,8,6,10
2023-06-01,10040,3,0,3,2,0,2
2023-06-01,38126,2,0,2,2,0,2
2023-06-01,9640,6,0,6,1,0,1
2023-06-01,45401,2,0,2,3,0,3
2023-06-01,38412,4,0,4,1,0,1
2023-06-01,46002,5,0,5,2,0,2
2023-06-01,55630,2,0,2,2,0,2
2023-06-01,131792,1,0,1,3,0,3
2023-06-01,38431,6,0,6,3,0,3
2023-06-01,9778,12,0,12,2,0,2
2023-06-01,38093,1,0,1,1,0,1
2023-06-01,38087,2,0,2,3,0,3
2023-06-01,38696,2,0,2,3,0,3
2023-06-01,18169,5,0,5,2,0,2
2023-06-01,136943,2,2,4,3,1,3
2023-06-01,136987,2,0,2,1,0,1
2023-06-01,24363,32,1,33,1,1,2
2023-06-01,138371,14,0,14,2,0,2
2023-06-01,132553,2,0,2,1,0,1
2023-06-01,24362,16,1,17,1,1,2
2023-06-01,131829,2,0,2,1,0,1
2023-06-01,45989,3,0,3,2,0,2
2023-06-01,38293,10,4,14,3,2,3
2023-06-01,24422,2,0,2,1,0,1
2023-06-01,38522,7,0,7,4,0,4
2023-06-01,55413,1,0,1,1,0,1
2023-06-01,133124,7,4,11,1,1,1
2023-06-01,38191,49,2,51,9,2,9
2023-06-01,45189,9,1,10,2,1,2
2023-06-01,38274,7,0,7,1,0,1
2023-06-01,55316,1,0,1,2,0,2
2023-06-01,63946,1,0,1,1,0,1
2023-06-01,38381,36,1,37,2,1,2
2023-06-01,46045,8,0,8,4,0,4
2023-06-01,150353,2,0,2,1,0,1
2023-06-01,38763,7,0,7,5,0,5
2023-06-01,56037,5,0,5,1,0,1
2023-06-01,24332,6,0,6,3,0,3
2023-06-01,56179,4,0,4,3,0,3
2023-06-01,18396,21,0,21,1,0,1
2023-06-01,17775,89,2,91,3,2,3
2023-06-01,7665,2,1,3,2,1,2
2023-06-01,38398,41,0,41,1,0,1
2023-06-01,24328,2,0,2,2,0,2
2023-06-01,9464,6,2,8,3,1,3
2023-06-01,140618,7,0,7,3,0,3
2023-06-01,38265,2,0,2,2,0,2
2023-06-01,135566,37,4,41,2,2,2
2023-06-01,141692,2,0,2,2,0,2
2023-06-01,38153,16,0,16,3,0,3
2023-06-01,38310,7,0,7,1,0,1
2023-06-01,10083,8,1,9,2,1,3
2023-06-01,18405,1,0,1,1,0,1
2023-06-01,63775,5,0,5,1,0,1
2023-06-01,4352,1,0,1,2,0,2
2023-06-01,141142,1,0,1,1,0,1
2023-06-01,18077,49,1,50,7,1,7
2023-06-01,38286,11,0,11,4,0,4
2023-06-01,56054,12,0,12,3,0,3
2023-06-01,59341,1,0,1,2,0,2
2023-06-01,23876,2,0,2,1,0,1
2023-06-01,45607,1,0,1,1,0,1
2023-06-01,45510,61,0,61,4,0,4
2023-06-01,9889,24,1,25,1,1,1
2023-06-01,135673,5,2,7,1,1,1
2023-06-01,45313,8,0,8,2,0,2
2023-06-01,38441,1,0,1,1,0,1
2023-06-01,38468,11,0,11,3,0,3
2023-06-01,38471,5,0,5,1,0,1
2023-06-01,45282,6,0,6,3,0,3
2023-06-01,56015,4,0,4,3,0,3
2023-06-01,38334,1,0,1,3,0,3
2023-06-01,38494,1,0,1,1,0,1
2023-06-01,18094,4,0,4,3,0,3
2023-06-01,137536,1,0,1,1,0,1
2023-06-01,17590,7,0,7,2,0,2
2023-06-01,38429,1,0,1,2,0,2
2023-06-01,133841,6,0,6,1,0,1
2023-06-01,38450,24,1,25,3,2,3
2023-06-01,38461,10,0,10,2,0,2
2023-06-01,24391,8,0,8,4,0,4
2023-06-01,150297,4,0,4,1,0,1
2023-06-01,38237,1,0,1,1,0,1
2023-06-01,134413,3,1,4,1,1,2
2023-06-01,139399,4,1,5,2,1,2
2023-06-01,139397,4,1,5,2,1,2
2023-06-01,4641,5,2,7,11,7,12
2023-06-01,38748,2,0,2,1,0,1
2023-06-01,38256,16,0,16,3,0,3
2023-06-01,131536,13,0,13,1,0,1
2023-06-01,50601,4,1,5,6,3,8
2023-06-01,23602,1,0,1,1,0,1
2023-06-01,18281,5,1,6,1,1,1
2023-06-01,139867,1,0,1,3,0,3
2023-06-01,141470,7,0,7,2,0,2
2023-06-01,38328,4,1,5,3,2,3
2023-06-01,55344,3,0,3,2,0,2
2023-06-01,9759,6,0,6,2,0,2
2023-06-01,10050,2,0,2,1,0,1
2023-06-01,38416,3,0,3,1,0,1
2023-06-01,38405,4,0,4,1,0,1
2023-06-01,24005,2,2,4,2,2,2
2023-06-01,4290000811,1,0,1,2,0,2
2023-06-01,38805,1,0,1,1,0,1
2023-06-01,18371,37,11,48,2,2,2
2023-06-01,37997,15,0,15,1,0,1
2023-06-01,4202202105,3,0,3,2,0,2
2023-06-01,134140,2,0,2,2,2,2
2023-06-01,64741,0,0,0,2,2,2
2023-06-01,64721,0,0,0,2,2,2
2023-06-01,64555,2,1,3,1,1,1
2023-06-01,63850,25,0,25,6,0,6
2023-06-01,37892,6,1,7,4,3,6
2023-06-01,56011,2,0,2,2,0,2
2023-06-01,17936,5,1,6,1,1,1
2023-06-01,38282,2,0,2,1,0,1
2023-06-01,138802,4,0,4,2,0,2
2023-06-01,38797,16,0,16,3,0,3
2023-06-01,9814,95,0,95,6,0,6
2023-06-01,38388,1,0,1,1,0,1
2023-06-01,45973,1,0,1,1,0,1
2023-06-01,18323,7,0,7,2,0,2
2023-06-01,17584,51,0,51,1,0,1
2023-06-01,10047,4,0,4,1,0,1
2023-06-01,38663,3,0,3,2,0,2
2023-06-01,38301,1,0,1,2,0,2
2023-06-01,38888,4,0,4,2,0,2
2023-06-01,55954,9,0,9,2,0,2
2023-06-01,18242,2,0,2,1,0,1
2023-06-01,24357,23,0,23,1,0,1
2023-06-01,23746,1,0,1,1,0,1
2023-06-01,139656,15,0,15,3,0,3
2023-06-01,23739,1,0,1,1,0,1
2023-06-01,58929,12,0,12,1,0,1
2023-06-01,17668,33,0,33,3,0,3
2023-06-01,56417,1,0,1,2,0,2
2023-06-01,62034,1,0,1,2,0,2
2023-06-01,199265,6,1,7,6,1,7
2023-06-01,60303,1,0,1,1,0,1
2023-06-01,60905,4,2,6,1,1,1
2023-06-01,60993,2,0,2,2,0,2
2023-06-01,60996,1,0,1,1,0,1
2023-06-01,203581,1,0,1,1,0,1
2023-06-01,199827,5,0,5,2,0,2
2023-06-01,29320,2,0,2,2,0,2
2023-06-01,51848,1,0,1,1,0,1
2023-06-01,198654,1,0,1,2,0,2
2023-06-01,203260,4,0,4,2,0,2
2023-06-01,46,8,1,9,7,4,7
2023-06-01,27,7,5,12,1,1,1
2023-06-01,4,44,9,53,8,4,10
2023-06-01,32,4,2,6,2,3,3
2023-06-01,1341,32,1,33,4,3,4
2023-06-01,45,11,1,12,1,1,1
2023-06-01,264,5,0,5,1,0,1
2023-06-01,13429,3,0,3,3,0,3
2023-06-01,27138,153,0,153,3,0,3
2023-06-01,27139,19,0,19,4,0,4
2023-06-01,4021,6,0,6,3,0,3
2023-06-01,27137,22,0,22,3,0,3
2023-06-01,5231,22,0,22,2,0,2
2023-06-01,385,1024,0,1024,4,0,4
2023-06-01,11488,29,1,30,2,1,2
2023-06-01,22,5,2,7,1,1,1
2023-06-01,10879,73,0,73,14,0,14
2023-06-01,29,5,1,6,5,1,5
2023-06-01,37,19,1,20,1,1,1
2023-06-01,302,12,2,14,13,7,13
2023-06-01,2675,51,0,51,6,0,6
2023-06-01,3766,25,0,25,1,0,1
2023-06-01,5972,1942,0,1942,4,0,4
2023-06-01,252,5,1,6,1,1,1
2023-06-01,11293,25,2,27,4,1,4
2023-06-01,396450,0,0,0,8,0,8
2023-06-01,6106,6,2,8,3,2,3
2023-06-01,2936,1,1,2,1,1,1
2023-06-01,72,123,0,123,23,0,23
2023-06-01,14,11,1,12,3,3,4
2023-06-01,48,2,1,3,1,1,1
2023-06-01,18,8,0,8,4,0,4
2023-06-01,13,6,1,7,1,1,1
2023-06-01,44795,1,0,1,1,0,1
2023-06-01,12930,2,1,3,1,1,2
2023-06-01,205084,1,0,1,1,0,1
2023-06-01,1201,23,0,23,4,0,4
2023-06-01,26,6,1,7,4,4,4
2023-06-01,158,85,13,98,3,3,3
2023-06-01,55,6,1,7,6,5,6
2023-06-01,62652,1,0,1,3,0,3
2023-06-01,116,27,0,27,1,0,1
2023-06-01,52,12,2,14,3,2,3
2023-06-01,24775,2,0,2,2,0,2
2023-06-01,239,10,1,11,1,1,1
2023-06-01,217,5,1,6,1,1,1
2023-06-01,297,23,1,24,13,1,13
2023-06-01,270,120,0,120,6,0,6
2023-06-01,17055,19,1,20,1,1,1
2023-06-01,131,6,2,8,2,1,2
2023-06-01,91,7,1,8,3,4,4
2023-06-01,5739,6,2,8,3,2,3
2023-06-01,194,3,1,4,1,1,1
2023-06-01,6192,7,4,11,2,2,2
2023-06-01,3573,158,474,632,43,114,116
2023-06-01,12,10,1,11,6,2,7
2023-06-01,40246,6,0,6,1,0,1
2023-06-01,198240,1,0,1,2,0,2
2023-06-01,201463,5,1,6,4,2,4
2023-06-01,198139,1,0,1,1,0,1
2023-06-01,198129,2,0,2,1,0,1
2023-06-01,198157,2,0,2,1,0,1
2023-06-01,51305,2,1,3,3,1,3
2023-06-01,212494,2,0,2,5,0,5
2023-06-01,200072,5,0,5,2,0,2
2023-06-01,197912,3,0,3,1,0,1
2023-06-01,47555,1,0,1,1,0,1
2023-06-01,204561,3,1,4,3,2,3
2023-06-01,11499,6,0,6,3,0,3
2023-06-01,40289,7,2,9,4,2,5
2023-06-01,679,2,0,2,1,0,1
2023-06-01,45381,3,0,3,2,0,2
2023-06-01,10060,21,0,21,2,0,2
2023-06-01,9321,24,0,24,2,0,2
2023-06-01,9525,1,0,1,1,0,1
2023-06-01,9634,4,0,4,3,0,3
2023-06-01,160,5,2,7,8,3,8
2023-06-01,31839,1,0,1,2,0,2
2023-06-01,393283,3,0,3,2,0,2
2023-06-01,2534,5,4,9,5,3,5
2023-06-01,104,18,2,20,3,1,3
2023-06-01,378,36,1,37,3,2,3
2023-06-01,198111,1,1,2,4,3,4
2023-06-01,34674,15,0,15,2,0,2
2023-06-01,57365,4,0,4,8,0,8
2023-06-01,197973,1,1,2,1,1,1
2023-06-01,225,20,0,20,3,0,3
2023-06-01,15296,68,2,70,33,8,33
2023-06-01,542,12,0,12,2,0,2
2023-06-01,159,7,1,8,2,1,2
2023-06-01,122,11,1,12,4,3,4
2023-06-01,11078,11,1,12,2,1,2
2023-06-01,127,29,3,32,3,2,3
2023-06-01,102,3,1,4,1,1,1
2023-06-01,20,4,1,5,5,5,6
2023-06-01,92,4,1,5,4,3,4
2023-06-01,1843,14,0,14,1,0,1
2023-06-01,1539,32,0,32,3,0,3
2023-06-01,1772,1,0,1,1,0,1
2023-06-01,23162,6,0,6,4,0,4
2023-06-01,396261,1,0,1,1,0,1
2023-06-01,11039,3,2,5,7,3,7
2023-06-01,4901,1,1,2,7,6,7
2023-06-01,68,7,1,8,1,1,1
2023-06-01,16989,9,0,9,2,0,2
2023-06-01,243,75,0,75,3,0,3
2023-06-01,6360,56,1,57,9,9,12
2023-06-01,16643,5,0,5,3,0,3
2023-06-01,7170,2,0,2,3,0,3
2023-06-01,40590,1,0,1,3,0,3
2023-06-01,21534,28,7,35,15,6,16
2023-06-01,32337,6,0,6,6,0,6
2023-06-01,19753,1,0,1,2,0,2
2023-06-01,33321,6,0,6,1,0,1
2023-06-01,19755,6,0,6,2,0,2
2023-06-01,6522,2,0,2,4,0,4
2023-06-01,1206,3,0,3,1,0,1
2023-06-01,1207,3,0,3,1,0,1
2023-06-01,7645,2,1,3,1,1,1
2023-06-01,2553,7,1,8,1,1,1
2023-06-01,6510,1,1,2,2,2,2
2023-06-01,4201,2,1,3,2,2,2
2023-06-01,3794,2,1,3,2,2,2
2023-06-01,299,6,1,7,2,1,2
2023-06-01,1706,21,1,22,2,1,2
2023-06-01,111,12,1,13,6,3,6
2023-06-01,396425,1,0,1,1,0,1
2023-06-01,266603,3,0,3,2,0,2
2023-06-01,271046,6,5,11,4,4,4
2023-06-01,266637,1,0,1,1,0,1
2023-06-01,266604,3,1,4,2,1,2
2023-06-01,265740,1,0,1,2,0,2
2023-06-01,264241,10,6,16,4,3,4
2023-06-01,271058,5,5,10,3,3,4
2023-06-01,266627,2,7,9,2,1,2
2023-06-01,271258,5,5,10,7,7,9
2023-06-01,271579,0,7,7,2,2,2
2023-06-01,271391,4,3,7,1,1,1
2023-06-01,266651,1,1,2,1,2,2
2023-06-01,266616,7,1,8,6,2,6
2023-06-01,266640,4,0,4,3,0,3
2023-06-01,266628,3,1,4,3,1,3
2023-06-01,265477,4,1,5,5,1,5
2023-06-01,271072,7,2,9,6,3,6
2023-06-01,266652,2,1,3,1,1,1
2023-06-01,266634,1,1,2,1,1,1
2023-06-01,266617,7,0,7,3,0,3
2023-06-01,266618,1,1,2,3,1,3
2023-06-01,266620,5,17,22,4,3,4
2023-06-01,265745,1,0,1,1,0,1
2023-06-01,266621,1,1,2,2,1,2
2023-06-01,266646,5,1,6,1,1,1
2023-06-01,266624,6,1,7,1,1,1
2023-06-01,266625,4,0,4,7,0,7
2023-06-01,265771,5,0,5,2,0,2
2023-06-01,265743,4,0,4,1,0,1
2023-06-01,266649,5,3,8,3,3,3
2023-06-01,266629,2,1,3,1,1,1
2023-06-01,265744,3,0,3,3,0,3
2023-06-01,266631,367,3,370,4,2,4
2023-06-01,55082,4,0,4,4,0,4
2023-06-01,266632,3,7,10,1,2,2
2023-06-01,266633,2,0,2,3,0,3
2023-06-01,266635,4,2,6,4,3,4
2023-06-01,265762,4,10,14,2,2,3
2023-06-01,266647,7,1,8,1,1,1
2023-06-01,265746,2,0,2,1,0,1
2023-06-01,271949,1,0,1,1,0,1
2023-06-01,266643,5,1,6,1,1,1
2023-06-01,271186,5,1,6,3,1,3
2023-06-01,266645,2,1,3,2,1,2
2023-06-01,265896,4,1,5,3,1,3
2023-06-01,265886,7,14,21,4,3,4
2023-06-01,265897,1,1,2,2,1,2
2023-06-01,265997,4,1,5,4,2,4
2023-06-01,266648,7,3,10,1,1,1
2023-06-01,265902,2,6,8,1,1,1
2023-06-01,265892,7,1,8,10,4,10
2023-06-01,265303,39,1,40,6,4,8
2023-06-01,271872,4,0,4,1,0,1
2023-06-01,265898,6,0,6,2,0,2
2023-06-01,265934,4,1,5,1,1,1
2023-06-01,28048,14,2,16,3,1,3
2023-06-01,265749,5,1,6,2,1,2
2023-06-01,265906,2,1,3,3,2,3
2023-06-01,53185,31,1,32,6,5,7
2023-06-01,265885,7,1,8,2,1,2
2023-06-01,61732,4,1,5,5,1,5
2023-06-01,265887,3,1,4,2,1,2
2023-06-01,265888,1,1,2,3,2,3
2023-06-01,2579,4,0,4,2,0,2
2023-06-01,2572,40,8,48,16,6,16
2023-06-01,26934,7,2,9,3,1,3
2023-06-01,46832,3,1,4,7,4,7
2023-06-01,397501,10,1,11,1,1,1
2023-06-01,397511,2,2,4,1,1,1
2023-06-01,50,10,1,11,3,1,3
2023-06-01,5723,39,1,40,6,2,6
2023-06-01,3582,5,2,7,3,3,3
2023-06-01,16920,7,4,11,6,5,6
2023-06-01,4190,20,1,21,4,1,4
2023-06-01,31822,12,0,12,5,0,5
2023-06-01,7281,1,0,1,2,0,2
2023-06-01,15046,3,0,3,1,0,1
2023-06-01,15029,0,0,0,5,4,5
2023-06-01,19050,9,3,12,9,7,9
2023-06-01,3527,20,1,21,4,2,4
2023-06-01,26806,7,1,8,11,6,11
2023-06-01,22950,12,1,13,3,1,3
2023-06-01,4246,16,0,16,4,0,4
2023-06-01,54965,1,0,1,1,0,1
2023-06-01,11975,8,0,8,4,0,4
2023-06-01,21778,11,1,12,1,2,2
2023-06-01,1412,2,1,3,1,1,1
2023-06-01,77,4,0,4,5,0,5
2023-06-01,209781,3,0,3,2,0,2
2023-06-01,6200,6,1,7,4,1,4
2023-06-01,400451,1,0,1,1,0,1
2023-06-01,62807,3,0,3,2,0,2
2023-06-01,205848,1,4,5,5,3,5
2023-06-01,1025,1,1,2,3,2,3
2023-06-01,36289,1,1,2,1,1,1
2023-06-01,398888,2,0,2,1,0,1
2023-06-01,211535,1,2,3,1,1,1
2023-06-01,49286,1,3,4,3,4,5
2023-06-01,393769,3,0,3,2,0,2
2023-06-01,55194,4,0,4,2,0,2
2023-06-01,14433,1,0,1,2,0,2
2023-06-01,1906,77,0,77,1,0,1
2023-06-01,11956,0,0,0,5,4,5
2023-06-01,3477,70,16,86,12,8,12
2023-06-01,49,16,4,20,3,3,3
2023-06-01,7276,6,1,7,2,2,2
2023-06-01,2037,2,1,3,1,1,1
2023-06-01,396465,6,2,8,1,1,1
2023-06-01,14852,6,0,6,2,0,2
2023-06-01,36067,10,0,10,1,0,1
2023-06-01,34878,4,3,7,4,4,4
2023-06-01,25776,1,0,1,1,0,1
2023-06-01,2841,8,0,8,1,0,1
2023-06-01,12145,3,0,3,6,0,6
2023-06-01,54669,2,0,2,1,0,1
2023-06-01,31991,1,0,1,1,0,1
2023-06-01,54393,20,0,20,2,0,2
2023-06-01,65,2,0,2,2,0,2
2023-06-01,396212,1,0,1,1,0,1
2023-06-01,393869,2,1,3,2,1,2
2023-06-01,4385,2,1,3,5,4,5
2023-06-01,32666,20,1,21,2,1,2
2023-06-01,36412,0,0,0,8,0,8
2023-06-01,11834,5,0,5,3,0,3
2023-06-01,1113,1,0,1,1,0,1
2023-06-01,14558,1,0,1,1,0,1
2023-06-01,19152,6,0,6,4,0,4
2023-06-01,2140,6,0,6,2,3,3
2023-06-01,12980,23,0,23,11,2,11
2023-06-01,15006,1,0,1,2,0,2
2023-06-01,1747,4,2,6,3,1,3
2023-06-01,14926,2,0,2,3,0,3
2023-06-01,204764,4,0,4,2,0,2
2023-06-01,15776,2,1,3,3,2,3
2023-06-01,60616,1,0,1,3,0,3
2023-06-01,209394,7,0,7,3,0,3
2023-06-01,200138,2,0,2,3,0,3
2023-06-01,39298,2,0,2,1,0,1
2023-06-01,8373,20,4,24,4,2,4
2023-06-01,13232,3,0,3,1,0,1
2023-06-01,37935,1,0,1,1,0,1
2023-06-01,17390,26,21,47,10,7,10
2023-06-01,393850,2,0,2,1,0,1
2023-06-01,14912,2,0,2,2,0,2
2023-06-01,2002,2,0,2,2,0,2
2023-06-01,23257,2,0,2,1,0,1
2023-06-01,26607,21,0,21,2,0,2
2023-06-01,16807,35,3,38,11,3,11
2023-06-01,6150,1,0,1,1,0,1
2023-06-01,394302,1,2,3,2,1,2
2023-06-01,132,11,0,11,1,0,1
2023-06-01,5719,10,1,11,4,3,4
2023-06-01,63,6,0,6,3,0,3
2023-06-01,6406,2,1,3,1,3,3
2023-06-01,7212,4,1,5,3,1,3
2023-06-01,37918,19,1,20,3,1,3
2023-06-01,46905,1,0,1,1,0,1
2023-06-01,10561,4,0,4,5,0,5
2023-06-01,7960,19,1,20,2,1,2
2023-06-01,3464,28,1,29,6,2,6
2023-06-01,14529,1,0,1,1,0,1
2023-06-01,7925,6,0,6,6,0,6
2023-06-01,23361,1,0,1,1,0,1
2023-06-01,2902,4,0,4,1,0,1
2023-06-01,14607,1,1,2,3,3,3
2023-06-01,23719,3,0,3,1,0,1
2023-06-01,87,17,2,19,1,1,1
2023-06-01,82,22,2,24,3,1,3
2023-06-01,98,1,0,1,3,0,3
2023-06-01,26577,18,0,18,5,0,5
2023-06-01,7050,3,1,4,1,1,1
2023-06-01,64102,3,1,4,1,1,1
2023-06-01,63295,10,3,13,2,1,2
2023-06-01,11049,14,9,23,4,2,4
2023-06-01,23859,4,0,4,1,0,1
2023-06-01,11995,4,0,4,4,0,4
2023-06-01,12093,2,1,3,2,2,2
2023-06-01,17324,7,7,14,3,3,3
2023-06-01,10343,5,1,6,3,1,3
2023-06-01,24,1,1,2,6,4,7
2023-06-01,819,19,1,20,12,4,12
2023-06-01,823,10,1,11,2,1,2
2023-06-01,11808,17,0,17,1,0,1
2023-06-01,5707,3,1,4,3,1,3
2023-06-01,18515,1,1,2,3,3,3
2023-06-01,16461,1,0,1,2,0,2
2023-06-01,14373,15,0,15,1,0,1
2023-06-01,20162,1,0,1,4,0,4
2023-06-01,26971,1,0,1,2,0,2
2023-06-01,13998,13,1,14,2,2,2
2023-06-01,32093,2,0,2,3,0,3
2023-06-01,16600,2,0,2,1,0,1
2023-06-01,27594,1,0,1,2,0,2
2023-06-01,3354,16,2,18,1,1,1
2023-06-01,327947,8,0,8,5,0,5
2023-06-01,26046,1,0,1,1,0,1
2023-06-01,3359,4,1,5,3,1,3
2023-06-01,2701,2,0,2,1,0,1
2023-06-01,167,3,0,3,3,0,3
2023-06-01,202414,2,4,6,5,2,5
2023-06-01,206186,2,1,3,6,4,6
2023-06-01,24796,5,8,13,6,3,6
2023-06-01,43268,6,0,6,3,0,3
2023-06-01,52500,1,1,2,5,2,5
2023-06-01,6591,5,1,6,1,1,1
2023-06-01,20126,2,0,2,2,0,2
2023-06-01,17153,4,0,4,2,0,2
2023-06-01,46558,38,13,51,2,2,2
2023-06-01,16474,13,0,13,1,0,1
2023-06-01,43894,16,4,20,2,1,2
2023-06-01,11479,1,0,1,1,0,1
2023-06-01,1701,2,0,2,1,0,1
2023-06-01,372,5,0,5,1,0,1
2023-06-01,10755,1,1,2,4,3,5
2023-06-01,8111,8,3,11,13,9,13
2023-06-01,11279,16,1,17,4,2,4
2023-06-01,2269,7,0,7,1,0,1
2023-06-01,7973,9,0,9,4,0,4
2023-06-01,44320,29,0,29,1,0,1
2023-06-01,24101,2,1,3,1,1,1
2023-06-01,51517,2,0,2,2,0,2
2023-06-01,201479,1,0,1,1,0,1
2023-06-01,89,6,0,6,1,0,1
2023-06-01,28852,6,2,8,1,1,1
2023-06-01,395592,18,2,20,5,4,5
2023-06-01,35605,1,0,1,1,0,1
2023-06-01,8147,11,5,16,1,1,1
2023-06-01,32094,6,1,7,3,1,3
2023-06-01,398364,1,0,1,1,0,1
2023-06-01,134237,3,0,3,3,0,3
2023-06-01,45909,4,0,4,2,0,2
2023-06-01,16435,5,0,5,2,0,2
2023-06-01,37628,22,0,22,6,0,6
2023-06-01,26488,3,0,3,1,0,1
2023-06-01,11363,9,0,9,3,0,3
2023-06-01,2900,9,2,11,3,2,3
2023-06-01,6071,11,0,11,3,0,3
2023-06-01,63593,15,0,15,3,0,3
2023-06-01,7256,35,0,35,4,0,4
2023-06-01,24546,7,0,7,6,0,6
2023-06-01,2535,35,0,35,11,0,11
2023-06-01,15753,20,0,20,6,0,6
2023-06-01,5501,32,7,39,3,3,3
2023-06-01,60824,24,2,26,3,3,3
2023-06-01,200943,17,5,22,3,3,3
2023-06-01,12643,5,2,7,3,3,3
2023-06-01,47610,12,4,16,1,1,1
2023-06-01,28714,2,1,3,3,3,3
2023-06-01,2496,1,1,2,1,1,1
2023-06-01,8036,2,1,3,2,2,2
2023-06-01,166,21,0,21,3,0,3
2023-06-01,7019,2,2,4,1,1,1
2023-06-01,393536,11,0,11,4,0,4
2023-06-01,33045,10,0,10,4,0,4
2023-06-01,22332,22,0,22,10,0,10
2023-06-01,3748,1,0,1,2,0,2
2023-06-01,47309,3,0,3,4,0,4
2023-06-01,33917,3,0,3,1,0,1
2023-06-01,207791,1,1,2,1,1,1
2023-06-01,61097,7,1,8,3,2,3
2023-06-01,207147,20,0,20,1,0,1
2023-06-01,197914,5,1,6,1,1,1
2023-06-01,199237,32,0,32,1,0,1
2023-06-01,22284,230,1,231,9,1,9
2023-06-01,70,64,2,66,2,3,3
2023-06-01,31983,3,0,3,3,0,3
2023-06-01,396926,3,1,4,23,5,23
2023-06-01,10546,5,2,7,1,1,1
2023-06-01,2013,5,0,5,1,0,1
2023-06-01,3428,5,1,6,3,1,3
2023-06-01,3902,4,0,4,1,0,1
2023-06-01,15601,1,0,1,2,0,2
2023-06-01,53434,1,0,1,1,0,1
2023-06-01,21899,8,0,8,3,0,3
2023-06-01,32528,27,0,27,13,0,13
2023-06-01,393514,3,0,3,1,0,1
2023-06-01,19579,1,0,1,1,0,1
2023-06-01,397351,1,0,1,2,0,2
2023-06-01,22191,34,0,34,10,0,10
2023-06-01,84,5,1,6,1,1,1
2023-06-01,3136,10,1,11,2,2,2
2023-06-01,4130,6,2,8,5,5,5
2023-06-01,397353,25,0,25,4,0,4
2023-06-01,14809,1,0,1,1,0,1
2023-06-01,53612,3,2,5,1,1,1
2023-06-01,27465,2,0,2,3,0,3
2023-06-01,11898,3,0,3,3,0,3
2023-06-01,393240,3,0,3,2,0,2
2023-06-01,393386,2,0,2,2,0,2
2023-06-01,398266,2,1,3,2,1,2
2023-06-01,55192,8,0,8,1,0,1
2023-06-01,398370,2,0,2,2,0,2
2023-06-01,36095,2,0,2,1,0,1
2023-06-01,397642,4,0,4,2,0,2
2023-06-01,394899,5,1,6,5,1,5
2023-06-01,19533,1,0,1,1,0,1
2023-06-01,2504,4,0,4,1,0,1
2023-06-01,3782,1,0,1,3,0,3
2023-06-01,802,10,0,10,1,0,1
2023-06-01,13326,1,1,2,4,1,4
2023-06-01,205,2,0,2,2,0,2
2023-06-01,2501,4,2,6,3,1,3
2023-06-01,25656,3,1,4,1,1,1
2023-06-01,10441,6,0,6,2,0,2
2023-06-01,1303,4,0,4,1,0,1
2023-06-01,11131,3,1,4,2,2,3
2023-06-01,2505,4,0,4,3,0,3
2023-06-01,1133,1,1,2,1,1,1
2023-06-01,198551,19,4,23,5,4,5
2023-06-01,12229,7,0,7,5,0,5
2023-06-01,7792,34,0,34,2,0,2
2023-06-01,30,4,0,4,1,0,1
2023-06-01,23237,4,1,5,2,1,2
2023-06-01,6262,22,9,31,1,1,1
2023-06-01,203947,5,0,5,2,0,2
2023-06-01,206870,2,0,2,2,0,2
2023-06-01,63217,5,0,5,4,0,4
2023-06-01,44308,14,0,14,1,0,1
2023-06-01,64456,1,0,1,1,0,1
2023-06-01,328236,5,0,5,1,0,1
2023-06-01,52164,5,0,5,1,0,1
2023-06-01,200108,5,1,6,4,3,4
2023-06-01,199325,5,0,5,4,0,4
2023-06-01,204251,2,1,3,1,2,2
2023-06-01,1842,11,1,12,5,1,5
2023-06-01,26282,2,2,4,1,1,1
2023-06-01,1715,9,0,9,1,0,1
2023-06-01,9433,11,4,15,4,2,4
2023-06-01,12148,4,2,6,3,3,4
2023-06-01,58698,7,1,8,1,1,1
2023-06-01,58588,1,0,1,1,0,1
2023-06-01,22683,18,0,18,9,0,9
2023-06-01,21,12,0,12,6,0,6
2023-06-01,395987,3,0,3,3,0,3
2023-06-01,40267,2,1,3,2,1,2
2023-06-01,37917,3,0,3,2,0,2
2023-06-01,12173,6,0,6,3,0,3
2023-06-01,1128,3,0,3,1,0,1
2023-06-01,43898,6,3,9,9,1,9
2023-06-01,54253,72,117,189,12,11,12
2023-06-01,1261,11,0,11,6,0,6
2023-06-01,4010,36,0,36,1,0,1
2023-06-01,38534,8,0,8,1,0,1
2023-06-01,26020,6,0,6,3,0,3
2023-06-01,3360,4,4,8,2,2,2
2023-06-01,17001,4,0,4,4,0,4
2023-06-01,209522,2,0,2,1,0,1
2023-06-01,10508,1,1,2,1,1,1
2023-06-01,57568,2,0,2,2,0,2
2023-06-01,60949,1,0,1,2,0,2
2023-06-01,210473,1,0,1,1,0,1
2023-06-01,272697,2,1,3,1,1,1
2023-06-01,3275,1,0,1,3,0,3
2023-06-01,399885,2,0,2,3,0,3
2023-06-01,565,1,0,1,1,0,1
2023-06-01,11197,1,0,1,2,0,2
2023-06-01,396310,3,3,6,2,2,2
2023-06-01,200721,1,0,1,1,0,1
2023-06-01,205954,1,0,1,1,0,1
2023-06-01,49553,1,0,1,1,0,1
2023-06-01,205065,1,0,1,1,0,1
2023-06-01,43,4,3,7,1,1,1
2023-06-01,683,41,3,44,2,2,2
2023-06-01,6979,12,0,12,5,0,5
2023-06-01,35039,82,0,82,15,0,15
2023-06-01,12510,10,0,10,5,0,5
2023-06-01,206277,1,0,1,3,0,3
2023-06-01,202926,3,0,3,4,0,4
2023-06-01,205356,11,0,11,3,0,3
2023-06-01,199928,1,0,1,3,0,3
2023-06-01,266600,1,0,1,4,0,4
2023-06-01,135401,4,0,4,3,0,3
2023-06-01,205159,1,0,1,3,0,3
2023-06-01,395949,1,0,1,3,0,3
2023-06-01,396434,2,0,2,3,0,3
2023-06-01,393335,2,0,2,4,0,4
2023-06-01,133767,7,0,7,3,0,3
2023-06-01,22057,6,0,6,3,0,3
2023-06-01,10326,5,2,7,5,4,5
2023-06-01,9431,3,2,5,1,1,1
2023-06-01,681,5,1,6,1,1,1
2023-06-01,11094,4,0,4,2,0,2
2023-06-01,85,17,1,18,2,1,2
2023-06-01,2837,2,0,2,2,0,2
2023-06-01,2839,4,0,4,3,0,3
2023-06-01,1926,2,0,2,1,0,1
2023-06-01,15496,1,0,1,1,0,1
2023-06-01,2846,2,0,2,2,0,2
2023-06-01,2843,8,0,8,1,0,1
2023-06-01,2834,4,0,4,1,0,1
2023-06-01,2833,2,0,2,1,0,1
2023-06-01,2831,1,0,1,1,0,1
2023-06-01,2842,1,0,1,1,0,1
2023-06-01,43844,5,0,5,1,0,1
2023-06-01,16251,2,0,2,1,0,1
2023-06-01,9088,1,0,1,1,0,1
2023-06-01,14365,36,0,36,5,0,5
2023-06-01,1313,12,0,12,3,0,3
2023-06-01,44786,47,1,48,7,1,7
2023-06-01,33691,4,0,4,3,0,3
2023-06-01,398754,58,1,59,2,2,2
2023-06-01,394898,7,1,8,3,1,3
2023-06-01,400817,3,2,5,2,1,2
2023-06-01,394902,8,1,9,3,2,3
2023-06-01,394897,12,1,13,1,1,1
2023-06-01,400133,1,0,1,1,0,1
2023-06-01,394895,7,1,8,4,1,4
2023-06-01,394903,4,1,5,4,1,4
2023-06-01,543,9,0,9,4,0,4
2023-06-01,18759,3,0,3,4,0,4
2023-06-01,22634,19,0,19,3,0,3
2023-06-01,57585,1,0,1,2,0,2
2023-06-01,57571,17,0,17,3,0,3
2023-06-01,198183,4,0,4,1,0,1
2023-06-01,198320,3,0,3,3,0,3
2023-06-01,30782,3,0,3,1,0,1
2023-06-01,50139,1,0,1,1,0,1
2023-06-01,57458,2,0,2,2,0,2
2023-06-01,61458,1,0,1,1,0,1
2023-06-01,61724,3,1,4,2,1,2
2023-06-01,52644,9,0,9,2,0,2
2023-06-01,61880,3,1,4,2,2,2
2023-06-01,28327,24,0,24,3,0,3
2023-06-01,28604,28,9,37,9,5,9
2023-06-01,61869,12,1,13,1,1,1
2023-06-01,61856,24,1,25,2,1,2
2023-06-01,262621,6,3,9,1,1,1
2023-06-01,61882,3,0,3,1,0,1
2023-06-01,61857,9,0,9,9,0,9
2023-06-01,61852,2,1,3,2,1,2
2023-06-01,14457,2,2,4,1,1,1
2023-06-01,61870,7,1,8,4,4,5
2023-06-01,53143,48,2,50,8,2,8
2023-06-01,61871,9,3,12,8,4,8
2023-06-01,264898,3,3,6,5,2,5
2023-06-01,61883,3,0,3,1,0,1
2023-06-01,11315,47,9,56,1,1,1
2023-06-01,267906,1,0,1,1,0,1
2023-06-01,61700,14,1,15,6,3,6
2023-06-01,262744,15,1,16,3,3,3
2023-06-01,265093,3,3,6,6,5,7
2023-06-01,271133,1,1,2,1,1,1
2023-06-01,52232,113,1,114,5,1,5
2023-06-01,270072,3,1,4,1,1,1
2023-06-01,61467,1,1,2,2,1,2
2023-06-01,61885,5,4,9,2,1,2
2023-06-01,61886,1,0,1,1,0,1
2023-06-01,262824,4,1,5,3,1,3
2023-06-01,61705,4,0,4,3,0,3
2023-06-01,61701,8,5,13,1,1,1
2023-06-01,61698,2,3,5,3,3,4
2023-06-01,61706,1,1,2,2,2,3
2023-06-01,262711,4,1,5,3,2,3
2023-06-01,61707,5,0,5,3,0,3
2023-06-01,52947,14,0,14,5,0,5
2023-06-01,28621,2,1,3,1,1,1
2023-06-01,61708,7,0,7,1,0,1
2023-06-01,61729,3,7,10,6,4,6
2023-06-01,262695,3,1,4,2,1,2
2023-06-01,52536,5,1,6,1,1,1
2023-06-01,28613,20,57,77,8,4,9
2023-06-01,61702,2,2,4,4,4,4
2023-06-01,61709,2,3,5,2,2,2
2023-06-01,61470,5,1,6,3,2,3
2023-06-01,262380,28,11,39,4,2,4
2023-06-01,61714,4,1,5,3,1,3
2023-06-01,52769,5,0,5,2,0,2
2023-06-01,263555,7,0,7,2,0,2
2023-06-01,386,49,0,49,1,0,1
2023-06-01,452,247,0,247,1,0,1
2023-06-01,118,2,0,2,1,0,1
2023-06-01,56,2,0,2,1,0,1
2023-06-01,399,15,0,15,2,0,2
2023-06-01,5852,297,0,297,2,0,2
2023-06-01,138,39,0,39,2,0,2
2023-06-01,27046,440,3,443,5,2,5
2023-06-01,28075,169,57,226,9,5,10
2023-06-01,61715,2,0,2,2,0,2
2023-06-01,61710,1,0,1,1,0,1
2023-06-01,61713,9,5,14,2,2,2
2023-06-01,61716,3,1,4,1,1,1
2023-06-01,52455,10,3,13,5,3,5
2023-06-01,52339,35,0,35,5,0,5
2023-06-01,61711,6,0,6,4,0,4
2023-06-01,61722,4,2,6,5,1,5
2023-06-01,61723,4,0,4,1,0,1
2023-06-01,52545,14,10,24,8,7,9
2023-06-01,61718,3,1,4,2,1,2
2023-06-01,61728,7,5,12,4,3,4
2023-06-01,267541,1,7,8,4,2,4
2023-06-01,271348,1,0,1,1,0,1
2023-06-01,28038,9,1,10,1,1,1
2023-06-01,28584,18,0,18,1,0,1
2023-06-01,61725,4,1,5,1,1,1
2023-06-01,270866,8,1,9,1,1,1
2023-06-01,262765,59,23,82,8,5,8
2023-06-01,262797,53,1,54,1,1,1
2023-06-01,61646,1,1,2,1,1,1
2023-06-01,270982,7,7,14,1,1,1
2023-06-01,270908,1,1,2,1,1,1
2023-06-01,61727,7,1,8,3,2,4
2023-06-01,61744,1,3,4,3,3,4
2023-06-01,272043,3,1,4,3,1,3
2023-06-01,271998,1,0,1,1,0,1
2023-06-01,28670,17,3,20,8,7,9
2023-06-01,272212,1,1,2,2,2,2
2023-06-01,28318,11,0,11,3,0,3
2023-06-01,61734,1,0,1,3,0,3
2023-06-01,262993,15,3,18,3,2,5
2023-06-01,52777,25,4,29,8,7,10
2023-06-01,61735,2,0,2,3,0,3
2023-06-01,271508,7,3,10,9,7,10
2023-06-01,270932,7,4,11,9,8,10
2023-06-01,61737,7,1,8,5,2,5
2023-06-01,271120,5,3,8,4,2,4
2023-06-01,61740,2,0,2,1,0,1
2023-06-01,61741,6,6,12,1,2,2
2023-06-01,262809,23,7,30,7,3,7
2023-06-01,13591,119,12,131,11,5,13
2023-06-01,61738,4,0,4,3,0,3
2023-06-01,52337,9,0,9,1,0,1
2023-06-01,263728,3,1,4,3,1,3
2023-06-01,263753,5,0,5,1,0,1
2023-06-01,52329,9,0,9,1,0,1
2023-06-01,262393,17,3,20,10,5,11
2023-06-01,52751,6,1,7,4,3,4
2023-06-01,61751,14,3,17,6,5,8
2023-06-01,5974,15,2,17,4,1,4
2023-06-01,140,4,0,4,1,0,1
2023-06-01,12013,9,0,9,1,0,1
2023-06-01,213,1,1,2,1,1,1
2023-06-01,3681,4,1,5,4,1,4
2023-06-01,16430,2,0,2,3,0,3
2023-06-01,10631,1,0,1,1,0,1
2023-06-01,270896,1,0,1,1,0,1
2023-06-01,61752,4,1,5,3,3,5
2023-06-01,61753,6,7,13,3,2,3
2023-06-01,61651,8,1,9,4,1,4
2023-06-01,262491,15,1,16,5,3,6
2023-06-01,263159,13,46,59,7,4,7
2023-06-01,61746,4,3,7,1,1,1
2023-06-01,27800,50,1,51,2,1,2
2023-06-01,61755,1,1,2,1,1,1
2023-06-01,270062,3,4,7,1,1,1
2023-06-01,61748,21,3,24,5,3,5
2023-06-01,262323,51,22,73,4,5,5
2023-06-01,52307,17,0,17,4,0,4
2023-06-01,61756,3,3,6,3,2,3
2023-06-01,61757,4,1,5,2,1,2
2023-06-01,61759,6,0,6,5,0,5
2023-06-01,61481,7,1,8,3,1,3
2023-06-01,53001,11,12,23,4,4,4
2023-06-01,28224,16,12,28,2,1,2
2023-06-01,27940,11,1,12,3,1,3
2023-06-01,61670,2,3,5,2,2,2
2023-06-01,61644,4,0,4,3,0,3
2023-06-01,61636,14,1,15,4,3,4
2023-06-01,61632,21,1,22,1,1,1
2023-06-01,61637,3,31,34,3,3,4
2023-06-01,271412,3,1,4,11,9,11
2023-06-01,61638,4,6,10,1,1,1
2023-06-01,264381,17,5,22,8,2,8
2023-06-01,61639,5,1,6,3,1,3
2023-06-01,61642,3,3,6,5,2,5
2023-06-01,264543,10,4,14,12,6,12
2023-06-01,61648,15,9,24,6,6,7
2023-06-01,262630,6,1,7,1,1,1
2023-06-01,53193,1,0,1,3,0,3
2023-06-01,264002,7,1,8,3,3,3
2023-06-01,61652,3,1,4,5,2,5
2023-06-01,61662,5,3,8,3,1,3
2023-06-01,61658,5,3,8,2,2,2
2023-06-01,270987,4,1,5,2,1,2
2023-06-01,272190,0,1,1,4,2,4
2023-06-01,61653,3,0,3,1,0,1
2023-06-01,61686,5,23,28,4,5,5
2023-06-01,61655,4,4,8,1,1,1
2023-06-01,61663,9,1,10,6,3,6
2023-06-01,61667,7,2,9,3,2,3
2023-06-01,61668,3,1,4,4,3,4
2023-06-01,33845,4,1,5,3,1,3
2023-06-01,31886,4,0,4,1,0,1
2023-06-01,61487,4,0,4,3,0,3
2023-06-01,263424,25,5,30,8,3,9
2023-06-01,53224,0,0,0,4,2,5
2023-06-01,263744,6,1,7,1,1,1
2023-06-01,52712,15,3,18,3,1,3
2023-06-01,61660,14,3,17,3,3,3
2023-06-01,264516,14,3,17,3,3,3
2023-06-01,61687,5,0,5,1,0,1
2023-06-01,61671,3,0,3,2,0,2
2023-06-01,61664,2,1,3,1,1,1
2023-06-01,61665,9,111,120,7,3,8
2023-06-01,266238,1,31,32,3,2,3
2023-06-01,61456,6,0,6,2,0,2
2023-06-01,262521,4,1,5,5,1,5
2023-06-01,264350,5,0,5,3,0,3
2023-06-01,61672,3,2,5,7,1,7
2023-06-01,61676,5,2,7,3,2,4
2023-06-01,61677,3,1,4,2,2,2
2023-06-01,264353,5,1,6,3,2,3
2023-06-01,61673,4,1,5,1,1,1
2023-06-01,264159,13,8,21,6,4,6
2023-06-01,263010,6,3,9,3,2,3
2023-06-01,61674,1,3,4,1,1,1
2023-06-01,61490,5,0,5,1,0,1
2023-06-01,61690,7,0,7,2,0,2
2023-06-01,264385,4,8,12,7,6,7
2023-06-01,262691,87,5,92,7,6,7
2023-06-01,270946,4,6,10,6,3,6
2023-06-01,266505,3,7,10,4,2,4
2023-06-01,270346,3,3,6,6,1,6
2023-06-01,61675,1,1,2,2,1,2
2023-06-01,28171,145,32,177,16,9,17
2023-06-01,270862,4,0,4,1,0,1
2023-06-01,61691,1,1,2,1,1,1
2023-06-01,61684,6,1,7,3,3,4
2023-06-01,270971,4,1,5,3,1,3
2023-06-01,53038,28,2,30,8,6,8
2023-06-01,61692,5,1,6,1,1,1
2023-06-01,26623,2,0,2,2,0,2
2023-06-01,27659,27,0,27,5,0,5
2023-06-01,264351,4,2,6,8,4,8
2023-06-01,28204,19,1,20,8,2,8
2023-06-01,263536,30,4,34,3,1,4
2023-06-01,61685,3,0,3,1,0,1
2023-06-01,61693,6,0,6,2,0,2
2023-06-01,264352,3,0,3,1,0,1
2023-06-01,264355,5,0,5,5,0,5
2023-06-01,264356,6,2,8,3,2,3
2023-06-01,262444,20,8,28,10,6,11
2023-06-01,61694,21,1,22,3,2,3
2023-06-01,14464,18,0,18,1,0,1
2023-06-01,9367,1,1,2,3,1,3
2023-06-01,38635,2,2,4,2,2,2
2023-06-01,43174,2,1,3,2,1,2
2023-06-01,11050,1,0,1,2,0,2
2023-06-01,15329,1,0,1,1,0,1
2023-06-01,1766,28,0,28,15,0,15
2023-06-01,4291100673,9,0,9,2,0,2
2023-06-01,4291101672,1,0,1,1,0,1
2023-06-01,14348,3,0,3,1,0,1
2023-06-01,18456,23,0,23,1,0,1
2023-06-01,3377,18,0,18,4,0,4
2023-06-01,11348,4,0,4,2,0,2
2023-06-01,394566,2,1,3,2,1,2
2023-06-01,207134,3,1,4,2,1,2
2023-06-01,400672,2,2,4,1,1,1
2023-06-01,46385,3,2,5,1,1,1
2023-06-01,50389,2,1,3,1,1,1
2023-06-01,39239,2,2,4,1,1,1
2023-06-01,210266,2,2,4,1,1,1
2023-06-01,209485,2,2,4,1,1,1
2023-06-01,136899,2,2,4,1,1,1
2023-06-01,397378,2,2,4,1,1,1
2023-06-01,208136,2,2,4,1,1,1
2023-06-01,213246,3,1,4,1,1,1
2023-06-01,400275,1,0,1,1,0,1
2023-06-01,394643,1,0,1,1,0,1
2023-06-01,35865,2,0,2,3,0,3
2023-06-01,395520,1,0,1,1,0,1
2023-06-01,1161,2,0,2,1,0,1
2023-06-01,270880,3,0,3,1,0,1
2023-06-01,264366,6,1,7,1,1,1
2023-06-01,264360,11,0,11,5,0,5
2023-06-01,264394,1,1,2,1,1,1
2023-06-01,52564,14,11,25,10,9,12
2023-06-01,52935,9,4,13,4,4,4
2023-06-01,52674,9,1,10,4,3,6
2023-06-01,264368,7,0,7,3,0,3
2023-06-01,264402,5,0,5,1,0,1
2023-06-01,264365,1,1,2,2,1,2
2023-06-01,264373,7,3,10,1,1,1
2023-06-01,263694,5,0,5,1,0,1
2023-06-01,4270,45,5,50,27,18,27
2023-06-01,265700,2,1,3,2,1,2
2023-06-01,61789,9,2,11,4,2,4
2023-06-01,264374,4,3,7,2,1,2
2023-06-01,270777,1,1,2,4,1,4
2023-06-01,264382,4,0,4,4,0,4
2023-06-01,264377,4,0,4,5,0,5
2023-06-01,264387,4,0,4,2,0,2
2023-06-01,262293,56,6,62,9,4,10
2023-06-01,264375,9,1,10,3,1,3
2023-06-01,28094,4,5,9,1,1,2
2023-06-01,27818,72,1,73,4,1,4
2023-06-01,264390,8,1,9,2,1,2
2023-06-01,52893,15,1,16,4,1,4
2023-06-01,264380,4,0,4,1,0,1
2023-06-01,264391,3,1,4,3,1,3
2023-06-01,264392,1,1,2,1,1,1
2023-06-01,264389,6,1,7,5,3,5
2023-06-01,264400,2,1,3,2,2,2
2023-06-01,264401,3,0,3,4,0,4
2023-06-01,264393,3,7,10,3,3,3
2023-06-01,264404,9,1,10,2,1,2
2023-06-01,28549,29,0,29,1,0,1
2023-06-01,264403,1,0,1,1,0,1
2023-06-01,28103,22,0,22,11,2,12
2023-06-01,264853,0,0,0,2,6,7
2023-06-01,30256,1,1,2,1,1,1
2023-06-01,14875,5,0,5,4,0,4
2023-06-01,61032,10,0,10,1,0,1
2023-06-01,32513,2,0,2,2,0,2
2023-06-01,1754,5,0,5,2,0,2
2023-06-01,22877,1,0,1,1,0,1
2023-06-01,135893,3,1,4,1,1,1
2023-06-01,31248,1,0,1,1,0,1
2023-06-01,288,61,0,61,3,0,3
2023-06-01,6342,15,0,15,5,0,5
2023-06-01,2025,7,0,7,4,0,4
2023-06-01,22696,4,0,4,4,0,4
2023-06-01,33517,7,7,14,3,3,3
2023-06-01,26247,18,0,18,2,0,2
2023-06-01,26898,32,0,32,2,0,2
2023-06-01,14677,76,0,76,2,0,2
2023-06-01,394865,3,0,3,1,0,1
2023-06-01,396001,7,0,7,2,0,2
2023-06-01,19342,1,0,1,3,0,3
2023-06-01,265632,5,1,6,1,1,1
2023-06-01,265903,4,0,4,2,0,2
2023-06-01,265891,5,0,5,4,0,4
2023-06-01,271410,7,1,8,5,4,5
2023-06-01,263766,11,0,11,1,0,1
2023-06-01,265773,2,0,2,2,0,2
2023-06-01,61579,9,1,10,5,4,6
2023-06-01,265894,3,0,3,1,0,1
2023-06-01,265753,1,1,2,2,1,2
2023-06-01,270016,4,0,4,2,0,2
2023-06-01,265976,3,1,4,2,1,2
2023-06-01,265916,3,1,4,2,1,2
2023-06-01,265910,1,1,2,1,1,1
2023-06-01,265932,1,0,1,2,0,2
2023-06-01,265754,5,0,5,3,0,3
2023-06-01,64103,1,0,1,2,0,2
2023-06-01,265907,2,0,2,1,0,1
2023-06-01,265917,7,3,10,4,3,4
2023-06-01,265969,1,12,13,1,2,2
2023-06-01,265905,4,3,7,4,3,4
2023-06-01,265918,4,4,8,4,2,4
2023-06-01,270439,5,1,6,4,3,5
2023-06-01,265922,4,1,5,2,1,2
2023-06-01,267494,4,0,4,4,0,4
2023-06-01,269756,1,0,1,1,0,1
2023-06-01,263841,4,1,5,5,2,5
2023-06-01,265909,2,0,2,2,0,2
2023-06-01,271314,3,1,4,1,1,1
2023-06-01,266308,3,1,4,4,4,4
2023-06-01,265923,3,1,4,2,1,2
2023-06-01,265928,4,2,6,7,4,7
2023-06-01,265929,1,1,2,1,1,1
2023-06-01,265975,5,1,6,12,11,13
2023-06-01,271610,1,1,2,1,1,1
2023-06-01,52531,17,1,18,17,11,18
2023-06-01,265911,23,1,24,3,3,3
2023-06-01,265913,6,2,8,1,1,1
2023-06-01,265912,3,2,5,5,3,5
2023-06-01,265943,7,1,8,4,2,4
2023-06-01,265914,3,5,8,6,7,8
2023-06-01,265758,6,0,6,1,0,1
2023-06-01,265930,5,1,6,1,1,1
2023-06-01,271970,6,0,6,2,0,2
2023-06-01,271163,2,0,2,6,3,7
2023-06-01,265990,5,1,6,5,1,5
2023-06-01,265920,1,1,2,1,1,1
2023-06-01,265985,1,1,2,2,2,2
2023-06-01,266006,3,4,7,7,3,7
2023-06-01,265944,3,9,12,1,5,5
2023-06-01,265996,7,1,8,3,1,3
2023-06-01,25917,4,0,4,4,0,4
2023-06-01,399381,8,0,8,5,0,5
2023-06-01,132264,4,0,4,1,0,1
2023-06-01,6112,1,0,1,1,0,1
2023-06-01,375,53,1,54,2,2,2
2023-06-01,31,6,0,6,4,0,4
2023-06-01,7573,6,0,6,1,0,1
2023-06-01,23255,18,0,18,4,0,4
2023-06-01,399938,4,0,4,3,0,3
2023-06-01,399939,2,0,2,2,0,2
2023-06-01,61496,3,2,5,3,1,3
2023-06-01,263730,1,0,1,1,0,1
2023-06-01,7727,8,1,9,2,1,2
2023-06-01,263690,1,0,1,1,0,1
2023-06-01,264415,4,6,10,3,3,3
2023-06-01,27930,12,8,20,3,3,3
2023-06-01,264793,5,0,5,1,0,1
2023-06-01,264407,1,0,1,1,0,1
2023-06-01,264414,3,1,4,3,2,3
2023-06-01,265798,5,0,5,3,0,3
2023-06-01,271724,11,0,11,1,0,1
2023-06-01,270956,1,2,3,3,3,3
2023-06-01,264406,8,1,9,3,3,3
2023-06-01,53135,27,3,30,3,4,4
2023-06-01,264411,14,1,15,3,1,3
2023-06-01,52607,2,5,7,4,3,4
2023-06-01,264412,3,3,6,1,1,1
2023-06-01,264424,7,19,26,4,3,4
2023-06-01,266841,2,0,2,4,0,4
2023-06-01,263701,2,0,2,2,0,2
2023-06-01,52937,18,1,19,5,3,5
2023-06-01,264416,7,1,8,5,4,6
2023-06-01,264428,14,13,27,5,5,6
2023-06-01,264429,8,3,11,4,3,4
2023-06-01,264413,5,0,5,1,0,1
2023-06-01,270984,3,5,8,1,2,2
2023-06-01,264433,1,7,8,1,2,2
2023-06-01,264421,1,1,2,1,1,1
2023-06-01,264434,3,5,8,2,3,3
2023-06-01,264437,7,1,8,1,3,3
2023-06-01,264422,4,20,24,2,3,3
2023-06-01,52746,8,1,9,1,1,1
2023-06-01,264425,7,17,24,4,3,4
2023-06-01,264426,14,1,15,5,3,5
2023-06-01,264442,6,1,7,6,3,6
2023-06-01,264430,7,1,8,6,1,6
2023-06-01,262316,53,10,63,8,8,9
2023-06-01,264443,4,1,5,2,1,2
2023-06-01,264432,10,3,13,2,1,2
2023-06-01,53016,17,1,18,4,2,4
2023-06-01,264423,1,0,1,1,0,1
2023-06-01,264435,1,0,1,1,0,1
2023-06-01,264446,9,0,9,3,0,3
2023-06-01,264465,8,0,8,3,0,3
2023-06-01,264427,5,0,5,3,0,3
2023-06-01,264106,6,1,7,5,1,5
2023-06-01,264440,21,1,22,5,4,5
2023-06-01,264441,5,1,6,2,2,2
2023-06-01,14962,44,0,44,5,0,5
2023-06-01,3152,3,1,4,1,1,1
2023-06-01,398014,2,1,3,1,1,1
2023-06-01,21856,1,0,1,2,0,2
2023-06-01,34414,11,4,15,3,2,3
2023-06-01,1255,3,0,3,1,0,1
2023-06-01,15119,2,0,2,3,0,3
2023-06-01,15118,3,0,3,3,0,3
2023-06-01,16580,31,0,31,3,0,3
2023-06-01,393312,4,0,4,4,0,4
2023-06-01,42894,43,7,50,2,2,2
2023-06-01,53461,1,0,1,3,0,3
2023-06-01,31817,2,0,2,2,0,2
2023-06-01,17128,2,0,2,1,0,1
2023-06-01,24014,4,0,4,1,0,1
2023-06-01,2857,8,1,9,11,7,12
2023-06-01,199578,4,2,6,3,3,3
2023-06-01,6366,2,1,3,4,2,4
2023-06-01,1938,1,0,1,1,0,1
2023-06-01,61493,14,6,20,4,4,5
2023-06-01,263741,5,0,5,2,0,2
2023-06-01,271908,4,0,4,2,0,2
2023-06-01,264449,5,1,6,9,5,9
2023-06-01,52979,11,1,12,3,3,6
2023-06-01,264450,7,7,14,6,4,6
2023-06-01,266833,3,0,3,1,0,1
2023-06-01,262675,43,1,44,13,9,16
2023-06-01,264466,1,0,1,2,0,2
2023-06-01,264523,5,1,6,2,1,2
2023-06-01,264518,3,0,3,2,0,2
2023-06-01,264470,8,1,9,9,2,9
2023-06-01,10881,18,1,19,10,7,10
2023-06-01,264471,9,1,10,2,1,2
2023-06-01,264483,1,3,4,1,1,1
2023-06-01,264475,4,0,4,2,0,2
2023-06-01,263468,4,3,7,5,3,5
2023-06-01,61900,8,1,9,8,3,8
2023-06-01,264484,10,0,10,1,0,1
2023-06-01,264487,3,3,6,1,1,1
2023-06-01,264485,20,14,34,4,3,4
2023-06-01,264503,7,1,8,3,2,3
2023-06-01,264489,7,1,8,3,1,3
2023-06-01,264522,3,1,4,1,1,1
2023-06-01,262470,9,1,10,5,4,5
2023-06-01,262387,9,2,11,10,6,10
2023-06-01,264491,6,5,11,7,5,8
2023-06-01,263715,2,0,2,2,0,2
2023-06-01,264497,4,1,5,2,1,2
2023-06-01,262546,15,5,20,4,2,4
2023-06-01,262979,17,3,20,9,5,9
2023-06-01,264502,3,0,3,1,0,1
2023-06-01,264494,1,1,2,1,2,2
2023-06-01,264495,5,0,5,3,0,3
2023-06-01,269810,2,0,2,2,0,2
2023-06-01,270871,3,1,4,1,1,1
2023-06-01,262962,9,0,9,3,0,3
2023-06-01,270362,7,11,18,5,3,5
2023-06-01,263712,1,0,1,1,0,1
2023-06-01,264504,6,0,6,2,0,2
2023-06-01,427,6,0,6,1,0,1
2023-06-01,450,1,0,1,1,0,1
2023-06-01,383,1,0,1,1,0,1
2023-06-01,391,8,0,8,1,0,1
2023-06-01,400,1,0,1,1,0,1
2023-06-01,6040,4,0,4,1,0,1
2023-06-01,400749,1,0,1,1,0,1
2023-06-01,2450,1,0,1,1,0,1
2023-06-01,545,4,3,7,3,2,3
2023-06-01,41701,7,1,8,2,2,2
2023-06-01,2665,228,0,228,6,0,6
2023-06-01,2682,3,0,3,8,0,8
2023-06-01,2680,6,0,6,1,0,1
2023-06-01,22949,1,0,1,2,0,2
2023-06-01,36368,3,0,3,3,0,3
2023-06-01,2648,14,2,16,1,1,1
2023-06-01,777,11,0,11,1,0,1
2023-06-01,1234,5,0,5,2,0,2
2023-06-01,377,7,1,8,1,1,1
2023-06-01,46662,1,0,1,1,0,1
2023-06-01,9432,2,0,2,3,0,3
2023-06-01,40127,1,0,1,2,0,2
2023-06-01,2818,4,2,6,10,5,11
2023-06-01,31459,1,1,2,1,1,2
2023-06-01,14398,19,0,19,7,0,7
2023-06-01,8116,10,0,10,7,0,7
2023-06-01,199563,29,0,29,1,0,1
2023-06-01,16519,2,1,3,1,1,1
2023-06-01,10754,7,0,7,3,0,3
2023-06-01,36786,2,2,4,1,1,1
2023-06-01,15318,14,1,15,2,1,2
2023-06-01,33602,6,0,6,1,0,1
2023-06-01,32555,1,0,1,3,0,3
2023-06-01,22953,3,1,4,1,1,1
2023-06-01,11489,41,0,41,2,0,2
2023-06-01,17516,31,3,34,2,2,2
2023-06-01,1307,2,0,2,1,0,1
2023-06-01,30614,27,1,28,16,1,16
2023-06-01,3613,2,0,2,2,0,2
2023-06-01,52245,0,0,0,4,0,4
2023-06-01,63319,4,0,4,2,0,2
2023-06-01,25689,22,2,24,5,1,5
2023-06-01,278,167,60,227,8,4,8
2023-06-01,18592,10,3,13,6,4,7
2023-06-01,28569,0,0,0,5,0,5
2023-06-01,28550,1,0,1,6,0,6
2023-06-01,3640,8,2,10,5,1,5
2023-06-01,28024,48,3,51,4,2,4
2023-06-01,10436,15,0,15,2,0,2
2023-06-01,11136,9,0,9,1,0,1
2023-06-01,10560,7,0,7,1,0,1
2023-06-01,7038,9,0,9,4,0,4
2023-06-01,265823,3,0,3,4,0,4
2023-06-01,263586,16,3,19,7,4,7
2023-06-01,264461,14,3,17,5,5,6
2023-06-01,264451,3,0,3,1,0,1
2023-06-01,52689,4,1,5,5,7,8
2023-06-01,61908,4,1,5,1,1,1
2023-06-01,264462,5,0,5,1,0,1
2023-06-01,264453,3,1,4,5,3,5
2023-06-01,262730,59,2,61,4,2,4
2023-06-01,263688,1,0,1,2,0,2
2023-06-01,263700,4,0,4,2,0,2
2023-06-01,264463,3,3,6,1,1,1
2023-06-01,264456,4,1,5,3,1,3
2023-06-01,264464,3,1,4,5,1,5
2023-06-01,264458,2,3,5,1,1,1
2023-06-01,264472,3,1,4,2,1,2
2023-06-01,264460,6,7,13,3,3,3
2023-06-01,263355,6,0,6,4,0,4
2023-06-01,264477,2,0,2,1,0,1
2023-06-01,52436,32,1,33,5,1,5
2023-06-01,26609,17,1,18,8,4,8
2023-06-01,264473,6,1,7,2,1,2
2023-06-01,52485,5,1,6,1,1,1
2023-06-01,263472,6,1,7,3,3,3
2023-06-01,53223,10,1,11,1,1,1
2023-06-01,53184,44,28,72,10,7,10
2023-06-01,264508,9,1,10,3,3,3
2023-06-01,263717,12,0,12,2,0,2
2023-06-01,264022,6,6,12,8,4,8
2023-06-01,263040,2,1,3,2,2,2
2023-06-01,264510,3,1,4,2,2,2
2023-06-01,264511,3,14,17,3,3,3
2023-06-01,53132,25,5,30,7,10,11
2023-06-01,264513,6,1,7,6,4,7
2023-06-01,263720,3,7,10,3,2,3
2023-06-01,264526,5,1,6,2,2,2
2023-06-01,264521,4,5,9,4,1,4
2023-06-01,271421,1,1,2,7,4,7
2023-06-01,263716,2,1,3,2,1,2
2023-06-01,264533,6,1,7,1,1,1
2023-06-01,264538,4,7,11,1,1,1
2023-06-01,264519,7,1,8,4,2,4
2023-06-01,264520,3,1,4,1,1,1
2023-06-01,262605,27,2,29,3,3,4
2023-06-01,4730,2,0,2,1,0,1
2023-06-01,17523,3,3,6,2,2,2
2023-06-01,55384,1,1,2,1,1,1
2023-06-01,2508,1,0,1,1,0,1
2023-06-01,17687,3,0,3,1,0,1
2023-06-01,17956,1,0,1,3,0,3
2023-06-01,17960,1,0,1,1,0,1
2023-06-01,23807,1,0,1,1,0,1
2023-06-01,131159,6,1,7,2,1,2
2023-06-01,55379,3,3,6,2,2,2
2023-06-01,131919,3,0,3,2,0,2
2023-06-01,55380,1,1,2,1,1,1
2023-06-01,55390,3,1,4,1,1,1
2023-06-01,23630,5,0,5,3,0,3
2023-06-01,23615,1,0,1,1,0,1
2023-06-01,131981,6,0,6,2,0,2
2023-06-01,63777,1,0,1,1,0,1
2023-06-01,2506,16,1,17,2,1,2
2023-06-01,24248,1,0,1,2,0,2
2023-06-01,10014,3,1,4,3,3,3
2023-06-01,7509,3,0,3,1,0,1
2023-06-01,4729,2,0,2,1,0,1
2023-06-01,3488,8,0,8,1,0,1
2023-06-01,38641,4,0,4,2,0,2
2023-06-01,17946,1,0,1,1,0,1
2023-06-01,24261,3,0,3,1,0,1
2023-06-01,2523,2,1,3,1,1,1
2023-06-01,45688,3,0,3,1,0,1
2023-06-01,24268,1,0,1,3,0,3
2023-06-01,131897,1,0,1,2,0,2
2023-06-01,9591,1,0,1,3,0,3
2023-06-01,18087,4,1,5,2,1,2
2023-06-01,55904,3,1,4,2,1,2
2023-06-01,131969,3,3,6,3,3,3
2023-06-01,146986,1,1,2,2,1,2
2023-06-01,131951,1,1,2,1,1,1
2023-06-01,23623,1,0,1,2,0,2
2023-06-01,58647,178,0,178,2,0,2
2023-06-01,58652,5,0,5,1,0,1
2023-06-01,18148,8,1,9,1,1,1
2023-06-01,63785,2,0,2,1,0,1
2023-06-01,24254,1,0,1,1,0,1
2023-06-01,17944,5,1,6,5,5,5
2023-06-01,18139,6,1,7,1,1,1
2023-06-01,58786,1,1,2,1,1,1
2023-06-01,131893,20,4,24,2,1,2
2023-06-01,9598,1,0,1,2,0,2
2023-06-01,59109,111,0,111,2,0,2
2023-06-01,2526,2,1,3,5,3,5
2023-06-01,4677,12,0,12,1,0,1
2023-06-01,17510,1,0,1,2,0,2
2023-06-01,18071,10,0,10,2,0,2
2023-06-01,18069,3,0,3,3,0,3
2023-06-01,9355,1,1,2,5,5,5
2023-06-01,4675,7,1,8,4,4,5
2023-06-01,17947,2,0,2,2,0,2
2023-06-01,59118,4,0,4,2,0,2
2023-06-01,9357,4,1,5,4,3,4
2023-06-01,5576,24,0,24,5,0,5
2023-06-01,38083,1,1,2,1,1,1
2023-06-01,44,6,0,6,1,0,1
2023-06-01,395501,1,0,1,2,0,2
2023-06-01,6041,56,0,56,1,0,1
2023-06-01,16354,5,0,5,1,0,1
2023-06-01,57432,1,0,1,3,0,3
2023-06-01,199311,1,0,1,1,0,1
2023-06-01,14702,2,1,3,2,1,2
2023-06-01,4268,7,0,7,1,0,1
2023-06-01,47708,2,1,3,3,2,3
2023-06-01,675,3,1,4,1,1,1
2023-06-01,25213,3,0,3,4,0,4
2023-06-01,53712,23,0,23,11,0,11
2023-06-01,395226,6,1,7,4,1,4
2023-06-01,1736,79,0,79,2,0,2
2023-06-01,35951,1,0,1,3,0,3
2023-06-01,11252,9,0,9,2,0,2
2023-06-01,22968,4,0,4,2,0,2
2023-06-01,31612,1,0,1,1,0,1
2023-06-01,27263,7,0,7,8,0,8
2023-06-01,55268,3,0,3,3,0,3
2023-06-01,397463,2,2,4,1,1,1
2023-06-01,395201,8,0,8,1,0,1
2023-06-01,396884,1,0,1,2,0,2
2023-06-01,400422,1,1,2,3,1,3
2023-06-01,978,3,0,3,2,0,2
2023-06-01,14298,5,1,6,1,1,1
2023-06-01,14486,3,0,3,2,0,2
2023-06-01,30679,3,3,6,1,1,1
2023-06-01,9489,27,0,27,2,0,2
2023-06-01,17595,8,0,8,1,0,1
2023-06-01,3671,2,1,3,2,1,2
2023-06-01,46750,0,0,0,2,2,3
2023-06-01,40591,2,0,2,1,0,1
2023-06-01,13541,6,1,7,2,1,2
2023-06-01,16462,17,3,20,1,1,1
2023-06-01,394003,1,0,1,1,0,1
2023-06-01,14706,1,0,1,2,0,2
2023-06-01,198380,11,0,11,1,0,1
2023-06-01,5520,6,2,8,1,1,1
2023-06-01,213087,2,0,2,1,0,1
2023-06-01,203761,1,0,1,1,0,1
2023-06-01,42873,6,1,7,1,1,1
2023-06-01,394990,8,0,8,1,0,1
2023-06-01,11309,7,1,8,2,1,2
2023-06-01,29773,5,1,6,3,2,3
2023-06-01,1761,20,0,20,2,0,2
2023-06-01,10357,3,0,3,2,0,2
2023-06-01,19530,3,1,4,2,2,2
2023-06-01,6263,17,1,18,3,3,3
2023-06-01,22717,17,0,17,12,0,12
2023-06-01,227171,4,0,4,2,0,2
2023-06-01,4983,149,0,149,16,0,16
2023-06-01,6363,15,0,15,5,0,5
2023-06-01,3918,16,0,16,6,0,6
2023-06-01,3917,20,0,20,6,0,6
2023-06-01,29484,7,5,12,2,2,2
2023-06-01,6039,93,0,93,1,0,1
2023-06-01,6579,7,0,7,3,0,3
2023-06-01,20239,1,0,1,2,0,2
2023-06-01,789,3,0,3,1,0,1
2023-06-01,18128,1,0,1,1,0,1
2023-06-01,22594,1,0,1,2,0,2
2023-06-01,11355,7,0,7,4,0,4
2023-06-01,6009,1,1,2,1,1,1
2023-06-01,2117,2,0,2,1,0,1
2023-06-01,11340,117,1,118,19,7,19
2023-06-01,3659,1,1,2,2,2,2
2023-06-01,23667,1,0,1,1,0,1
2023-06-01,17152,1,0,1,2,0,2
2023-06-01,46543,1,0,1,3,0,3
2023-06-01,3390,5,1,6,3,2,3
2023-06-01,289,2,0,2,1,0,1
2023-06-01,29981,3,0,3,2,0,2
2023-06-01,36232,2,1,3,2,1,2
2023-06-01,399998,3,0,3,3,0,3
2023-06-01,36001,9,1,10,4,4,4
2023-06-01,40862,1,0,1,1,0,1
2023-06-01,398298,1,0,1,3,0,3
2023-06-01,36127,1,1,2,2,1,2
2023-06-01,394037,5,1,6,2,2,2
2023-06-01,398921,1,0,1,1,0,1
2023-06-01,63229,2,0,2,1,0,1
2023-06-01,20000,1,0,1,2,0,2
2023-06-01,22444,2,0,2,4,0,4
2023-06-01,398758,3,0,3,2,0,2
2023-06-01,395264,1,0,1,1,0,1
2023-06-01,399037,1,0,1,2,0,2
2023-06-01,398552,1,0,1,1,0,1
2023-06-01,398303,1,0,1,1,0,1
2023-06-01,395510,1,1,2,1,2,2
2023-06-01,398925,2,0,2,1,0,1
2023-06-01,15242,1,1,2,1,1,1
2023-06-01,62866,1,1,2,2,2,2
2023-06-01,398305,10,0,10,1,0,1
2023-06-01,397760,2,0,2,3,0,3
2023-06-01,398311,5,0,5,2,0,2
2023-06-01,27487,1,0,1,4,0,4
2023-06-01,398259,2,0,2,1,0,1
2023-06-01,394305,3,0,3,2,0,2
2023-06-01,399238,1,0,1,1,0,1
2023-06-01,36269,1,0,1,1,0,1
2023-06-01,25876,28,0,28,3,0,3
2023-06-01,398173,14,0,14,5,0,5
2023-06-01,18723,20,0,20,5,0,5
2023-06-01,6042,6,0,6,1,0,1
2023-06-01,5058,1,1,2,1,1,1
2023-06-01,17711,1,0,1,1,0,1
2023-06-01,24287,1,1,2,3,4,4
2023-06-01,56131,6,0,6,1,0,1
2023-06-01,1945,5,0,5,2,0,2
2023-06-01,2060,1,0,1,1,0,1
2023-06-01,22586,15,0,15,3,0,3
2023-06-01,35928,71,0,71,24,0,24
2023-06-01,9159,9,0,9,3,0,3
2023-06-01,25631,8,1,9,2,2,2
2023-06-01,1586,1,0,1,1,0,1
2023-06-01,8067,5,0,5,1,0,1
2023-06-01,18816,9,0,9,4,0,4
2023-06-01,33194,9,0,9,1,0,1
2023-06-01,22216,49,3,52,8,3,8
2023-06-01,2103,2,0,2,2,0,2
2023-06-01,3562,7,1,8,1,1,1
2023-06-01,49382,4,0,4,3,0,3
2023-06-01,18676,70,0,70,14,0,14
2023-06-01,19637,98,5,103,21,2,21
2023-06-01,36657,4,0,4,3,0,3
2023-06-01,8158,1,0,1,1,0,1
2023-06-01,60665,1,0,1,1,0,1
2023-06-01,14110,12,0,12,7,0,7
2023-06-01,393647,3,0,3,1,0,1
2023-06-01,394807,1,0,1,2,0,2
2023-06-01,395027,1,0,1,1,0,1
2023-06-01,36080,1,0,1,3,0,3
2023-06-01,395054,1,0,1,2,0,2
2023-06-01,396069,1,0,1,1,0,1
2023-06-01,26716,8,1,9,4,1,4
2023-06-01,32077,4,0,4,3,0,3
2023-06-01,17289,5,0,5,2,0,2
2023-06-01,397133,1,0,1,1,0,1
2023-06-01,26158,2,0,2,3,0,3
2023-06-01,394759,3,0,3,2,0,2
2023-06-01,395262,1,1,2,2,1,3
2023-06-01,397865,6,0,6,3,0,3
2023-06-01,394665,1,0,1,3,0,3
2023-06-01,393578,1,0,1,2,0,2
2023-06-01,40203,1,0,1,3,0,3
2023-06-01,394628,3,1,4,3,1,3
2023-06-01,394620,4,0,4,4,0,4
2023-06-01,394850,1,0,1,3,0,3
2023-06-01,19120,1,0,1,1,0,1
2023-06-01,394683,1,1,2,2,1,2
2023-06-01,393808,2,0,2,2,0,2
2023-06-01,62194,16,0,16,5,0,5
2023-06-01,38016,1,3,4,9,7,11
2023-06-01,50154,1,0,1,1,0,1
2023-06-01,7345,45,1,46,6,2,6
2023-06-01,16466,11,0,11,6,0,6
2023-06-01,10475,1,0,1,2,0,2
2023-06-01,19165,52,20,72,13,8,13
2023-06-01,53903,9,0,9,2,0,2
2023-06-01,46299,1,0,1,1,0,1
2023-06-01,21780,1,0,1,3,0,3
2023-06-01,20300,6,0,6,1,0,1
2023-06-01,394797,1,0,1,1,0,1
2023-06-01,204594,2,0,2,2,0,2
2023-06-01,203268,8,0,8,3,0,3
2023-06-01,5786,199,1,200,1,1,1
2023-06-01,32870,3,0,3,1,0,1
2023-06-01,1204,25,0,25,5,0,5
2023-06-01,132909,1,0,1,1,0,1
2023-06-01,9348,1,0,1,1,0,1
2023-06-01,19399,15,1,16,4,2,4
2023-06-01,33091,3,0,3,3,0,3
2023-06-01,394395,3,0,3,1,0,1
2023-06-01,42175,3,1,4,4,3,4
2023-06-01,1657,14,1,15,3,1,3
2023-06-01,53380,5,0,5,3,0,3
2023-06-01,22834,1,1,2,3,2,3
2023-06-01,43375,3,0,3,2,0,2
2023-06-01,22498,7,0,7,3,0,3
2023-06-01,62490,6,0,6,1,0,1
2023-06-01,64217,2,0,2,2,0,2
2023-06-01,399239,4,0,4,1,0,1
2023-06-01,398803,5,0,5,1,0,1
2023-06-01,399027,1,0,1,1,0,1
2023-06-01,54878,1,0,1,1,0,1
2023-06-01,398735,2,1,3,1,1,1
2023-06-01,64209,4,0,4,1,0,1
2023-06-01,398903,1,1,2,1,1,1
2023-06-01,395306,1,0,1,1,0,1
2023-06-01,54277,2,0,2,2,0,2
2023-06-01,13573,1,0,1,3,0,3
2023-06-01,270147,1,1,2,1,1,1
2023-06-01,400329,1,0,1,1,0,1
2023-06-01,54746,4,0,4,1,0,1
2023-06-01,33196,1,0,1,3,0,3
2023-06-01,33133,14,0,14,4,0,4
2023-06-01,394066,2,0,2,1,0,1
2023-06-01,398857,1,0,1,1,0,1
2023-06-01,394786,3,0,3,1,0,1
2023-06-01,53633,3,0,3,3,0,3
2023-06-01,398923,1,0,1,2,0,2
2023-06-01,399255,1,0,1,1,0,1
2023-06-01,398180,3,0,3,1,0,1
2023-06-01,397494,6,6,12,7,3,7
2023-06-01,60759,5,0,5,1,0,1
2023-06-01,399374,6,0,6,1,0,1
2023-06-01,54337,3,0,3,5,0,5
2023-06-01,211474,1,0,1,1,0,1
2023-06-01,397860,2,0,2,2,0,2
2023-06-01,40678,1,0,1,3,0,3
2023-06-01,26367,7,0,7,6,0,6
2023-06-01,26649,3,0,3,1,0,1
2023-06-01,13325,9,0,9,4,0,4
2023-06-01,19933,1,0,1,3,0,3
2023-06-01,58686,1,0,1,1,0,1
2023-06-01,2894,23,0,23,4,0,4
2023-06-01,398086,1,0,1,2,0,2
2023-06-01,1556,5,0,5,1,0,1
2023-06-01,1555,5,0,5,2,0,2
2023-06-01,1501,97,0,97,2,0,2
2023-06-01,1568,3,0,3,1,0,1
2023-06-01,1567,2,0,2,1,0,1
2023-06-01,1563,3,0,3,1,0,1
2023-06-01,1566,1,0,1,1,0,1
2023-06-01,54226,3,0,3,3,0,3
2023-06-01,40625,5,0,5,3,0,3
2023-06-01,22174,1,0,1,3,0,3
2023-06-01,396259,14,0,14,2,0,2
2023-06-01,399106,4,0,4,1,0,1
2023-06-01,14241,11,0,11,2,0,2
2023-06-01,399363,5,0,5,1,0,1
2023-06-01,395926,2,0,2,2,0,2
2023-06-01,400025,2,0,2,1,0,1
2023-06-01,53449,4,1,5,3,2,3
2023-06-01,135295,4,0,4,1,0,1
2023-06-01,15357,1,0,1,1,0,1
2023-06-01,32225,3,0,3,5,0,5
2023-06-01,202276,23,14,37,5,5,5
2023-06-01,33235,3,0,3,2,0,2
2023-06-01,46453,14,1,15,5,1,5
2023-06-01,55873,4,0,4,3,0,3
2023-06-01,186,1,0,1,2,0,2
2023-06-01,3606,13,0,13,3,0,3
2023-06-01,396484,1,0,1,3,0,3
2023-06-01,10255,9,2,11,1,1,1
2023-06-01,14836,9,0,9,3,0,3
2023-06-01,399697,3,0,3,3,0,3
2023-06-01,26557,4,0,4,3,0,3
2023-06-01,19184,3,0,3,1,0,1
2023-06-01,6075,197,0,197,6,0,6
2023-06-01,55282,1,0,1,4,0,4
2023-06-01,2850,1,0,1,1,0,1
2023-06-01,13783,7,0,7,4,0,4
2023-06-01,393337,20,0,20,2,0,2
2023-06-01,33670,12,0,12,1,0,1
2023-06-01,131468,1,0,1,2,0,2
2023-06-01,15991,18,1,19,2,2,2
2023-06-01,1781,7,0,7,4,0,4
2023-06-01,1704,4,0,4,4,0,4
2023-06-01,20258,34,0,34,9,0,9
2023-06-01,26100,3,0,3,4,2,4
2023-06-01,16550,3,0,3,1,0,1
2023-06-01,688,3,0,3,1,0,1
2023-06-01,596,1,0,1,1,0,1
2023-06-01,40327,1,0,1,3,0,3
2023-06-01,397647,1,0,1,2,0,2
2023-06-01,400170,2,1,3,1,1,1
2023-06-01,26214,1,0,1,1,0,1
2023-06-01,397491,1,0,1,2,0,2
2023-06-01,397891,1,0,1,2,0,2
2023-06-01,395679,2,0,2,1,0,1
2023-06-01,21698,2,0,2,1,0,1
2023-06-01,394098,4,0,4,4,0,4
2023-06-01,396871,4,2,6,4,1,4
2023-06-01,394048,1,0,1,1,0,1
2023-06-01,46626,9,0,9,1,0,1
2023-06-01,40956,3,0,3,3,0,3
2023-06-01,19186,3,0,3,5,0,5
2023-06-01,15131,3,0,3,2,0,2
2023-06-01,32307,11,2,13,3,3,3
2023-06-01,33350,6,0,6,3,0,3
2023-06-01,19737,1,0,1,2,0,2
2023-06-01,398451,1,1,2,1,1,1
2023-06-01,19464,3,0,3,3,0,3
2023-06-01,400371,2,0,2,1,0,1
2023-06-01,397118,3,0,3,1,0,1
2023-06-01,22480,7,0,7,1,0,1
2023-06-01,21681,2,0,2,2,0,2
2023-06-01,21891,3,0,3,1,0,1
2023-06-01,6553,6,0,6,2,0,2
2023-06-01,32028,0,0,0,2,0,2
2023-06-01,21515,1,0,1,4,0,4
2023-06-01,62637,6,0,6,1,0,1
2023-06-01,27219,1,0,1,2,0,2
2023-06-01,32136,2,0,2,4,0,4
2023-06-01,2641,6,0,6,3,0,3
2023-06-01,7610,1,1,2,7,1,7
2023-06-01,7472,8,0,8,1,0,1
2023-06-01,20868,15,0,15,2,0,2
2023-06-01,10564,16,0,16,1,0,1
2023-06-01,54886,2,0,2,2,0,2
2023-06-01,32180,2,0,2,1,0,1
2023-06-01,398914,1,0,1,4,0,4
2023-06-01,22303,1,1,2,2,2,2
2023-06-01,62810,1,1,2,4,4,4
2023-06-01,395871,1,0,1,2,0,2
2023-06-01,33153,3,0,3,3,0,3
2023-06-01,6056,3,0,3,3,0,3
2023-06-01,32818,1,0,1,3,0,3
2023-06-01,7860,1,1,2,3,1,3
2023-06-01,13485,12,0,12,3,0,3
2023-06-01,9619,7,4,11,4,4,4
2023-06-01,1411,20,0,20,4,0,4
2023-06-01,45128,1,1,2,1,1,1
2023-06-01,36982,8,2,10,1,1,1
2023-06-01,20343,13,0,13,2,0,2
2023-06-01,394917,5,0,5,2,0,2
2023-06-01,63435,9,0,9,6,0,6
2023-06-01,21545,7,1,8,1,1,1
2023-06-01,32361,5,3,8,2,2,2
2023-06-01,22323,5,0,5,2,0,2
2023-06-01,54192,3,0,3,1,0,1
2023-06-01,257,11,6,17,2,1,2
2023-06-01,21708,3,0,3,1,0,1
2023-06-01,46425,2,0,2,3,0,3
2023-06-01,14212,8,2,10,1,1,1
2023-06-01,29878,3,1,4,2,1,2
2023-06-01,393282,7,2,9,1,1,1
2023-06-01,11399,2,4,6,2,2,2
2023-06-01,58877,1,1,2,1,1,1
2023-06-01,14981,1,0,1,2,0,2
2023-06-01,399366,1,0,1,3,0,3
2023-06-01,399371,2,0,2,4,0,4
2023-06-01,399367,1,0,1,3,0,3
2023-06-01,400089,2,0,2,4,0,4
2023-06-01,399529,1,0,1,3,0,3
2023-06-01,399370,1,0,1,4,0,4
2023-06-01,399369,1,0,1,3,0,3
2023-06-01,399368,1,0,1,3,0,3
2023-06-01,399364,1,0,1,3,0,3
2023-06-01,399713,1,0,1,2,0,2
2023-06-01,399714,1,0,1,3,0,3
2023-06-01,399365,1,0,1,3,0,3
2023-06-01,395586,1,0,1,4,0,4
2023-06-01,339586,1,0,1,2,0,2
2023-06-01,395259,2,0,2,3,0,3
2023-06-01,63160,1,0,1,3,0,3
2023-06-01,36857,7,0,7,2,0,2
2023-06-01,18108,6,0,6,2,0,2
2023-06-01,17336,3,0,3,2,0,2
2023-06-01,61153,10,0,10,1,0,1
2023-06-01,12079,8,9,17,1,2,2
2023-06-01,15806,3,1,4,6,3,6
2023-06-01,1347,6,0,6,1,0,1
2023-06-01,7821,49,0,49,1,0,1
2023-06-01,1712,39,2,41,2,2,2
2023-06-01,199116,1,1,2,1,1,1
2023-06-01,11985,9,11,20,4,4,4
2023-06-01,3911,26,0,26,10,0,10
2023-06-01,7355,1,0,1,2,0,2
2023-06-01,201773,2,0,2,1,0,1
2023-06-01,11700,13,0,13,6,0,6
2023-06-01,1776,1,0,1,1,0,1
2023-06-01,14263,7,1,8,10,2,10
2023-06-01,11607,1,0,1,2,0,2
2023-06-01,33189,5,1,6,11,4,12
2023-06-01,24434,1,0,1,1,0,1
2023-06-01,399592,1,0,1,1,0,1
2023-06-01,397903,2,0,2,1,0,1
2023-06-01,49586,3,1,4,2,2,2
2023-06-01,204777,1,0,1,3,0,3
2023-06-01,5663,14,0,14,2,0,2
2023-06-01,21633,3,0,3,1,0,1
2023-06-01,7774,2,1,3,3,1,3
2023-06-01,637,306,0,306,5,0,5
2023-06-01,27495,16,0,16,3,0,3
2023-06-01,27570,2,0,2,1,0,1
2023-06-01,6468,11,0,11,10,0,10
2023-06-01,7834,28,0,28,1,0,1
2023-06-01,26462,2,1,3,6,4,6
2023-06-01,3755,5,1,6,6,4,6
2023-06-01,30237,3,0,3,1,0,1
2023-06-01,220,1,0,1,1,0,1
2023-06-01,264527,8,0,8,3,0,3
2023-06-01,52349,13,0,13,3,0,3
2023-06-01,264528,6,6,12,5,2,5
2023-06-01,264539,3,1,4,4,1,4
2023-06-01,264529,5,0,5,4,0,4
2023-06-01,262458,5,1,6,5,1,6
2023-06-01,262755,26,1,27,8,3,8
2023-06-01,264530,5,0,5,1,0,1
2023-06-01,262369,33,12,45,2,2,2
2023-06-01,264542,7,3,10,3,2,3
2023-06-01,52426,34,0,34,2,0,2
2023-06-01,264545,3,0,3,3,0,3
2023-06-01,263521,1,0,1,2,0,2
2023-06-01,264536,14,3,17,1,1,1
2023-06-01,264540,5,0,5,2,0,2
2023-06-01,264541,7,1,8,4,2,4
2023-06-01,53076,2,0,2,3,0,3
2023-06-01,264537,1,0,1,1,0,1
2023-06-01,262407,4,1,5,2,1,2
2023-06-01,273603,0,0,0,2,0,2
2023-06-01,262216,7,0,7,4,0,4
2023-06-01,270944,4,51,55,3,2,3
2023-06-01,264544,3,1,4,8,6,8
2023-06-01,272014,3,0,3,1,0,1
2023-06-01,272957,1,0,1,1,0,1
2023-06-01,266846,1,0,1,1,0,1
2023-06-01,264548,4,1,5,4,1,4
2023-06-01,267454,4,2,6,3,1,3
2023-06-01,264549,8,0,8,1,0,1
2023-06-01,264547,8,1,9,2,1,3
2023-06-01,264550,5,6,11,5,3,5
2023-06-01,264551,6,8,14,2,1,2
2023-06-01,264566,7,1,8,3,1,3
2023-06-01,52236,10,0,10,2,0,2
2023-06-01,264555,6,1,7,8,4,8
2023-06-01,264557,5,2,7,3,2,3
2023-06-01,52612,11,3,14,5,3,5
2023-06-01,263592,8,2,10,1,1,1
2023-06-01,271564,3,3,6,5,4,5
2023-06-01,263736,9,0,9,2,0,2
2023-06-01,28131,16,5,21,6,4,6
2023-06-01,264553,5,0,5,2,0,2
2023-06-01,264559,3,0,3,2,0,2
2023-06-01,264573,4,1,5,3,3,4
2023-06-01,264850,5,1,6,1,1,1
2023-06-01,264561,5,0,5,2,0,2
2023-06-01,1215,3,1,4,1,1,1
2023-06-01,1216,3,1,4,1,1,1
2023-06-01,206209,2,1,3,1,1,1
2023-06-01,4184,3,1,4,1,1,1
2023-06-01,1217,6,1,7,1,1,1
2023-06-01,23885,5,2,7,1,1,1
2023-06-01,20037,1,1,2,1,1,1
2023-06-01,38956,3,0,3,2,0,2
2023-06-01,18663,2,0,2,2,0,2
2023-06-01,4469,6,0,6,2,0,2
2023-06-01,32472,8,0,8,3,0,3
2023-06-01,5049,18,0,18,4,0,4
2023-06-01,21439,6,0,6,4,0,4
2023-06-01,3452,3,0,3,1,0,1
2023-06-01,15269,6,0,6,2,0,2
2023-06-01,18701,43,0,43,10,0,10
2023-06-01,4503,5,0,5,4,0,4
2023-06-01,395674,3,0,3,4,0,4
2023-06-01,270546,5,0,5,1,0,1
2023-06-01,270875,5,1,6,5,1,6
2023-06-01,271804,4,1,5,1,1,1
2023-06-01,52807,4,1,5,2,2,2
2023-06-01,264570,3,7,10,4,3,5
2023-06-01,53190,20,3,23,2,1,2
2023-06-01,262832,21,7,28,8,7,8
2023-06-01,52467,4,1,5,3,1,3
2023-06-01,262159,48,1,49,3,2,3
2023-06-01,264571,5,1,6,7,4,7
2023-06-01,264193,8,1,9,3,2,3
2023-06-01,265645,1,0,1,1,0,1
2023-06-01,265337,4,1,5,2,3,3
2023-06-01,264599,5,1,6,3,1,3
2023-06-01,264574,11,1,12,5,2,5
2023-06-01,264576,3,0,3,1,0,1
2023-06-01,264577,3,3,6,3,2,3
2023-06-01,263985,14,3,17,6,4,7
2023-06-01,264578,4,6,10,2,2,2
2023-06-01,264579,5,0,5,1,0,1
2023-06-01,264580,7,5,12,5,3,5
2023-06-01,263829,4,1,5,1,1,1
2023-06-01,263729,4,0,4,3,0,3
2023-06-01,28453,1,0,1,1,0,1
2023-06-01,262668,38,0,38,8,0,8
2023-06-01,52717,22,0,22,1,0,1
2023-06-01,52610,3,0,3,1,0,1
2023-06-01,263554,10,1,11,1,1,1
2023-06-01,52968,16,11,27,4,3,4
2023-06-01,264584,7,5,12,3,3,3
2023-06-01,262535,35,1,36,6,5,6
2023-06-01,264585,7,2,9,1,1,1
2023-06-01,264586,5,1,6,1,2,2
2023-06-01,264591,3,1,4,3,1,3
2023-06-01,264587,4,0,4,3,0,3
2023-06-01,264220,1,0,1,2,0,2
2023-06-01,265704,11,1,12,7,1,7
2023-06-01,264588,5,4,9,4,2,4
2023-06-01,262814,41,1,42,5,1,5
2023-06-01,19089,113,5,118,3,1,3
2023-06-01,198864,6,3,9,1,1,1
2023-06-01,23503,15,1,16,5,2,7
2023-06-01,17347,7,0,7,3,0,3
2023-06-01,5665,5,0,5,1,0,1
2023-06-01,200933,1,0,1,2,0,2
2023-06-01,11747,2,0,2,1,0,1
2023-06-01,398132,1,0,1,1,0,1
2023-06-01,46106,4,0,4,2,0,2
2023-06-01,395437,85,0,85,4,0,4
2023-06-01,398178,1,0,1,2,0,2
2023-06-01,397774,1,1,2,1,1,1
2023-06-01,397343,5,0,5,2,0,2
2023-06-01,397414,1,0,1,2,0,2
2023-06-01,397304,3,0,3,2,0,2
2023-06-01,20416,2,0,2,3,0,3
2023-06-01,19564,3,2,5,2,1,2
2023-06-01,263739,4,2,6,3,3,3
2023-06-01,263821,9,1,10,1,1,1
2023-06-01,269788,4,0,4,4,0,4
2023-06-01,264603,1,1,2,3,3,3
2023-06-01,264596,3,4,7,4,3,5
2023-06-01,264597,7,0,7,6,0,6
2023-06-01,264594,4,1,5,2,1,2
2023-06-01,52887,1,1,2,3,3,3
2023-06-01,264153,5,2,7,1,1,1
2023-06-01,264604,1,1,2,1,1,1
2023-06-01,264094,3,0,3,3,0,3
2023-06-01,264093,4,2,6,3,2,3
2023-06-01,264602,8,1,9,2,2,2
2023-06-01,27720,19,1,20,12,5,12
2023-06-01,11562,148,1,149,8,1,8
2023-06-01,53222,19,9,28,6,4,6
2023-06-01,270994,6,1,7,1,1,1
2023-06-01,270870,5,7,12,2,1,2
2023-06-01,15256,13,1,14,7,1,7
2023-06-01,263732,7,3,10,2,2,2
2023-06-01,52268,23,1,24,2,2,2
2023-06-01,263746,2,0,2,1,0,1
2023-06-01,270816,4,1,5,3,3,5
2023-06-01,264104,2,0,2,1,0,1
2023-06-01,264103,3,2,5,3,3,4
2023-06-01,263735,5,1,6,1,1,1
2023-06-01,264116,3,1,4,4,2,4
2023-06-01,264110,5,4,9,2,1,2
2023-06-01,264119,1,1,2,5,3,5
2023-06-01,270052,5,0,5,1,0,1
2023-06-01,264114,7,6,13,2,1,2
2023-06-01,263154,4,1,5,3,3,3
2023-06-01,61775,5,1,6,3,4,4
2023-06-01,264214,4,13,17,3,3,3
2023-06-01,52858,7,11,18,3,2,4
2023-06-01,263438,3,0,3,5,0,5
2023-06-01,20981,1,0,1,2,0,2
2023-06-01,36704,2,0,2,1,0,1
2023-06-01,22907,3,0,3,4,0,4
2023-06-01,30013,6,3,9,2,1,2
2023-06-01,2041,2,0,2,1,0,1
2023-06-01,24433,4,0,4,1,0,1
2023-06-01,396087,1,0,1,2,0,2
2023-06-01,58611,3,0,3,1,0,1
2023-06-01,400629,1,0,1,3,0,3
2023-06-01,400421,1,0,1,3,0,3
2023-06-01,400220,22,1,23,2,2,2
2023-06-01,15295,1,0,1,2,0,2
2023-06-01,7386,2,0,2,3,0,3
2023-06-01,11482,2,0,2,3,0,3
2023-06-01,28360,70,6,76,9,6,10
2023-06-01,52312,7,0,7,1,0,1
2023-06-01,264123,2,2,4,1,1,1
2023-06-01,264101,7,1,8,3,1,3
2023-06-01,264108,3,1,4,4,2,4
2023-06-01,264107,4,1,5,1,1,1
2023-06-01,262880,11,3,14,6,6,6
2023-06-01,270930,3,1,4,2,2,2
2023-06-01,262720,38,1,39,8,4,8
2023-06-01,264125,5,0,5,3,0,3
2023-06-01,264124,7,1,8,5,3,5
2023-06-01,263749,4,6,10,3,1,3
2023-06-01,264135,3,3,6,6,5,6
2023-06-01,52833,2,0,2,1,0,1
2023-06-01,263574,3,3,6,5,4,5
2023-06-01,264152,3,3,6,2,2,2
2023-06-01,264145,4,1,5,8,2,9
2023-06-01,264136,3,0,3,1,0,1
2023-06-01,262821,26,1,27,7,3,8
2023-06-01,264134,1,0,1,1,0,1
2023-06-01,264164,14,3,17,3,3,3
2023-06-01,263589,14,3,17,5,1,5
2023-06-01,264172,3,0,3,3,0,3
2023-06-01,28397,4,0,4,2,0,2
2023-06-01,264167,2,3,5,1,1,1
2023-06-01,264166,5,0,5,2,0,2
2023-06-01,264180,1,1,2,2,2,2
2023-06-01,270876,5,0,5,2,0,2
2023-06-01,264168,7,1,8,2,1,2
2023-06-01,52655,4,1,5,1,2,2
2023-06-01,270775,5,0,5,4,0,4
2023-06-01,61581,3,3,6,2,2,2
2023-06-01,264194,5,1,6,1,1,1
2023-06-01,264174,7,1,8,2,1,2
2023-06-01,262669,90,37,127,5,3,5
2023-06-01,264177,5,1,6,1,1,1
2023-06-01,265840,1,1,2,2,1,2
2023-06-01,776,1,0,1,1,0,1
2023-06-01,262346,25,11,36,5,5,6
2023-06-01,52604,5,1,6,2,2,2
2023-06-01,264118,5,1,6,4,2,4
2023-06-01,264117,15,2,17,3,3,3
2023-06-01,271614,1,1,2,1,1,1
2023-06-01,262811,7,3,10,8,4,8
2023-06-01,264128,2,1,3,1,1,1
2023-06-01,27695,9,2,11,1,2,2
2023-06-01,264130,7,1,8,1,1,1
2023-06-01,264147,7,1,8,5,3,5
2023-06-01,264139,1,1,2,1,1,1
2023-06-01,271069,4,3,7,9,8,9
2023-06-01,270909,4,1,5,3,1,3
2023-06-01,264146,2,1,3,1,1,1
2023-06-01,264158,4,1,5,5,1,5
2023-06-01,264137,6,3,9,5,2,5
2023-06-01,264181,5,1,6,1,1,1
2023-06-01,264182,1,1,2,4,2,4
2023-06-01,264260,4,0,4,1,0,1
2023-06-01,264163,1,1,2,1,1,1
2023-06-01,264188,2,1,3,1,1,1
2023-06-01,264197,5,7,12,5,3,5
2023-06-01,272158,0,1,1,2,1,2
2023-06-01,264192,1,0,1,2,0,2
2023-06-01,52449,4,0,4,2,0,2
2023-06-01,263751,4,16,20,1,1,1
2023-06-01,264189,5,1,6,3,3,4
2023-06-01,264206,5,1,6,6,2,6
2023-06-01,65339,1,0,1,1,0,1
2023-06-01,26491,0,0,0,1,0,1
2023-06-01,264200,1,1,2,8,7,8
2023-06-01,263800,4,1,5,1,1,1
2023-06-01,264196,1,1,2,4,4,4
2023-06-01,264201,3,1,4,1,1,1
2023-06-01,264207,3,1,4,2,2,2
2023-06-01,264208,3,0,3,1,0,1
2023-06-01,61904,14,0,14,1,0,1
2023-06-01,264204,6,3,9,4,2,4
2023-06-01,264203,7,0,7,1,0,1
2023-06-01,264213,5,1,6,5,2,5
2023-06-01,263339,17,1,18,2,1,2
2023-06-01,264148,5,1,6,1,1,2
2023-06-01,265346,5,4,9,4,4,4
2023-06-01,262582,36,1,37,1,1,1
2023-06-01,263740,6,1,7,1,1,1
2023-06-01,28577,3,1,4,3,3,3
2023-06-01,52877,5,1,6,5,4,5
2023-06-01,264155,5,1,6,1,1,1
2023-06-01,264160,4,1,5,6,3,7
2023-06-01,264178,2,4,6,2,1,2
2023-06-01,264157,4,0,4,2,0,2
2023-06-01,271596,2,1,3,2,1,2
2023-06-01,271523,3,0,3,1,0,1
2023-06-01,52764,6,0,6,1,0,1
2023-06-01,53233,17,0,17,4,0,4
2023-06-01,273744,1,1,2,3,1,3
2023-06-01,270256,6,2,8,5,2,5
2023-06-01,263768,2,2,4,3,3,4
2023-06-01,19889,132,1,133,7,5,8
2023-06-01,61497,4,2,6,3,1,3
2023-06-01,53232,13,1,14,3,1,3
2023-06-01,264205,5,0,5,2,0,2
2023-06-01,271255,2,0,2,1,0,1
2023-06-01,264212,15,1,16,5,3,5
2023-06-01,264211,5,1,6,7,2,7
2023-06-01,52760,13,1,14,2,1,2
2023-06-01,27660,14,3,17,2,1,2
2023-06-01,270744,5,2,7,2,1,2
2023-06-01,262307,6,0,6,1,0,1
2023-06-01,262374,11,2,13,6,5,6
2023-06-01,1290,9,1,10,3,1,3
2023-06-01,202116,5,0,5,4,0,4
2023-06-01,396290,17,0,17,2,0,2
2023-06-01,396128,1,0,1,1,0,1
2023-06-01,198578,12,0,12,1,0,1
2023-06-01,33004,25,1,26,4,3,4
2023-06-01,17108,2,1,3,3,1,3
2023-06-01,263765,13,1,14,2,1,2
2023-06-01,265755,1,0,1,1,0,1
2023-06-01,27984,9,1,10,3,3,3
2023-06-01,264225,4,0,4,4,0,4
2023-06-01,269980,6,5,11,2,1,2
2023-06-01,270900,4,2,6,2,2,2
2023-06-01,271328,5,7,12,8,6,8
2023-06-01,263757,5,1,6,3,2,3
2023-06-01,61441,2,0,2,2,0,2
2023-06-01,264229,3,1,4,2,1,2
2023-06-01,264224,3,7,10,3,1,3
2023-06-01,264235,3,2,5,1,1,1
2023-06-01,264236,6,2,8,1,1,2
2023-06-01,264232,4,0,4,4,0,4
2023-06-01,262146,8,1,9,3,1,3
2023-06-01,52996,2,1,3,1,1,1
2023-06-01,17069,68,1,69,4,1,4
2023-06-01,264233,6,3,9,2,1,2
2023-06-01,61572,2,1,3,3,2,3
2023-06-01,61498,3,1,4,3,2,5
2023-06-01,263761,4,1,5,2,3,3
2023-06-01,264242,7,33,40,1,1,1
2023-06-01,265831,16,0,16,2,0,2
2023-06-01,264234,3,0,3,4,0,4
2023-06-01,52367,33,0,33,1,0,1
2023-06-01,262168,17,1,18,3,1,3
2023-06-01,271851,1,0,1,1,0,1
2023-06-01,264237,3,2,5,2,2,2
2023-06-01,264239,5,7,12,1,1,1
2023-06-01,264244,1,3,4,3,1,3
2023-06-01,262336,21,3,24,1,1,1
2023-06-01,264251,4,0,4,1,0,1
2023-06-01,270548,7,2,9,6,4,8
2023-06-01,262377,6,1,7,1,2,3
2023-06-01,264254,1,0,1,1,0,1
2023-06-01,270660,7,0,7,2,0,2
2023-06-01,269989,4,4,8,1,1,1
2023-06-01,270655,3,0,3,1,0,1
2023-06-01,28151,16,0,16,3,0,3
2023-06-01,270661,1,1,2,2,1,2
2023-06-01,270650,7,17,24,1,1,1
2023-06-01,270651,4,1,5,2,1,2
2023-06-01,270662,4,0,4,3,0,3
2023-06-01,52631,9,1,10,10,3,10
2023-06-01,270663,5,0,5,2,0,2
2023-06-01,262591,13,1,14,5,6,7
2023-06-01,262290,16,28,44,6,4,6
2023-06-01,52846,14,1,15,1,1,1
2023-06-01,262741,31,3,34,3,3,3
2023-06-01,264247,5,15,20,4,3,4
2023-06-01,264259,3,2,5,3,3,3
2023-06-01,265369,8,6,14,5,5,6
2023-06-01,52431,12,2,14,7,2,7
2023-06-01,264249,4,0,4,6,0,6
2023-06-01,264246,7,0,7,6,0,6
2023-06-01,264248,7,3,10,5,3,5
2023-06-01,264258,5,0,5,2,0,2
2023-06-01,262394,27,2,29,4,3,4
2023-06-01,262485,24,1,25,6,7,8
2023-06-01,263164,5,1,6,4,4,5
2023-06-01,53171,3,1,4,1,1,1
2023-06-01,264253,2,0,2,1,0,1
2023-06-01,52708,10,1,11,5,1,5
2023-06-01,263781,4,1,5,6,3,6
2023-06-01,264257,5,0,5,3,0,3
2023-06-01,28287,120,26,146,2,1,2
2023-06-01,262500,14,3,17,3,1,3
2023-06-01,262638,6,3,9,1,1,1
2023-06-01,271036,7,1,8,3,2,3
2023-06-01,262252,8,1,9,3,3,3
2023-06-01,28638,11,5,16,1,1,1
2023-06-01,52799,21,0,21,4,0,4
2023-06-01,262448,10,1,11,4,2,4
2023-06-01,264268,2,1,3,1,2,2
2023-06-01,264264,3,0,3,1,0,1
2023-06-01,264067,6,3,9,1,1,1
2023-06-01,264272,3,2,5,2,2,2
2023-06-01,264262,1,1,2,1,1,1
2023-06-01,264265,6,3,9,1,1,1
2023-06-01,270073,4,0,4,3,0,3
2023-06-01,264263,5,0,5,2,0,2
2023-06-01,264738,16,32,48,4,2,4
2023-06-01,263780,10,1,11,2,1,2
2023-06-01,263578,17,1,18,2,1,2
2023-06-01,264267,5,0,5,1,0,1
2023-06-01,264266,1,1,2,1,1,1
2023-06-01,28183,67,17,84,2,1,2
2023-06-01,264283,1,0,1,2,0,2
2023-06-01,264269,3,0,3,1,0,1
2023-06-01,264282,4,0,4,1,0,1
2023-06-01,264284,5,6,11,3,3,3
2023-06-01,61499,4,0,4,4,0,4
2023-06-01,14867,0,0,0,2,0,2
2023-06-01,27975,82,1,83,7,1,7
2023-06-01,264274,3,19,22,2,3,3
2023-06-01,264290,15,1,16,6,5,6
2023-06-01,264286,3,0,3,2,0,2
2023-06-01,264289,1,1,2,7,6,7
2023-06-01,271623,5,1,6,2,2,2
2023-06-01,270891,2,3,5,1,1,1
2023-06-01,264280,7,1,8,7,4,7
2023-06-01,262606,24,1,25,11,5,12
2023-06-01,264278,4,0,4,1,0,1
2023-06-01,264281,8,7,15,1,1,1
2023-06-01,264285,3,3,6,6,2,6
2023-06-01,52427,3,1,4,5,1,5
2023-06-01,19315,3,0,3,3,0,3
2023-06-01,61500,4,0,4,3,0,3
2023-06-01,263789,1,1,2,2,2,2
2023-06-01,263848,1,1,2,1,1,1
2023-06-01,263784,1,0,1,1,0,1
2023-06-01,263775,5,0,5,4,0,4
2023-06-01,263790,1,0,1,1,0,1
2023-06-01,269993,9,0,9,3,0,3
2023-06-01,264295,15,3,18,7,5,7
2023-06-01,263755,4,1,5,2,1,2
2023-06-01,264294,3,3,6,8,5,8
2023-06-01,262274,4,2,6,4,4,4
2023-06-01,264300,2,1,3,1,1,1
2023-06-01,28317,14,0,14,3,0,3
2023-06-01,265766,0,0,0,2,0,2
2023-06-01,52821,6,3,9,4,4,5
2023-06-01,264298,2,0,2,1,0,1
2023-06-01,264299,6,1,7,1,1,1
2023-06-01,263202,2,1,3,1,1,1
2023-06-01,263395,9,3,12,4,2,4
2023-06-01,270910,7,0,7,1,0,1
2023-06-01,264302,1,2,3,2,2,2
2023-06-01,263043,9,1,10,3,1,3
2023-06-01,25832,1,0,1,2,0,2
2023-06-01,264296,1,0,1,1,0,1
2023-06-01,264301,4,2,6,2,3,3
2023-06-01,263631,7,1,8,3,2,3
2023-06-01,262656,5,1,6,2,2,2
2023-06-01,262992,11,0,11,1,0,1
2023-06-01,263782,2,0,2,2,0,2
2023-06-01,53045,13,15,28,3,2,3
2023-06-01,264323,2,1,3,1,1,2
2023-06-01,264307,2,1,3,1,1,1
2023-06-01,269974,1,0,1,1,0,1
2023-06-01,264322,7,1,8,1,1,2
2023-06-01,52865,19,9,28,4,4,4
2023-06-01,264308,4,0,4,5,0,5
2023-06-01,273616,0,1,1,4,2,4
2023-06-01,264310,3,1,4,1,1,1
2023-06-01,262683,9,0,9,3,0,3
2023-06-01,264316,2,1,3,1,1,1
2023-06-01,264315,5,0,5,1,0,1
2023-06-01,264328,6,4,10,3,2,3
2023-06-01,264318,3,2,5,1,1,1
2023-06-01,264327,3,1,4,6,3,6
2023-06-01,263035,15,2,17,9,4,10
2023-06-01,264309,1,3,4,2,2,2
2023-06-01,264324,7,1,8,5,1,5
2023-06-01,264311,7,7,14,3,3,3
2023-06-01,264331,7,1,8,1,1,1
2023-06-01,263792,10,1,11,2,1,3
2023-06-01,264312,5,0,5,2,0,2
2023-06-01,264319,5,7,12,1,1,1
2023-06-01,264320,6,0,6,2,0,2
2023-06-01,264336,7,3,10,1,1,1
2023-06-01,264337,5,0,5,1,0,1
2023-06-01,263786,13,0,13,3,0,3
2023-06-01,262518,21,2,23,7,2,7
2023-06-01,27715,181,6,187,18,4,18
2023-06-01,52653,12,6,18,1,1,1
2023-06-01,270111,1,1,2,2,1,2
2023-06-01,270122,1,0,1,1,0,1
2023-06-01,61813,5,2,7,2,2,2
2023-06-01,266747,2,0,2,4,0,4
2023-06-01,264326,3,1,4,2,2,2
2023-06-01,264341,4,0,4,1,0,1
2023-06-01,262362,9,3,12,1,1,1
2023-06-01,27955,16,0,16,5,0,5
2023-06-01,28270,15,1,16,3,1,3
2023-06-01,263796,2,0,2,1,0,1
2023-06-01,262590,9,0,9,1,0,1
2023-06-01,28378,31,0,31,1,0,1
2023-06-01,211909,3,0,3,2,0,2
2023-06-01,24840,6,3,9,3,4,4
2023-06-01,47769,3,1,4,2,2,2
2023-06-01,47920,1,0,1,1,0,1
2023-06-01,200675,3,1,4,8,6,8
2023-06-01,46456,7,0,7,3,0,3
2023-06-01,396264,6,0,6,2,0,2
2023-06-01,396000,2,0,2,4,0,4
2023-06-01,17326,5,1,6,2,1,2
2023-06-01,14762,14,0,14,3,0,3
2023-06-01,5540,3,0,3,3,0,3
2023-06-01,627,6,0,6,2,0,2
2023-06-01,724,0,0,0,2,0,2
2023-06-01,665,48,0,48,2,0,2
2023-06-01,616,5,0,5,2,0,2
2023-06-01,5839,29,0,29,1,0,1
2023-06-01,647,340,0,340,2,0,2
2023-06-01,262916,273,3,276,4,1,4
2023-06-01,263838,3,1,4,1,1,1
2023-06-01,399382,2,1,3,3,1,4
2023-06-01,264333,4,0,4,1,0,1
2023-06-01,264338,3,1,4,1,1,1
2023-06-01,264334,1,0,1,1,0,1
2023-06-01,52540,6,3,9,3,3,3
2023-06-01,263657,5,0,5,1,0,1
2023-06-01,264340,3,1,4,1,1,1
2023-06-01,263806,1,0,1,1,0,1
2023-06-01,270919,1,1,2,1,1,1
2023-06-01,264343,2,0,2,3,0,3
2023-06-01,52364,5,0,5,1,0,1
2023-06-01,28293,26,1,27,10,4,10
2023-06-01,270877,5,1,6,7,3,7
2023-06-01,264346,7,0,7,5,0,5
2023-06-01,263760,4,0,4,2,0,2
2023-06-01,28066,11,0,11,2,0,2
2023-06-01,61910,11,3,14,4,2,4
2023-06-01,263914,4,4,8,1,1,1
2023-06-01,266482,7,1,8,3,2,3
2023-06-01,263439,12,3,15,2,1,2
2023-06-01,263805,4,1,5,2,1,2
2023-06-01,264345,7,1,8,5,3,5
2023-06-01,263846,3,1,4,1,1,1
2023-06-01,263845,3,1,4,3,2,3
2023-06-01,264342,6,3,9,4,3,4
2023-06-01,262604,28,3,31,4,1,4
2023-06-01,262748,29,2,31,2,1,2
2023-06-01,28152,32,0,32,4,0,4
2023-06-01,61862,2,1,3,1,1,1
2023-06-01,52819,5,0,5,6,2,6
2023-06-01,264348,1,0,1,3,0,3
2023-06-01,28255,13,5,18,3,3,5
2023-06-01,263847,3,1,4,4,3,4
2023-06-01,263849,5,1,6,1,1,1
2023-06-01,263704,3,3,6,3,1,3
2023-06-01,52389,2,1,3,4,1,4
2023-06-01,28104,14,0,14,1,0,1
2023-06-01,262944,8,0,8,2,0,2
2023-06-01,263921,3,3,6,1,1,1
2023-06-01,262241,23,0,23,3,0,3
2023-06-01,272874,3,1,4,2,3,3
2023-06-01,264660,6,1,7,1,1,1
2023-06-01,263772,4,0,4,4,0,4
2023-06-01,27796,34,3,37,11,5,11
2023-06-01,263873,1,1,2,1,1,1
2023-06-01,263861,1,3,4,2,2,2
2023-06-01,263852,1,0,1,2,0,2
2023-06-01,263858,7,3,10,5,3,5
2023-06-01,264066,1,1,2,1,1,1
2023-06-01,28405,4,0,4,3,0,3
2023-06-01,263863,1,0,1,1,0,1
2023-06-01,263853,14,0,14,2,0,2
2023-06-01,270076,2,0,2,2,0,2
2023-06-01,262622,8,0,8,3,0,3
2023-06-01,263855,7,2,9,5,1,5
2023-06-01,14709,53,0,53,2,0,2
2023-06-01,263857,4,4,8,2,1,2
2023-06-01,262927,2,0,2,3,0,3
2023-06-01,263866,4,1,5,1,1,1
2023-06-01,264681,27,0,27,4,0,4
2023-06-01,263867,5,0,5,1,0,1
2023-06-01,262575,7,0,7,1,0,1
2023-06-01,264651,4,0,4,1,0,1
2023-06-01,263818,4,0,4,2,0,2
2023-06-01,265389,6,2,8,5,4,6
2023-06-01,263868,7,0,7,1,0,1
2023-06-01,263864,10,1,11,6,1,6
2023-06-01,263802,4,0,4,2,0,2
2023-06-01,262573,10,3,13,1,1,1
2023-06-01,263874,1,1,2,1,3,3
2023-06-01,263870,4,0,4,1,0,1
2023-06-01,263830,1,0,1,1,0,1
2023-06-01,263827,1,0,1,2,0,2
2023-06-01,21727,1,0,1,4,0,4
2023-06-01,31564,2,1,3,7,3,7
2023-06-01,212424,2,1,3,5,5,6
2023-06-01,22700,3,0,3,3,0,3
2023-06-01,264759,9,1,10,5,5,6
2023-06-01,263777,22,1,23,5,1,5
2023-06-01,27792,41,1,42,4,1,4
2023-06-01,263967,4,4,8,1,1,1
2023-06-01,263878,3,3,6,3,2,3
2023-06-01,266410,4,2,6,4,3,4
2023-06-01,262790,9,3,12,3,1,3
2023-06-01,263557,7,15,22,2,2,2
2023-06-01,272221,0,1,1,4,3,4
2023-06-01,271247,6,4,10,8,7,11
2023-06-01,263902,5,0,5,2,0,2
2023-06-01,263882,3,0,3,1,0,1
2023-06-01,263895,2,1,3,1,1,1
2023-06-01,263886,1,0,1,2,0,2
2023-06-01,263884,5,0,5,1,0,1
2023-06-01,263885,2,0,2,1,0,1
2023-06-01,262523,9,1,10,2,2,2
2023-06-01,264788,1,2,3,2,1,2
2023-06-01,263795,8,0,8,5,0,5
2023-06-01,263897,6,3,9,5,4,5
2023-06-01,263898,5,1,6,4,2,4
2023-06-01,263906,3,16,19,4,3,4
2023-06-01,263887,4,0,4,4,0,4
2023-06-01,265096,5,1,6,3,2,4
2023-06-01,263896,7,1,8,2,1,2
2023-06-01,263900,4,6,10,1,1,1
2023-06-01,263808,5,0,5,2,0,2
2023-06-01,263811,5,0,5,2,0,2
2023-06-01,270773,4,0,4,3,0,3
2023-06-01,263911,5,0,5,1,0,1
2023-06-01,263912,14,0,14,2,0,2
2023-06-01,263907,3,7,10,1,1,1
2023-06-01,263918,6,1,7,1,1,1
2023-06-01,263904,7,7,14,2,3,3
2023-06-01,263905,14,3,17,1,1,1
2023-06-01,28407,2,0,2,1,0,1
2023-06-01,61890,24,3,27,6,5,6
2023-06-01,263915,7,1,8,3,1,3
2023-06-01,61506,5,1,6,2,1,2
2023-06-01,263913,6,3,9,3,2,3
2023-06-01,61494,1,0,1,1,0,1
2023-06-01,61520,1,0,1,1,0,1
2023-06-01,64104,2,0,2,2,0,2
2023-06-01,207730,2,0,2,1,0,1
2023-06-01,10100,48,4,52,14,6,14
2023-06-01,21549,14,0,14,4,0,4
2023-06-01,19858,2,0,2,4,0,4
2023-06-01,26741,1,0,1,3,0,3
2023-06-01,29817,3,0,3,1,0,1
2023-06-01,59121,3,0,3,3,0,3
2023-06-01,808,53,0,53,2,0,2
2023-06-01,61495,1,0,1,1,0,1
2023-06-01,61504,1,1,2,1,1,1
2023-06-01,52404,1,0,1,2,0,2
2023-06-01,14232,24,1,25,3,1,3
2023-06-01,263814,2,0,2,1,0,1
2023-06-01,263937,3,0,3,1,0,1
2023-06-01,270947,1,3,4,1,2,2
2023-06-01,263927,1,0,1,1,0,1
2023-06-01,28411,12,0,12,3,0,3
2023-06-01,263939,7,3,10,8,4,8
2023-06-01,263933,1,1,2,1,1,1
2023-06-01,263924,6,5,11,1,1,1
2023-06-01,52510,3,1,4,1,1,2
2023-06-01,61508,3,1,4,3,3,3
2023-06-01,52812,2,3,5,1,1,1
2023-06-01,61940,5,1,6,6,3,6
2023-06-01,53124,11,1,12,3,2,3
2023-06-01,263942,5,1,6,2,1,2
2023-06-01,263941,2,1,3,4,3,4
2023-06-01,52770,9,1,10,4,3,4
2023-06-01,263925,5,1,6,1,1,1
2023-06-01,263926,3,1,4,3,3,3
2023-06-01,263928,4,2,6,4,2,4
2023-06-01,263930,2,2,4,1,1,1
2023-06-01,28273,8,0,8,6,0,6
2023-06-01,53061,3,1,4,6,3,7
2023-06-01,263929,3,6,9,3,1,3
2023-06-01,263931,4,0,4,2,0,2
2023-06-01,262817,14,1,15,1,1,1
2023-06-01,263820,4,0,4,3,0,3
2023-06-01,264017,3,1,4,7,3,7
2023-06-01,263954,4,1,5,1,1,1
2023-06-01,263932,7,1,8,3,2,3
2023-06-01,263946,6,1,7,8,2,9
2023-06-01,263943,8,0,8,3,0,3
2023-06-01,262649,41,1,42,6,3,6
2023-06-01,263823,6,0,6,2,0,2
2023-06-01,263963,12,0,12,2,0,2
2023-06-01,263962,3,1,4,1,1,1
2023-06-01,263826,10,4,14,4,3,4
2023-06-01,264611,4,0,4,2,0,2
2023-06-01,263948,7,6,13,4,3,4
2023-06-01,264634,4,0,4,1,0,1
2023-06-01,264064,4,1,5,1,1,1
2023-06-01,10497,12,1,13,4,2,4
2023-06-01,54484,1,0,1,1,0,1
2023-06-01,63146,1,0,1,2,0,2
2023-06-01,13336,14,0,14,3,0,3
2023-06-01,400301,5,0,5,1,0,1
2023-06-01,1110,1,0,1,1,0,1
2023-06-01,56736,29,1,30,1,1,1
2023-06-01,11231,32,0,32,3,0,3
2023-06-01,136990,4,0,4,3,0,3
2023-06-01,17234,1,2,3,2,2,2
2023-06-01,919,6,0,6,1,0,1
2023-06-01,942,9,0,9,1,0,1
2023-06-01,23779,5,1,6,4,1,4
2023-06-01,18259,8,4,12,5,4,5
2023-06-01,38629,2,1,3,2,2,2
2023-06-01,23122,1,0,1,2,0,2
2023-06-01,263950,7,1,8,3,2,4
2023-06-01,263949,2,1,3,2,1,2
2023-06-01,262949,5,1,6,5,2,5
2023-06-01,263957,1,0,1,1,0,1
2023-06-01,267424,5,0,5,4,0,4
2023-06-01,263947,3,5,8,3,1,4
2023-06-01,263951,4,1,5,1,1,1
2023-06-01,263952,4,4,8,1,2,2
2023-06-01,263965,2,0,2,1,0,1
2023-06-01,263955,7,0,7,1,0,1
2023-06-01,263956,1,1,2,1,1,1
2023-06-01,61772,6,1,7,3,1,3
2023-06-01,270940,6,0,6,2,0,2
2023-06-01,263958,8,3,11,2,3,3
2023-06-01,263970,1,1,2,1,1,1
2023-06-01,263964,2,1,3,3,2,3
2023-06-01,27797,4,8,12,3,2,3
2023-06-01,263960,2,1,3,1,1,1
2023-06-01,27790,18,1,19,5,3,5
2023-06-01,264607,3,1,4,2,1,2
2023-06-01,262428,43,5,48,7,4,7
2023-06-01,263807,4,0,4,3,0,3
2023-06-01,263968,7,3,10,6,5,6
2023-06-01,265501,4,0,4,3,0,3
2023-06-01,270156,3,0,3,2,0,2
2023-06-01,263441,4,1,5,1,1,1
2023-06-01,263973,1,1,2,4,3,4
2023-06-01,263972,1,0,1,1,0,1
2023-06-01,263974,7,3,10,4,2,4
2023-06-01,263993,4,0,4,1,0,1
2023-06-01,263833,2,0,2,2,0,2
2023-06-01,263979,7,1,8,6,5,7
2023-06-01,263987,1,5,6,1,1,1
2023-06-01,263976,1,0,1,1,0,1
2023-06-01,263988,7,1,8,2,3,3
2023-06-01,263971,7,2,9,4,3,4
2023-06-01,263983,4,3,7,2,1,2
2023-06-01,263977,6,0,6,3,0,3
2023-06-01,52571,11,3,14,8,2,8
2023-06-01,263978,3,0,3,1,0,1
2023-06-01,263995,3,4,7,3,4,5
2023-06-01,263982,3,1,4,4,4,4
2023-06-01,263984,3,1,4,2,1,2
2023-06-01,263981,12,7,19,2,3,3
2023-06-01,264645,5,0,5,3,0,3
2023-06-01,15540,12,3,15,4,2,4
2023-06-01,15486,16,1,17,6,1,6
2023-06-01,142516,1,0,1,1,0,1
2023-06-01,17860,3,0,3,4,0,4
2023-06-01,9183,264,1,265,2,2,2
2023-06-01,132699,1,0,1,1,0,1
2023-06-01,15465,9,2,11,2,2,2
2023-06-01,56114,4,0,4,1,0,1
2023-06-01,327697,2,1,3,1,1,1
2023-06-01,6900,33,2,35,3,2,3
2023-06-01,15854,11,0,11,2,0,2
2023-06-01,8243,1,0,1,2,0,2
2023-06-01,29262,32,1,33,2,1,2
2023-06-01,207736,1,0,1,1,0,1
2023-06-01,205640,10,0,10,1,0,1
2023-06-01,47140,1,0,1,2,0,2
2023-06-01,47641,2,0,2,1,0,1
2023-06-01,209573,2,0,2,2,0,2
2023-06-01,44920,7,2,9,4,1,4
2023-06-01,205394,9,7,16,8,7,8
2023-06-01,209621,1,1,2,1,1,1
2023-06-01,209624,1,1,2,4,3,4
2023-06-01,208017,1,0,1,1,0,1
2023-06-01,209633,1,0,1,2,0,2
2023-06-01,209632,1,0,1,1,0,1
2023-06-01,212068,1,4,5,3,4,5
2023-06-01,12399,4,1,5,7,5,8
2023-06-01,209405,1,0,1,1,0,1
2023-06-01,209627,4,0,4,3,0,3
2023-06-01,47485,1,1,2,3,2,3
2023-06-01,210203,1,0,1,2,0,2
2023-06-01,60392,1,0,1,2,0,2
2023-06-01,51327,2,0,2,2,0,2
2023-06-01,198947,2,1,3,1,1,1
2023-06-01,16623,8,0,8,4,0,4
2023-06-01,14017,21,0,21,4,0,4
2023-06-01,16475,1,0,1,2,0,2
2023-06-01,395451,1,0,1,1,0,1
2023-06-01,393429,6,0,6,1,0,1
2023-06-01,395526,8,0,8,5,0,5
2023-06-01,32715,3,0,3,2,0,2
2023-06-01,31804,1,0,1,1,0,1
2023-06-01,54430,5,0,5,2,0,2
2023-06-01,22223,2,0,2,1,0,1
2023-06-01,396052,5,0,5,5,0,5
2023-06-01,29960,5,0,5,4,0,4
2023-06-01,7382,2,0,2,1,0,1
2023-06-01,54926,2,0,2,2,0,2
2023-06-01,396283,3,0,3,1,0,1
2023-06-01,55044,40,0,40,6,0,6
2023-06-01,399107,3,0,3,1,0,1
2023-06-01,400734,1,1,2,1,2,2
2023-06-01,393455,3,0,3,1,0,1
2023-06-01,26936,2,0,2,2,0,2
2023-06-01,46956,5,0,5,3,0,3
2023-06-01,19537,1,8,9,1,3,3
2023-06-01,19430,5,0,5,1,0,1
2023-06-01,11214,1,0,1,1,0,1
2023-06-01,393859,1,0,1,1,0,1
2023-06-01,46200,1,0,1,3,0,3
2023-06-01,397370,4,0,4,1,0,1
2023-06-01,397026,3,1,4,2,1,2
2023-06-01,395020,2,0,2,1,0,1
2023-06-01,26053,1,0,1,1,0,1
2023-06-01,398410,1,0,1,2,0,2
2023-06-01,31812,6,0,6,4,0,4
2023-06-01,18439,6,2,8,3,2,3
2023-06-01,397981,1,0,1,1,0,1
2023-06-01,40736,8,0,8,2,0,2
2023-06-01,25809,9,0,9,2,0,2
2023-06-01,398822,1,0,1,2,0,2
2023-06-01,45008,3,0,3,1,0,1
2023-06-01,45535,9,0,9,2,0,2
2023-06-01,139274,1,0,1,1,0,1
2023-06-01,10370,5,0,5,2,0,2
2023-06-01,26034,32,0,32,4,0,4
2023-06-01,1780,3,0,3,4,0,4
2023-06-01,395421,3,1,4,1,1,1
2023-06-01,38305,2,0,2,1,0,1
2023-06-01,2715,58,1,59,5,5,6
2023-06-01,16498,2,0,2,2,0,2
2023-06-01,45213,2,1,3,1,1,1
2023-06-01,20054,34,30,64,2,2,2
2023-06-01,8522,3,1,4,5,3,5
2023-06-01,399315,2,0,2,2,0,2
2023-06-01,396054,3,0,3,2,0,2
2023-06-01,13379,5,0,5,4,0,4
2023-06-01,17122,1,0,1,1,0,1
2023-06-01,399344,1,0,1,1,0,1
2023-06-01,399490,1,0,1,2,0,2
2023-06-01,140693,3,0,3,2,0,2
2023-06-01,40051,6,0,6,3,0,3
2023-06-01,54330,6,0,6,2,0,2
2023-06-01,15260,2,0,2,2,0,2
2023-06-01,29736,18,2,20,2,2,2
2023-06-01,23344,9,9,18,12,9,12
2023-06-01,22604,22,21,43,12,11,12
2023-06-01,398849,1,1,2,1,1,1
2023-06-01,30224,1,0,1,2,0,2
2023-06-01,46557,2,0,2,1,0,1
2023-06-01,188,32,0,32,4,0,4
2023-06-01,29601,13,0,13,1,0,1
2023-06-01,2457,2,0,2,1,0,1
2023-06-01,30703,2,0,2,4,0,4
2023-06-01,53927,6,0,6,4,0,4
2023-06-01,56207,18,1,19,2,1,2
2023-06-01,18625,3,0,3,1,0,1
2023-06-01,395769,1,0,1,1,0,1
2023-06-01,27592,1,0,1,3,0,3
2023-06-01,62889,1,0,1,3,0,3
2023-06-01,393839,4,0,4,3,0,3
2023-06-01,395325,1,0,1,1,0,1
2023-06-01,396220,1,0,1,2,0,2
2023-06-01,398241,1,0,1,2,0,2
2023-06-01,394977,45,26,71,22,5,22
2023-06-01,1553,2,0,2,1,0,1
2023-06-01,25242,9,0,9,1,0,1
2023-06-01,209237,4,0,4,3,0,3
2023-06-01,22198,2,0,2,2,0,2
2023-06-01,17071,69,0,69,3,0,3
2023-06-01,31328,11,0,11,9,0,9
2023-06-01,135348,10,0,10,2,0,2
2023-06-01,5788,3,0,3,2,0,2
2023-06-01,19744,1,0,1,1,0,1
2023-06-01,199701,1,0,1,1,0,1
2023-06-01,29837,2,1,3,1,1,1
2023-06-01,8466,1,0,1,2,0,2
2023-06-01,54345,1,1,2,2,1,2
2023-06-01,27628,15,0,15,5,0,5
2023-06-01,43484,4,0,4,2,0,2
2023-06-01,34778,2,0,2,3,0,3
2023-06-01,36564,1,1,2,1,1,1
2023-06-01,793,1,0,1,1,0,1
2023-06-01,42165,2,0,2,2,0,2
2023-06-01,198096,2,1,3,1,1,1
2023-06-01,59078,39,6,45,5,2,6
2023-06-01,37965,89,0,89,5,0,5
2023-06-01,55988,1,0,1,1,0,1
2023-06-01,7535,9,0,9,1,0,1
2023-06-01,19226,1,0,1,2,0,2
2023-06-01,27676,8,0,8,4,0,4
2023-06-01,258,2,0,2,1,0,1
2023-06-01,2046,6,0,6,1,0,1
2023-06-01,398,1,0,1,1,0,1
2023-06-01,744,1,0,1,1,0,1
2023-06-01,441,1,0,1,1,0,1
2023-06-01,656,1,0,1,1,0,1
2023-06-01,6022,1,0,1,1,0,1
2023-06-01,5831,3,0,3,1,0,1
2023-06-01,1205,3,1,4,1,1,1
2023-06-01,27293,13,0,13,2,0,2
2023-06-01,36459,25,2,27,12,11,14
2023-06-01,1441,2,0,2,2,0,2
2023-06-01,138627,2,0,2,4,0,4
2023-06-01,16613,3,0,3,3,0,3
2023-06-01,40497,1,0,1,2,0,2
2023-06-01,6629,5,1,6,2,1,2
2023-06-01,202435,2,0,2,1,0,1
2023-06-01,396013,1,1,2,2,2,2
2023-06-01,396016,6,1,7,2,3,3
2023-06-01,19690,9,1,10,3,2,3
2023-06-01,399519,3,2,5,2,1,2
2023-06-01,33030,1,0,1,1,0,1
2023-06-01,400268,1,1,2,1,1,1
2023-06-01,32178,1,0,1,1,0,1
2023-06-01,399252,15,2,17,4,3,4
2023-06-01,400186,24,0,24,1,0,1
2023-06-01,46719,11,0,11,3,0,3
2023-06-01,18420,1,0,1,1,0,1
2023-06-01,17713,1,0,1,1,0,1
2023-06-01,38847,1,0,1,1,0,1
2023-06-01,38844,5,0,5,1,0,1
2023-06-01,38845,2,0,2,1,0,1
2023-06-01,46290,2,0,2,1,0,1
2023-06-01,46103,5,2,7,2,1,2
2023-06-01,2532,1,0,1,5,0,5
2023-06-01,1840,20,0,20,2,0,2
2023-06-01,22884,912,50,962,6,1,6
2023-06-01,1580,4,0,4,1,0,1
2023-06-01,16928,22,0,22,3,0,3
2023-06-01,15063,8,0,8,2,0,2
2023-06-01,25709,2,0,2,4,0,4
2023-06-01,136247,4,0,4,1,0,1
2023-06-01,15199,1,1,2,2,1,2
2023-06-01,395064,1,0,1,1,0,1
2023-06-01,19,15,3,18,3,3,3
2023-06-01,14822,3,0,3,1,0,1
2023-06-01,206223,2,0,2,1,0,1
2023-06-01,45867,11,0,11,3,0,3
2023-06-01,139055,2,0,2,3,0,3
2023-06-01,137448,3,0,3,1,0,1
2023-06-01,399145,3,0,3,2,0,2
2023-06-01,63303,5,0,5,6,0,6
2023-06-01,32799,2,0,2,5,0,5
2023-06-01,54714,3,0,3,2,0,2
2023-06-01,63376,1,0,1,1,0,1
2023-06-01,11106,4,0,4,3,0,3
2023-06-01,13712,2,0,2,2,0,2
2023-06-01,26783,35,0,35,3,0,3
2023-06-01,1562,3,0,3,1,0,1
2023-06-01,40623,2,1,3,1,1,1
2023-06-01,32907,2,0,2,3,0,3
2023-06-01,15139,12,0,12,3,0,3
2023-06-01,14763,1,0,1,3,0,3
2023-06-01,397388,1,1,2,1,1,1
2023-06-01,53260,3,0,3,2,0,2
2023-06-01,14550,1,0,1,4,0,4
2023-06-01,6932,5,0,5,3,0,3
2023-06-01,7762,9,0,9,4,0,4
2023-06-01,254,20,2,22,3,2,3
2023-06-01,394721,1,0,1,3,0,3
2023-06-01,17248,6,0,6,2,0,2
2023-06-01,27370,14,0,14,4,0,4
2023-06-01,20464,37,1,38,16,1,16
2023-06-01,20252,3,0,3,4,0,4
2023-06-01,395139,13,0,13,4,0,4
2023-06-01,197921,2,0,2,2,0,2
2023-06-01,30741,2,0,2,3,0,3
2023-06-01,20633,1,1,2,8,6,9
2023-06-01,56966,1,0,1,1,0,1
2023-06-01,57094,1,0,1,2,0,2
2023-06-01,213316,1,15,16,6,10,13
2023-06-01,205817,7,0,7,3,0,3
2023-06-01,203355,1,1,2,1,1,1
2023-06-01,205684,1,1,2,2,2,2
2023-06-01,273642,1,2,3,1,1,1
2023-06-01,199865,3,0,3,2,0,2
2023-06-01,212634,3,0,3,1,0,1
2023-06-01,201120,1,0,1,1,0,1
2023-06-01,13128,1,1,2,2,1,2
2023-06-01,41289,2,1,3,7,1,7
2023-06-01,205046,2,2,4,3,2,3
2023-06-01,8826,2,0,2,3,0,3
2023-06-01,211286,4,7,11,1,1,1
2023-06-01,60344,4,0,4,3,0,3
2023-06-01,13040,1,1,2,2,2,2
2023-06-01,210482,1,0,1,1,0,1
2023-06-01,63471,1,0,1,1,0,1
2023-06-01,24771,5,0,5,2,0,2
2023-06-01,48778,8,1,9,4,2,4
2023-06-01,29515,20,1,21,2,2,2
2023-06-01,33846,4,10,14,3,3,3
2023-06-01,8435,31,0,31,4,0,4
2023-06-01,49758,36,0,36,3,0,3
2023-06-01,61357,2,0,2,2,0,2
2023-06-01,25367,6,0,6,3,0,3
2023-06-01,13088,0,0,0,3,0,3
2023-06-01,209560,1,0,1,2,0,2
2023-06-01,209589,2,1,3,1,1,1
2023-06-01,202072,4,0,4,3,0,3
2023-06-01,209593,1,0,1,1,0,1
2023-06-01,205399,20,0,20,1,0,1
2023-06-01,208773,1,0,1,1,0,1
2023-06-01,209591,7,1,8,7,5,7
2023-06-01,56381,3,2,5,6,8,9
2023-06-01,62357,5,0,5,1,0,1
2023-06-01,949,10,26,36,3,5,6
2023-06-01,206988,4,1,5,7,5,7
2023-06-01,209571,2,0,2,1,0,1
2023-06-01,209495,1,0,1,3,0,3
2023-06-01,213207,4,0,4,2,0,2
2023-06-01,51053,5,1,6,2,1,2
2023-06-01,202623,10,9,19,7,6,7
2023-06-01,200048,1,0,1,3,0,3
2023-06-01,57489,5,1,6,1,1,1
2023-06-01,60005,1,0,1,1,0,1
2023-06-01,200166,1,0,1,1,0,1
2023-06-01,203746,1,0,1,3,0,3
2023-06-01,202181,1,1,2,2,2,2
2023-06-01,204656,1,0,1,1,0,1
2023-06-01,60346,1,0,1,1,0,1
2023-06-01,210240,2,0,2,2,0,2
2023-06-01,52006,1,0,1,1,0,1
2023-06-01,203504,1,0,1,1,0,1
2023-06-01,205433,1,0,1,1,0,1
2023-06-01,60067,1,0,1,2,0,2
2023-06-01,201851,1,0,1,3,0,3
2023-06-01,34777,1,0,1,5,0,5
2023-06-01,200028,1,0,1,3,0,3
2023-06-01,200022,1,0,1,1,0,1
2023-06-01,203006,1,0,1,3,0,3
2023-06-01,39580,2,0,2,1,0,1
2023-06-01,201429,1,0,1,2,0,2
2023-06-01,207935,1,0,1,3,0,3
2023-06-01,210493,1,0,1,2,0,2
2023-06-01,207288,1,0,1,1,0,1
2023-06-01,203371,1,0,1,3,0,3
2023-06-01,201717,1,1,2,1,1,1
2023-06-01,62103,2,0,2,3,0,3
2023-06-01,25379,1,0,1,2,0,2
2023-06-01,202734,1,0,1,2,0,2
2023-06-01,62122,1,0,1,2,0,2
2023-06-01,59960,1,0,1,2,0,2
2023-06-01,59946,1,0,1,2,0,2
2023-06-01,59941,1,0,1,2,0,2
2023-06-01,200829,1,0,1,1,0,1
2023-06-01,12990,14,1,15,5,2,5
2023-06-01,62168,1,1,2,1,1,1
2023-06-01,29028,9,2,11,2,4,4
2023-06-01,198485,3,0,3,1,0,1
2023-06-01,209139,1,0,1,1,0,1
2023-06-01,57124,2,1,3,4,2,6
2023-06-01,38915,3,15,18,8,3,9
2023-06-01,33503,1,1,2,1,1,1
2023-06-01,40007,1,1,2,3,1,3
2023-06-01,36390,1,0,1,2,0,2
2023-06-01,141760,3,1,4,3,2,3
2023-06-01,32611,6,1,7,2,2,2
2023-06-01,26996,4,0,4,2,0,2
2023-06-01,29356,7,0,7,3,0,3
2023-06-01,13588,31,0,31,8,0,8
2023-06-01,30233,1,0,1,3,0,3
2023-06-01,16988,12,0,12,4,0,4
2023-06-01,41700,2,1,3,2,1,2
2023-06-01,3828,5,0,5,1,0,1
2023-06-01,14512,1,0,1,2,0,2
2023-06-01,34037,4,0,4,1,0,1
2023-06-01,39838,1,0,1,1,0,1
2023-06-01,270026,8,7,15,4,1,4
2023-06-01,208888,1,0,1,1,0,1
2023-06-01,198548,1,0,1,1,0,1
2023-06-01,212550,2,0,2,3,0,3
2023-06-01,49285,6,1,7,3,3,3
2023-06-01,198045,3,0,3,2,0,2
2023-06-01,33692,8,0,8,5,0,5
2023-06-01,1224,2,1,3,4,3,4
2023-06-01,12075,16,0,16,9,0,9
2023-06-01,17350,22,0,22,9,0,9
2023-06-01,46163,5,0,5,8,0,8
2023-06-01,11318,3,1,4,5,3,5
2023-06-01,19661,10,1,11,7,1,7
2023-06-01,16913,4,0,4,2,0,2
2023-06-01,20105,7,0,7,2,0,2
2023-06-01,2047,26,3,29,2,4,5
2023-06-01,20890,1,0,1,2,0,2
2023-06-01,210040,1,0,1,2,0,2
2023-06-01,13266,4,0,4,2,0,2
2023-06-01,17011,5,0,5,2,0,2
2023-06-01,7165,4,0,4,3,0,3
2023-06-01,1342,6,1,7,3,1,3
2023-06-01,396100,1,0,1,1,0,1
2023-06-01,396326,2,0,2,3,0,3
2023-06-01,394979,1,0,1,1,0,1
2023-06-01,396230,1,0,1,2,0,2
2023-06-01,30252,1,0,1,1,0,1
2023-06-01,393344,5,0,5,3,0,3
2023-06-01,46574,1,0,1,1,0,1
2023-06-01,36821,1,1,2,3,3,3
2023-06-01,396251,1,0,1,4,0,4
2023-06-01,36812,1,0,1,2,0,2
2023-06-01,6169,4,1,5,9,4,10
2023-06-01,396109,2,1,3,4,1,4
2023-06-01,13580,2,0,2,1,0,1
2023-06-01,4923,1,0,1,1,0,1
2023-06-01,393914,2,0,2,5,0,5
2023-06-01,53971,3,0,3,3,0,3
2023-06-01,19377,5,0,5,7,0,7
2023-06-01,53620,5,4,9,9,5,9
2023-06-01,54920,3,0,3,1,0,1
2023-06-01,62632,2,0,2,2,0,2
2023-06-01,53646,5,0,5,1,0,1
2023-06-01,398641,1,0,1,2,0,2
2023-06-01,396219,1,0,1,1,0,1
2023-06-01,398866,2,0,2,4,0,4
2023-06-01,63020,3,0,3,3,0,3
2023-06-01,53120,4,1,5,1,1,1
2023-06-01,16717,6,1,7,5,2,5
2023-06-01,22377,2,0,2,2,0,2
2023-06-01,393316,8,0,8,7,0,7
2023-06-01,395604,2,0,2,1,0,1
2023-06-01,398219,1,0,1,1,0,1
2023-06-01,54037,5,0,5,2,0,2
2023-06-01,21721,1,0,1,2,0,2
2023-06-01,62598,1,0,1,2,0,2
2023-06-01,54901,1,0,1,1,0,1
2023-06-01,397080,2,0,2,2,0,2
2023-06-01,397156,2,0,2,1,0,1
2023-06-01,21851,1,0,1,1,0,1
2023-06-01,18944,1,1,2,2,1,2
2023-06-01,30458,1,0,1,1,0,1
2023-06-01,393389,1,0,1,1,0,1
2023-06-01,46665,2,0,2,3,0,3
2023-06-01,36169,1,0,1,1,0,1
2023-06-01,397023,2,1,3,1,1,1
2023-06-01,201596,5,0,5,1,0,1
2023-06-01,22764,16,0,16,12,0,12
2023-06-01,41587,2,0,2,2,0,2
2023-06-01,1109,1,0,1,1,0,1
2023-06-01,6720,2,2,4,2,2,2
2023-06-01,63045,4,0,4,4,0,4
2023-06-01,395516,17,0,17,5,0,5
2023-06-01,394769,1,0,1,3,0,3
2023-06-01,46470,1,0,1,1,0,1
2023-06-01,3784,4,0,4,4,0,4
2023-06-01,18454,2,0,2,4,0,4
2023-06-01,210290,1,1,2,1,1,1
2023-06-01,201093,7,1,8,6,1,6
2023-06-01,213125,1,0,1,1,0,1
2023-06-01,213037,2,0,2,1,0,1
2023-06-01,200478,15,2,17,16,1,16
2023-06-01,206614,6,6,12,9,8,9
2023-06-01,394213,2,0,2,3,0,3
2023-06-01,204257,16,0,16,3,0,3
2023-06-01,199393,1,1,2,1,1,1
2023-06-01,201076,5,6,11,3,4,4
2023-06-01,199270,6,1,7,6,3,7
2023-06-01,21070,15,0,15,3,0,3
2023-06-01,28690,53,0,53,5,0,5
2023-06-01,12701,28,0,28,8,0,8
2023-06-01,44022,21,0,21,4,0,4
2023-06-01,17343,5,0,5,2,0,2
2023-06-01,395015,14,0,14,2,0,2
2023-06-01,38066,11,0,11,2,0,2
2023-06-01,1117,1,0,1,1,0,1
2023-06-01,40112,1,0,1,2,0,2
2023-06-01,395624,10,0,10,2,0,2
2023-06-01,16364,3,0,3,2,0,2
2023-06-01,394396,2,0,2,3,0,3
2023-06-01,53658,1,0,1,1,0,1
2023-06-01,26206,2,1,3,3,1,3
2023-06-01,397694,1,0,1,2,0,2
2023-06-01,394860,2,0,2,1,0,1
2023-06-01,62865,2,0,2,1,0,1
2023-06-01,16802,1,0,1,2,0,2
2023-06-01,393907,1,0,1,3,0,3
2023-06-01,16796,42,2,44,9,2,9
2023-06-01,139323,4,0,4,4,0,4
2023-06-01,21671,1,0,1,2,0,2
2023-06-01,398833,8,0,8,3,0,3
2023-06-01,3633,27,0,27,2,0,2
2023-06-01,26884,11,0,11,2,0,2
2023-06-01,263881,5,0,5,5,0,5
2023-06-01,53027,2,0,2,1,0,1
2023-06-01,56122,2,0,2,3,0,3
2023-06-01,15160,20,0,20,3,0,3
2023-06-01,17372,2,0,2,2,0,2
2023-06-01,17371,12,0,12,3,0,3
2023-06-01,395114,1,1,2,2,1,2
2023-06-01,62706,7,0,7,1,0,1
2023-06-01,14661,7,0,7,1,0,1
2023-06-01,396292,11,0,11,2,0,2
2023-06-01,12065,2,0,2,1,0,1
2023-06-01,393912,3,0,3,3,0,3
2023-06-01,33283,2,0,2,2,0,2
2023-06-01,394311,14,3,17,1,1,1
2023-06-01,5664,2,0,2,5,0,5
2023-06-01,19869,2,0,2,1,0,1
2023-06-01,394520,16,1,17,3,1,3
2023-06-01,11105,18,0,18,2,0,2
2023-06-01,54605,1,0,1,1,0,1
2023-06-01,11257,1,0,1,4,0,4
2023-06-01,22636,3,0,3,4,0,4
2023-06-01,2653,1,0,1,4,0,4
2023-06-01,566,5,0,5,1,0,1
2023-06-01,813,17,0,17,2,0,2
2023-06-01,399973,1,0,1,2,0,2
2023-06-01,23760,2,0,2,3,0,3
2023-06-01,26704,47,0,47,9,0,9
2023-06-01,35888,3,0,3,1,0,1
2023-06-01,19925,3,0,3,3,0,3
2023-06-01,397832,1,0,1,2,0,2
2023-06-01,399997,3,0,3,2,0,2
2023-06-01,399361,8,0,8,2,0,2
2023-06-01,63385,21,0,21,2,0,2
2023-06-01,400288,1,0,1,1,0,1
2023-06-01,7950,10,0,10,2,0,2
2023-06-01,822,2,0,2,1,0,1
2023-06-01,36391,4,2,6,1,1,1
2023-06-01,818,1,0,1,1,0,1
2023-06-01,393952,103,0,103,3,0,3
2023-06-01,806,22,0,22,5,0,5
2023-06-01,35857,1,0,1,1,0,1
2023-06-01,63259,1,0,1,1,0,1
2023-06-01,55273,1,0,1,2,0,2
2023-06-01,399601,1,0,1,2,0,2
2023-06-01,400392,1,0,1,2,0,2
2023-06-01,53403,1,0,1,4,0,4
2023-06-01,25635,1,2,3,4,2,4
2023-06-01,22686,2,1,3,4,1,4
2023-06-01,31930,1,0,1,1,0,1
2023-06-01,11998,1,0,1,1,0,1
2023-06-01,8160,5,0,5,1,0,1
2023-06-01,63322,1,0,1,1,0,1
2023-06-01,3958,17,0,17,4,0,4
2023-06-01,394127,2,0,2,3,0,3
2023-06-01,399961,1,0,1,2,0,2
2023-06-01,400637,1,0,1,2,0,2
2023-06-01,53588,1,0,1,3,0,3
2023-06-01,63209,4,0,4,2,0,2
2023-06-01,32121,2,0,2,3,0,3
2023-06-01,396486,1,0,1,2,0,2
2023-06-01,17042,1,0,1,1,0,1
2023-06-01,18621,1,0,1,3,0,3
2023-06-01,18814,2,0,2,2,0,2
2023-06-01,40439,1,0,1,3,0,3
2023-06-01,910,1,0,1,1,0,1
2023-06-01,19372,0,0,0,2,0,2
2023-06-01,64258,30,0,30,3,0,3
2023-06-01,26361,2,0,2,2,0,2
2023-06-01,40332,0,0,0,2,0,2
2023-06-01,26321,7,0,7,1,0,1
2023-06-01,398323,2,0,2,1,0,1
2023-06-01,398245,1,0,1,1,0,1
2023-06-01,63355,2,0,2,1,0,1
2023-06-01,40868,1,0,1,1,0,1
2023-06-01,398089,4,0,4,2,0,2
2023-06-01,19150,1,0,1,2,0,2
2023-06-01,400784,1,0,1,1,0,1
2023-06-01,398800,1,0,1,2,0,2
2023-06-01,19469,1,0,1,2,0,2
2023-06-01,397585,1,0,1,1,0,1
2023-06-01,54351,12,2,14,5,4,6
2023-06-01,31779,2,0,2,1,0,1
2023-06-01,398185,1,0,1,1,0,1
2023-06-01,11048,1,1,2,2,1,2
2023-06-01,40121,8,0,8,2,0,2
2023-06-01,394986,1,1,2,1,1,1
2023-06-01,400528,1,1,2,1,1,1
2023-06-01,52284,5,1,6,1,1,2
2023-06-01,137909,1,1,2,1,1,1
2023-06-01,395768,20,0,20,6,0,6
2023-06-01,396045,1,1,2,2,1,2
2023-06-01,398195,1,0,1,3,0,3
2023-06-01,13920,1,0,1,1,0,1
2023-06-01,398937,1,0,1,1,0,1
2023-06-01,53978,1,1,2,3,2,3
2023-06-01,398203,3,1,4,5,2,5
2023-06-01,395947,1,0,1,1,0,1
2023-06-01,398254,1,0,1,3,0,3
2023-06-01,393932,2,0,2,1,0,1
2023-06-01,398043,15,3,18,1,1,1
2023-06-01,398222,1,1,2,1,1,2
2023-06-01,396387,2,0,2,1,0,1
2023-06-01,54806,9,0,9,2,0,2
2023-06-01,394703,2,0,2,2,0,2
2023-06-01,40302,1,0,1,1,0,1
2023-06-01,26695,3,3,6,2,1,2
2023-06-01,16584,0,0,0,2,0,2
2023-06-01,36205,4,0,4,2,0,2
2023-06-01,10265,1,0,1,2,0,2
2023-06-01,32156,6,0,6,1,0,1
2023-06-01,10958,12,1,13,3,1,3
2023-06-01,205252,2,0,2,1,0,1
2023-06-01,398811,1,1,2,2,2,2
2023-06-01,398760,2,0,2,1,0,1
2023-06-01,32564,21,0,21,3,0,3
2023-06-01,53442,1,0,1,1,0,1
2023-06-01,23217,1,0,1,2,0,2
2023-06-01,395198,20,0,20,3,0,3
2023-06-01,23307,1,1,2,5,2,5
2023-06-01,19351,4,0,4,4,0,4
2023-06-01,4476,6,0,6,1,0,1
2023-06-01,11079,25,0,25,2,0,2
2023-06-01,32347,3,0,3,3,0,3
2023-06-01,399429,43,0,43,2,0,2
2023-06-01,36750,6,0,6,3,0,3
2023-06-01,14873,4,0,4,2,0,2
2023-06-01,30409,4,0,4,4,0,4
2023-06-01,395399,5,0,5,3,0,3
2023-06-01,19416,83,0,83,6,0,6
2023-06-01,16730,22,0,22,3,0,3
2023-06-01,395272,3,0,3,1,0,1
2023-06-01,264008,6,3,9,1,1,1
2023-06-01,263990,7,4,11,1,1,1
2023-06-01,263991,3,3,6,7,5,7
2023-06-01,27694,4,0,4,1,0,1
2023-06-01,263992,3,0,3,3,3,3
2023-06-01,262550,4,1,5,1,1,1
2023-06-01,270361,11,0,11,7,0,7
2023-06-01,263544,52,3,55,5,3,5
2023-06-01,265989,14,1,15,1,1,1
2023-06-01,264004,4,4,8,1,1,1
2023-06-01,262231,35,1,36,4,1,4
2023-06-01,263836,4,0,4,1,0,1
2023-06-01,264618,1,1,2,1,1,1
2023-06-01,264612,1,0,1,2,0,2
2023-06-01,264647,2,1,3,2,1,2
2023-06-01,17079,67,0,67,1,0,1
2023-06-01,64339,1,0,1,1,0,1
2023-06-01,262995,14,3,17,5,4,5
2023-06-01,262978,10,3,13,7,7,9
2023-06-01,264021,5,1,6,2,1,2
2023-06-01,264011,3,1,4,1,1,1
2023-06-01,264020,7,3,10,2,2,2
2023-06-01,264005,2,3,5,2,2,2
2023-06-01,264621,4,0,4,1,0,1
2023-06-01,264014,5,1,6,8,4,8
2023-06-01,28080,12,1,13,3,1,3
2023-06-01,264006,3,3,6,2,4,5
2023-06-01,264007,1,0,1,2,0,2
2023-06-01,264013,10,23,33,9,6,10
2023-06-01,264026,7,3,10,1,1,1
2023-06-01,53066,58,3,61,6,3,6
2023-06-01,264015,3,1,4,1,1,1
2023-06-01,264010,1,1,2,7,4,7
2023-06-01,264001,15,1,16,1,1,1
2023-06-01,52951,37,4,41,6,5,6
2023-06-01,264072,1,1,2,1,1,1
2023-06-01,264027,2,3,5,1,1,1
2023-06-01,271217,3,0,3,3,0,3
2023-06-01,264023,8,7,15,5,4,5
2023-06-01,11003,5,0,5,1,0,1
2023-06-01,15442,8,0,8,2,0,2
2023-06-01,35163,10,0,10,4,0,4
2023-06-01,22978,1,0,1,1,0,1
2023-06-01,22887,5,0,5,2,0,2
2023-06-01,393257,1,0,1,1,0,1
2023-06-01,52019,2,0,2,2,0,2
2023-06-01,13748,5,0,5,3,0,3
2023-06-01,1114,1,0,1,1,0,1
2023-06-01,200996,5,0,5,1,0,1
2023-06-01,19200,2,1,3,1,1,1
2023-06-01,23341,15,0,15,2,0,2
2023-06-01,47029,1,0,1,2,0,2
2023-06-01,4193,33,1,34,5,2,5
2023-06-01,19977,8,0,8,2,0,2
2023-06-01,29120,10,0,10,2,0,2
2023-06-01,17989,5,0,5,2,0,2
2023-06-01,40723,1,0,1,1,0,1
2023-06-01,54635,3,0,3,2,0,2
2023-06-01,400856,2,0,2,3,0,3
2023-06-01,204109,4,1,5,8,5,9
2023-06-01,50510,6,0,6,3,0,3
2023-06-01,1493,27,0,27,1,0,1
2023-06-01,1502,24,0,24,1,0,1
2023-06-01,18553,1,0,1,1,0,1
2023-06-01,3363,28,1,29,4,2,4
2023-06-01,142110,6,0,6,1,0,1
2023-06-01,8450,4,0,4,1,0,1
2023-06-01,45172,18,0,18,4,0,4
2023-06-01,17107,3,0,3,1,0,1
2023-06-01,13636,2,0,2,5,0,5
2023-06-01,30681,1,0,1,2,0,2
2023-06-01,53187,3,2,5,4,2,4
2023-06-01,1251,60,2,62,20,6,20
2023-06-01,28571,41,5,46,5,4,5
2023-06-01,30376,2,0,2,1,0,1
2023-06-01,11773,3,0,3,5,0,5
2023-06-01,1880,16,4,20,14,5,14
2023-06-01,1881,4,0,4,1,0,1
2023-06-01,59383,8,0,8,3,0,3
2023-06-01,26439,9,0,9,1,0,1
2023-06-01,456,2,0,2,1,0,1
2023-06-01,60855,77,0,77,3,0,3
2023-06-01,35289,4,0,4,3,0,3
2023-06-01,211817,1,0,1,3,0,3
2023-06-01,32229,14,0,14,2,0,2
2023-06-01,53172,10,4,14,5,2,5
2023-06-01,52639,6,2,8,12,11,13
2023-06-01,264024,3,3,6,2,1,2
2023-06-01,264028,5,0,5,1,0,1
2023-06-01,52242,8,0,8,1,0,1
2023-06-01,61577,2,2,4,1,1,1
2023-06-01,264025,6,1,7,3,1,3
2023-06-01,270949,1,1,2,4,4,4
2023-06-01,264030,7,1,8,1,1,1
2023-06-01,264071,4,6,10,7,4,7
2023-06-01,53111,6,1,7,3,3,3
2023-06-01,264063,3,1,4,1,1,1
2023-06-01,264031,7,0,7,2,0,2
2023-06-01,264032,2,1,3,1,1,1
2023-06-01,263530,10,1,11,1,1,1
2023-06-01,263668,9,3,12,5,4,5
2023-06-01,264033,5,2,7,1,1,1
2023-06-01,265693,4,6,10,3,5,5
2023-06-01,52914,3,0,3,5,0,5
2023-06-01,53086,14,7,21,7,4,7
2023-06-01,264036,7,3,10,3,1,3
2023-06-01,264050,5,1,6,1,1,1
2023-06-01,262633,9,0,9,3,0,3
2023-06-01,264045,4,1,5,1,1,1
2023-06-01,264078,1,1,2,1,1,1
2023-06-01,262512,6,3,9,7,2,7
2023-06-01,264615,4,0,4,1,0,1
2023-06-01,264042,3,1,4,4,4,6
2023-06-01,264051,8,1,9,4,1,4
2023-06-01,270948,3,0,3,2,0,2
2023-06-01,263426,2,1,3,1,1,1
2023-06-01,264041,7,0,7,1,0,1
2023-06-01,61902,21,3,24,2,1,2
2023-06-01,264043,3,1,4,2,1,2
2023-06-01,264058,5,0,5,3,0,3
2023-06-01,27688,19,17,36,7,3,7
2023-06-01,264055,1,0,1,1,0,1
2023-06-01,264053,7,1,8,2,2,2
2023-06-01,28654,6,3,9,5,4,6
2023-06-01,264046,3,3,6,3,4,4
2023-06-01,264047,3,2,5,1,1,1
2023-06-01,264054,3,3,6,6,2,6
2023-06-01,264048,6,2,8,2,1,2
2023-06-01,8094,48,1,49,1,1,1
2023-06-01,206228,3,2,5,1,1,1
2023-06-01,206618,32,1,33,3,2,3
2023-06-01,12331,2,1,3,3,2,3
2023-06-01,8803,13,0,13,3,0,3
2023-06-01,3680,2,0,2,2,0,2
2023-06-01,7905,6,0,6,1,0,1
2023-06-01,7448,15,0,15,3,0,3
2023-06-01,393451,6,0,6,4,0,4
2023-06-01,397112,6,0,6,2,0,2
2023-06-01,32480,8,0,8,3,0,3
2023-06-01,21680,29,0,29,5,0,5
2023-06-01,264065,4,0,4,1,0,1
2023-06-01,264049,3,1,4,4,1,4
2023-06-01,264059,4,4,8,2,2,2
2023-06-01,264608,1,1,2,1,1,1
2023-06-01,264629,5,0,5,2,0,2
2023-06-01,264056,4,1,5,1,1,1
2023-06-01,264060,5,0,5,2,0,2
2023-06-01,264062,3,1,4,2,1,2
2023-06-01,272181,0,1,1,2,1,2
2023-06-01,262819,4,2,6,2,3,3
2023-06-01,53081,5,0,5,1,0,1
2023-06-01,264068,1,0,1,1,0,1
2023-06-01,269892,4,1,5,1,1,1
2023-06-01,262784,42,31,73,1,1,1
2023-06-01,263604,13,0,13,1,0,1
2023-06-01,263587,17,2,19,3,2,3
2023-06-01,263543,6,2,8,3,2,3
2023-06-01,262324,3,1,4,2,2,2
2023-06-01,263196,2,0,2,3,0,3
2023-06-01,61483,8,0,8,3,0,3
2023-06-01,64099,3,0,3,3,0,3
2023-06-01,264070,1,1,2,1,1,1
2023-06-01,264076,7,1,8,6,3,7
2023-06-01,263085,14,3,17,1,1,1
2023-06-01,61514,5,0,5,1,0,1
2023-06-01,19373,29,5,34,2,2,2
2023-06-01,264631,3,1,4,1,1,1
2023-06-01,264074,3,0,3,2,0,2
2023-06-01,52544,19,3,22,6,5,6
2023-06-01,264082,3,0,3,1,0,1
2023-06-01,263627,15,7,22,5,4,5
2023-06-01,264084,3,3,6,2,2,2
2023-06-01,52711,10,2,12,7,6,7
2023-06-01,264609,4,1,5,2,1,2
2023-06-01,1111,1,0,1,1,0,1
2023-06-01,40503,1,0,1,1,0,1
2023-06-01,19106,1,1,2,2,2,2
2023-06-01,264088,1,3,4,1,1,1
2023-06-01,264077,3,4,7,1,4,4
2023-06-01,264086,7,2,9,1,1,1
2023-06-01,264079,3,4,7,4,2,5
2023-06-01,264089,2,0,2,1,0,1
2023-06-01,264625,3,0,3,4,0,4
2023-06-01,271984,4,0,4,4,0,4
2023-06-01,52439,16,0,16,3,0,3
2023-06-01,265138,1,1,2,3,1,3
2023-06-01,265124,4,1,5,1,1,1
2023-06-01,265125,2,1,3,1,1,1
2023-06-01,265122,3,3,6,1,1,1
2023-06-01,262960,5,1,6,4,1,4
2023-06-01,265127,5,1,6,1,1,1
2023-06-01,265128,14,1,15,2,1,2
2023-06-01,265121,3,1,4,1,1,1
2023-06-01,264091,3,3,6,2,2,2
2023-06-01,61776,9,4,13,3,2,4
2023-06-01,263671,2,0,2,1,0,1
2023-06-01,265129,5,0,5,2,0,2
2023-06-01,264092,3,3,6,2,2,2
2023-06-01,53046,9,2,11,3,2,3
2023-06-01,262145,33,2,35,3,2,3
2023-06-01,264090,5,1,6,1,1,1
2023-06-01,265117,5,1,6,4,3,4
2023-06-01,265118,5,7,12,1,1,1
2023-06-01,265119,5,0,5,2,0,2
2023-06-01,265150,14,7,21,6,4,6
2023-06-01,262422,5,2,7,1,2,2
2023-06-01,53156,10,0,10,2,0,2
2023-06-01,61578,5,1,6,1,1,1
2023-06-01,265131,7,7,14,2,3,3
2023-06-01,265136,7,3,10,4,3,4
2023-06-01,265133,4,0,4,1,0,1
2023-06-01,265132,1,0,1,1,0,1
2023-06-01,393847,8,0,8,2,0,2
2023-06-01,33371,21,0,21,2,0,2
2023-06-01,397010,4,0,4,2,0,2
2023-06-01,2036,1,0,1,1,0,1
2023-06-01,36427,1,0,1,4,0,4
2023-06-01,2546,1,1,2,1,1,1
2023-06-01,21079,2,1,3,3,1,3
2023-06-01,211739,5,0,5,1,0,1
2023-06-01,34846,1,0,1,1,0,1
2023-06-01,3734,12,0,12,2,0,2
2023-06-01,265140,3,1,4,5,2,5
2023-06-01,263601,7,7,14,10,4,11
2023-06-01,265134,2,0,2,1,0,1
2023-06-01,265141,6,2,8,5,4,6
2023-06-01,52916,8,15,23,4,2,4
2023-06-01,264636,3,0,3,2,0,2
2023-06-01,264644,1,0,1,1,0,1
2023-06-01,264652,3,0,3,1,0,1
2023-06-01,265517,4,0,4,1,0,1
2023-06-01,263623,29,1,30,1,1,1
2023-06-01,28652,32,1,33,3,1,3
2023-06-01,265139,3,1,4,4,1,4
2023-06-01,265146,5,0,5,2,0,2
2023-06-01,265142,7,1,8,1,1,1
2023-06-01,262460,15,1,16,2,1,2
2023-06-01,262406,6,2,8,2,2,4
2023-06-01,265164,1,0,1,1,0,1
2023-06-01,265143,6,2,8,4,3,4
2023-06-01,52977,36,6,42,4,3,4
2023-06-01,265675,6,0,6,4,0,4
2023-06-01,52722,8,1,9,3,3,4
2023-06-01,61948,14,7,21,7,4,7
2023-06-01,265152,3,3,6,2,2,2
2023-06-01,61509,7,0,7,3,0,3
2023-06-01,265148,3,1,4,4,3,4
2023-06-01,265155,4,0,4,4,0,4
2023-06-01,45470,17,2,19,3,2,3
2023-06-01,263487,2,1,3,1,1,1
2023-06-01,262376,11,3,14,5,5,7
2023-06-01,28229,28,3,31,8,4,8
2023-06-01,265153,6,0,6,1,0,1
2023-06-01,264641,5,0,5,2,0,2
2023-06-01,272786,9,3,12,9,5,9
2023-06-01,265151,1,1,2,1,1,1
2023-06-01,52741,7,1,8,5,1,5
2023-06-01,265161,3,3,6,1,1,1
2023-06-01,265162,6,2,8,3,2,3
2023-06-01,265163,3,3,6,2,3,4
2023-06-01,270704,4,5,9,9,6,9
2023-06-01,265157,4,1,5,1,1,1
2023-06-01,262794,14,1,15,3,2,3
2023-06-01,57370,21,15,36,3,1,3
2023-06-01,8444,7,0,7,9,0,9
2023-06-01,205994,4,0,4,2,0,2
2023-06-01,203183,9,0,9,3,0,3
2023-06-01,213050,2,1,3,8,5,8
2023-06-01,7862,43,8,51,20,4,20
2023-06-01,136197,7,18,25,1,1,1
2023-06-01,29982,6,0,6,2,0,2
2023-06-01,23098,3,0,3,1,0,1
2023-06-01,13684,26,3,29,13,3,13
2023-06-01,2697,144,1,145,4,1,4
2023-06-01,205664,3,0,3,3,0,3
2023-06-01,400692,2,0,2,2,0,2
2023-06-01,26258,1,0,1,2,0,2
2023-06-01,13809,2,0,2,1,0,1
2023-06-01,62811,10,0,10,4,0,4
2023-06-01,555,4,0,4,3,0,3
2023-06-01,18664,2,0,2,3,0,3
2023-06-01,18800,1,0,1,1,0,1
2023-06-01,48037,53,5,58,3,3,3
2023-06-01,212157,8,7,15,3,3,3
2023-06-01,19428,17,0,17,8,0,8
2023-06-01,139398,4,1,5,2,1,2
2023-06-01,210504,1,0,1,2,0,2
2023-06-01,136682,2,1,3,2,1,2
2023-06-01,5219,0,0,0,2,0,2
2023-06-01,2577,2,0,2,2,0,2
2023-06-01,5374,2,0,2,1,0,1
2023-06-01,9983,4,0,4,1,0,1
2023-06-01,138681,21,0,21,2,0,2
2023-06-01,39052,3,0,3,2,0,2
2023-06-01,398577,3,1,4,2,2,2
2023-06-01,398642,3,1,4,2,2,2
2023-06-01,2003,19,0,19,10,0,10
2023-06-01,3410,1,0,1,2,0,2
2023-06-01,33976,2,0,2,1,0,1
2023-06-01,14349,18,0,18,3,0,3
2023-06-01,25978,2,0,2,3,0,3
2023-06-01,14169,1,0,1,1,0,1
2023-06-01,400119,4,0,4,1,0,1
2023-06-01,53485,2,0,2,1,0,1
2023-06-01,400761,1,0,1,2,0,2
2023-06-01,400722,1,0,1,3,0,3
2023-06-01,60060,2,0,2,1,0,1
2023-06-01,40729,2,0,2,3,0,3
2023-06-01,62989,13,2,15,2,2,2
2023-06-01,16681,38,0,38,7,0,7
2023-06-01,784,1,0,1,1,0,1
2023-06-01,49278,23,9,32,4,3,4
2023-06-01,397925,2,0,2,1,0,1
2023-06-01,398359,1,0,1,2,0,2
2023-06-01,17026,3,0,3,2,0,2
2023-06-01,40208,1,0,1,1,0,1
2023-06-01,30581,1,0,1,2,0,2
2023-06-01,53546,1,0,1,1,0,1
2023-06-01,395543,3,0,3,2,0,2
2023-06-01,399012,3,0,3,2,0,2
2023-06-01,399124,1,0,1,2,0,2
2023-06-01,53826,2,0,2,4,0,4
2023-06-01,3925,17,0,17,5,0,5
2023-06-01,398388,1,0,1,1,0,1
2023-06-01,461,1,0,1,1,0,1
2023-06-01,6652,2,0,2,2,0,2
2023-06-01,54654,1,0,1,1,0,1
2023-06-01,32023,1,0,1,1,0,1
2023-06-01,40567,1,0,1,1,0,1
2023-06-01,31584,1,0,1,1,0,1
2023-06-01,3634,2,1,3,3,1,3
2023-06-01,1516,20,0,20,1,0,1
2023-06-01,6006,1,0,1,1,0,1
2023-06-01,24390,1,2,3,1,1,1
2023-06-01,19368,5,0,5,8,0,8
2023-06-01,36233,1,0,1,2,0,2
2023-06-01,62653,1,0,1,1,0,1
2023-06-01,55119,1,0,1,3,0,3
2023-06-01,64293,1,0,1,3,0,3
2023-06-01,397744,1,0,1,1,0,1
2023-06-01,62678,1,0,1,1,0,1
2023-06-01,21821,4,0,4,3,0,3
2023-06-01,397523,0,0,0,2,0,2
2023-06-01,21751,1,0,1,2,0,2
2023-06-01,396242,1,0,1,3,0,3
2023-06-01,23359,1,0,1,2,0,2
2023-06-01,30183,1,0,1,2,0,2
2023-06-01,54218,1,0,1,1,0,1
2023-06-01,53592,1,0,1,2,0,2
2023-06-01,1967,1,1,2,3,1,3
2023-06-01,21784,2,0,2,3,0,3
2023-06-01,36413,2,0,2,2,0,2
2023-06-01,399643,2,0,2,2,0,2
2023-06-01,28795,1,0,1,2,0,2
2023-06-01,62719,2,0,2,3,0,3
2023-06-01,11098,1,0,1,1,0,1
2023-06-01,10849,57,0,57,1,0,1
2023-06-01,21799,8,0,8,3,0,3
2023-06-01,14183,1,1,2,1,1,1
2023-06-01,7301,1,0,1,2,0,2
2023-06-01,398424,5,0,5,4,0,4
2023-06-01,396881,4,4,8,1,1,1
2023-06-01,33608,1,0,1,2,0,2
2023-06-01,2147,10,0,10,2,0,2
2023-06-01,22244,6,0,6,3,0,3
2023-06-01,35532,5,0,5,1,0,1
2023-06-01,20221,6,0,6,3,0,3
2023-06-01,7238,13,0,13,2,0,2
2023-06-01,10982,17,0,17,7,0,7
2023-06-01,21892,0,0,0,2,0,2
2023-06-01,53295,1,0,1,2,0,2
2023-06-01,1311,8,0,8,4,0,4
2023-06-01,44829,6,0,6,3,0,3
2023-06-01,2426,1,0,1,1,0,1
2023-06-01,6801,2,0,2,2,0,2
2023-06-01,59624,2,1,3,13,10,15
2023-06-01,201052,8,0,8,2,0,2
2023-06-01,29493,1,1,2,3,1,3
2023-06-01,2643,4,1,5,1,1,1
2023-06-01,2148,2,0,2,1,0,1
2023-06-01,208903,1,0,1,1,0,1
2023-06-01,396341,1,0,1,1,0,1
2023-06-01,47056,2,0,2,3,0,3
2023-06-01,40980,4,6,10,1,1,1
2023-06-01,46784,11,0,11,5,0,5
2023-06-01,11939,20,0,20,8,0,8
2023-06-01,4158,9,1,10,4,1,4
2023-06-01,9342,4,0,4,5,0,5
2023-06-01,17366,7,0,7,3,0,3
2023-06-01,11228,13,2,15,10,2,10
2023-06-01,27142,57,2,59,3,1,3
2023-06-01,5307,57,1,58,1,1,1
2023-06-01,203396,13,2,15,2,3,3
2023-06-01,207283,3,0,3,3,0,3
2023-06-01,205405,1,0,1,3,0,3
2023-06-01,205404,1,0,1,2,0,2
2023-06-01,205403,1,0,1,2,0,2
2023-06-01,205379,1,0,1,3,0,3
2023-06-01,44218,1,0,1,1,0,1
2023-06-01,60664,41,1,42,5,2,5
2023-06-01,204915,2,2,4,1,1,1
2023-06-01,200026,3,1,4,2,1,2
2023-06-01,203952,4,0,4,1,0,1
2023-06-01,202189,1,0,1,2,0,2
2023-06-01,1124,4,0,4,1,0,1
2023-06-01,206294,1,0,1,1,0,1
2023-06-01,134589,8,0,8,1,0,1
2023-06-01,9580,3,0,3,3,0,3
2023-06-01,33820,3,0,3,1,0,1
2023-06-01,50799,3,0,3,1,0,1
2023-06-01,206024,3,0,3,2,0,2
2023-06-01,25182,1,1,2,5,3,5
2023-06-01,197949,12,0,12,6,0,6
2023-06-01,211280,6,0,6,1,0,1
2023-06-01,201208,5,0,5,2,0,2
2023-06-01,28756,21,0,21,4,0,4
2023-06-01,207982,1,0,1,2,0,2
2023-06-01,8211,12,1,13,4,2,4
2023-06-01,15740,4,0,4,3,0,3
2023-06-01,213065,5,1,6,3,1,3
2023-06-01,212778,3,1,4,3,1,3
2023-06-01,1145,1,0,1,1,0,1
2023-06-01,1146,1,0,1,1,0,1
2023-06-01,1149,1,0,1,1,0,1
2023-06-01,1104,12,5,17,1,3,3
2023-06-01,1147,1,0,1,1,0,1
2023-06-01,49362,24,1,25,13,3,13
2023-06-01,201017,12,1,13,2,1,2
2023-06-01,15625,54,0,54,5,0,5
2023-06-01,44074,3,0,3,3,0,3
2023-06-01,210908,2,0,2,1,0,1
2023-06-01,25039,4,0,4,2,0,2
2023-06-01,8255,11,0,11,3,0,3
2023-06-01,15675,6,0,6,2,0,2
2023-06-01,206567,12,1,13,3,1,3
2023-06-01,34339,11,0,11,2,0,2
2023-06-01,5635,2,0,2,1,0,1
2023-06-01,200757,3,0,3,2,0,2
2023-06-01,210543,2,1,3,1,1,1
2023-06-01,23763,4,0,4,7,0,7
2023-06-01,393226,9,0,9,10,0,10
2023-06-01,21137,13,0,13,2,0,2
2023-06-01,203651,4,0,4,3,0,3
2023-06-01,211095,4,1,5,1,1,1
2023-06-01,203770,1,0,1,1,0,1
2023-06-01,198259,29,0,29,4,0,4
2023-06-01,60257,4,0,4,1,0,1
2023-06-01,197938,1,1,2,1,1,1
2023-06-01,59756,1,0,1,1,0,1
2023-06-01,3373,2,0,2,1,0,1
2023-06-01,3374,2,0,2,1,0,1
2023-06-01,3376,4,0,4,1,0,1
2023-06-01,3375,16,0,16,1,0,1
2023-06-01,200139,2,1,3,1,1,1
2023-06-01,15245,2,0,2,1,0,1
2023-06-01,54647,1,0,1,1,0,1
2023-06-01,7726,112,32,144,8,6,8
2023-06-01,20648,1,0,1,1,0,1
2023-06-01,210103,1,6,7,3,5,6
2023-06-01,210477,3,1,4,3,1,3
2023-06-01,205388,7,3,10,8,1,8
2023-06-01,211484,1,0,1,1,0,1
2023-06-01,41171,2,0,2,1,0,1
2023-06-01,210491,1,0,1,4,0,4
2023-06-01,47753,4,4,8,2,2,2
2023-06-01,210760,2,1,3,1,1,1
2023-06-01,210471,1,1,2,2,1,2
2023-06-01,56893,4,0,4,2,0,2
2023-06-01,210463,1,0,1,1,0,1
2023-06-01,203162,1,0,1,1,0,1
2023-06-01,201864,1,0,1,2,0,2
2023-06-01,210458,1,0,1,1,0,1
2023-06-01,199740,1,0,1,1,0,1
2023-06-01,57889,3,0,3,2,0,2
2023-06-01,20253,14,18,32,13,9,14
2023-06-01,209861,1,6,7,2,6,6
2023-06-01,57884,1,0,1,3,0,3
2023-06-01,210449,2,2,4,1,1,1
2023-06-01,210432,1,0,1,2,0,2
2023-06-01,3724,14,0,14,1,0,1
2023-06-01,57228,2,1,3,1,1,1
2023-06-01,57113,2,1,3,1,1,1
2023-06-01,206217,6,0,6,1,0,1
2023-06-01,42893,3,0,3,6,0,6
2023-06-01,201109,22,0,22,1,0,1
2023-06-01,51332,1,0,1,1,0,1
2023-06-01,32904,3,0,3,4,0,4
2023-06-01,32365,3,1,4,3,2,3
2023-06-01,36416,5,1,6,9,6,10
2023-06-01,21297,4,1,5,1,1,1
2023-06-01,30051,5,0,5,2,0,2
2023-06-01,15307,12,0,12,3,0,3
2023-06-01,7,16,1,17,1,1,1
2023-06-01,41648,1,0,1,1,0,1
2023-06-01,14167,1,0,1,1,0,1
2023-06-01,16471,13,0,13,3,2,4
2023-06-01,55252,1,0,1,1,0,1
2023-06-01,23140,11,1,12,3,3,3
2023-06-01,264724,4,1,5,2,1,2
2023-06-01,26610,19,2,21,4,2,4
2023-06-01,28116,3,0,3,3,0,3
2023-06-01,395034,2,0,2,1,0,1
2023-06-01,393594,1,0,1,1,0,1
2023-06-01,53460,3,0,3,1,0,1
2023-06-01,395351,2,0,2,1,0,1
2023-06-01,1638,2,0,2,2,0,2
2023-06-01,20052,6,1,7,3,2,3
2023-06-01,18709,13,0,13,3,0,3
2023-06-01,13759,1,0,1,1,0,1
2023-06-01,210358,3,0,3,3,0,3
2023-06-01,15499,3,1,4,3,2,3
2023-06-01,15733,1,1,2,1,1,1
2023-06-01,9042,12,3,15,2,1,2
2023-06-01,16085,4,0,4,3,0,3
2023-06-01,20743,4,2,6,3,1,3
2023-06-01,12162,1,0,1,3,0,3
2023-06-01,134111,7,0,7,1,0,1
2023-06-01,201991,1,0,1,2,0,2
2023-06-01,44321,3,0,3,2,0,2
2023-06-01,202533,1,0,1,1,0,1
2023-06-01,206115,1,0,1,2,0,2
2023-06-01,61166,1,0,1,1,0,1
2023-06-01,64461,1,0,1,2,0,2
2023-06-01,41129,1,0,1,1,0,1
2023-06-01,41917,1,0,1,1,0,1
2023-06-01,41177,1,0,1,1,0,1
2023-06-01,59525,2,0,2,3,0,3
2023-06-01,209002,1,0,1,7,0,7
2023-06-01,208087,6,0,6,6,0,6
2023-06-01,44340,3,0,3,1,0,1
2023-06-01,49319,1,0,1,3,0,3
2023-06-01,44405,1,0,1,2,0,2
2023-06-01,50576,1,0,1,3,0,3
2023-06-01,42782,1,0,1,1,0,1
2023-06-01,56673,1,0,1,1,0,1
2023-06-01,49376,1,0,1,1,0,1
2023-06-01,42581,5,0,5,2,0,2
2023-06-01,42209,2,1,3,3,1,3
2023-06-01,39523,2,0,2,3,0,3
2023-06-01,49641,2,1,3,3,2,3
2023-06-01,47231,1,0,1,1,0,1
2023-06-01,44835,1,0,1,1,0,1
2023-06-01,48172,2,0,2,6,0,6
2023-06-01,208538,1,0,1,1,0,1
2023-06-01,51503,2,0,2,1,0,1
2023-06-01,57975,2,0,2,1,0,1
2023-06-01,208515,1,0,1,2,0,2
2023-06-01,203781,1,0,1,2,0,2
2023-06-01,41409,1,0,1,2,0,2
2023-06-01,204875,2,0,2,4,0,4
2023-06-01,14864,3,0,3,2,0,2
2023-06-01,3260,6,0,6,1,0,1
2023-06-01,6501,23,0,23,3,0,3
2023-06-01,14733,54,0,54,4,0,4
2023-06-01,2544,22,0,22,14,0,14
2023-06-01,23448,3,0,3,3,0,3
2023-06-01,12551,28,0,28,6,0,6
2023-06-01,262534,3,1,4,1,1,1
2023-06-01,3486,7,6,13,5,5,5
2023-06-01,40848,1,0,1,1,0,1
2023-06-01,22912,3,0,3,1,0,1
2023-06-01,20191,29,4,33,3,2,3
2023-06-01,204323,1,0,1,2,0,2
2023-06-01,202668,1,0,1,2,0,2
2023-06-01,201012,16,0,16,5,0,5
2023-06-01,204514,1,0,1,2,0,2
2023-06-01,210616,23,0,23,2,0,2
2023-06-01,53695,13,0,13,4,0,4
2023-06-01,2570,20,1,21,1,1,1
2023-06-01,400650,2,0,2,3,0,3
2023-06-01,24120,7,0,7,3,0,3
2023-06-01,37501,11,2,13,1,1,1
2023-06-01,32720,10,0,10,3,0,3
2023-06-01,29302,1,0,1,1,0,1
2023-06-01,211174,1,1,2,1,1,1
2023-06-01,41390,4,0,4,1,0,1
2023-06-01,201781,1,0,1,1,0,1
2023-06-01,34866,1,0,1,1,0,1
2023-06-01,3935,1,0,1,1,0,1
2023-06-01,5516,8,0,8,3,0,3
2023-06-01,25049,12,0,12,3,0,3
2023-06-01,17654,18,0,18,1,0,1
2023-06-01,55491,2,0,2,1,0,1
2023-06-01,137787,5,0,5,3,0,3
2023-06-01,54535,46,0,46,11,0,11
2023-06-01,46264,1,0,1,1,0,1
2023-06-01,11452,9,0,9,5,0,5
2023-06-01,19254,39,0,39,6,0,6
2023-06-01,399251,1,0,1,3,0,3
2023-06-01,42114,1,0,1,1,0,1
2023-06-01,396207,8,0,8,1,0,1
2023-06-01,42213,1,0,1,1,0,1
2023-06-01,62882,10,0,10,1,0,1
2023-06-01,204590,1,0,1,1,0,1
2023-06-01,20478,12,0,12,5,0,5
2023-06-01,12086,107,0,107,3,0,3
2023-06-01,16153,1,0,1,1,0,1
2023-06-01,196809,3,0,3,2,0,2
2023-06-01,208983,1,0,1,3,0,3
2023-06-01,61211,13,1,14,10,3,11
2023-06-01,9502,48,0,48,4,0,4
2023-06-01,136198,3,2,5,1,1,1
2023-06-01,12018,9,0,9,3,0,3
2023-06-01,62974,2,0,2,1,0,1
2023-06-01,13633,4,0,4,2,0,2
2023-06-01,12190,12,0,12,3,0,3
2023-06-01,20243,6,0,6,2,0,2
2023-06-01,10364,3,0,3,2,0,2
2023-06-01,37520,3,2,5,2,2,2
2023-06-01,53527,4,0,4,1,0,1
2023-06-01,43857,10,1,11,3,1,3
2023-06-01,49220,2,1,3,3,2,3
2023-06-01,10857,22,0,22,4,0,4
2023-06-01,18113,8,0,8,2,0,2
2023-06-01,32067,35,0,35,6,0,6
2023-06-01,3145,19,1,20,3,1,3
2023-06-01,16050,26,0,26,4,0,4
2023-06-01,24012,20,0,20,6,0,6
2023-06-01,12128,2,0,2,2,0,2
2023-06-01,10457,14,0,14,5,0,5
2023-06-01,6527,14,0,14,1,0,1
2023-06-01,8659,13,1,14,5,1,5
2023-06-01,43128,4,1,5,6,3,6
2023-06-01,197953,1,0,1,3,0,3
2023-06-01,203239,1,2,3,2,2,2
2023-06-01,199336,1,1,2,2,2,2
2023-06-01,199666,5,5,10,3,2,3
2023-06-01,57037,4,3,7,2,1,2
2023-06-01,204031,1,0,1,3,0,3
2023-06-01,201683,1,0,1,1,0,1
2023-06-01,209613,1,0,1,2,0,2
2023-06-01,53786,1,0,1,1,0,1
2023-06-01,210371,1,0,1,2,0,2
2023-06-01,48158,18,0,18,15,0,15
2023-06-01,395289,1,0,1,1,0,1
2023-06-01,2615,30,0,30,9,0,9
2023-06-01,33703,2,1,3,4,1,4
2023-06-01,4528,7,2,9,2,2,2
2023-06-01,32064,4,1,5,4,2,4
2023-06-01,211316,6,0,6,9,0,9
2023-06-01,203424,6,2,8,3,2,3
2023-06-01,41076,3,0,3,1,0,1
2023-06-01,20470,2,0,2,1,0,1
2023-06-01,26933,1,0,1,1,0,1
2023-06-01,53418,5,0,5,1,0,1
2023-06-01,395223,1,0,1,1,0,1
2023-06-01,8278,1,1,2,1,1,1
2023-06-01,3130,4,1,5,5,3,6
2023-06-01,205436,14,0,14,6,0,6
2023-06-01,15243,1,0,1,2,0,2
2023-06-01,1559,2,0,2,1,0,1
2023-06-01,1551,1,0,1,1,0,1
2023-06-01,37978,14,0,14,2,0,2
2023-06-01,7564,24,0,24,3,0,3
2023-06-01,2895,6,1,7,6,3,6
2023-06-01,9488,23,0,23,4,0,4
2023-06-01,5180,49,0,49,3,0,3
2023-06-01,4152,14,1,15,2,1,2
2023-06-01,137545,2,0,2,3,0,3
2023-06-01,132866,10,0,10,2,0,2
2023-06-01,6867,2,1,3,1,1,1
2023-06-01,1265,4,0,4,2,0,2
2023-06-01,53798,2,0,2,2,0,2
2023-06-01,29197,23,0,23,4,0,4
2023-06-01,398564,15,2,17,2,2,2
2023-06-01,262829,1,1,2,1,1,1
2023-06-01,38474,4,2,6,3,1,3
2023-06-01,42848,9,5,14,2,2,2
2023-06-01,19899,15,0,15,3,0,3
2023-06-01,3503,3,0,3,1,0,1
2023-06-01,27604,1,0,1,2,0,2
2023-06-01,36407,3,1,4,2,2,2
2023-06-01,30109,18,0,18,6,0,6
2023-06-01,10152,4,0,4,3,0,3
2023-06-01,35691,2,4,6,1,1,1
2023-06-01,205124,3,0,3,1,0,1
2023-06-01,209535,16,0,16,2,0,2
2023-06-01,209424,2,1,3,1,1,1
2023-06-01,208271,1,0,1,2,0,2
2023-06-01,208574,1,1,2,2,2,2
2023-06-01,198386,3,0,3,3,0,3
2023-06-01,56559,4,0,4,2,0,2
2023-06-01,20733,1,0,1,1,0,1
2023-06-01,25236,1,0,1,1,0,1
2023-06-01,213159,1,0,1,2,0,2
2023-06-01,50391,2,5,7,1,6,6
2023-06-01,207691,3,0,3,5,0,5
2023-06-01,209323,1,1,2,4,5,5
2023-06-01,208057,3,0,3,3,0,3
2023-06-01,209425,3,0,3,1,0,1
2023-06-01,207502,2,1,3,1,1,1
2023-06-01,209531,1,1,2,2,2,2
2023-06-01,209532,1,0,1,1,0,1
2023-06-01,209634,4,1,5,1,1,1
2023-06-01,208731,3,8,11,2,3,3
2023-06-01,211290,3,0,3,2,0,2
2023-06-01,203671,1,0,1,1,0,1
2023-06-01,209541,2,0,2,1,0,1
2023-06-01,39587,1,1,2,6,1,6
2023-06-01,59890,5,1,6,8,7,10
2023-06-01,209191,1,0,1,1,0,1
2023-06-01,14327,3,0,3,4,0,4
2023-06-01,39069,1,0,1,1,0,1
2023-06-01,200233,2,1,3,2,2,2
2023-06-01,43453,1,0,1,3,0,3
2023-06-01,398145,3,0,3,1,0,1
2023-06-01,396969,3,0,3,3,0,3
2023-06-01,62514,1,0,1,1,0,1
2023-06-01,8762,6,1,7,1,1,1
2023-06-01,30408,1,0,1,1,0,1
2023-06-01,2471,15,0,15,1,0,1
2023-06-01,3323,1,1,2,1,1,1
2023-06-01,22522,15,0,15,2,0,2
2023-06-01,19096,1,0,1,1,0,1
2023-06-01,54363,31,0,31,12,0,12
2023-06-01,37121,221,0,221,5,0,5
2023-06-01,1770,2,0,2,1,0,1
2023-06-01,50432,4,0,4,4,0,4
2023-06-01,50422,6,0,6,3,0,3
2023-06-01,32243,1,0,1,1,0,1
2023-06-01,1432,1,0,1,3,0,3
2023-06-01,13706,29,3,32,2,2,2
2023-06-01,393740,14,0,14,2,0,2
2023-06-01,2488,1,1,2,1,1,1
2023-06-01,7968,10,0,10,3,0,3
2023-06-01,395577,10,0,10,2,0,2
2023-06-01,11789,2,0,2,1,0,1
2023-06-01,394728,3,1,4,3,3,4
2023-06-01,33632,1,0,1,3,0,3
2023-06-01,30569,47,0,47,2,0,2
2023-06-01,399060,35,1,36,3,2,3
2023-06-01,399049,10,1,11,3,1,3
2023-06-01,150317,2,0,2,1,0,1
2023-06-01,400339,7,6,13,2,2,2
2023-06-01,21605,1,0,1,3,0,3
2023-06-01,397179,1,0,1,2,0,2
2023-06-01,22644,6,0,6,3,0,3
2023-06-01,2640,1,1,2,2,2,2
2023-06-01,397675,1,0,1,1,0,1
2023-06-01,46184,1,0,1,4,0,4
2023-06-01,393964,9,0,9,2,0,2
2023-06-01,397488,1,2,3,3,2,3
2023-06-01,62629,1,0,1,1,0,1
2023-06-01,397971,1,0,1,1,0,1
2023-06-01,31292,1,0,1,1,0,1
2023-06-01,397670,1,0,1,1,0,1
2023-06-01,46674,1,0,1,1,0,1
2023-06-01,53355,4,1,5,4,1,4
2023-06-01,397697,1,0,1,1,0,1
2023-06-01,398151,1,0,1,2,0,2
2023-06-01,397931,1,0,1,1,0,1
2023-06-01,397328,2,0,2,3,0,3
2023-06-01,54687,1,0,1,1,0,1
2023-06-01,398027,1,0,1,1,0,1
2023-06-01,397503,1,0,1,1,0,1
2023-06-01,397457,1,1,2,2,2,2
2023-06-01,397419,2,0,2,1,0,1
2023-06-01,23130,1,0,1,1,0,1
2023-06-01,46568,3,0,3,2,0,2
2023-06-01,397302,2,0,2,3,0,3
2023-06-01,400107,3,0,3,1,0,1
2023-06-01,25775,1,0,1,1,0,1
2023-06-01,43897,1,0,1,2,0,2
2023-06-01,60307,1,0,1,2,0,2
2023-06-01,60948,1,0,1,2,0,2
2023-06-01,202921,8,1,9,4,3,4
2023-06-01,25968,2,0,2,3,0,3
2023-06-01,6812,10,0,10,4,0,4
2023-06-01,46977,12,0,12,2,0,2
2023-06-01,202553,11,6,17,1,1,1
2023-06-01,208153,3,3,6,1,1,1
2023-06-01,27555,16,0,16,5,0,5
2023-06-01,137904,6,0,6,2,0,2
2023-06-01,400541,2,3,5,3,1,3
2023-06-01,399115,1,1,2,1,1,1
2023-06-01,19655,1,0,1,2,0,2
2023-06-01,21857,6,0,6,1,0,1
2023-06-01,396432,6,0,6,5,0,5
2023-06-01,26276,2,0,2,1,0,1
2023-06-01,400121,1,0,1,2,0,2
2023-06-01,400403,1,0,1,1,0,1
2023-06-01,1088,2,1,3,2,2,2
2023-06-01,400238,21,1,22,3,1,3
2023-06-01,54459,2,0,2,3,0,3
2023-06-01,205303,3,0,3,3,0,3
2023-06-01,28944,3,0,3,1,0,1
2023-06-01,2799,2,1,3,1,1,1
2023-06-01,63039,15,0,15,3,0,3
2023-06-01,4749,21,0,21,10,0,10
2023-06-01,205975,3,1,4,2,2,2
2023-06-01,212083,1,0,1,1,0,1
2023-06-01,209045,4,2,6,9,5,10
2023-06-01,199541,25,0,25,2,0,2
2023-06-01,55542,38,0,38,7,0,7
2023-06-01,10464,16,1,17,3,1,3
2023-06-01,395077,1,0,1,1,0,1
2023-06-01,18982,6,2,8,1,2,2
2023-06-01,55164,3,0,3,1,0,1
2023-06-01,63103,8,0,8,4,0,4
2023-06-01,17750,3,0,3,3,0,3
2023-06-01,2202,6,0,6,1,0,1
2023-06-01,2439,1,0,1,1,0,1
2023-06-01,34576,2,1,3,1,1,1
2023-06-01,11649,1,0,1,5,0,5
2023-06-01,201263,1,1,2,1,1,1
2023-06-01,30866,9,0,9,1,0,1
2023-06-01,44060,2,0,2,3,0,3
2023-06-01,207106,1,0,1,1,0,1
2023-06-01,205650,2,0,2,1,0,1
2023-06-01,205577,1,0,1,1,0,1
2023-06-01,202320,2,0,2,3,0,3
2023-06-01,204831,1,0,1,1,0,1
2023-06-01,208465,1,0,1,3,0,3
2023-06-01,202356,3,0,3,1,0,1
2023-06-01,202369,1,0,1,1,0,1
2023-06-01,202001,1,0,1,1,0,1
2023-06-01,200309,2,0,2,2,0,2
2023-06-01,209514,1,0,1,1,0,1
2023-06-01,206106,1,0,1,3,0,3
2023-06-01,201415,2,0,2,3,0,3
2023-06-01,207591,2,0,2,2,0,2
2023-06-01,207444,1,0,1,3,0,3
2023-06-01,213079,1,0,1,3,0,3
2023-06-01,212361,1,0,1,1,0,1
2023-06-01,212307,2,0,2,2,0,2
2023-06-01,25125,35,0,35,3,0,3
2023-06-01,202447,3,0,3,2,0,2
2023-06-01,211329,4,0,4,2,0,2
2023-06-01,211518,1,0,1,1,0,1
2023-06-01,210625,7,3,10,1,1,1
2023-06-01,8867,27,1,28,3,2,3
2023-06-01,228,4,1,5,1,1,1
2023-06-01,12195,0,0,0,3,0,3
2023-06-01,12159,2,1,3,4,1,4
2023-06-01,36701,2,0,2,1,0,1
2023-06-01,30165,17,1,18,7,3,7
2023-06-01,6074,1,0,1,3,0,3
2023-06-01,3314,1,0,1,1,0,1
2023-06-01,394673,3,0,3,2,0,2
2023-06-01,395174,3,7,10,3,1,3
2023-06-01,2015,8,0,8,2,0,2
2023-06-01,54403,1,0,1,3,0,3
2023-06-01,15276,1,0,1,1,0,1
2023-06-01,21907,2,1,3,1,1,1
2023-06-01,32585,1,0,1,1,0,1
2023-06-01,397812,1,0,1,1,0,1
2023-06-01,14906,1,0,1,1,0,1
2023-06-01,47070,1,0,1,3,0,3
2023-06-01,30378,1,0,1,3,0,3
2023-06-01,397871,1,0,1,1,0,1
2023-06-01,19656,1,0,1,1,0,1
2023-06-01,400505,1,0,1,2,0,2
2023-06-01,26302,2,0,2,2,0,2
2023-06-01,397130,3,0,3,3,0,3
2023-06-01,63078,1,0,1,2,0,2
2023-06-01,62581,1,0,1,1,0,1
2023-06-01,395449,1,0,1,1,0,1
2023-06-01,395879,1,0,1,3,0,3
2023-06-01,395574,1,0,1,1,0,1
2023-06-01,395612,1,0,1,1,0,1
2023-06-01,46165,1,0,1,1,0,1
2023-06-01,396469,1,2,3,1,1,1
2023-06-01,396477,6,0,6,2,0,2
2023-06-01,11821,3,0,3,1,0,1
2023-06-01,63048,1,0,1,1,0,1
2023-06-01,22425,1,0,1,3,0,3
2023-06-01,395645,2,0,2,2,0,2
2023-06-01,11639,1,0,1,2,0,2
2023-06-01,400028,1,0,1,1,0,1
2023-06-01,396160,2,0,2,1,0,1
2023-06-01,395560,2,0,2,1,0,1
2023-06-01,36638,2,0,2,1,0,1
2023-06-01,39959,6,0,6,1,0,1
2023-06-01,32000,4,0,4,2,0,2
2023-06-01,16811,57,0,57,2,0,2
2023-06-01,23088,5,0,5,5,0,5
2023-06-01,396177,1,0,1,1,0,1
2023-06-01,20421,3,0,3,1,0,1
2023-06-01,395057,2,0,2,2,0,2
2023-06-01,10511,6,0,6,4,0,4
2023-06-01,18642,16,0,16,2,0,2
2023-06-01,396844,1,0,1,3,0,3
2023-06-01,22793,2,0,2,1,0,1
2023-06-01,396042,1,0,1,2,0,2
2023-06-01,396131,1,0,1,3,0,3
2023-06-01,6500,2,0,2,3,0,3
2023-06-01,396148,1,0,1,3,0,3
2023-06-01,16666,1,0,1,3,0,3
2023-06-01,22479,1,0,1,2,0,2
2023-06-01,394036,1,0,1,1,0,1
2023-06-01,22336,1,0,1,3,0,3
2023-06-01,395607,1,0,1,4,0,4
2023-06-01,395086,1,0,1,1,0,1
2023-06-01,396161,1,0,1,3,0,3
2023-06-01,15358,3,0,3,3,0,3
2023-06-01,400131,1,0,1,1,0,1
2023-06-01,53640,1,0,1,1,0,1
2023-06-01,397645,2,0,2,1,0,1
2023-06-01,395701,2,0,2,1,0,1
2023-06-01,393326,1,0,1,1,0,1
2023-06-01,207845,2,0,2,1,0,1
2023-06-01,207870,2,0,2,1,0,1
2023-06-01,7285,1,0,1,1,0,1
2023-06-01,16812,1,0,1,1,0,1
2023-06-01,25673,6,0,6,4,0,4
2023-06-01,209314,2,1,3,2,2,2
2023-06-01,60421,1,0,1,1,0,1
2023-06-01,196802,2,0,2,2,0,2
2023-06-01,41092,1,0,1,1,0,1
2023-06-01,201617,1,0,1,3,0,3
2023-06-01,202121,1,0,1,2,0,2
2023-06-01,201125,1,0,1,2,0,2
2023-06-01,32559,1,0,1,1,0,1
2023-06-01,6124,1,1,2,3,3,3
2023-06-01,19180,55,1,56,1,1,1
2023-06-01,28118,428,2,430,10,4,10
2023-06-01,12066,41,0,41,2,0,2
2023-06-01,14782,21,1,22,3,1,3
2023-06-01,63391,3,0,3,4,0,4
2023-06-01,38870,10,0,10,5,0,5
2023-06-01,19178,7,0,7,3,0,3
2023-06-01,22098,21,1,22,5,1,6
2023-06-01,26072,22,2,24,3,3,4
2023-06-01,10615,35,0,35,4,0,4
2023-06-01,2575,1,1,2,2,1,2
2023-06-01,399234,5,0,5,2,0,2
2023-06-01,7764,5,3,8,3,3,3
2023-06-01,19113,15,0,15,3,0,3
2023-06-01,7150,8,0,8,3,0,3
2023-06-01,18844,1,0,1,2,0,2
2023-06-01,20004,33,0,33,3,0,3
2023-06-01,271871,1,0,1,1,0,1
2023-06-01,18715,11,0,11,1,0,1
2023-06-01,55013,5,0,5,4,0,4
2023-06-01,4200009708,2,0,2,1,0,1
2023-06-01,7988,2,0,2,1,0,1
2023-06-01,7359,4,1,5,1,1,1
2023-06-01,4015,4,1,5,1,1,1
2023-06-01,13860,29,0,29,5,0,5
2023-06-01,44743,4,0,4,2,0,2
2023-06-01,205574,2,1,3,2,2,2
2023-06-01,46118,3,0,3,2,0,2
2023-06-01,54973,1,0,1,1,0,1
2023-06-01,16502,34,0,34,2,0,2
2023-06-01,7068,12,0,12,2,0,2
2023-06-01,11971,8,1,9,2,1,2
2023-06-01,36393,2,0,2,2,0,2
2023-06-01,203885,15,0,15,2,0,2
2023-06-01,397879,5,0,5,1,0,1
2023-06-01,396287,4,0,4,3,0,3
2023-06-01,20414,6,0,6,2,0,2
2023-06-01,13778,29,0,29,17,0,17
2023-06-01,22876,2,0,2,3,0,3
2023-06-01,11719,10,0,10,4,0,4
2023-06-01,24061,3,0,3,2,0,2
2023-06-01,27016,1,5,6,1,1,1
2023-06-01,15304,1,1,2,2,2,2
2023-06-01,31382,6,2,8,4,1,4
2023-06-01,1831,1,0,1,1,0,1
2023-06-01,2549,4,1,5,3,2,3
2023-06-01,3810,17,0,17,2,0,2
2023-06-01,3484,83,1,84,4,1,4
2023-06-01,21520,23,0,23,2,0,2
2023-06-01,3596,197,0,197,3,0,3
2023-06-01,265519,3,0,3,3,0,3
2023-06-01,270167,1,5,6,1,1,1
2023-06-01,270149,2,1,3,1,1,1
2023-06-01,28414,39,0,39,1,0,1
2023-06-01,22122,79,1,80,1,1,1
2023-06-01,2904,1,0,1,1,0,1
2023-06-01,15236,9,0,9,3,0,3
2023-06-01,16960,179,11,190,8,1,8
2023-06-01,2708,49,1,50,3,1,3
2023-06-01,28526,46,0,46,2,0,2
2023-06-01,28477,41,0,41,1,0,1
2023-06-01,263134,1,1,2,2,1,2
2023-06-01,28417,29,0,29,1,0,1
2023-06-01,4493,14,0,14,1,0,1
2023-06-01,7184,169,0,169,1,0,1
2023-06-01,28404,0,1,1,2,1,2
2023-06-01,3141,1,0,1,1,0,1
2023-06-01,16596,63,1,64,3,1,3
2023-06-01,28505,9,0,9,1,0,1
2023-06-01,28403,60,215,275,2,2,2
2023-06-01,3454,2,0,2,3,0,3
2023-06-01,28391,153,0,153,1,0,1
2023-06-01,7325,50,0,50,1,0,1
2023-06-01,28519,19,1,20,2,1,2
2023-06-01,28555,27,11,38,5,3,5
2023-06-01,28570,1,0,1,1,0,1
2023-06-01,22011,127,4,131,6,1,6
2023-06-01,28492,8,0,8,7,0,7
2023-06-01,15107,18,0,18,6,0,6
2023-06-01,265504,8,0,8,3,0,3
2023-06-01,28533,5,0,5,2,0,2
2023-06-01,28525,4,0,4,2,0,2
2023-06-01,28530,5,0,5,1,0,1
2023-06-01,28534,21,4,25,2,1,2
2023-06-01,28544,11,2,13,1,2,2
2023-06-01,28543,5,0,5,1,0,1
2023-06-01,28537,10,5,15,1,1,1
2023-06-01,3548,85,0,85,1,0,1
2023-06-01,28446,1,0,1,1,0,1
2023-06-01,44503,9,0,9,8,0,8
2023-06-01,19313,1,0,1,1,0,1
2023-06-01,213013,1,1,2,2,1,2
2023-06-01,209497,2,0,2,1,0,1
2023-06-01,209908,2,0,2,1,0,1
2023-06-01,208062,1,0,1,1,0,1
2023-06-01,51297,7,2,9,7,3,7
2023-06-01,202102,1,0,1,2,0,2
2023-06-01,196736,3,0,3,4,0,4
2023-06-01,206704,1,1,2,1,1,1
2023-06-01,48605,2,3,5,1,1,1
2023-06-01,204808,1,0,1,2,0,2
2023-06-01,200589,3,0,3,2,0,2
2023-06-01,51571,2,1,3,3,2,3
2023-06-01,203503,4,1,5,1,1,2
2023-06-01,400444,2,0,2,1,0,1
2023-06-01,204540,2,0,2,6,0,6
2023-06-01,28776,9,0,9,2,0,2
2023-06-01,27313,5,0,5,2,0,2
2023-06-01,202282,14,1,15,7,2,7
2023-06-01,204242,3,0,3,2,0,2
2023-06-01,14601,2,0,2,4,0,4
2023-06-01,39849,2,0,2,2,0,2
2023-06-01,201867,4,0,4,4,0,4
2023-06-01,62064,48,0,48,2,0,2
2023-06-01,200116,1,0,1,2,0,2
2023-06-01,60293,2,0,2,1,0,1
2023-06-01,212449,6,3,9,2,2,2
2023-06-01,47132,13,3,16,2,2,2
2023-06-01,42764,3,0,3,6,0,6
2023-06-01,202550,1,1,2,3,3,4
2023-06-01,209703,4,0,4,2,0,2
2023-06-01,209529,5,0,5,7,0,7
2023-06-01,213338,2,0,2,6,0,6
2023-06-01,206182,6,1,7,6,3,7
2023-06-01,201573,6,0,6,3,0,3
2023-06-01,209492,14,0,14,3,0,3
2023-06-01,202170,6,0,6,2,0,2
2023-06-01,43112,1,0,1,2,0,2
2023-06-01,60483,4,0,4,2,0,2
2023-06-01,207498,3,1,4,2,1,2
2023-06-01,19203,1,0,1,2,0,2
2023-06-01,61083,1,1,2,3,1,3
2023-06-01,52113,2,0,2,2,0,2
2023-06-01,42467,2,0,2,3,0,3
2023-06-01,60943,2,0,2,4,0,4
2023-06-01,200794,4,0,4,7,0,7
2023-06-01,206660,1,0,1,1,0,1
2023-06-01,20337,8,0,8,2,0,2
2023-06-01,272693,1,1,2,1,1,2
2023-06-01,272694,3,0,3,4,0,4
2023-06-01,271682,4,1,5,7,3,7
2023-06-01,399071,3,0,3,1,0,1
2023-06-01,10250,7,0,7,4,0,4
2023-06-01,36469,4,0,4,2,0,2
2023-06-01,398401,1,0,1,1,0,1
2023-06-01,62855,1,0,1,2,0,2
2023-06-01,395236,2,1,3,1,2,2
2023-06-01,36069,11,1,12,2,1,2
2023-06-01,27321,4,1,5,2,1,2
2023-06-01,30132,3,2,5,6,6,8
2023-06-01,393507,5,1,6,1,1,1
2023-06-01,397620,1,0,1,2,0,2
2023-06-01,16824,8,0,8,1,0,1
2023-06-01,205826,4,0,4,3,0,3
2023-06-01,33442,19,3,22,10,2,10
2023-06-01,54624,22,0,22,4,0,4
2023-06-01,11866,4,0,4,3,0,3
2023-06-01,30403,3,0,3,3,0,3
2023-06-01,132377,2,0,2,2,0,2
2023-06-01,58658,11,0,11,1,0,1
2023-06-01,27616,1,0,1,4,0,4
2023-06-01,206866,31,0,31,4,0,4
2023-06-01,211974,3,0,3,2,0,2
2023-06-01,59710,3,0,3,2,0,2
2023-06-01,204415,1,1,2,1,1,1
2023-06-01,1289,5,0,5,3,0,3
2023-06-01,16710,13,0,13,2,0,2
2023-06-01,55158,29,1,30,7,1,8
2023-06-01,212033,2,1,3,4,4,5
2023-06-01,32835,17,0,17,2,0,2
2023-06-01,23171,3,0,3,3,0,3
2023-06-01,205729,1,0,1,1,0,1
2023-06-01,57424,12,0,12,1,0,1
2023-06-01,205973,1,0,1,3,0,3
2023-06-01,57119,8,2,10,6,3,6
2023-06-01,54177,7,1,8,3,3,3
2023-06-01,46356,2,0,2,1,0,1
2023-06-01,272030,7,1,8,3,1,3
2023-06-01,272066,3,0,3,1,0,1
2023-06-01,272124,1,0,1,2,0,2
2023-06-01,272022,2,2,4,6,3,6
2023-06-01,266436,8,31,39,6,3,6
2023-06-01,272644,1,1,2,1,1,1
2023-06-01,10655,19,0,19,7,0,7
2023-06-01,13513,2,0,2,4,0,4
2023-06-01,19580,2,0,2,2,0,2
2023-06-01,206732,5,1,6,6,4,6
2023-06-01,203277,1,0,1,1,0,1
2023-06-01,201196,3,1,4,3,1,3
2023-06-01,200843,1,0,1,2,0,2
2023-06-01,397182,4,2,6,2,2,2
2023-06-01,46513,8,3,11,6,3,6
2023-06-01,395481,1,0,1,1,0,1
2023-06-01,3602,208,0,208,1,0,1
2023-06-01,211349,2,0,2,3,0,3
2023-06-01,212636,2,0,2,3,0,3
2023-06-01,199536,4,1,5,5,3,5
2023-06-01,201518,2,1,3,4,2,4
2023-06-01,57111,3,1,4,6,3,7
2023-06-01,28941,2,0,2,1,0,1
2023-06-01,15130,36,7,43,1,1,1
2023-06-01,25996,14,11,25,2,2,2
2023-06-01,26589,2,0,2,1,0,1
2023-06-01,21529,3,2,5,4,2,4
2023-06-01,47449,0,1,1,2,7,8
2023-06-01,51818,1,0,1,1,0,1
2023-06-01,40568,2,2,4,3,3,3
2023-06-01,27299,13,8,21,3,3,3
2023-06-01,399970,7,17,24,1,1,1
2023-06-01,56849,33,2,35,2,2,2
2023-06-01,7809,7,1,8,3,1,4
2023-06-01,397635,11,1,12,4,1,4
2023-06-01,26791,2,0,2,2,0,2
2023-06-01,394027,5,1,6,2,1,2
2023-06-01,24539,6,0,6,3,0,3
2023-06-01,9087,3,0,3,1,0,1
2023-06-01,22203,6,0,6,4,0,4
2023-06-01,205501,3,0,3,2,0,2
2023-06-01,31297,3,0,3,1,0,1
2023-06-01,197975,2,0,2,3,0,3
2023-06-01,29828,7,0,7,3,0,3
2023-06-01,33022,2,0,2,2,0,2
2023-06-01,48075,14,0,14,4,0,4
2023-06-01,1348,1,0,1,1,0,1
2023-06-01,40385,1,0,1,3,0,3
2023-06-01,2494,1,1,2,1,1,1
2023-06-01,33600,1,1,2,1,1,1
2023-06-01,31828,5,0,5,1,0,1
2023-06-01,10955,3,0,3,1,0,1
2023-06-01,25691,2,0,2,1,0,1
2023-06-01,12460,10,1,11,3,2,3
2023-06-01,57141,2,0,2,1,0,1
2023-06-01,57144,21,0,21,6,0,6
2023-06-01,45046,2,0,2,2,0,2
2023-06-01,198859,3,1,4,1,1,1
2023-06-01,51176,1,0,1,1,0,1
2023-06-01,199954,1,1,2,2,2,2
2023-06-01,200067,2,0,2,2,0,2
2023-06-01,8267,5,1,6,2,2,2
2023-06-01,397121,4,0,4,1,0,1
2023-06-01,27198,6,0,6,1,0,1
2023-06-01,10680,11,1,12,1,1,1
2023-06-01,394747,1,0,1,3,0,3
2023-06-01,6559,9,0,9,1,0,1
2023-06-01,30629,2,0,2,3,0,3
2023-06-01,32537,11,0,11,6,0,6
2023-06-01,207116,4,0,4,1,0,1
2023-06-01,207441,2,0,2,1,0,1
2023-06-01,12422,4,7,11,2,4,4
2023-06-01,8319,11,2,13,13,6,16
2023-06-01,8303,3,0,3,2,0,2
2023-06-01,52756,7,1,8,2,2,2
2023-06-01,212403,1,1,2,1,1,1
2023-06-01,57376,2,1,3,2,2,2
2023-06-01,23167,11,0,11,2,0,2
2023-06-01,13043,19,0,19,5,0,5
2023-06-01,29088,2,0,2,4,0,4
2023-06-01,141367,2,0,2,3,0,3
2023-06-01,141364,2,0,2,3,0,3
2023-06-01,138162,2,0,2,3,0,3
2023-06-01,141435,2,0,2,3,0,3
2023-06-01,271787,2,0,2,2,0,2
2023-06-01,27343,3,0,3,3,0,3
2023-06-01,399076,2,0,2,2,0,2
2023-06-01,396121,2,0,2,4,0,4
2023-06-01,398416,9,0,9,3,0,3
2023-06-01,203160,10,0,10,4,0,4
2023-06-01,8232,7,0,7,3,0,3
2023-06-01,205527,6,0,6,3,0,3
2023-06-01,16751,12,0,12,7,0,7
2023-06-01,9197,2,3,5,1,1,1
2023-06-01,12291,14,0,14,3,0,3
2023-06-01,35391,1,0,1,2,0,2
2023-06-01,38943,4,0,4,1,0,1
2023-06-01,211800,1,0,1,1,0,1
2023-06-01,212382,1,0,1,1,0,1
2023-06-01,206978,4,1,5,1,1,1
2023-06-01,205806,11,0,11,3,0,3
2023-06-01,205769,11,1,12,8,7,10
2023-06-01,201151,4,0,4,3,0,3
2023-06-01,57408,1,0,1,2,0,2
2023-06-01,198002,1,1,2,1,1,1
2023-06-01,201144,2,0,2,1,0,1
2023-06-01,51782,2,0,2,1,0,1
2023-06-01,57210,2,0,2,2,0,2
2023-06-01,211140,9,0,9,3,0,3
2023-06-01,4680,28,1,29,7,3,7
2023-06-01,23793,16,0,16,1,0,1
2023-06-01,18125,1,1,2,6,4,6
2023-06-01,9991,1,0,1,2,0,2
2023-06-01,59104,3,0,3,2,0,2
2023-06-01,38654,5,0,5,1,0,1
2023-06-01,18124,9,1,10,2,2,2
2023-06-01,24291,4,0,4,3,0,3
2023-06-01,131938,1,0,1,3,0,3
2023-06-01,17932,2,1,3,4,3,4
2023-06-01,16880,7,3,10,7,6,7
2023-06-01,131925,10,4,14,4,3,4
2023-06-01,45685,1,0,1,1,0,1
2023-06-01,58651,1,1,2,1,1,1
2023-06-01,53648,1,0,1,1,0,1
2023-06-01,103563,0,0,0,2,0,2
2023-06-01,55756,3,0,3,1,0,1
2023-06-01,32531,96,0,96,4,0,4
2023-06-01,17651,2,0,2,1,0,1
2023-06-01,132157,1,0,1,1,0,1
2023-06-01,60649,1,1,2,1,1,1
2023-06-01,58657,2,0,2,1,0,1
2023-06-01,136221,1,0,1,1,0,1
2023-06-01,3807,29,1,30,3,3,3
2023-06-01,30499,1,0,1,1,0,1
2023-06-01,137690,5,5,10,1,1,1
2023-06-01,6744,1,0,1,1,0,1
2023-06-01,14223,2,0,2,2,0,2
2023-06-01,22828,1,1,2,2,2,2
2023-06-01,26438,13,0,13,3,0,3
2023-06-01,263300,3,3,6,2,1,2
2023-06-01,10417,2,0,2,4,2,4
2023-06-01,271354,1,1,2,1,1,1
2023-06-01,21982,4,0,4,4,0,4
2023-06-01,395527,1,0,1,2,0,2
2023-06-01,8103,812,25,837,12,3,12
2023-06-01,54248,1,0,1,2,0,2
2023-06-01,3450,28,0,28,8,2,8
2023-06-01,20312,6,0,6,3,0,3
2023-06-01,23007,2,0,2,1,0,1
2023-06-01,27892,4,0,4,1,0,1
2023-06-01,27893,1,0,1,2,0,2
2023-06-01,17287,1,0,1,1,0,1
2023-06-01,27890,1,0,1,1,0,1
2023-06-01,132321,4,0,4,1,0,1
2023-06-01,53352,13,0,13,5,0,5
2023-06-01,400117,4,0,4,2,0,2
2023-06-01,33434,1,0,1,4,0,4
2023-06-01,10952,2,1,3,1,1,1
2023-06-01,13393,1,0,1,3,0,3
2023-06-01,399715,1,0,1,1,0,1
2023-06-01,13376,2,0,2,2,0,2
2023-06-01,202575,1,0,1,1,0,1
2023-06-01,207714,40,1,41,2,1,2
2023-06-01,198853,1,1,2,2,1,2
2023-06-01,24149,2,2,4,2,2,3
2023-06-01,393750,25,0,25,2,0,2
2023-06-01,33523,1,0,1,3,0,3
2023-06-01,48647,6,0,6,4,0,4
2023-06-01,32601,14,0,14,1,0,1
2023-06-01,11375,3,0,3,2,0,2
2023-06-01,206523,16,0,16,2,0,2
2023-06-01,211101,19,0,19,3,0,3
2023-06-01,8217,4,0,4,3,0,3
2023-06-01,210026,2,1,3,3,4,4
2023-06-01,12734,5,0,5,2,0,2
2023-06-01,62701,1,0,1,2,0,2
2023-06-01,34088,1,0,1,1,0,1
2023-06-01,46528,16,0,16,5,0,5
2023-06-01,16758,29,0,29,6,0,6
2023-06-01,394409,11,0,11,10,0,10
2023-06-01,63222,9,0,9,3,0,3
2023-06-01,131462,17,0,17,2,0,2
2023-06-01,205881,1,1,2,7,4,8
2023-06-01,17199,10,0,10,3,0,3
2023-06-01,6482,10,0,10,3,0,3
2023-06-01,26054,13,0,13,2,0,2
2023-06-01,10967,34,0,34,4,0,4
2023-06-01,11396,13,2,15,5,1,5
2023-06-01,15117,3,0,3,2,0,2
2023-06-01,141044,1,0,1,1,0,1
2023-06-01,46342,22,0,22,5,0,5
2023-06-01,10837,46,2,48,3,2,3
2023-06-01,11687,5,0,5,6,0,6
2023-06-01,26551,2,0,2,2,0,2
2023-06-01,11602,6,0,6,2,0,2
2023-06-01,26498,2,0,2,2,0,2
2023-06-01,398573,5,2,7,2,2,2
2023-06-01,18930,7,0,7,1,0,1
2023-06-01,1678,27,0,27,11,0,11
2023-06-01,18443,5,0,5,4,0,4
2023-06-01,3576,5,0,5,2,0,2
2023-06-01,394985,5,0,5,2,0,2
2023-06-01,26905,1,0,1,2,0,2
2023-06-01,19693,21,4,25,6,2,6
2023-06-01,16037,6,0,6,7,0,7
2023-06-01,13515,3,0,3,1,0,1
2023-06-01,21984,5,0,5,2,0,2
2023-06-01,6334,7,0,7,2,0,2
2023-06-01,13945,6,0,6,3,0,3
2023-06-01,25997,10,0,10,6,0,6
2023-06-01,5744,3,8,11,1,1,1
2023-06-01,394546,3,0,3,4,0,4
2023-06-01,397722,1,0,1,1,0,1
2023-06-01,6998,7,0,7,3,0,3
2023-06-01,21693,14,0,14,8,0,8
2023-06-01,50952,1,0,1,1,0,1
2023-06-01,59599,1,0,1,1,0,1
2023-06-01,201005,2,0,2,1,0,1
2023-06-01,35761,6,4,10,6,2,6
2023-06-01,213271,1,0,1,1,0,1
2023-06-01,211159,1,0,1,1,0,1
2023-06-01,205874,1,0,1,1,0,1
2023-06-01,210212,1,0,1,1,0,1
2023-06-01,204554,1,0,1,1,0,1
2023-06-01,206004,4,0,4,3,0,3
2023-06-01,39024,3,0,3,1,0,1
2023-06-01,209850,4,0,4,1,0,1
2023-06-01,62110,1,0,1,1,0,1
2023-06-01,50186,32,0,32,1,0,1
2023-06-01,202439,1,0,1,1,0,1
2023-06-01,34314,1,0,1,1,0,1
2023-06-01,199606,5,1,6,2,1,2
2023-06-01,62093,1,1,2,2,1,2
2023-06-01,204727,1,0,1,1,0,1
2023-06-01,208257,3,2,5,3,1,3
2023-06-01,212212,1,0,1,1,0,1
2023-06-01,205052,4,1,5,2,2,2
2023-06-01,44712,1,1,2,5,4,5
2023-06-01,12996,20,8,28,10,8,10
2023-06-01,208045,1,1,2,2,2,2
2023-06-01,8672,1,0,1,1,0,1
2023-06-01,42157,1,0,1,1,0,1
2023-06-01,202593,1,0,1,1,0,1
2023-06-01,203535,1,0,1,1,0,1
2023-06-01,30855,4,0,4,7,0,7
2023-06-01,29680,14,1,15,8,3,8
2023-06-01,61215,4,1,5,6,6,7
2023-06-01,59709,1,0,1,3,0,3
2023-06-01,11442,4,1,5,1,1,1
2023-06-01,36850,8,3,11,1,1,1
2023-06-01,11540,2,1,3,1,1,1
2023-06-01,53785,2,0,2,1,0,1
2023-06-01,53384,1,1,2,3,1,3
2023-06-01,40245,1,0,1,1,0,1
2023-06-01,17031,1,0,1,1,0,1
2023-06-01,19718,7,1,8,1,1,1
2023-06-01,18538,1,0,1,1,0,1
2023-06-01,32417,1,0,1,2,0,2
2023-06-01,398580,9,0,9,2,0,2
2023-06-01,393875,1,1,2,2,1,2
2023-06-01,399565,1,0,1,3,0,3
2023-06-01,22854,2,0,2,1,0,1
2023-06-01,33401,2,0,2,3,0,3
2023-06-01,26087,1,0,1,1,0,1
2023-06-01,395312,1,0,1,2,0,2
2023-06-01,19094,1,0,1,1,0,1
2023-06-01,12031,1,0,1,1,0,1
2023-06-01,14306,5,0,5,1,0,1
2023-06-01,2539,1,0,1,1,0,1
2023-06-01,46780,1,0,1,1,0,1
2023-06-01,2547,1,0,1,1,0,1
2023-06-01,21558,5,0,5,6,0,6
2023-06-01,49309,1,0,1,3,0,3
2023-06-01,15687,2,0,2,1,0,1
2023-06-01,20137,5,0,5,2,0,2
2023-06-01,134096,27,0,27,1,0,1
2023-06-01,5264,2,0,2,1,0,1
2023-06-01,781,2,1,3,3,1,3
2023-06-01,782,1,0,1,1,0,1
2023-06-01,10384,15,1,16,3,1,3
2023-06-01,398242,2,0,2,1,0,1
2023-06-01,55120,6,0,6,3,0,3
2023-06-01,397057,2,0,2,1,0,1
2023-06-01,17212,2,0,2,2,0,2
2023-06-01,209377,3,5,8,3,2,3
2023-06-01,209998,4,0,4,2,0,2
2023-06-01,207437,1,1,2,2,1,2
2023-06-01,208118,4,0,4,2,0,2
2023-06-01,209358,1,0,1,4,0,4
2023-06-01,208355,1,1,2,1,1,1
2023-06-01,209473,1,0,1,3,0,3
2023-06-01,208785,4,0,4,6,0,6
2023-06-01,204489,1,0,1,1,0,1
2023-06-01,209513,3,0,3,1,0,1
2023-06-01,213313,3,0,3,1,0,1
2023-06-01,212271,2,7,9,3,10,10
2023-06-01,204958,6,1,7,3,1,3
2023-06-01,209510,2,2,4,4,4,5
2023-06-01,200797,6,1,7,7,2,7
2023-06-01,209509,5,4,9,2,2,2
2023-06-01,207048,2,2,4,2,2,2
2023-06-01,47648,2,1,3,4,4,4
2023-06-01,211300,1,0,1,1,0,1
2023-06-01,9555,37,6,43,1,1,1
2023-06-01,31975,6,0,6,3,0,3
2023-06-01,46078,1,0,1,2,0,2
2023-06-01,33770,120,0,120,1,0,1
2023-06-01,11863,1,0,1,2,0,2
2023-06-01,3382,4,1,5,4,1,4
2023-06-01,2576,20,28,48,1,1,1
2023-06-01,65540,8,1,9,2,1,2
2023-06-01,3923,4,1,5,3,1,3
2023-06-01,4046,14,5,19,3,2,3
2023-06-01,55606,2,0,2,2,0,2
2023-06-01,4961,27,0,27,2,0,2
2023-06-01,19422,46,1,47,4,2,5
2023-06-01,27183,1,0,1,2,0,2
2023-06-01,1021,1,0,1,2,0,2
2023-06-01,46683,1,0,1,1,0,1
2023-06-01,15103,1,0,1,1,0,1
2023-06-01,397678,2,0,2,2,0,2
2023-06-01,54163,2,0,2,1,0,1
2023-06-01,14153,32,20,52,1,2,2
2023-06-01,1387,0,0,0,2,2,2
2023-06-01,22368,278,0,278,1,0,1
2023-06-01,11960,1,2,3,6,3,6
2023-06-01,27725,63,0,63,1,0,1
2023-06-01,30313,12,4,16,2,1,2
2023-06-01,9292,8,1,9,2,1,2
2023-06-01,18822,328,2,330,1,1,1
2023-06-01,52505,7,0,7,2,0,2
2023-06-01,266877,2,0,2,2,0,2
2023-06-01,28036,38,1,39,3,1,3
2023-06-01,52420,29,0,29,4,0,4
2023-06-01,26599,561,145,706,18,1,18
2023-06-01,65407,0,0,0,2,0,2
2023-06-01,65435,1,8,9,4,2,4
2023-06-01,65021,0,0,0,2,0,2
2023-06-01,65430,28,0,28,1,0,1
2023-06-01,65406,0,0,0,2,0,2
2023-06-01,27699,181,12,193,4,1,4
2023-06-01,65445,0,0,0,2,0,2
2023-06-01,65442,0,0,0,2,0,2
2023-06-01,13548,3,0,3,4,0,4
2023-06-01,22063,1,0,1,1,0,1
2023-06-01,397115,23,0,23,1,0,1
2023-06-01,3943,1,1,2,1,2,2
2023-06-01,10867,3,0,3,1,0,1
2023-06-01,9877,4,1,5,3,2,3
2023-06-01,6035,108,0,108,4,0,4
2023-06-01,140720,1,1,2,1,1,1
2023-06-01,62585,3,0,3,3,0,3
2023-06-01,33015,3,0,3,1,0,1
2023-06-01,12928,2,0,2,1,0,1
2023-06-01,9025,4,0,4,1,0,1
2023-06-01,55562,3,0,3,1,0,1
2023-06-01,13806,57,0,57,8,0,8
2023-06-01,13476,25,1,26,5,1,5
2023-06-01,205081,3,5,8,2,2,3
2023-06-01,205700,2,1,3,2,1,2
2023-06-01,62038,2,1,3,1,1,1
2023-06-01,204977,1,0,1,3,0,3
2023-06-01,15544,19,3,22,7,4,8
2023-06-01,202957,3,1,4,1,1,1
2023-06-01,34966,6,1,7,10,4,11
2023-06-01,204279,6,1,7,6,3,6
2023-06-01,24635,1,0,1,3,0,3
2023-06-01,16818,5,0,5,4,0,4
2023-06-01,5409,4,2,6,7,7,10
2023-06-01,15372,9,1,10,7,2,7
2023-06-01,9020,2,1,3,1,1,1
2023-06-01,35170,4,1,5,2,2,2
2023-06-01,21207,22,1,23,2,1,2
2023-06-01,10448,1,0,1,2,0,2
2023-06-01,22213,9,0,9,1,0,1
2023-06-01,22217,1,0,1,3,0,3
2023-06-01,24313,96,0,96,6,0,6
2023-06-01,24952,1,0,1,1,0,1
2023-06-01,53007,6,0,6,3,0,3
2023-06-01,35950,30,0,30,3,0,3
2023-06-01,58653,7,0,7,3,0,3
2023-06-01,39771,13,0,13,6,0,6
2023-06-01,131921,34,13,47,4,4,5
2023-06-01,203849,4,0,4,1,0,1
2023-06-01,37711,7,0,7,2,0,2
2023-06-01,37616,15,1,16,4,1,4
2023-06-01,22735,3,0,3,2,0,2
2023-06-01,9084,17,0,17,1,0,1
2023-06-01,208744,3,0,3,4,0,4
2023-06-01,50200,3,0,3,1,0,1
2023-06-01,202065,3,0,3,3,0,3
2023-06-01,272000,1,0,1,1,0,1
2023-06-01,46337,23,0,23,1,0,1
2023-06-01,399838,2,0,2,1,0,1
2023-06-01,270014,6,4,10,6,3,7
2023-06-01,137937,1,0,1,1,0,1
2023-06-01,139705,1,0,1,1,0,1
2023-06-01,135314,1,0,1,1,0,1
2023-06-01,139706,1,0,1,1,0,1
2023-06-01,149290,5,1,6,5,3,6
2023-06-01,150432,1,0,1,1,0,1
2023-06-01,148990,12,0,12,1,0,1
2023-06-01,147060,5,0,5,2,0,2
2023-06-01,148987,8,0,8,1,0,1
2023-06-01,400211,1,0,1,1,0,1
2023-06-01,13411,1,0,1,1,0,1
2023-06-01,211808,7,0,7,3,0,3
2023-06-01,12094,1,0,1,1,0,1
2023-06-01,211423,2,1,3,1,1,1
2023-06-01,200358,1,0,1,1,0,1
2023-06-01,212562,3,0,3,2,0,2
2023-06-01,203792,1,0,1,1,0,1
2023-06-01,51006,1,0,1,1,0,1
2023-06-01,211733,2,0,2,3,0,3
2023-06-01,201321,1,1,2,1,1,1
2023-06-01,199426,2,2,4,1,1,1
2023-06-01,207866,2,1,3,5,5,6
2023-06-01,199523,1,0,1,1,0,1
2023-06-01,1886,7,0,7,3,0,3
2023-06-01,199244,2,1,3,3,2,4
2023-06-01,211829,1,0,1,1,0,1
2023-06-01,206355,2,1,3,5,1,5
2023-06-01,42290,5,0,5,1,0,1
2023-06-01,207010,1,0,1,2,0,2
2023-06-01,204519,1,0,1,1,0,1
2023-06-01,35344,5,0,5,3,0,3
2023-06-01,209312,1,1,2,1,1,1
2023-06-01,206663,3,0,3,7,0,7
2023-06-01,14449,2,0,2,2,0,2
2023-06-01,210535,1,0,1,1,0,1
2023-06-01,202052,2,0,2,2,0,2
2023-06-01,199717,10,0,10,2,0,2
2023-06-01,212263,2,1,3,7,5,7
2023-06-01,204182,2,1,3,3,1,3
2023-06-01,201042,1,0,1,2,0,2
2023-06-01,210743,2,5,7,1,2,2
2023-06-01,210448,1,0,1,1,0,1
2023-06-01,203847,2,0,2,1,0,1
2023-06-01,202042,3,2,5,6,2,6
2023-06-01,50919,4,1,5,4,1,4
2023-06-01,149977,1,0,1,1,0,1
2023-06-01,212536,3,0,3,3,0,3
2023-06-01,42220,14,1,15,3,2,3
2023-06-01,206930,7,0,7,1,0,1
2023-06-01,207757,1,0,1,1,0,1
2023-06-01,212081,2,1,3,1,1,1
2023-06-01,213287,1,0,1,1,0,1
2023-06-01,210805,1,1,2,1,1,1
2023-06-01,199452,7,0,7,1,0,1
2023-06-01,39291,3,0,3,2,0,2
2023-06-01,211991,2,0,2,5,0,5
2023-06-01,201060,2,0,2,1,0,1
2023-06-01,141148,1,0,1,1,0,1
2023-06-01,43054,3,0,3,1,0,1
2023-06-01,49794,2,0,2,5,0,5
2023-06-01,212406,1,0,1,3,0,3
2023-06-01,394651,2,0,2,4,0,4
2023-06-01,44706,4,0,4,3,0,3
2023-06-01,210627,2,1,3,6,2,6
2023-06-01,62166,14,1,15,8,4,8
2023-06-01,200171,1,0,1,1,0,1
2023-06-01,203709,37,0,37,1,0,1
2023-06-01,207763,1,0,1,1,0,1
2023-06-01,202844,2,1,3,7,3,8
2023-06-01,37627,2,0,2,3,0,3
2023-06-01,37629,18,0,18,4,0,4
2023-06-01,37727,8,1,9,7,3,7
2023-06-01,328196,7,1,8,2,1,2
2023-06-01,328279,5,0,5,1,0,1
2023-06-01,328098,3,0,3,1,0,1
2023-06-01,37648,5,0,5,2,0,2
2023-06-01,37523,2,0,2,5,0,5
2023-06-01,328155,2,0,2,3,0,3
2023-06-01,327909,15,0,15,5,0,5
2023-06-01,37637,17,0,17,3,0,3
2023-06-01,37603,1,1,2,1,1,2
2023-06-01,37642,1,1,2,4,1,4
2023-06-01,37658,1,0,1,3,0,3
2023-06-01,37564,19,17,36,9,3,9
2023-06-01,37650,22,0,22,6,0,6
2023-06-01,37653,2,0,2,3,0,3
2023-06-01,327714,3,0,3,3,0,3
2023-06-01,29751,0,0,0,3,0,3
2023-06-01,37654,10,0,10,1,0,1
2023-06-01,327804,12,1,13,5,2,5
2023-06-01,37251,4,0,4,1,0,1
2023-06-01,37519,3,1,4,5,2,5
2023-06-01,327716,9,0,9,3,0,3
2023-06-01,57050,4,8,12,8,5,10
2023-06-01,328799,1,0,1,2,0,2
2023-06-01,327726,2,1,3,1,1,1
2023-06-01,327725,5,0,5,2,0,2
2023-06-01,327727,3,0,3,4,0,4
2023-06-01,327728,4,1,5,3,1,3
2023-06-01,327742,3,0,3,1,0,1
2023-06-01,327721,4,0,4,3,0,3
2023-06-01,327797,1,0,1,1,0,1
2023-06-01,26422,9,0,9,1,0,1
2023-06-01,37618,5,1,6,6,2,6
2023-06-01,327761,5,0,5,4,0,4
2023-06-01,327737,1,0,1,3,0,3
2023-06-01,327764,4,1,5,2,1,2
2023-06-01,327757,1,0,1,1,0,1
2023-06-01,327768,5,0,5,2,0,2
2023-06-01,20180,2,0,2,1,0,1
2023-06-01,327706,3,0,3,1,0,1
2023-06-01,327772,5,0,5,3,0,3
2023-06-01,327799,51,0,51,5,0,5
2023-06-01,327828,4,0,4,2,0,2
2023-06-01,327747,1,0,1,1,0,1
2023-06-01,327802,12,0,12,3,0,3
2023-06-01,327819,1,1,2,1,1,1
2023-06-01,327809,4,0,4,2,0,2
2023-06-01,327808,5,0,5,3,0,3
2023-06-01,327805,2,1,3,2,2,2
2023-06-01,327745,2,0,2,4,0,4
2023-06-01,327840,1,0,1,1,0,1
2023-06-01,62587,21,0,21,1,0,1
2023-06-01,272092,2,0,2,1,0,1
2023-06-01,272816,1,0,1,1,0,1
2023-06-01,136785,1,0,1,1,0,1
2023-06-01,399674,50,0,50,1,0,1
2023-06-01,210334,39,0,39,1,0,1
2023-06-01,201390,1,0,1,1,0,1
2023-06-01,142267,3,0,3,3,0,3
2023-06-01,65539,1,0,1,1,0,1
2023-06-01,212338,3,0,3,2,0,2
2023-06-01,135067,1,1,2,1,1,1
2023-06-01,6149,1,0,1,1,0,1
2023-06-01,328739,7,1,8,3,1,3
2023-06-01,37473,30,3,33,3,2,3
2023-06-01,327806,2,0,2,2,0,2
2023-06-01,327824,38,17,55,5,3,5
2023-06-01,327798,14,0,14,2,0,2
2023-06-01,37074,13,1,14,3,1,4
2023-06-01,327712,54,1,55,1,1,1
2023-06-01,327692,26,0,26,3,0,3
2023-06-01,398152,1,0,1,1,0,1
2023-06-01,139065,11,0,11,1,0,1
2023-06-01,270157,1,0,1,1,0,1
2023-06-01,137951,82,1,83,2,1,3
2023-06-01,204721,6,0,6,3,0,3
2023-06-01,63787,1,0,1,1,0,1
2023-06-01,21853,3,1,4,3,1,3
2023-06-01,273,1,0,1,1,0,1
2023-06-01,328011,1,0,1,1,0,1
2023-06-01,328184,1,0,1,1,0,1
2023-06-01,7127,6,0,6,1,0,1
2023-06-01,11809,15,0,15,4,0,4
2023-06-01,394655,19,0,19,1,0,1
2023-06-01,7423,10,0,10,4,0,4
2023-06-01,54257,5,0,5,3,0,3
2023-06-01,21931,1,0,1,3,0,3
2023-06-01,23109,1,0,1,3,0,3
2023-06-01,13619,1,0,1,1,0,1
2023-06-01,4583,19,0,19,4,0,4
2023-06-01,1787,1,0,1,1,0,1
2023-06-01,398928,1,0,1,2,0,2
2023-06-01,398934,1,0,1,2,0,2
2023-06-01,32125,1,0,1,1,0,1
2023-06-01,16481,20,0,20,1,0,1
2023-06-01,26746,8,0,8,3,0,3
2023-06-01,5647,14,0,14,1,0,1
2023-06-01,26940,9,0,9,9,0,9
2023-06-01,23366,25,0,25,1,0,1
2023-06-01,18818,3,0,3,1,0,1
2023-06-01,10235,45,0,45,1,0,1
2023-06-01,32908,6,1,7,3,1,3
2023-06-01,18841,4,2,6,4,2,4
2023-06-01,18828,4,2,6,1,1,1
2023-06-01,133145,1,3,4,1,2,2
2023-06-01,56093,8,2,10,3,1,3
2023-06-01,16733,20,2,22,4,2,4
2023-06-01,36291,8,0,8,1,0,1
2023-06-01,31746,1,0,1,3,0,3
2023-06-01,9419,5,1,6,10,1,10
2023-06-01,9247,3,0,3,2,0,2
2023-06-01,13401,1,0,1,2,0,2
2023-06-01,54205,4,0,4,2,0,2
2023-06-01,393364,1,0,1,3,0,3
2023-06-01,394692,1,0,1,2,0,2
2023-06-01,670,1,0,1,1,0,1
2023-06-01,672,1,0,1,1,0,1
2023-06-01,671,1,0,1,1,0,1
2023-06-01,615,1,0,1,1,0,1
2023-06-01,673,1,0,1,1,0,1
2023-06-01,11500,8,0,8,3,0,3
2023-06-01,17003,6,0,6,8,0,8
2023-06-01,394600,1,1,2,2,2,2
2023-06-01,10859,6,0,6,1,0,1
2023-06-01,10273,24,0,24,3,0,3
2023-06-01,33372,15,0,15,2,0,2
2023-06-01,2159,25,0,25,2,0,2
2023-06-01,27646,7,0,7,4,0,4
2023-06-01,62873,1,0,1,2,0,2
2023-06-01,8698,163,0,163,3,0,3
2023-06-01,61056,2,1,3,3,2,3
2023-06-01,200338,1,0,1,1,0,1
2023-06-01,201470,1,1,2,1,1,1
2023-06-01,207182,1,0,1,3,0,3
2023-06-01,198709,2,0,2,8,0,8
2023-06-01,47252,10,0,10,5,0,5
2023-06-01,60594,1,0,1,1,0,1
2023-06-01,200672,1,0,1,4,0,4
2023-06-01,200594,1,0,1,5,0,5
2023-06-01,203364,1,0,1,3,0,3
2023-06-01,203551,2,0,2,4,0,4
2023-06-01,203475,1,0,1,1,0,1
2023-06-01,202450,1,0,1,2,0,2
2023-06-01,202465,1,0,1,2,0,2
2023-06-01,205713,1,0,1,3,0,3
2023-06-01,202607,1,0,1,4,0,4
2023-06-01,50095,2,0,2,4,0,4
2023-06-01,201427,1,0,1,5,0,5
2023-06-01,201307,1,1,2,1,1,2
2023-06-01,200609,1,0,1,1,0,1
2023-06-01,212968,1,1,2,3,1,3
2023-06-01,51619,2,0,2,2,0,2
2023-06-01,50271,2,0,2,3,0,3
2023-06-01,21054,12,0,12,4,0,4
2023-06-01,21301,11,0,11,4,0,4
2023-06-01,26174,1,0,1,2,0,2
2023-06-01,11910,4,0,4,4,0,4
2023-06-01,25609,1,0,1,2,0,2
2023-06-01,19398,3,0,3,1,0,1
2023-06-01,20617,16,0,16,2,0,2
2023-06-01,32251,4,0,4,2,0,2
2023-06-01,132119,1,0,1,2,0,2
2023-06-01,23653,3,0,3,3,0,3
2023-06-01,206450,1,0,1,1,0,1
2023-06-01,205860,3,0,3,1,0,1
2023-06-01,210043,7,0,7,4,0,4
2023-06-01,140578,1,0,1,2,0,2
2023-06-01,17756,26,0,26,2,0,2
2023-06-01,133127,4,0,4,1,0,1
2023-06-01,132396,2,0,2,1,0,1
2023-06-01,7286,2,0,2,1,0,1
2023-06-01,20437,6,0,6,2,0,2
2023-06-01,31715,1,0,1,1,0,1
2023-06-01,13322,46,0,46,5,0,5
2023-06-01,40923,46,0,46,4,0,4
2023-06-01,270119,2,1,3,3,2,3
2023-06-01,5470,2,1,3,1,1,1
2023-06-01,2129,19,0,19,4,0,4
2023-06-01,2592,1,0,1,1,0,1
2023-06-01,53257,22,0,22,1,0,1
2023-06-01,14395,1,0,1,2,0,2
2023-06-01,10052,3,0,3,4,0,4
2023-06-01,16889,1,0,1,3,0,3
2023-06-01,394387,1,0,1,1,0,1
2023-06-01,7403,12,0,12,1,0,1
2023-06-01,39978,2,0,2,2,0,2
2023-06-01,399005,1,0,1,1,0,1
2023-06-01,399089,1,0,1,1,0,1
2023-06-01,395151,5,0,5,3,0,3
2023-06-01,328252,4,0,4,5,0,5
2023-06-01,328249,4,1,5,1,1,1
2023-06-01,328227,5,0,5,1,0,1
2023-06-01,328224,3,0,3,2,0,2
2023-06-01,328246,3,0,3,3,0,3
2023-06-01,328238,1,0,1,1,0,1
2023-06-01,328220,8,1,9,4,2,4
2023-06-01,328225,2,0,2,2,0,2
2023-06-01,328213,1,1,2,1,1,1
2023-06-01,328199,3,0,3,4,0,4
2023-06-01,328203,4,16,20,1,1,1
2023-06-01,328248,1,0,1,2,0,2
2023-06-01,37567,2,0,2,3,0,3
2023-06-01,22226,1,0,1,1,0,1
2023-06-01,2920,125,0,125,4,0,4
2023-06-01,39098,1,0,1,1,0,1
2023-06-01,397433,11,0,11,3,0,3
2023-06-01,394583,3,0,3,1,0,1
2023-06-01,398537,6,2,8,2,2,2
2023-06-01,64086,3,0,3,2,0,2
2023-06-01,16728,5,0,5,6,0,6
2023-06-01,25021,1,0,1,1,0,1
2023-06-01,22245,1,0,1,1,0,1
2023-06-01,34542,5,0,5,2,0,2
2023-06-01,33614,14,0,14,3,0,3
2023-06-01,3495,18,2,20,3,2,3
2023-06-01,328180,8,0,8,3,0,3
2023-06-01,328212,1,1,2,4,1,4
2023-06-01,21589,23,1,24,3,1,3
2023-06-01,30387,12,1,13,2,2,2
2023-06-01,4211,1,0,1,1,0,1
2023-06-01,23107,12,0,12,1,0,1
2023-06-01,36433,6,0,6,4,0,4
2023-06-01,15989,15,0,15,4,0,4
2023-06-01,6394,2,0,2,1,0,1
2023-06-01,201869,5,0,5,2,0,2
2023-06-01,199083,1,0,1,2,0,2
2023-06-01,39400,1,0,1,1,0,1
2023-06-01,24398,4,1,5,5,2,5
2023-06-01,62724,6,0,6,4,0,4
2023-06-01,26960,14,0,14,2,0,2
2023-06-01,201698,2,1,3,2,2,2
2023-06-01,200397,1,0,1,2,0,2
2023-06-01,44227,1,0,1,3,2,3
2023-06-01,59921,3,1,4,3,1,3
2023-06-01,64455,1,0,1,3,0,3
2023-06-01,64454,1,0,1,2,0,2
2023-06-01,209450,1,0,1,1,0,1
2023-06-01,206048,2,1,3,4,1,5
2023-06-01,51757,1,0,1,1,0,1
2023-06-01,210075,1,1,2,1,1,1
2023-06-01,64477,1,0,1,2,0,2
2023-06-01,204018,1,0,1,1,0,1
2023-06-01,12122,7,0,7,3,0,3
2023-06-01,2024,4,0,4,1,0,1
2023-06-01,3401,3,0,3,4,0,4
2023-06-01,6341,3,0,3,2,0,2
2023-06-01,12274,11,0,11,1,0,1
2023-06-01,393649,1,0,1,2,0,2
2023-06-01,30030,2,0,2,2,0,2
2023-06-01,46313,18,0,18,11,0,11
2023-06-01,20062,10,0,10,1,0,1
2023-06-01,8414,5,1,6,3,1,3
2023-06-01,38028,12,0,12,1,0,1
2023-06-01,133735,6,0,6,4,0,4
2023-06-01,133506,13,0,13,2,0,2
2023-06-01,133505,9,0,9,2,0,2
2023-06-01,133734,4,0,4,3,0,3
2023-06-01,63617,6,0,6,3,0,3
2023-06-01,134610,4,0,4,2,0,2
2023-06-01,36081,4,0,4,1,0,1
2023-06-01,31547,18,0,18,3,0,3
2023-06-01,23047,3,0,3,4,0,4
2023-06-01,395366,21,0,21,6,0,6
2023-06-01,394452,12,0,12,4,0,4
2023-06-01,16922,5,0,5,2,0,2
2023-06-01,300,33,1,34,1,1,1
2023-06-01,6026,21,0,21,1,0,1
2023-06-01,59630,2,1,3,1,1,1
2023-06-01,23921,6,0,6,5,0,5
2023-06-01,59863,1,0,1,1,0,1
2023-06-01,2571,22,5,27,8,4,8
2023-06-01,398846,2,0,2,1,0,1
2023-06-01,3743,8,0,8,1,0,1
2023-06-01,26976,4,0,4,2,0,2
2023-06-01,398194,14,0,14,5,0,5
2023-06-01,1448,7,1,8,6,4,6
2023-06-01,7786,25,0,25,3,0,3
2023-06-01,397226,21,11,32,1,1,1
2023-06-01,32980,3,0,3,2,0,2
2023-06-01,30371,2,1,3,3,3,3
2023-06-01,399161,2,2,4,1,1,1
2023-06-01,399167,4,0,4,1,0,1
2023-06-01,399153,2,0,2,1,0,1
2023-06-01,399155,2,2,4,1,1,1
2023-06-01,399157,2,2,4,1,1,1
2023-06-01,399158,2,2,4,1,1,1
2023-06-01,399164,2,2,4,1,1,1
2023-06-01,399170,4,0,4,1,0,1
2023-06-01,5065,8,0,8,1,0,1
2023-06-01,272018,2,1,3,1,1,1
2023-06-01,198990,1,0,1,1,0,1
2023-06-01,40178,1,0,1,1,0,1
2023-06-01,54769,9,0,9,3,0,3
2023-06-01,55907,4,3,7,3,2,3
2023-06-01,24275,1,0,1,1,0,1
2023-06-01,2512,13,0,13,3,0,3
2023-06-01,53446,1,0,1,2,0,2
2023-06-01,7091,4,0,4,4,0,4
2023-06-01,397379,1,0,1,3,0,3
2023-06-01,30311,7,0,7,2,0,2
2023-06-01,206770,1,0,1,2,0,2
2023-06-01,203689,4,0,4,5,0,5
2023-06-01,203920,1,0,1,3,0,3
2023-06-01,211985,2,0,2,2,0,2
2023-06-01,206937,1,0,1,2,0,2
2023-06-01,400190,4,4,8,4,3,4
2023-06-01,46154,9,0,9,3,0,3
2023-06-01,5761,1,1,2,1,1,1
2023-06-01,131932,71,0,71,2,0,2
2023-06-01,206237,5,0,5,2,0,2
2023-06-01,21612,25,1,26,6,1,6
2023-06-01,13327,1,0,1,3,0,3
2023-06-01,3449,1,0,1,1,0,1
2023-06-01,4597,1,1,2,2,2,2
2023-06-01,63311,4,2,6,10,7,10
2023-06-01,207161,1,1,2,3,2,3
2023-06-01,201085,2,1,3,1,1,1
2023-06-01,209293,1,0,1,3,0,3
2023-06-01,206096,1,0,1,2,0,2
2023-06-01,202583,10,0,10,1,0,1
2023-06-01,29110,1,0,1,2,0,2
2023-06-01,272883,1,2,3,1,1,1
2023-06-01,37919,2,0,2,3,0,3
2023-06-01,37910,1,0,1,1,0,1
2023-06-01,58785,1,1,2,1,1,1
2023-06-01,137804,1,0,1,1,0,1
2023-06-01,34865,1,0,1,3,0,3
2023-06-01,146987,3,0,3,2,0,2
2023-06-01,9604,3,0,3,1,0,1
2023-06-01,1738,23,0,23,2,0,2
2023-06-01,9893,28,0,28,2,0,2
2023-06-01,7872,7,1,8,2,3,3
2023-06-01,393611,3,0,3,3,0,3
2023-06-01,16561,1,0,1,3,0,3
2023-06-01,203078,4,0,4,2,0,2
2023-06-01,32358,6,0,6,2,0,2
2023-06-01,22723,3,0,3,1,0,1
2023-06-01,21965,19,0,19,8,0,8
2023-06-01,17983,22,0,22,3,0,3
2023-06-01,2072,1,0,1,4,0,4
2023-06-01,2094,9,0,9,5,0,5
2023-06-01,398663,4,2,6,3,2,3
2023-06-01,393946,11,0,11,4,0,4
2023-06-01,40703,20,0,20,14,0,14
2023-06-01,43500,2,2,4,4,3,4
2023-06-01,5662,10,2,12,7,4,7
2023-06-01,25802,3,0,3,3,0,3
2023-06-01,13448,14,2,16,8,4,9
2023-06-01,41936,1,0,1,2,0,2
2023-06-01,16099,3,1,4,5,1,5
2023-06-01,15337,3,0,3,2,0,2
2023-06-01,55642,3,0,3,3,0,3
2023-06-01,58069,5,1,6,1,1,1
2023-06-01,2012,2,0,2,1,0,1
2023-06-01,773,4,0,4,4,0,4
2023-06-01,546,3,0,3,1,0,1
2023-06-01,22252,26,0,26,2,0,2
2023-06-01,394450,5,0,5,3,0,3
2023-06-01,395370,6,0,6,1,0,1
2023-06-01,21701,6,1,7,2,1,3
2023-06-01,33281,2,1,3,2,1,2
2023-06-01,21369,31,0,31,4,0,4
2023-06-01,54216,1,0,1,2,0,2
2023-06-01,53926,4,0,4,4,0,4
2023-06-01,262155,1,0,1,1,0,1
2023-06-01,54591,4,0,4,2,0,2
2023-06-01,10499,4,0,4,3,0,3
2023-06-01,54231,2,0,2,2,0,2
2023-06-01,10968,14,0,14,1,0,1
2023-06-01,141469,2,0,2,3,0,3
2023-06-01,137476,3,0,3,1,0,1
2023-06-01,395627,1,0,1,4,0,4
2023-06-01,25789,6,0,6,2,0,2
2023-06-01,394271,1,1,2,2,2,2
2023-06-01,26190,6,0,6,2,0,2
2023-06-01,3592,37,0,37,3,0,3
2023-06-01,3603,1,0,1,2,0,2
2023-06-01,3700,4,1,5,4,1,4
2023-06-01,400758,1,0,1,2,0,2
2023-06-01,7768,13,0,13,5,0,5
2023-06-01,153,4,0,4,1,0,1
2023-06-01,4291035137,4,0,4,1,0,1
2023-06-01,19863,57,31,88,5,3,6
2023-06-01,141468,13,0,13,3,0,3
2023-06-01,52035,1,0,1,1,0,1
2023-06-01,202098,1,0,1,3,0,3
2023-06-01,32577,3,0,3,3,0,3
2023-06-01,10806,15,0,15,5,0,5
2023-06-01,397324,3,1,4,3,3,3
2023-06-01,27404,1,1,2,1,1,2
2023-06-01,54816,12,0,12,1,0,1
2023-06-01,394153,2,0,2,1,0,1
2023-06-01,18526,2,10,12,2,1,2
2023-06-01,400326,1,0,1,1,0,1
2023-06-01,398542,1,0,1,1,0,1
2023-06-01,26457,1,5,6,4,6,6
2023-06-01,395688,2,1,3,1,2,2
2023-06-01,17138,4,11,15,2,2,3
2023-06-01,6248,1,0,1,1,0,1
2023-06-01,398206,1,0,1,1,0,1
2023-06-01,398255,3,0,3,2,0,2
2023-06-01,399326,1,0,1,1,0,1
2023-06-01,400638,1,1,2,1,1,1
2023-06-01,396841,3,0,3,2,0,2
2023-06-01,14965,4,0,4,2,0,2
2023-06-01,26060,1,0,1,2,0,2
2023-06-01,40350,2,0,2,7,0,7
2023-06-01,62827,13,1,14,3,3,3
2023-06-01,19431,4,0,4,1,0,1
2023-06-01,32606,2,0,2,2,0,2
2023-06-01,393915,1,0,1,1,0,1
2023-06-01,393539,1,0,1,1,0,1
2023-06-01,396937,1,0,1,1,0,1
2023-06-01,46139,2,0,2,3,0,3
2023-06-01,11757,31,0,31,10,0,10
2023-06-01,1932,1,0,1,2,0,2
2023-06-01,198309,3,1,4,1,1,1
2023-06-01,25807,6,0,6,4,0,4
2023-06-01,46196,7,0,7,1,0,1
2023-06-01,27022,4,0,4,1,0,1
2023-06-01,22238,4,0,4,2,0,2
2023-06-01,2602,7,1,8,11,7,12
2023-06-01,29917,1,0,1,2,0,2
2023-06-01,21111,5,0,5,3,0,3
2023-06-01,26810,17,2,19,3,3,3
2023-06-01,12423,1,1,2,1,1,1
2023-06-01,35686,3,0,3,2,0,2
2023-06-01,393665,1,0,1,2,0,2
2023-06-01,16746,21,0,21,4,0,4
2023-06-01,55102,5,0,5,4,0,4
2023-06-01,20404,3,0,3,3,0,3
2023-06-01,40196,24,0,24,3,0,3
2023-06-01,398655,4,2,6,2,2,2
2023-06-01,399449,16,0,16,8,0,8
2023-06-01,38327,2,1,3,4,2,4
2023-06-01,398060,1,0,1,1,0,1
2023-06-01,33170,1,0,1,3,0,3
2023-06-01,29984,3,0,3,2,0,2
2023-06-01,26423,7,0,7,3,0,3
2023-06-01,11177,1,0,1,1,0,1
2023-06-01,29731,5,0,5,4,0,4
2023-06-01,15101,4,2,6,4,1,4
2023-06-01,32128,1,0,1,3,0,3
2023-06-01,17023,2,0,2,1,0,1
2023-06-01,55055,1,0,1,1,0,1
2023-06-01,9411,66,1,67,2,1,2
2023-06-01,13611,28,0,28,1,0,1
2023-06-01,139211,4,0,4,2,0,2
2023-06-01,397847,3,0,3,1,0,1
2023-06-01,63284,21,0,21,1,0,1
2023-06-01,397269,4,0,4,3,0,3
2023-06-01,19320,3,0,3,1,0,1
2023-06-01,139896,3,0,3,5,0,5
2023-06-01,137061,4,0,4,3,0,3
2023-06-01,133327,1,0,1,3,0,3
2023-06-01,18882,10,0,10,3,0,3
2023-06-01,205142,4,0,4,2,0,2
2023-06-01,7246,32,0,32,7,0,7
2023-06-01,31756,1,0,1,1,0,1
2023-06-01,32484,3,3,6,2,2,2
2023-06-01,55215,3,0,3,2,0,2
2023-06-01,398156,25,0,25,3,0,3
2023-06-01,398765,6,1,7,4,3,5
2023-06-01,211093,1,0,1,1,0,1
2023-06-01,27512,3,0,3,3,0,3
2023-06-01,209875,1,0,1,2,0,2
2023-06-01,5479,7,1,8,2,2,2
2023-06-01,4616,8,1,9,4,1,4
2023-06-01,33187,1,1,2,3,2,3
2023-06-01,11829,5,0,5,4,0,4
2023-06-01,400571,1,0,1,2,0,2
2023-06-01,133058,4,0,4,1,0,1
2023-06-01,36691,2,0,2,1,0,1
2023-06-01,132524,15,1,16,2,2,2
2023-06-01,58758,4,1,5,3,1,3
2023-06-01,23770,3,1,4,2,2,2
2023-06-01,134322,1,0,1,2,0,2
2023-06-01,42326,4,0,4,3,0,3
2023-06-01,26442,13,0,13,3,0,3
2023-06-01,133875,1,0,1,1,0,1
2023-06-01,8609,1,0,1,1,0,1
2023-06-01,6377,2,1,3,2,2,2
2023-06-01,27897,3,0,3,3,0,3
2023-06-01,64411,2,1,3,4,2,4
2023-06-01,11506,16,18,34,2,2,2
2023-06-01,39550,5,0,5,2,0,2
2023-06-01,4605,14,6,20,2,2,3
2023-06-01,393938,5,0,5,3,0,3
2023-06-01,18874,7,1,8,6,1,6
2023-06-01,23795,6,0,6,2,0,2
2023-06-01,18276,1,0,1,1,0,1
2023-06-01,2274,5,0,5,3,0,3
2023-06-01,8556,1,0,1,1,0,1
2023-06-01,48950,23,0,23,6,0,6
2023-06-01,23387,25,0,25,3,0,3
2023-06-01,22316,4,0,4,2,0,2
2023-06-01,23036,10,1,11,8,1,8
2023-06-01,393969,1,0,1,2,0,2
2023-06-01,400681,1,0,1,2,0,2
2023-06-01,15488,1,0,1,1,0,1
2023-06-01,46269,93,1,94,11,1,11
2023-06-01,28810,2,0,2,3,0,3
2023-06-01,201271,9,1,10,3,2,3
2023-06-01,211124,33,0,33,4,0,4
2023-06-01,398295,1,0,1,1,0,1
2023-06-01,397906,1,1,2,1,1,1
2023-06-01,398812,1,0,1,3,0,3
2023-06-01,2683,2,1,3,5,2,5
2023-06-01,16742,5,0,5,3,0,3
2023-06-01,211689,4,0,4,1,0,1
2023-06-01,198285,1,0,1,1,0,1
2023-06-01,39104,5,0,5,1,0,1
2023-06-01,210827,1,0,1,2,0,2
2023-06-01,210828,1,0,1,3,0,3
2023-06-01,60904,4,0,4,2,0,2
2023-06-01,205070,4,0,4,1,0,1
2023-06-01,57507,3,0,3,8,0,8
2023-06-01,26691,4,0,4,3,0,3
2023-06-01,398258,4,0,4,3,0,3
2023-06-01,23084,15,0,15,1,0,1
2023-06-01,204284,3,0,3,3,0,3
2023-06-01,45956,3,0,3,1,0,1
2023-06-01,7328,11,0,11,4,0,4
2023-06-01,262914,18,0,18,3,0,3
2023-06-01,22863,4,0,4,1,0,1
2023-06-01,20045,1,0,1,2,0,2
2023-06-01,25797,2,0,2,2,0,2
2023-06-01,11628,2,0,2,2,0,2
2023-06-01,46129,2,0,2,1,0,1
2023-06-01,54085,2,0,2,3,0,3
2023-06-01,21774,9,0,9,6,0,6
2023-06-01,53737,1,0,1,1,0,1
2023-06-01,40560,2,0,2,1,0,1
2023-06-01,54719,1,0,1,3,0,3
2023-06-01,29266,2,0,2,2,0,2
2023-06-01,12908,1,0,1,1,0,1
2023-06-01,62982,2,0,2,2,0,2
2023-06-01,62195,2,0,2,2,0,2
2023-06-01,133188,3,0,3,4,0,4
2023-06-01,200544,2,1,3,2,2,2
2023-06-01,5517,3,1,4,3,1,3
2023-06-01,13900,18,0,18,3,0,3
2023-06-01,203211,4,0,4,2,0,2
2023-06-01,15513,1,0,1,1,0,1
2023-06-01,2067,1,0,1,2,0,2
2023-06-01,27324,18,0,18,5,0,5
2023-06-01,32563,2,0,2,4,0,4
2023-06-01,53604,1,0,1,1,0,1
2023-06-01,10372,2,0,2,3,0,3
2023-06-01,2048,142,0,142,2,0,2
2023-06-01,4196,45,5,50,6,4,6
2023-06-01,2011,2,1,3,3,1,3
2023-06-01,4243,10,0,10,7,0,7
2023-06-01,29702,11,0,11,3,0,3
2023-06-01,29750,13,0,13,2,0,2
2023-06-01,10966,3,0,3,1,0,1
2023-06-01,20561,1,1,2,2,2,2
2023-06-01,150301,2,0,2,2,0,2
2023-06-01,10934,7,1,8,3,1,3
2023-06-01,394184,1,0,1,1,0,1
2023-06-01,53419,1,0,1,1,0,1
2023-06-01,4879,1,0,1,1,0,1
2023-06-01,18727,1,0,1,2,0,2
2023-06-01,23111,1,0,1,1,0,1
2023-06-01,21735,5,0,5,3,0,3
2023-06-01,23200,1,1,2,1,1,1
2023-06-01,16734,2,0,2,1,0,1
2023-06-01,33738,1,0,1,1,0,1
2023-06-01,11694,1,0,1,1,0,1
2023-06-01,2875,1,1,2,1,1,1
2023-06-01,13382,1,1,2,2,1,2
2023-06-01,398746,1,0,1,1,0,1
2023-06-01,202167,15,0,15,3,0,3
2023-06-01,43422,4,0,4,1,0,1
2023-06-01,13283,3,1,4,3,2,3
2023-06-01,11577,2,0,2,3,0,3
2023-06-01,19935,10,0,10,2,0,2
2023-06-01,46889,3,0,3,6,0,6
2023-06-01,16860,3,0,3,1,0,1
2023-06-01,10294,1,0,1,1,0,1
2023-06-01,394493,5,0,5,4,0,4
2023-06-01,1798,23,4,27,8,6,9
2023-06-01,30459,6,0,6,1,0,1
2023-06-01,40088,6,0,6,4,0,4
2023-06-01,19834,1,3,4,7,6,7
2023-06-01,21935,1,0,1,1,0,1
2023-06-01,6941,2,0,2,2,0,2
2023-06-01,33439,1,0,1,1,0,1
2023-06-01,11517,15,0,15,2,0,2
2023-06-01,7358,6,0,6,3,0,3
2023-06-01,131444,1,0,1,1,0,1
2023-06-01,36502,6,1,7,2,2,2
2023-06-01,17264,15,0,15,2,0,2
2023-06-01,46233,3,0,3,3,0,3
2023-06-01,6105,1,0,1,2,0,2
2023-06-01,34578,2,1,3,3,1,3
2023-06-01,60946,1,0,1,2,0,2
2023-06-01,20548,1,0,1,1,0,1
2023-06-01,205625,1,0,1,2,0,2
2023-06-01,199034,1,0,1,1,0,1
2023-06-01,35685,1,0,1,1,0,1
2023-06-01,15818,1,0,1,3,0,3
2023-06-01,207689,1,0,1,2,0,2
2023-06-01,213022,1,0,1,1,0,1
2023-06-01,60066,1,0,1,3,0,3
2023-06-01,56560,1,0,1,1,0,1
2023-06-01,6832,1,0,1,3,0,3
2023-06-01,51894,2,1,3,3,2,3
2023-06-01,15483,1,0,1,2,0,2
2023-06-01,47814,10,1,11,1,1,1
2023-06-01,60324,1,0,1,1,0,1
2023-06-01,201574,1,0,1,1,0,1
2023-06-01,15684,1,0,1,2,0,2
2023-06-01,50485,1,0,1,3,0,3
2023-06-01,49690,3,1,4,4,5,5
2023-06-01,209677,2,1,3,2,2,2
2023-06-01,203926,2,1,3,2,2,2
2023-06-01,211846,2,1,3,2,2,2
2023-06-01,393349,13,0,13,2,0,2
2023-06-01,57052,8,1,9,4,1,4
2023-06-01,19541,9,1,10,3,2,3
2023-06-01,22220,4,0,4,3,0,3
2023-06-01,393342,2,0,2,2,0,2
2023-06-01,7171,4,0,4,2,0,2
2023-06-01,395608,1,0,1,1,0,1
2023-06-01,210208,1,0,1,1,0,1
2023-06-01,47791,1,0,1,2,0,2
2023-06-01,211303,1,0,1,1,0,1
2023-06-01,149302,1,0,1,2,0,2
2023-06-01,50108,1,0,1,2,0,2
2023-06-01,50985,1,0,1,1,0,1
2023-06-01,60220,1,0,1,1,0,1
2023-06-01,207602,1,0,1,2,0,2
2023-06-01,207601,1,0,1,2,0,2
2023-06-01,394249,1,0,1,1,0,1
2023-06-01,399707,2,0,2,1,0,1
2023-06-01,7060,1,1,2,1,1,1
2023-06-01,398938,1,0,1,2,0,2
2023-06-01,26672,1,0,1,2,0,2
2023-06-01,33572,1,0,1,2,0,2
2023-06-01,40053,1,0,1,2,0,2
2023-06-01,30706,1,1,2,2,1,2
2023-06-01,199875,1,1,2,2,1,2
2023-06-01,206800,1,0,1,2,0,2
2023-06-01,206457,1,0,1,2,0,2
2023-06-01,31223,2,0,2,2,0,2
2023-06-01,132802,1,0,1,1,0,1
2023-06-01,33043,1,0,1,2,0,2
2023-06-01,199764,1,0,1,1,0,1
2023-06-01,206071,1,0,1,2,0,2
2023-06-01,393692,1,0,1,2,0,2
2023-06-01,393828,1,1,2,2,1,2
2023-06-01,23766,1,0,1,2,0,2
2023-06-01,395686,3,1,4,3,2,3
2023-06-01,23765,1,0,1,2,0,2
2023-06-01,133902,1,0,1,2,0,2
2023-06-01,135424,1,0,1,2,0,2
2023-06-01,399842,1,0,1,1,0,1
2023-06-01,62424,3,2,5,2,2,2
2023-06-01,398118,3,0,3,2,0,2
2023-06-01,30800,3,0,3,2,0,2
2023-06-01,13483,9,0,9,4,0,4
2023-06-01,14895,4,0,4,3,0,3
2023-06-01,396137,1,0,1,2,0,2
2023-06-01,26567,5,0,5,2,0,2
2023-06-01,62763,14,0,14,1,0,1
2023-06-01,398382,3,0,3,1,0,1
2023-06-01,26534,3,0,3,2,0,2
2023-06-01,200058,16,0,16,2,0,2
2023-06-01,133013,9,0,9,2,0,2
2023-06-01,11892,33,0,33,5,0,5
2023-06-01,29016,11,0,11,3,0,3
2023-06-01,9823,11,0,11,6,0,6
2023-06-01,6628,1,0,1,1,0,1
2023-06-01,201101,7,0,7,2,0,2
2023-06-01,21595,39,0,39,8,0,8
2023-06-01,16793,9,1,10,3,1,3
2023-06-01,132469,11,0,11,3,0,3
2023-06-01,46156,11,0,11,7,0,7
2023-06-01,11052,6,0,6,2,0,2
2023-06-01,26425,27,1,28,5,2,6
2023-06-01,10953,34,0,34,2,0,2
2023-06-01,7772,7,0,7,9,0,9
2023-06-01,11198,2,0,2,1,0,1
2023-06-01,40120,1,0,1,4,0,4
2023-06-01,133077,1,0,1,6,0,6
2023-06-01,136779,1,0,1,4,0,4
2023-06-01,399569,2,0,2,2,0,2
2023-06-01,32906,12,0,12,8,0,8
2023-06-01,395228,19,0,19,5,0,5
2023-06-01,12226,18,0,18,4,0,4
2023-06-01,14121,3,0,3,4,0,4
2023-06-01,7741,3,0,3,3,0,3
2023-06-01,209822,4,0,4,2,0,2
2023-06-01,13829,3,0,3,1,0,1
2023-06-01,198878,1,0,1,1,0,1
2023-06-01,29899,1,1,2,4,1,4
2023-06-01,26026,1,0,1,1,0,1
2023-06-01,394907,10,1,11,2,2,2
2023-06-01,39970,10,1,11,1,1,1
2023-06-01,23250,4,0,4,1,0,1
2023-06-01,22510,3,0,3,1,0,1
2023-06-01,30697,1,1,2,1,1,1
2023-06-01,30437,65,0,65,8,0,8
2023-06-01,30491,20,0,20,1,0,1
2023-06-01,3481,16,0,16,1,0,1
2023-06-01,2705,1,0,1,2,0,2
2023-06-01,13348,19,0,19,4,0,4
2023-06-01,206281,10,2,12,7,3,7
2023-06-01,8224,3,1,4,5,4,5
2023-06-01,207189,1,0,1,1,0,1
2023-06-01,211389,2,0,2,1,0,1
2023-06-01,201987,1,0,1,1,0,1
2023-06-01,206685,1,0,1,2,0,2
2023-06-01,39382,2,0,2,2,0,2
2023-06-01,328148,4,0,4,2,0,2
2023-06-01,19919,2,1,3,2,1,2
2023-06-01,266159,2,1,3,2,1,2
2023-06-01,328218,20,0,20,1,0,1
2023-06-01,394527,1,0,1,3,0,3
2023-06-01,394545,2,1,3,5,1,5
2023-06-01,266149,7,7,14,3,3,3
2023-06-01,266171,3,1,4,3,4,4
2023-06-01,328161,1,0,1,1,0,1
2023-06-01,328187,3,0,3,3,0,3
2023-06-01,328167,5,1,6,4,1,4
2023-06-01,266172,5,0,5,2,0,2
2023-06-01,266150,1,1,2,2,1,2
2023-06-01,266146,1,1,2,2,1,2
2023-06-01,265720,5,0,5,1,0,1
2023-06-01,266183,3,0,3,3,0,3
2023-06-01,266187,1,0,1,1,0,1
2023-06-01,265714,12,0,12,2,0,2
2023-06-01,209578,3,1,4,2,1,2
2023-06-01,328258,4,0,4,1,0,1
2023-06-01,266197,5,5,10,9,5,9
2023-06-01,270342,6,3,9,3,1,3
2023-06-01,267470,3,6,9,13,12,14
2023-06-01,266198,3,3,6,4,2,4
2023-06-01,271110,7,16,23,6,4,6
2023-06-01,266200,3,1,4,1,1,1
2023-06-01,266538,6,1,7,4,1,4
2023-06-01,266527,3,0,3,1,0,1
2023-06-01,266189,1,0,1,1,0,1
2023-06-01,266188,7,1,8,4,1,4
2023-06-01,11294,1,0,1,1,0,1
2023-06-01,394864,1,1,2,3,2,3
2023-06-01,268242,3,1,4,3,3,3
2023-06-01,17701,3,1,4,3,3,3
2023-06-01,23781,4,0,4,1,0,1
2023-06-01,14262,1,0,1,2,0,2
2023-06-01,54704,2,0,2,1,0,1
2023-06-01,11795,10,9,19,2,1,2
2023-06-01,397077,5,0,5,3,0,3
2023-06-01,3725,3,3,6,1,1,1
2023-06-01,397191,2,0,2,1,0,1
2023-06-01,22435,2,0,2,1,0,1
2023-06-01,47616,1,1,2,1,1,1
2023-06-01,8590,9,7,16,1,1,1
2023-06-01,24442,2,2,4,1,1,1
2023-06-01,25031,9,0,9,4,0,4
2023-06-01,200471,1,0,1,1,0,1
2023-06-01,6095,6,0,6,5,0,5
2023-06-01,210378,1,1,2,2,1,2
2023-06-01,21293,3,1,4,2,1,2
2023-06-01,18500,3,0,3,3,0,3
2023-06-01,398177,1,0,1,1,0,1
2023-06-01,397275,1,0,1,1,0,1
2023-06-01,398458,1,0,1,2,0,2
2023-06-01,399768,2,0,2,3,0,3
2023-06-01,40951,1,0,1,2,0,2
2023-06-01,19929,1,0,1,1,0,1
2023-06-01,398967,1,0,1,2,0,2
2023-06-01,397498,2,0,2,2,0,2
2023-06-01,2513,1,0,1,3,0,3
2023-06-01,9095,2,1,3,1,1,1
2023-06-01,36026,10,0,10,5,0,5
2023-06-01,36693,2,0,2,3,0,3
2023-06-01,32591,2,0,2,3,0,3
2023-06-01,21047,3,0,3,2,0,2
2023-06-01,199104,4,0,4,3,0,3
2023-06-01,15769,28,5,33,3,2,3
2023-06-01,42701,5,0,5,2,0,2
2023-06-01,2824,33,0,33,3,0,3
2023-06-01,24055,3,0,3,2,0,2
2023-06-01,131994,3,0,3,2,0,2
2023-06-01,24467,17,4,21,3,2,3
2023-06-01,17694,3,0,3,2,0,2
2023-06-01,18375,2,0,2,2,0,2
2023-06-01,396083,2,0,2,1,0,1
2023-06-01,394417,3,0,3,2,0,2
2023-06-01,140592,12,6,18,5,3,5
2023-06-01,135008,37,3,40,3,2,3
2023-06-01,136601,18,3,21,3,3,3
2023-06-01,13303,3,0,3,4,0,4
2023-06-01,25940,8,0,8,6,0,6
2023-06-01,30146,4,0,4,2,0,2
2023-06-01,687,5,1,6,1,1,1
2023-06-01,27922,3,0,3,3,0,3
2023-06-01,6711,1,0,1,1,0,1
2023-06-01,328029,4,1,5,6,3,6
2023-06-01,328045,3,2,5,6,1,6
2023-06-01,328404,4,0,4,1,0,1
2023-06-01,328209,3,1,4,6,3,6
2023-06-01,328182,4,0,4,1,0,1
2023-06-01,328024,2,1,3,5,2,5
2023-06-01,328244,1,0,1,1,0,1
2023-06-01,328223,5,1,6,3,1,3
2023-06-01,328171,2,0,2,1,0,1
2023-06-01,328141,1,0,1,2,0,2
2023-06-01,328144,3,0,3,1,0,1
2023-06-01,328197,4,0,4,2,0,2
2023-06-01,328162,5,1,6,3,1,3
2023-06-01,328146,4,0,4,3,0,3
2023-06-01,328142,1,0,1,2,0,2
2023-06-01,328189,3,0,3,3,0,3
2023-06-01,328486,4,0,4,1,0,1
2023-06-01,5939,4,0,4,1,0,1
2023-06-01,1959,1,0,1,1,0,1
2023-06-01,2749,14,0,14,1,0,1
2023-06-01,5979,3,0,3,1,0,1
2023-06-01,21501,14,0,14,1,0,1
2023-06-01,398786,1,0,1,1,0,1
2023-06-01,131077,3,0,3,1,0,1
2023-06-01,47406,7,0,7,5,2,5
2023-06-01,12237,1,0,1,3,0,3
2023-06-01,24008,21,0,21,3,0,3
2023-06-01,132000,3,0,3,2,0,2
2023-06-01,22640,1,0,1,1,0,1
2023-06-01,15661,3,0,3,3,0,3
2023-06-01,26269,23,1,24,2,2,2
2023-06-01,397025,2,0,2,3,0,3
2023-06-01,328186,2,0,2,2,0,2
2023-06-01,328185,1,0,1,1,0,1
2023-06-01,328215,1,0,1,1,0,1
2023-06-01,1983,1,0,1,1,0,1
2023-06-01,395867,1,0,1,1,0,1
2023-06-01,131964,1,1,2,1,1,1
2023-06-01,395398,1,0,1,2,0,2
2023-06-01,267263,7,1,8,5,4,5
2023-06-01,267310,3,1,4,2,2,2
2023-06-01,396176,2,1,3,3,1,3
2023-06-01,328267,1,1,2,4,2,4
2023-06-01,44994,2,1,3,6,3,6
2023-06-01,48177,1,0,1,2,0,2
2023-06-01,267819,3,0,3,3,0,3
2023-06-01,396965,4,0,4,2,0,2
2023-06-01,266151,3,1,4,2,2,2
2023-06-01,266210,3,3,6,1,1,1
2023-06-01,200547,11,0,11,2,0,2
2023-06-01,210292,4,0,4,1,0,1
2023-06-01,266547,3,3,6,2,3,3
2023-06-01,265727,5,1,6,1,1,1
2023-06-01,266534,2,1,3,4,2,5
2023-06-01,266553,3,2,5,2,1,2
2023-06-01,262881,9,1,10,4,3,4
2023-06-01,266541,6,1,7,1,1,1
2023-06-01,266535,3,4,7,3,3,3
2023-06-01,266542,3,1,4,2,1,2
2023-06-01,265725,6,2,8,2,1,2
2023-06-01,266554,4,1,5,3,1,3
2023-06-01,266641,7,7,14,4,3,4
2023-06-01,266642,5,0,5,3,0,3
2023-06-01,266549,6,1,7,2,1,2
2023-06-01,266546,6,3,9,1,1,1
2023-06-01,265018,14,3,17,2,1,2
2023-06-01,265689,12,0,12,1,0,1
2023-06-01,266569,4,17,21,1,1,1
2023-06-01,27952,4,0,4,2,0,2
2023-06-01,266552,2,1,3,3,2,3
2023-06-01,266551,3,9,12,3,3,3
2023-06-01,266556,4,1,5,1,1,1
2023-06-01,266577,3,0,3,1,0,1
2023-06-01,266572,1,1,2,4,1,4
2023-06-01,272865,1,0,1,1,0,1
2023-06-01,265717,1,0,1,1,0,1
2023-06-01,266564,3,0,3,1,0,1
2023-06-01,9366,6,0,6,3,0,3
2023-06-01,40102,4,0,4,3,0,3
2023-06-01,25607,18,1,19,4,2,5
2023-06-01,262935,3,0,3,2,0,2
2023-06-01,27745,6,0,6,1,0,1
2023-06-01,20255,63,1,64,6,2,7
2023-06-01,61442,7,0,7,3,0,3
2023-06-01,27653,19,2,21,3,1,3
2023-06-01,263221,7,0,7,2,0,2
2023-06-01,61460,26,0,26,3,0,3
2023-06-01,15914,35,0,35,4,0,4
2023-06-01,1724,1,0,1,1,0,1
2023-06-01,60278,3,1,4,2,1,2
2023-06-01,12311,1,0,1,1,0,1
2023-06-01,32071,1,0,1,3,0,3
2023-06-01,3482,3,0,3,3,0,3
2023-06-01,25470,4,0,4,1,0,1
2023-06-01,19512,17,0,17,9,0,9
2023-06-01,63102,1,0,1,1,0,1
2023-06-01,267789,2,1,3,1,1,1
2023-06-01,28064,4,0,4,1,0,1
2023-06-01,61612,2,0,2,1,0,1
2023-06-01,31865,6,0,6,2,0,2
2023-06-01,397992,1,0,1,1,0,1
2023-06-01,15322,1,0,1,2,0,2
2023-06-01,398945,2,0,2,2,0,2
2023-06-01,398038,6,0,6,1,0,1
2023-06-01,398475,3,0,3,4,0,4
2023-06-01,398123,3,3,6,3,3,3
2023-06-01,398291,17,0,17,2,0,2
2023-06-01,398147,1,0,1,1,0,1
2023-06-01,33593,5,0,5,1,0,1
2023-06-01,58780,2,0,2,1,0,1
2023-06-01,26335,5,0,5,2,0,2
2023-06-01,14882,6,0,6,5,0,5
2023-06-01,139344,7,0,7,1,0,1
2023-06-01,16525,7,0,7,3,0,3
2023-06-01,205037,1,1,2,2,1,2
2023-06-01,43922,1,1,2,3,1,3
2023-06-01,200060,1,1,2,1,1,1
2023-06-01,11206,30,0,30,1,0,1
2023-06-01,26063,6,0,6,7,0,7
2023-06-01,7582,3,0,3,1,0,1
2023-06-01,4667,1,0,1,1,0,1
2023-06-01,133857,2,0,2,1,0,1
2023-06-01,17542,3,0,3,1,0,1
2023-06-01,13561,1,0,1,1,0,1
2023-06-01,26125,5,0,5,1,0,1
2023-06-01,203724,21,6,27,20,6,21
2023-06-01,205272,8,3,11,14,6,15
2023-06-01,138003,2,0,2,3,0,3
2023-06-01,140660,2,0,2,2,0,2
2023-06-01,396344,3,0,3,1,0,1
2023-06-01,2278,3,1,4,1,1,1
2023-06-01,17275,19,0,19,6,0,6
2023-06-01,7810,5,0,5,6,0,6
2023-06-01,3955,10,0,10,11,0,11
2023-06-01,17327,3,0,3,1,0,1
2023-06-01,6883,1,1,2,2,2,2
2023-06-01,10545,1,0,1,3,0,3
2023-06-01,11663,6,0,6,1,0,1
2023-06-01,38910,3,0,3,3,0,3
2023-06-01,38551,4,3,7,4,3,4
2023-06-01,17866,1,0,1,2,0,2
2023-06-01,205431,4,160,164,1,2,2
2023-06-01,200461,2,1,3,3,3,4
2023-06-01,22804,10,0,10,5,0,5
2023-06-01,23348,4,0,4,1,0,1
2023-06-01,396215,1,0,1,2,0,2
2023-06-01,14503,1,0,1,1,0,1
2023-06-01,53642,1,0,1,2,0,2
2023-06-01,396483,3,0,3,2,0,2
2023-06-01,26765,1,0,1,1,0,1
2023-06-01,14936,1,0,1,1,0,1
2023-06-01,393527,1,0,1,1,0,1
2023-06-01,43056,7,0,7,4,0,4
2023-06-01,11444,1,0,1,1,0,1
2023-06-01,396976,2,0,2,1,0,1
2023-06-01,23293,1,0,1,1,0,1
2023-06-01,27348,14,0,14,2,0,2
2023-06-01,396284,8,0,8,1,0,1
2023-06-01,54513,1,0,1,1,0,1
2023-06-01,14795,9,0,9,4,0,4
2023-06-01,17311,1,0,1,1,0,1
2023-06-01,133014,26,1,27,3,2,3
2023-06-01,53987,14,0,14,4,0,4
2023-06-01,17377,10,0,10,4,0,4
2023-06-01,399678,7,0,7,4,0,4
2023-06-01,4179,18,0,18,3,0,3
2023-06-01,10995,14,0,14,4,0,4
2023-06-01,22125,31,0,31,4,0,4
2023-06-01,396499,10,0,10,5,0,5
2023-06-01,398561,4,0,4,3,0,3
2023-06-01,26579,2,0,2,2,0,2
2023-06-01,28551,2,0,2,1,0,1
2023-06-01,46312,3,0,3,2,0,2
2023-06-01,17374,4,0,4,4,0,4
2023-06-01,394974,1,0,1,2,0,2
2023-06-01,46564,4,0,4,3,0,3
2023-06-01,54786,1,0,1,2,0,2
2023-06-01,36263,4,1,5,1,1,1
2023-06-01,396278,1,0,1,1,0,1
2023-06-01,13474,14,0,14,5,0,5
2023-06-01,29967,7,0,7,4,0,4
2023-06-01,11462,1,0,1,2,0,2
2023-06-01,262224,1,0,1,1,0,1
2023-06-01,206051,1,0,1,1,0,1
2023-06-01,2384,4,0,4,3,0,3
2023-06-01,397185,1,0,1,1,0,1
2023-06-01,397820,2,0,2,2,0,2
2023-06-01,393371,2,0,2,4,0,4
2023-06-01,62495,1,0,1,2,0,2
2023-06-01,18648,1,0,1,1,0,1
2023-06-01,397509,2,0,2,2,0,2
2023-06-01,21733,1,0,1,1,0,1
2023-06-01,399322,1,0,1,2,0,2
2023-06-01,397640,2,0,2,2,0,2
2023-06-01,398097,2,0,2,1,0,1
2023-06-01,398063,2,0,2,4,0,4
2023-06-01,22358,1,0,1,3,0,3
2023-06-01,397830,1,0,1,1,0,1
2023-06-01,397400,3,0,3,3,0,3
2023-06-01,397357,1,0,1,1,0,1
2023-06-01,398198,1,0,1,5,0,5
2023-06-01,393986,1,1,2,2,2,2
2023-06-01,46756,1,0,1,2,0,2
2023-06-01,27311,5,0,5,4,0,4
2023-06-01,398165,1,0,1,1,0,1
2023-06-01,40898,19,0,19,1,0,1
2023-06-01,397794,1,1,2,1,1,1
2023-06-01,399345,1,0,1,1,0,1
2023-06-01,398697,2,1,3,1,1,1
2023-06-01,16699,1,0,1,1,0,1
2023-06-01,32861,5,0,5,5,0,5
2023-06-01,46615,4,0,4,3,0,3
2023-06-01,55008,1,0,1,1,0,1
2023-06-01,32685,1,0,1,1,0,1
2023-06-01,397169,1,0,1,1,0,1
2023-06-01,3839,7,1,8,3,1,3
2023-06-01,23496,9,0,9,2,0,2
2023-06-01,32665,3,0,3,3,0,3
2023-06-01,14513,1,1,2,3,2,3
2023-06-01,23282,40,0,40,2,0,2
2023-06-01,13313,2,0,2,3,0,3
2023-06-01,33217,5,0,5,2,0,2
2023-06-01,5766,8,2,10,2,2,2
2023-06-01,396269,10,0,10,5,0,5
2023-06-01,17052,6,0,6,2,0,2
2023-06-01,3709,49,0,49,3,0,3
2023-06-01,263758,1,0,1,4,0,4
2023-06-01,13798,7,0,7,3,0,3
2023-06-01,15141,4,0,4,2,0,2
2023-06-01,36548,31,0,31,2,0,2
2023-06-01,9486,1,0,1,3,0,3
2023-06-01,26539,2,0,2,3,0,3
2023-06-01,25667,43,0,43,6,0,6
2023-06-01,17282,4,0,4,3,0,3
2023-06-01,397961,1,0,1,2,0,2
2023-06-01,53507,3,1,4,5,4,5
2023-06-01,27353,10,0,10,3,0,3
2023-06-01,33348,5,0,5,3,0,3
2023-06-01,7152,16,0,16,2,0,2
2023-06-01,393256,7,4,11,2,2,2
2023-06-01,8651,9,0,9,3,0,3
2023-06-01,265699,1,0,1,1,0,1
2023-06-01,201329,4,0,4,2,0,2
2023-06-01,62689,1,0,1,1,0,1
2023-06-01,5632,1,0,1,1,0,1
2023-06-01,46868,9,0,9,3,0,3
2023-06-01,46341,19,0,19,3,0,3
2023-06-01,19820,32,0,32,6,0,6
2023-06-01,13688,4,0,4,1,0,1
2023-06-01,197636,11,0,11,1,0,1
2023-06-01,21074,2,0,2,1,0,1
2023-06-01,15515,3,0,3,1,0,1
2023-06-01,395339,15,0,15,3,0,3
2023-06-01,395267,3,0,3,1,0,1
2023-06-01,39174,3,0,3,4,0,4
2023-06-01,46483,2,0,2,1,0,1
2023-06-01,399443,1,0,1,1,0,1
2023-06-01,399766,1,0,1,1,0,1
2023-06-01,399695,1,0,1,1,0,1
2023-06-01,54864,8,0,8,5,0,5
2023-06-01,14693,11,0,11,3,0,3
2023-06-01,11511,1,0,1,3,0,3
2023-06-01,53984,7,0,7,3,0,3
2023-06-01,55143,4,0,4,3,0,3
2023-06-01,49915,26,25,51,7,6,7
2023-06-01,11731,2,0,2,2,0,2
2023-06-01,51303,1,0,1,1,0,1
2023-06-01,47718,1,0,1,1,0,1
2023-06-01,59902,1,0,1,1,0,1
2023-06-01,63185,1,0,1,1,0,1
2023-06-01,14948,14,0,14,3,0,3
2023-06-01,133388,4,0,4,2,0,2
2023-06-01,136963,1,0,1,1,0,1
2023-06-01,59907,2,0,2,3,0,3
2023-06-01,134109,1,0,1,3,0,3
2023-06-01,55250,1,0,1,2,0,2
2023-06-01,23193,1,0,1,2,0,2
2023-06-01,22910,44,0,44,3,0,3
2023-06-01,64226,19,0,19,2,0,2
2023-06-01,395784,5,0,5,4,0,4
2023-06-01,1415,19,0,19,2,0,2
2023-06-01,40126,5,0,5,4,0,4
2023-06-01,13530,8,0,8,3,0,3
2023-06-01,15323,5,0,5,2,0,2
2023-06-01,36091,1,0,1,1,0,1
2023-06-01,33566,18,5,23,6,2,6
2023-06-01,12099,3,0,3,2,0,2
2023-06-01,46465,3,0,3,1,0,1
2023-06-01,393759,19,0,19,4,0,4
2023-06-01,53368,2,0,2,3,0,3
2023-06-01,25844,11,0,11,8,0,8
2023-06-01,6949,67,0,67,7,0,7
2023-06-01,19004,4,0,4,2,0,2
2023-06-01,22089,4,0,4,2,0,2
2023-06-01,59241,4,0,4,1,0,1
2023-06-01,27623,1,1,2,4,2,4
2023-06-01,395660,1,0,1,4,0,4
2023-06-01,17162,1,0,1,1,0,1
2023-06-01,45946,9,0,9,4,0,4
2023-06-01,10666,6,0,6,1,0,1
2023-06-01,11155,13,1,14,2,1,2
2023-06-01,18722,118,0,118,1,0,1
2023-06-01,199793,1,0,1,1,0,1
2023-06-01,19708,1,0,1,1,0,1
2023-06-01,32013,4,0,4,4,0,4
2023-06-01,13882,28,0,28,4,0,4
2023-06-01,26229,26,2,28,4,1,4
2023-06-01,399775,1,0,1,1,0,1
2023-06-01,3705,3,0,3,2,0,2
2023-06-01,394283,2,0,2,2,0,2
2023-06-01,398805,1,0,1,1,0,1
2023-06-01,399035,2,0,2,4,0,4
2023-06-01,398547,1,1,2,1,1,1
2023-06-01,30177,1,1,2,2,1,2
2023-06-01,398361,2,0,2,3,0,3
2023-06-01,398732,1,0,1,3,0,3
2023-06-01,54468,2,0,2,3,0,3
2023-06-01,398324,2,1,3,2,1,2
2023-06-01,395600,1,0,1,1,0,1
2023-06-01,132292,1,0,1,1,0,1
2023-06-01,26409,3,0,3,4,0,4
2023-06-01,55171,4,0,4,4,0,4
2023-06-01,27475,6,0,6,5,0,5
2023-06-01,204597,4,0,4,4,0,4
2023-06-01,196968,6,1,7,7,1,8
2023-06-01,12941,7,3,10,11,5,12
2023-06-01,55175,1,0,1,2,0,2
2023-06-01,27349,5,0,5,2,0,2
2023-06-01,398809,1,0,1,1,0,1
2023-06-01,55067,3,0,3,2,0,2
2023-06-01,18952,2,0,2,1,0,1
2023-06-01,55079,6,5,11,4,4,4
2023-06-01,23108,1,0,1,1,0,1
2023-06-01,399282,4,0,4,2,0,2
2023-06-01,54652,3,1,4,4,3,4
2023-06-01,27020,6,0,6,3,0,3
2023-06-01,11487,6,0,6,1,0,1
2023-06-01,21951,2,1,3,3,3,3
2023-06-01,55064,3,3,6,1,6,7
2023-06-01,55003,1,0,1,2,0,2
2023-06-01,200174,1,0,1,1,0,1
2023-06-01,55267,1,0,1,3,0,3
2023-06-01,17084,2,0,2,1,0,1
2023-06-01,54972,7,2,9,2,1,2
2023-06-01,55216,1,0,1,5,0,5
2023-06-01,55172,1,0,1,3,0,3
2023-06-01,27295,1,0,1,3,0,3
2023-06-01,11353,6,0,6,5,0,5
2023-06-01,132789,22,2,24,6,2,6
2023-06-01,26064,1,0,1,1,0,1
2023-06-01,33467,1,0,1,3,0,3
2023-06-01,40206,1,0,1,1,0,1
2023-06-01,55263,3,0,3,5,0,5
2023-06-01,55247,11,1,12,6,1,6
2023-06-01,55251,3,0,3,3,0,3
2023-06-01,55231,1,0,1,2,0,2
2023-06-01,23517,1,0,1,1,0,1
2023-06-01,23523,4,1,5,2,1,3
2023-06-01,55271,3,0,3,3,0,3
2023-06-01,40555,4,1,5,3,1,3
2023-06-01,19032,9,0,9,1,0,1
2023-06-01,33303,1,0,1,1,0,1
2023-06-01,26941,1,0,1,2,0,2
2023-06-01,64601,1,0,1,1,0,1
2023-06-01,40594,6,0,6,1,0,1
2023-06-01,30219,27,0,27,3,0,3
2023-06-01,11490,2,0,2,1,0,1
2023-06-01,33587,1,0,1,3,0,3
2023-06-01,30321,5,0,5,2,0,2
2023-06-01,16620,1,0,1,2,0,2
2023-06-01,40763,4,2,6,4,2,4
2023-06-01,394851,2,2,4,4,2,4
2023-06-01,40076,6,1,7,5,1,5
2023-06-01,30513,13,1,14,2,3,3
2023-06-01,54038,10,0,10,2,0,2
2023-06-01,36201,10,0,10,3,0,3
2023-06-01,63035,4,0,4,3,0,3
2023-06-01,13971,6,0,6,6,0,6
2023-06-01,32177,1,0,1,1,0,1
2023-06-01,23419,3,0,3,6,0,6
2023-06-01,53949,5,0,5,1,0,1
2023-06-01,62488,3,1,4,3,2,3
2023-06-01,14091,13,0,13,3,0,3
2023-06-01,11180,2,0,2,1,0,1
2023-06-01,30396,2,1,3,1,1,1
2023-06-01,30418,9,0,9,7,0,7
2023-06-01,54889,0,0,0,3,0,3
2023-06-01,4876,5,0,5,1,0,1
2023-06-01,19819,5,0,5,2,0,2
2023-06-01,46915,28,0,28,1,0,1
2023-06-01,4574,1,0,1,4,0,4
2023-06-01,55142,7,0,7,3,0,3
2023-06-01,62539,1,0,1,3,0,3
2023-06-01,19039,2,0,2,1,0,1
2023-06-01,52347,31,0,31,5,0,5
2023-06-01,27448,1,0,1,3,0,3
2023-06-01,35971,2,0,2,1,0,1
2023-06-01,29765,9,3,12,2,1,2
2023-06-01,6651,1,0,1,1,0,1
2023-06-01,62544,2,0,2,2,0,2
2023-06-01,395821,2,0,2,2,0,2
2023-06-01,62932,1,0,1,1,0,1
2023-06-01,26833,2,0,2,1,0,1
2023-06-01,62588,6,1,7,4,1,4
2023-06-01,62500,1,0,1,3,0,3
2023-06-01,40949,1,0,1,1,0,1
2023-06-01,62586,3,0,3,3,0,3
2023-06-01,1115,1,0,1,3,0,3
2023-06-01,62649,2,1,3,1,1,2
2023-06-01,62576,4,0,4,1,0,1
2023-06-01,394180,2,0,2,1,0,1
2023-06-01,11512,11,1,12,3,2,3
2023-06-01,16577,2,0,2,2,0,2
2023-06-01,952,3,1,4,6,7,9
2023-06-01,62640,9,5,14,3,3,3
2023-06-01,30495,5,0,5,4,0,4
2023-06-01,398304,2,1,3,2,1,2
2023-06-01,54327,6,1,7,4,3,4
2023-06-01,47063,5,0,5,5,0,5
2023-06-01,40670,7,0,7,2,0,2
2023-06-01,62473,4,0,4,2,0,2
2023-06-01,16654,6,0,6,1,0,1
2023-06-01,54708,1,0,1,2,0,2
2023-06-01,21953,1,0,1,2,0,2
2023-06-01,62714,4,5,9,2,2,2
2023-06-01,54707,9,0,9,2,0,2
2023-06-01,54039,1,1,2,3,1,3
2023-06-01,62739,1,0,1,1,0,1
2023-06-01,393384,2,0,2,1,0,1
2023-06-01,22578,1,0,1,1,0,1
2023-06-01,53354,0,0,0,3,0,3
2023-06-01,22311,3,0,3,2,0,2
2023-06-01,36008,6,2,8,4,4,4
2023-06-01,26836,4,0,4,2,0,2
2023-06-01,46903,4,0,4,5,0,5
2023-06-01,27225,2,0,2,2,0,2
2023-06-01,393268,4,0,4,2,0,2
2023-06-01,27240,8,0,8,4,0,4
2023-06-01,29892,20,0,20,3,0,3
2023-06-01,26167,24,1,25,6,1,6
2023-06-01,54086,13,0,13,3,0,3
2023-06-01,11982,1,0,1,1,0,1
2023-06-01,15317,6,2,8,4,5,5
2023-06-01,32386,1,0,1,1,0,1
2023-06-01,54829,5,1,6,3,1,3
2023-06-01,54611,4,0,4,2,0,2
2023-06-01,398869,1,0,1,1,0,1
2023-06-01,54335,8,0,8,1,0,1
2023-06-01,55130,1,0,1,2,0,2
2023-06-01,11382,1,0,1,1,0,1
2023-06-01,18472,1,1,2,4,1,4
2023-06-01,142273,1,0,1,1,0,1
2023-06-01,27027,7,5,12,5,3,5
2023-06-01,393719,1,0,1,1,0,1
2023-06-01,54862,1,0,1,1,0,1
2023-06-01,395665,1,0,1,1,0,1
2023-06-01,15025,1,0,1,1,0,1
2023-06-01,394511,14,0,14,3,0,3
2023-06-01,33673,1,0,1,1,0,1
2023-06-01,393290,1,6,7,1,4,4
2023-06-01,396094,1,0,1,1,0,1
2023-06-01,397868,1,0,1,3,0,3
2023-06-01,30391,1,0,1,1,0,1
2023-06-01,19147,1,0,1,2,0,2
2023-06-01,20313,5,1,6,3,1,3
2023-06-01,40942,1,0,1,1,0,1
2023-06-01,40766,6,0,6,1,0,1
2023-06-01,46351,1,0,1,1,0,1
2023-06-01,17268,1,0,1,3,0,3
2023-06-01,397875,1,0,1,1,0,1
2023-06-01,53991,14,5,19,15,11,17
2023-06-01,11807,3,1,4,3,3,3
2023-06-01,15000,8,0,8,2,0,2
2023-06-01,397608,6,0,6,3,0,3
2023-06-01,19780,3,0,3,5,0,5
2023-06-01,53904,2,1,3,3,1,3
2023-06-01,53834,7,2,9,2,2,2
2023-06-01,33611,3,0,3,2,0,2
2023-06-01,31899,1,0,1,1,0,1
2023-06-01,55011,9,0,9,5,0,5
2023-06-01,54287,1,0,1,1,0,1
2023-06-01,46289,1,0,1,1,0,1
2023-06-01,23312,1,0,1,3,0,3
2023-06-01,23436,6,0,6,3,0,3
2023-06-01,15349,2,0,2,2,0,2
2023-06-01,54306,1,0,1,1,0,1
2023-06-01,26399,3,0,3,3,0,3
2023-06-01,30155,1,0,1,1,0,1
2023-06-01,13764,1,0,1,1,0,1
2023-06-01,46392,8,0,8,1,0,1
2023-06-01,33405,2,0,2,2,0,2
2023-06-01,30218,2,0,2,1,0,1
2023-06-01,396338,24,0,24,2,0,2
2023-06-01,19890,2,0,2,2,0,2
2023-06-01,17304,3,0,3,1,0,1
2023-06-01,33093,1,0,1,3,0,3
2023-06-01,399740,2,0,2,3,0,3
2023-06-01,29986,1,0,1,3,0,3
2023-06-01,22998,2,0,2,2,0,2
2023-06-01,62929,2,0,2,4,0,4
2023-06-01,21832,25,0,25,2,0,2
2023-06-01,393355,2,0,2,3,0,3
2023-06-01,46315,1,0,1,1,0,1
2023-06-01,397790,3,1,4,2,1,2
2023-06-01,3295,15,0,15,5,0,5
2023-06-01,63136,4,0,4,1,0,1
2023-06-01,22319,8,0,8,3,0,3
2023-06-01,4224,4,1,5,2,2,2
2023-06-01,33477,1,0,1,2,0,2
2023-06-01,36792,1,1,2,1,1,1
2023-06-01,40148,3,0,3,3,0,3
2023-06-01,23467,3,0,3,8,0,8
2023-06-01,55117,3,0,3,3,0,3
2023-06-01,31965,4,0,4,3,0,3
2023-06-01,62845,1,0,1,1,0,1
2023-06-01,46941,8,0,8,3,0,3
2023-06-01,33008,1,0,1,1,0,1
2023-06-01,395202,1,0,1,2,0,2
2023-06-01,395055,2,0,2,3,0,3
2023-06-01,35938,10,0,10,4,0,4
2023-06-01,393367,1,0,1,2,0,2
2023-06-01,47020,3,1,4,2,2,2
2023-06-01,34012,2,1,3,1,1,1
2023-06-01,14452,1,0,1,1,0,1
2023-06-01,53847,4,0,4,5,0,5
2023-06-01,62921,2,0,2,2,0,2
2023-06-01,18745,5,0,5,2,0,2
2023-06-01,22943,9,0,9,2,0,2
2023-06-01,63325,2,0,2,4,0,4
2023-06-01,29696,19,0,19,1,0,1
2023-06-01,14228,5,0,5,4,0,4
2023-06-01,11980,2,0,2,2,0,2
2023-06-01,13952,1,0,1,1,0,1
2023-06-01,398183,1,0,1,1,0,1
2023-06-01,136265,4,0,4,5,0,5
2023-06-01,36144,1,0,1,2,0,2
2023-06-01,53513,2,0,2,3,0,3
2023-06-01,397591,5,0,5,2,0,2
2023-06-01,16991,1,1,2,3,2,3
2023-06-01,62872,1,1,2,3,1,3
2023-06-01,54978,2,0,2,4,0,4
2023-06-01,39938,20,0,20,2,0,2
2023-06-01,32248,7,1,8,1,1,1
2023-06-01,62834,2,0,2,2,0,2
2023-06-01,35906,19,0,19,6,0,6
2023-06-01,46259,2,0,2,2,0,2
2023-06-01,25619,8,0,8,3,0,3
2023-06-01,62938,4,0,4,1,0,1
2023-06-01,400492,1,0,1,1,0,1
2023-06-01,19696,1,0,1,1,0,1
2023-06-01,63015,6,0,6,2,0,2
2023-06-01,16750,1,0,1,2,0,2
2023-06-01,14894,4,0,4,1,0,1
2023-06-01,63004,3,0,3,3,0,3
2023-06-01,30228,4,0,4,2,0,2
2023-06-01,27639,3,0,3,2,0,2
2023-06-01,16816,17,2,19,2,3,3
2023-06-01,55184,1,0,1,1,0,1
2023-06-01,22555,5,0,5,2,0,2
2023-06-01,8018,17,0,17,5,0,5
2023-06-01,62952,4,0,4,2,0,2
2023-06-01,62622,12,0,12,5,0,5
2023-06-01,62942,3,0,3,2,0,2
2023-06-01,23011,1,0,1,1,0,1
2023-06-01,63225,1,0,1,2,0,2
2023-06-01,63019,7,3,10,2,2,2
2023-06-01,55259,14,3,17,3,3,5
2023-06-01,395509,1,0,1,1,0,1
2023-06-01,63040,1,0,1,1,0,1
2023-06-01,47091,2,0,2,3,0,3
2023-06-01,32594,1,0,1,3,0,3
2023-06-01,32421,30,0,30,1,0,1
2023-06-01,25675,1,0,1,1,0,1
2023-06-01,32490,3,0,3,1,0,1
2023-06-01,20718,1,0,1,2,0,2
2023-06-01,62512,4,3,7,4,3,5
2023-06-01,393307,2,0,2,2,0,2
2023-06-01,394775,2,1,3,2,1,2
2023-06-01,54793,1,0,1,2,0,2
2023-06-01,53779,2,2,4,2,1,2
2023-06-01,11468,3,1,4,7,2,7
2023-06-01,31783,8,0,8,7,0,7
2023-06-01,19386,1,0,1,1,0,1
2023-06-01,27615,6,0,6,2,0,2
2023-06-01,11699,7,0,7,3,0,3
2023-06-01,13543,1,1,2,3,3,3
2023-06-01,53944,1,0,1,2,0,2
2023-06-01,32767,4,1,5,2,1,2
2023-06-01,21705,4,1,5,1,1,1
2023-06-01,26225,12,0,12,4,0,4
2023-06-01,40449,3,0,3,3,0,3
2023-06-01,16794,1,0,1,2,0,2
2023-06-01,32321,1,0,1,3,0,3
2023-06-01,396012,4,1,5,2,1,2
2023-06-01,46240,3,0,3,3,0,3
2023-06-01,62818,6,0,6,2,0,2
2023-06-01,55021,4,0,4,2,0,2
2023-06-01,27626,0,0,0,3,0,3
2023-06-01,26475,1,0,1,1,0,1
2023-06-01,33729,2,0,2,2,0,2
2023-06-01,17146,4,0,4,2,0,2
2023-06-01,7915,5,0,5,3,0,3
2023-06-01,17038,4,0,4,3,0,3
2023-06-01,18758,2,0,2,1,0,1
2023-06-01,19683,3,0,3,2,0,2
2023-06-01,396203,1,0,1,2,0,2
2023-06-01,394479,2,0,2,4,0,4
2023-06-01,393433,5,0,5,3,0,3
2023-06-01,36586,1,0,1,1,0,1
2023-06-01,46143,2,0,2,1,0,1
2023-06-01,394776,2,0,2,2,0,2
2023-06-01,40809,1,0,1,1,0,1
2023-06-01,40794,2,0,2,1,0,1
2023-06-01,46974,16,2,18,3,1,3
2023-06-01,46833,3,0,3,2,0,2
2023-06-01,199432,1,0,1,1,0,1
2023-06-01,200136,1,0,1,1,0,1
2023-06-01,203728,1,2,3,1,1,1
2023-06-01,198607,2,0,2,1,0,1
2023-06-01,213236,1,5,6,1,3,3
2023-06-01,38140,2,0,2,1,0,1
2023-06-01,45131,2,2,4,1,1,1
2023-06-01,45589,6,0,6,2,0,2
2023-06-01,5692,1,1,2,2,2,3
2023-06-01,131930,2,0,2,2,0,2
2023-06-01,133891,3,0,3,2,0,2
2023-06-01,54807,2,0,2,1,0,1
2023-06-01,397136,2,0,2,1,0,1
2023-06-01,55796,1,0,1,1,0,1
2023-06-01,54115,9,11,20,1,1,1
2023-06-01,395403,11,15,26,4,5,6
2023-06-01,136468,1,2,3,1,1,1
2023-06-01,31967,3,1,4,1,1,1
2023-06-01,37112,5,0,5,3,0,3
2023-06-01,398871,1,1,2,1,1,1
2023-06-01,398835,1,1,2,1,1,1
2023-06-01,398899,1,0,1,2,0,2
2023-06-01,398953,1,0,1,2,0,2
2023-06-01,398886,1,0,1,2,0,2
2023-06-01,40916,2,5,7,2,2,2
2023-06-01,56328,0,4,4,3,7,7
2023-06-01,395993,2,0,2,1,0,1
2023-06-01,40146,3,4,7,2,2,2
2023-06-01,399561,1,1,2,1,1,1
2023-06-01,40895,7,0,7,1,0,1
2023-06-01,31867,2,1,3,1,1,1
2023-06-01,399137,1,0,1,1,0,1
2023-06-01,40272,1,0,1,1,0,1
2023-06-01,396189,1,0,1,1,0,1
2023-06-01,398724,1,0,1,2,0,2
2023-06-01,12201,2,0,2,1,0,1
2023-06-01,398926,1,0,1,2,0,2
2023-06-01,398868,1,1,2,1,1,1
2023-06-01,18211,27,0,27,5,0,5
2023-06-01,4673,20,3,23,4,3,4
2023-06-01,173,2,0,2,5,0,5
2023-06-01,2511,5,0,5,1,0,1
2023-06-01,59091,1,0,1,1,0,1
2023-06-01,18131,2,2,4,3,2,3
2023-06-01,22315,38,0,38,1,0,1
2023-06-01,36161,3,0,3,2,0,2
2023-06-01,9452,1,0,1,1,0,1
2023-06-01,38113,8,0,8,2,0,2
2023-06-01,22693,7,0,7,4,0,4
2023-06-01,397344,11,0,11,3,0,3
2023-06-01,24949,3,0,3,1,0,1
2023-06-01,13063,1,0,1,1,0,1
2023-06-01,5609,2,0,2,1,0,1
2023-06-01,31705,4,0,4,2,0,2
2023-06-01,204222,1,0,1,1,0,1
2023-06-01,57506,1,1,2,1,1,1
2023-06-01,60270,1,0,1,1,0,1
2023-06-01,263683,33,4,37,2,1,2
2023-06-01,52470,3,0,3,2,0,2
2023-06-01,17870,5,0,5,2,0,2
2023-06-01,53463,1,0,1,1,0,1
2023-06-01,395610,125,0,125,4,0,4
2023-06-01,37130,27,0,27,2,0,2
2023-06-01,3067,105,1,106,6,1,6
2023-06-01,16800,14,0,14,2,0,2
2023-06-01,37007,10,0,10,5,0,5
2023-06-01,7502,7,0,7,1,0,1
2023-06-01,37914,2,0,2,1,0,1
2023-06-01,17512,3,0,3,1,0,1
2023-06-01,27336,26,0,26,8,0,8
2023-06-01,141400,1,0,1,2,0,2
2023-06-01,3813,2,0,2,1,0,1
2023-06-01,17147,7,2,9,1,1,1
2023-06-01,5133,7,0,7,1,0,1
2023-06-01,619,2,0,2,1,0,1
2023-06-01,5860,2,0,2,1,0,1
2023-06-01,62775,1,1,2,3,3,3
2023-06-01,396961,6,6,12,3,3,3
2023-06-01,198875,3,0,3,1,0,1
2023-06-01,44013,1,0,1,2,0,2
2023-06-01,208272,11,1,12,1,1,1
2023-06-01,50195,5,1,6,1,1,1
2023-06-01,59807,3,0,3,3,0,3
2023-06-01,39097,24,0,24,4,0,4
2023-06-01,198220,2,0,2,1,0,1
2023-06-01,198218,5,0,5,3,0,3
2023-06-01,12508,2,1,3,6,5,6
2023-06-01,200860,1,0,1,2,0,2
2023-06-01,211172,1,0,1,2,0,2
2023-06-01,21506,1,1,2,1,1,1
2023-06-01,16649,2,0,2,3,0,3
2023-06-01,14737,1,0,1,1,0,1
2023-06-01,395877,2,0,2,3,0,3
2023-06-01,399000,1,0,1,2,0,2
2023-06-01,12349,15,0,15,4,0,4
2023-06-01,8569,37,2,39,6,3,6
2023-06-01,39290,11,2,13,4,3,4
2023-06-01,398757,29,0,29,3,0,3
2023-06-01,55504,6,0,6,3,0,3
2023-06-01,57834,4,0,4,3,0,3
2023-06-01,14235,4,1,5,3,2,3
2023-06-01,1797,3,1,4,2,2,2
2023-06-01,18628,4,0,4,2,0,2
2023-06-01,45442,10,0,10,2,0,2
2023-06-01,45133,3,1,4,2,1,2
2023-06-01,134984,3,0,3,3,0,3
2023-06-01,9880,9,0,9,3,0,3
2023-06-01,1935,2,0,2,1,0,1
2023-06-01,14072,15,0,15,1,0,1
2023-06-01,26818,4,0,4,3,0,3
2023-06-01,23074,29,1,30,9,4,9
2023-06-01,26243,12,0,12,2,0,2
2023-06-01,36075,4,0,4,3,0,3
2023-06-01,46930,3,0,3,2,0,2
2023-06-01,13506,40,4,44,4,1,4
2023-06-01,38470,2,3,5,1,1,1
2023-06-01,36534,6,0,6,4,0,4
2023-06-01,54060,1,0,1,1,0,1
2023-06-01,22845,6,0,6,2,0,2
2023-06-01,14827,2,0,2,3,0,3
2023-06-01,9835,79,9,88,4,2,4
2023-06-01,10506,5,0,5,1,0,1
2023-06-01,62894,2,0,2,2,0,2
2023-06-01,30198,6,0,6,3,0,3
2023-06-01,2769,1,0,1,3,0,3
2023-06-01,10846,22,1,23,4,1,4
2023-06-01,9274,12,0,12,1,0,1
2023-06-01,213283,4,0,4,1,0,1
2023-06-01,202783,1,0,1,1,0,1
2023-06-01,198588,4,0,4,1,0,1
2023-06-01,199365,3,0,3,1,0,1
2023-06-01,59431,11,0,11,1,0,1
2023-06-01,58323,1,1,2,2,1,2
2023-06-01,198653,1,0,1,2,0,2
2023-06-01,198968,3,0,3,3,0,3
2023-06-01,44009,3,1,4,2,1,2
2023-06-01,57958,9,0,9,3,0,3
2023-06-01,58011,2,1,3,4,4,5
2023-06-01,33959,1,0,1,2,0,2
2023-06-01,13169,10,0,10,3,0,3
2023-06-01,15916,67,0,67,2,0,2
2023-06-01,21296,7,0,7,3,0,3
2023-06-01,46080,1,0,1,2,0,2
2023-06-01,400588,1,0,1,3,0,3
2023-06-01,400769,3,1,4,1,1,1
2023-06-01,400756,1,0,1,1,0,1
2023-06-01,22054,3,0,3,1,0,1
2023-06-01,398369,1,0,1,1,0,1
2023-06-01,40364,2,0,2,1,0,1
2023-06-01,16570,62,0,62,3,0,3
2023-06-01,7773,2,0,2,1,0,1
2023-06-01,327926,10,6,16,7,3,7
2023-06-01,328020,4,0,4,2,0,2
2023-06-01,328025,5,0,5,1,0,1
2023-06-01,328193,2,1,3,1,1,1
2023-06-01,328032,7,3,10,4,3,4
2023-06-01,329017,1,0,1,1,0,1
2023-06-01,328043,2,0,2,5,0,5
2023-06-01,37193,5,0,5,3,0,3
2023-06-01,329219,1,0,1,1,0,1
2023-06-01,328037,1,1,2,6,2,6
2023-06-01,328067,1,0,1,4,0,4
2023-06-01,61092,7,0,7,5,0,5
2023-06-01,328049,5,1,6,3,2,3
2023-06-01,328051,5,0,5,5,0,5
2023-06-01,328054,1,0,1,1,0,1
2023-06-01,328077,4,0,4,3,0,3
2023-06-01,328078,1,0,1,1,0,1
2023-06-01,328439,1,0,1,1,0,1
2023-06-01,265939,1,0,1,2,0,2
2023-06-01,265988,1,1,2,2,1,2
2023-06-01,265991,1,1,2,1,1,1
2023-06-01,265952,7,7,14,6,5,6
2023-06-01,265935,4,0,4,3,0,3
2023-06-01,265936,7,7,14,6,6,6
2023-06-01,265763,5,0,5,2,0,2
2023-06-01,271923,5,1,6,2,1,2
2023-06-01,265953,7,5,12,6,5,6
2023-06-01,265781,1,1,2,1,1,1
2023-06-01,265946,7,7,14,1,1,1
2023-06-01,267433,3,2,5,2,1,2
2023-06-01,265767,4,1,5,1,1,1
2023-06-01,265947,5,3,8,2,2,2
2023-06-01,265769,5,0,5,1,0,1
2023-06-01,265968,4,1,5,5,1,5
2023-06-01,265948,5,4,9,5,3,5
2023-06-01,265999,4,0,4,2,0,2
2023-06-01,265960,2,1,3,3,2,3
2023-06-01,265961,1,0,1,1,0,1
2023-06-01,265834,1,0,1,2,0,2
2023-06-01,265770,1,2,3,1,1,1
2023-06-01,265955,3,0,3,4,0,4
2023-06-01,265982,5,1,6,1,1,1
2023-06-01,265956,1,0,1,1,0,1
2023-06-01,265957,1,1,2,1,1,1
2023-06-01,266867,1,0,1,1,0,1
2023-06-01,265977,1,0,1,1,0,1
2023-06-01,265964,3,0,3,1,0,1
2023-06-01,265965,3,0,3,1,0,1
2023-06-01,265966,3,0,3,1,0,1
2023-06-01,267432,2,4,6,3,1,3
2023-06-01,265971,7,5,12,2,2,2
2023-06-01,265972,5,1,6,5,1,5
2023-06-01,265973,7,1,8,1,1,1
2023-06-01,265974,1,1,2,1,1,1
2023-06-01,265774,4,0,4,2,0,2
2023-06-01,267455,5,1,6,4,5,5
2023-06-01,267430,6,5,11,1,1,1
2023-06-01,265995,3,1,4,2,2,2
2023-06-01,265983,4,1,5,1,1,1
2023-06-01,265778,1,0,1,2,0,2
2023-06-01,265785,1,0,1,3,0,3
2023-06-01,265993,1,0,1,1,0,1
2023-06-01,265979,3,3,6,5,2,5
2023-06-01,54885,9,0,9,2,0,2
2023-06-01,394217,1,0,1,2,0,2
2023-06-01,19220,5,0,5,2,0,2
2023-06-01,59752,8,2,10,1,1,2
2023-06-01,2621,2,0,2,1,0,1
2023-06-01,57574,3,0,3,2,0,2
2023-06-01,27047,58,0,58,3,0,3
2023-06-01,27069,14,0,14,3,0,3
2023-06-01,7297,7,0,7,4,0,4
2023-06-01,26485,11,0,11,10,0,10
2023-06-01,327839,8,0,8,1,0,1
2023-06-01,46512,9,0,9,2,0,2
2023-06-01,9509,4,2,6,1,1,1
2023-06-01,18271,6,0,6,2,0,2
2023-06-01,327792,13,0,13,1,0,1
2023-06-01,19247,6,0,6,2,0,2
2023-06-01,6614,154,0,154,11,0,11
2023-06-01,18933,16,0,16,1,0,1
2023-06-01,13567,24,0,24,3,0,3
2023-06-01,2642,16,0,16,4,0,4
2023-06-01,7486,1,0,1,1,0,1
2023-06-01,328172,1,0,1,3,0,3
2023-06-01,328123,1,0,1,1,0,1
2023-06-01,328188,3,0,3,1,0,1
2023-06-01,328747,1,0,1,4,0,4
2023-06-01,328237,1,1,2,2,2,2
2023-06-01,37449,6,0,6,2,0,2
2023-06-01,14443,2,0,2,3,0,3
2023-06-01,3777,1,0,1,3,0,3
2023-06-01,45138,2,0,2,1,0,1
2023-06-01,36561,1,0,1,1,0,1
2023-06-01,63983,4,0,4,1,0,1
2023-06-01,940,13,0,13,1,0,1
2023-06-01,7908,116,1,117,11,1,11
2023-06-01,327956,3,0,3,4,0,4
2023-06-01,327950,13,0,13,4,0,4
2023-06-01,14890,7,0,7,5,0,5
2023-06-01,27742,71,6,77,9,1,9
2023-06-01,18840,64,1,65,8,1,8
2023-06-01,27811,2,0,2,3,0,3
2023-06-01,52298,1,0,1,1,0,1
2023-06-01,3795,1,0,1,2,0,2
2023-06-01,7926,17,0,17,3,0,3
2023-06-01,393248,3,0,3,1,0,1
2023-06-01,393689,4,1,5,3,4,4
2023-06-01,14014,18,3,21,4,2,4
2023-06-01,2650,2,0,2,1,0,1
2023-06-01,16875,28,0,28,9,0,9
2023-06-01,31880,10,0,10,2,0,2
2023-06-01,131856,2,0,2,2,0,2
2023-06-01,25969,29,0,29,4,0,4
2023-06-01,400215,1,0,1,1,0,1
2023-06-01,209165,1,1,2,1,1,1
2023-06-01,399415,1,0,1,1,0,1
2023-06-01,400438,1,1,2,1,1,1
2023-06-01,935,1,0,1,1,0,1
2023-06-01,62999,1,0,1,1,0,1
2023-06-01,400167,1,0,1,1,0,1
2023-06-01,400469,1,1,2,1,1,1
2023-06-01,26518,1,0,1,1,0,1
2023-06-01,398734,4,0,4,2,0,2
2023-06-01,400034,1,0,1,1,0,1
2023-06-01,400245,4,3,7,1,1,1
2023-06-01,399921,1,0,1,1,0,1
2023-06-01,400064,1,0,1,1,0,1
2023-06-01,395488,1,0,1,2,0,2
2023-06-01,400090,1,0,1,1,0,1
2023-06-01,22649,2,1,3,1,1,1
2023-06-01,400027,1,0,1,1,0,1
2023-06-01,400068,1,0,1,2,0,2
2023-06-01,833,2,2,4,1,1,1
2023-06-01,26297,4,0,4,2,0,2
2023-06-01,400020,1,0,1,2,0,2
2023-06-01,400153,1,0,1,2,0,2
2023-06-01,399693,24,2,26,1,1,1
2023-06-01,397085,2,1,3,2,1,2
2023-06-01,5734,14,0,14,1,0,1
2023-06-01,32713,4,0,4,4,0,4
2023-06-01,54996,5,0,5,3,0,3
2023-06-01,19574,6,1,7,4,1,4
2023-06-01,32691,1,0,1,4,0,4
2023-06-01,394700,15,0,15,2,0,2
2023-06-01,22524,1,0,1,1,0,1
2023-06-01,393749,1,0,1,1,0,1
2023-06-01,46277,5,0,5,4,0,4
2023-06-01,23381,19,0,19,3,0,3
2023-06-01,25602,6,0,6,2,0,2
2023-06-01,52226,13,0,13,2,0,2
2023-06-01,61492,4,0,4,3,0,3
2023-06-01,52497,4,0,4,1,0,1
2023-06-01,8122,3,0,3,1,0,1
2023-06-01,393655,1,0,1,3,0,3
2023-06-01,17575,2,0,2,1,0,1
2023-06-01,56043,15,0,15,4,0,4
2023-06-01,22460,59,0,59,5,0,5
2023-06-01,62757,3,0,3,2,0,2
2023-06-01,22809,14,0,14,5,0,5
2023-06-01,3446,2,0,2,2,0,2
2023-06-01,17759,1,0,1,1,0,1
2023-06-01,33619,33,0,33,9,0,9
2023-06-01,25733,9,0,9,3,0,3
2023-06-01,210137,5,0,5,4,0,4
2023-06-01,138481,3,0,3,3,0,3
2023-06-01,14626,38,0,38,2,0,2
2023-06-01,20955,2,0,2,3,0,3
2023-06-01,53392,1,0,1,2,0,2
2023-06-01,3550,4,0,4,1,0,1
2023-06-01,23980,2,0,2,2,0,2
2023-06-01,37518,22,0,22,2,0,2
2023-06-01,22255,20,0,20,1,0,1
2023-06-01,7020,41,0,41,4,0,4
2023-06-01,9317,49,0,49,3,0,3
2023-06-01,6524,7,0,7,2,0,2
2023-06-01,63138,5,0,5,3,0,3
2023-06-01,54152,2,0,2,3,0,3
2023-06-01,63174,3,0,3,5,0,5
2023-06-01,27486,1,0,1,1,0,1
2023-06-01,8952,4,0,4,2,0,2
2023-06-01,396370,2,1,3,1,1,1
2023-06-01,399469,2,0,2,1,0,1
2023-06-01,46922,1,0,1,2,0,2
2023-06-01,17330,5,0,5,5,0,5
2023-06-01,393490,2,1,3,5,3,5
2023-06-01,150416,2,0,2,1,0,1
2023-06-01,46168,2,0,2,3,0,3
2023-06-01,40704,1,0,1,3,0,3
2023-06-01,97,2,0,2,2,0,2
2023-06-01,394674,2,0,2,2,0,2
2023-06-01,54963,9,0,9,3,0,3
2023-06-01,53427,1,1,2,5,4,5
2023-06-01,22447,1,0,1,1,0,1
2023-06-01,52391,5,1,6,2,2,2
2023-06-01,395559,10,0,10,1,0,1
2023-06-01,203569,1,0,1,1,0,1
2023-06-01,52112,1,6,7,2,1,2
2023-06-01,211728,2,0,2,1,0,1
2023-06-01,263767,5,0,5,2,0,2
2023-06-01,58681,10,0,10,1,0,1
2023-06-01,38495,11,0,11,2,0,2
2023-06-01,398813,11,2,13,2,2,2
2023-06-01,52396,4,0,4,1,0,1
2023-06-01,1350,5,0,5,1,0,1
2023-06-01,24112,4,0,4,1,0,1
2023-06-01,27479,3,0,3,3,0,3
2023-06-01,2033,12,1,13,2,2,2
2023-06-01,10798,82,0,82,27,0,27
2023-06-01,36248,2,0,2,1,0,1
2023-06-01,5080,26,1,27,6,1,6
2023-06-01,13918,1,0,1,1,0,1
2023-06-01,3926,14,1,15,3,1,3
2023-06-01,398033,4,0,4,1,0,1
2023-06-01,12054,7,0,7,3,0,3
2023-06-01,394435,1,0,1,1,0,1
2023-06-01,6118,10,0,10,5,0,5
2023-06-01,18481,2,0,2,3,0,3
2023-06-01,19870,3,0,3,1,0,1
2023-06-01,52250,2,1,3,2,1,2
2023-06-01,22541,52,16,68,11,4,11
2023-06-01,24075,5,2,7,1,1,1
2023-06-01,30488,1,0,1,1,0,1
2023-06-01,4604,1,0,1,1,0,1
2023-06-01,26611,202,445,647,1,1,1
2023-06-01,21798,3,0,3,3,0,3
2023-06-01,46565,1,0,1,1,0,1
2023-06-01,35968,2,0,2,3,0,3
2023-06-01,36440,2,0,2,2,0,2
2023-06-01,55062,1,0,1,2,0,2
2023-06-01,19085,1,0,1,2,0,2
2023-06-01,54135,3,0,3,4,0,4
2023-06-01,54449,1,0,1,2,0,2
2023-06-01,16429,2,0,2,3,0,3
2023-06-01,54675,1,0,1,2,0,2
2023-06-01,46369,1,0,1,2,0,2
2023-06-01,40887,0,0,0,2,0,2
2023-06-01,11883,3,0,3,4,0,4
2023-06-01,19732,1,0,1,2,0,2
2023-06-01,36209,1,0,1,3,0,3
2023-06-01,53489,1,0,1,2,0,2
2023-06-01,36335,1,0,1,2,0,2
2023-06-01,27303,1,0,1,2,0,2
2023-06-01,62498,1,0,1,2,0,2
2023-06-01,40334,1,0,1,2,0,2
2023-06-01,36009,1,0,1,2,0,2
2023-06-01,36462,1,0,1,2,0,2
2023-06-01,32689,1,0,1,3,0,3
2023-06-01,46843,1,0,1,2,0,2
2023-06-01,40324,1,0,1,2,0,2
2023-06-01,63156,7,0,7,3,0,3
2023-06-01,63166,1,0,1,2,0,2
2023-06-01,53377,1,0,1,2,0,2
2023-06-01,63164,1,0,1,2,0,2
2023-06-01,63167,1,0,1,2,0,2
2023-06-01,398003,1,0,1,2,0,2
2023-06-01,398005,1,0,1,2,0,2
2023-06-01,395695,1,0,1,2,0,2
2023-06-01,397999,1,0,1,2,0,2
2023-06-01,397555,1,0,1,2,0,2
2023-06-01,397502,1,0,1,3,0,3
2023-06-01,12227,2,0,2,3,0,3
2023-06-01,397937,1,0,1,2,0,2
2023-06-01,398004,1,0,1,2,0,2
2023-06-01,398000,1,0,1,2,0,2
2023-06-01,397998,1,0,1,2,0,2
2023-06-01,398002,1,0,1,2,0,2
2023-06-01,398001,1,0,1,2,0,2
2023-06-01,395693,2,0,2,3,0,3
2023-06-01,393374,0,0,0,2,0,2
2023-06-01,46520,4,0,4,4,0,4
2023-06-01,397369,8,0,8,2,0,2
2023-06-01,5696,35,0,35,3,0,3
2023-06-01,22221,40,0,40,1,0,1
2023-06-01,11870,17,0,17,8,0,8
2023-06-01,55571,2,0,2,3,0,3
2023-06-01,7838,40,0,40,6,0,6
2023-06-01,264729,2,0,2,2,0,2
2023-06-01,135880,6,0,6,1,0,1
2023-06-01,12052,25,0,25,3,0,3
2023-06-01,30710,13,0,13,3,0,3
2023-06-01,398154,1,0,1,1,0,1
2023-06-01,16821,4,0,4,1,0,1
2023-06-01,19738,37,3,40,7,1,7
2023-06-01,33562,6,0,6,2,0,2
2023-06-01,14579,11,0,11,6,0,6
2023-06-01,47003,1,0,1,1,0,1
2023-06-01,62997,1,2,3,1,1,1
2023-06-01,30192,1,0,1,1,0,1
2023-06-01,393393,17,0,17,2,0,2
2023-06-01,396105,4,0,4,1,0,1
2023-06-01,395643,1,0,1,1,0,1
2023-06-01,394167,2,0,2,1,0,1
2023-06-01,54915,4,0,4,3,0,3
2023-06-01,54916,4,0,4,3,0,3
2023-06-01,17328,4,0,4,4,0,4
2023-06-01,395447,11,0,11,2,0,2
2023-06-01,399946,0,0,0,2,0,2
2023-06-01,396223,1,0,1,1,0,1
2023-06-01,396840,2,0,2,1,0,1
2023-06-01,36593,1,0,1,1,0,1
2023-06-01,399920,1,1,2,2,1,2
2023-06-01,398705,2,0,2,2,0,2
2023-06-01,400134,1,0,1,1,0,1
2023-06-01,399725,2,0,2,2,0,2
2023-06-01,400314,1,0,1,1,0,1
2023-06-01,46600,1,0,1,2,0,2
2023-06-01,400622,1,0,1,3,0,3
2023-06-01,1053,1,0,1,1,0,1
2023-06-01,400524,1,0,1,2,0,2
2023-06-01,394671,2,0,2,1,0,1
2023-06-01,397745,2,0,2,2,0,2
2023-06-01,397803,5,0,5,3,0,3
2023-06-01,14614,3,0,3,3,0,3
2023-06-01,53302,3,0,3,3,0,3
2023-06-01,4954,6,0,6,1,0,1
2023-06-01,55111,1,0,1,1,0,1
2023-06-01,15268,1,0,1,1,0,1
2023-06-01,7183,3,0,3,3,0,3
2023-06-01,2695,4,0,4,1,0,1
2023-06-01,14799,5,0,5,3,0,3
2023-06-01,33565,3,0,3,4,0,4
2023-06-01,32739,12,0,12,2,0,2
2023-06-01,17386,15,0,15,3,0,3
2023-06-01,63211,2,0,2,2,0,2
2023-06-01,36808,4,0,4,2,0,2
2023-06-01,10662,3,0,3,5,0,5
2023-06-01,40390,3,0,3,3,0,3
2023-06-01,11379,3,0,3,4,0,4
2023-06-01,394261,2,0,2,2,0,2
2023-06-01,394366,1,0,1,2,0,2
2023-06-01,11313,48,0,48,1,0,1
2023-06-01,399911,4,0,4,3,0,3
2023-06-01,32246,8,0,8,1,0,1
2023-06-01,15086,9,0,9,3,0,3
2023-06-01,20131,1,0,1,3,0,3
2023-06-01,396921,13,3,16,4,2,4
2023-06-01,398875,10,6,16,3,3,3
2023-06-01,21783,3,0,3,2,0,2
2023-06-01,32255,18,0,18,3,0,3
2023-06-01,19273,24,0,24,3,0,3
2023-06-01,394617,1,0,1,1,0,1
2023-06-01,32893,1,0,1,2,0,2
2023-06-01,394534,12,0,12,3,0,3
2023-06-01,30012,18,0,18,14,0,14
2023-06-01,394910,1,0,1,1,0,1
2023-06-01,397618,1,0,1,1,0,1
2023-06-01,11101,5,0,5,2,0,2
2023-06-01,3769,9,0,9,2,0,2
2023-06-01,36566,3,0,3,2,0,2
2023-06-01,36567,2,0,2,2,0,2
2023-06-01,36568,2,0,2,3,0,3
2023-06-01,36569,2,0,2,2,0,2
2023-06-01,36570,2,0,2,2,0,2
2023-06-01,36571,2,0,2,2,0,2
2023-06-01,36572,2,0,2,2,0,2
2023-06-01,36573,2,0,2,2,0,2
2023-06-01,36574,2,0,2,2,0,2
2023-06-01,36575,2,0,2,2,0,2
2023-06-01,36576,2,0,2,2,0,2
2023-06-01,36577,2,0,2,2,0,2
2023-06-01,36578,2,0,2,2,0,2
2023-06-01,36580,2,0,2,2,0,2
2023-06-01,36760,2,0,2,2,0,2
2023-06-01,36761,2,0,2,3,0,3
2023-06-01,36762,2,0,2,2,0,2
2023-06-01,36764,2,0,2,2,0,2
2023-06-01,36765,2,0,2,2,0,2
2023-06-01,36767,2,0,2,3,0,3
2023-06-01,36768,2,0,2,2,0,2
2023-06-01,36769,2,0,2,2,0,2
2023-06-01,36772,2,0,2,2,0,2
2023-06-01,36787,2,0,2,2,0,2
2023-06-01,54204,2,0,2,2,0,2
2023-06-01,36581,2,0,2,3,0,3
2023-06-01,36766,2,0,2,2,0,2
2023-06-01,394400,13,0,13,3,0,3
2023-06-01,394401,15,0,15,3,0,3
2023-06-01,32795,3,0,3,2,0,2
2023-06-01,17247,1,0,1,2,0,2
2023-06-01,7362,1,0,1,2,0,2
2023-06-01,21938,5,0,5,3,0,3
2023-06-01,12037,6,0,6,1,0,1
2023-06-01,7800,5,0,5,4,0,4
2023-06-01,138938,1,0,1,2,0,2
2023-06-01,62481,2,0,2,1,0,1
2023-06-01,54053,19,0,19,2,0,2
2023-06-01,22012,7,0,7,2,0,2
2023-06-01,46973,5,0,5,3,0,3
2023-06-01,393556,4,0,4,3,0,3
2023-06-01,15071,5,0,5,3,0,3
2023-06-01,24030,4,0,4,2,0,2
2023-06-01,3826,2,0,2,2,0,2
2023-06-01,26529,2,0,2,3,0,3
2023-06-01,55290,9,0,9,2,0,2
2023-06-01,18880,20,0,20,15,0,15
2023-06-01,2897,5,0,5,2,0,2
2023-06-01,393861,3,0,3,4,0,4
2023-06-01,23397,2,0,2,2,0,2
2023-06-01,33245,1,0,1,1,0,1
2023-06-01,26564,1,0,1,1,0,1
2023-06-01,22648,2,0,2,2,0,2
2023-06-01,11596,15,0,15,4,0,4
2023-06-01,33166,4,0,4,3,0,3
2023-06-01,397147,2,0,2,2,0,2
2023-06-01,10348,2,0,2,2,0,2
2023-06-01,26342,37,3,40,5,1,5
2023-06-01,45139,2,2,4,2,1,2
2023-06-01,58862,2,0,2,2,0,2
2023-06-01,10975,42,4,46,6,2,6
2023-06-01,11245,18,0,18,9,0,9
2023-06-01,3525,72,0,72,1,0,1
2023-06-01,19400,12,0,12,1,0,1
2023-06-01,17161,44,0,44,7,0,7
2023-06-01,22808,26,0,26,6,0,6
2023-06-01,55706,11,5,16,5,5,6
2023-06-01,51439,5,4,9,4,4,5
2023-06-01,398722,3,1,4,2,1,2
2023-06-01,52913,57,8,65,4,4,5
2023-06-01,262644,6,1,7,4,2,4
2023-06-01,265158,7,3,10,6,3,6
2023-06-01,265166,7,1,8,1,1,1
2023-06-01,262338,10,2,12,2,2,2
2023-06-01,265203,4,0,4,1,0,1
2023-06-01,271646,6,2,8,3,1,3
2023-06-01,265168,1,1,2,1,1,1
2023-06-01,265169,4,4,8,7,4,7
2023-06-01,265176,7,0,7,1,0,1
2023-06-01,271134,7,7,14,1,1,1
2023-06-01,271004,2,1,3,1,1,1
2023-06-01,28124,29,1,30,4,1,4
2023-06-01,22882,3,0,3,1,0,1
2023-06-01,265170,3,1,4,2,1,2
2023-06-01,265247,10,1,11,2,1,2
2023-06-01,265178,1,1,2,5,5,5
2023-06-01,265186,1,0,1,1,0,1
2023-06-01,265191,3,0,3,1,0,1
2023-06-01,28226,23,2,25,1,1,1
2023-06-01,265190,1,1,2,2,2,2
2023-06-01,265188,3,3,6,5,4,5
2023-06-01,265182,2,0,2,1,0,1
2023-06-01,263098,16,1,17,6,4,7
2023-06-01,263815,2,0,2,1,0,1
2023-06-01,265174,3,1,4,1,1,1
2023-06-01,265177,5,0,5,1,0,1
2023-06-01,265180,4,0,4,2,0,2
2023-06-01,265183,1,0,1,2,0,2
2023-06-01,265172,4,4,8,6,5,6
2023-06-01,265173,5,0,5,1,0,1
2023-06-01,28408,2,1,3,4,4,4
2023-06-01,265185,4,1,5,4,3,4
2023-06-01,264649,4,0,4,1,0,1
2023-06-01,265194,1,3,4,2,1,2
2023-06-01,265279,14,2,16,6,4,6
2023-06-01,28618,50,1,51,8,3,8
2023-06-01,265189,7,4,11,5,3,6
2023-06-01,265204,1,1,2,2,1,2
2023-06-01,265197,5,5,10,4,3,4
2023-06-01,265484,7,7,14,11,6,11
2023-06-01,265503,4,0,4,2,0,2
2023-06-01,262715,22,3,25,3,1,3
2023-06-01,52625,8,2,10,4,1,4
2023-06-01,265199,1,0,1,2,0,2
2023-06-01,265213,4,0,4,2,0,2
2023-06-01,264667,3,0,3,1,0,1
2023-06-01,262220,15,8,23,3,3,3
2023-06-01,265200,4,0,4,3,0,3
2023-06-01,262289,4,1,5,3,1,3
2023-06-01,52634,3,2,5,5,3,5
2023-06-01,265246,3,8,11,2,1,2
2023-06-01,264839,3,0,3,1,0,1
2023-06-01,52623,2,1,3,2,1,2
2023-06-01,265214,3,3,6,3,2,3
2023-06-01,265255,7,3,10,1,2,2
2023-06-01,265804,6,0,6,2,0,2
2023-06-01,265219,5,0,5,1,0,1
2023-06-01,264654,4,0,4,1,0,1
2023-06-01,267748,1,0,1,1,0,1
2023-06-01,265208,1,0,1,1,0,1
2023-06-01,265226,1,1,2,1,1,1
2023-06-01,52271,13,0,13,2,0,2
2023-06-01,264658,1,1,2,1,1,1
2023-06-01,265224,2,1,3,2,2,2
2023-06-01,265210,5,1,6,1,1,1
2023-06-01,265227,5,1,6,1,1,1
2023-06-01,272026,2,0,2,1,0,1
2023-06-01,271863,2,0,2,1,0,1
2023-06-01,265237,6,0,6,1,0,1
2023-06-01,265238,1,1,2,1,1,1
2023-06-01,265220,5,2,7,1,1,1
2023-06-01,21922,9,1,10,6,2,6
2023-06-01,14946,19,0,19,3,0,3
2023-06-01,16831,46,0,46,4,0,4
2023-06-01,265240,2,1,3,2,1,2
2023-06-01,61485,4,0,4,1,0,1
2023-06-01,265242,2,6,8,1,1,1
2023-06-01,265243,4,1,5,4,1,4
2023-06-01,265222,3,1,4,2,2,3
2023-06-01,265244,4,3,7,7,5,7
2023-06-01,265223,1,0,1,1,0,1
2023-06-01,61517,4,0,4,5,0,5
2023-06-01,19990,12,1,13,4,3,5
2023-06-01,52864,8,1,9,1,1,1
2023-06-01,265230,1,0,1,5,0,5
2023-06-01,265245,7,6,13,1,1,1
2023-06-01,265225,3,1,4,1,1,1
2023-06-01,265231,7,9,16,3,2,3
2023-06-01,262791,17,1,18,5,6,7
2023-06-01,265249,2,3,5,6,5,7
2023-06-01,265250,5,1,6,3,1,3
2023-06-01,263069,10,3,13,2,2,2
2023-06-01,265262,14,1,15,7,2,7
2023-06-01,262731,5,1,6,13,5,14
2023-06-01,265259,4,0,4,3,0,3
2023-06-01,52560,9,1,10,3,3,3
2023-06-01,265258,1,0,1,2,0,2
2023-06-01,265256,7,6,13,3,4,4
2023-06-01,263483,6,1,7,7,2,7
2023-06-01,265257,7,7,14,5,4,6
2023-06-01,265286,4,0,4,1,0,1
2023-06-01,27927,129,4,133,2,1,2
2023-06-01,52829,2,2,4,1,1,1
2023-06-01,265265,3,3,6,3,2,3
2023-06-01,264672,1,0,1,1,0,1
2023-06-01,52481,4,0,4,2,0,2
2023-06-01,265283,7,1,8,1,1,1
2023-06-01,52393,3,1,4,1,1,1
2023-06-01,265260,3,3,6,5,3,5
2023-06-01,265261,5,0,5,3,0,3
2023-06-01,262854,29,1,30,10,7,11
2023-06-01,3480,3,0,3,19,0,19
2023-06-01,46745,1,0,1,1,0,1
2023-06-01,55091,5,7,12,5,1,5
2023-06-01,394723,3,0,3,4,0,4
2023-06-01,18838,2,0,2,3,0,3
2023-06-01,13726,2,0,2,2,0,2
2023-06-01,25964,2,0,2,2,0,2
2023-06-01,29926,1,0,1,2,0,2
2023-06-01,40240,1,0,1,1,0,1
2023-06-01,398441,2,0,2,2,0,2
2023-06-01,395812,1,0,1,1,0,1
2023-06-01,55260,16,0,16,2,0,2
2023-06-01,63165,2,0,2,1,0,1
2023-06-01,46830,8,0,8,3,0,3
2023-06-01,40109,1,0,1,3,0,3
2023-06-01,16855,1,0,1,1,0,1
2023-06-01,399556,1,0,1,2,0,2
2023-06-01,25716,12,0,12,4,0,4
2023-06-01,1676,3,0,3,1,0,1
2023-06-01,3654,3,0,3,1,0,1
2023-06-01,17180,1,0,1,1,0,1
2023-06-01,12245,3,0,3,2,0,2
2023-06-01,1439,1,0,1,2,0,2
2023-06-01,395868,3,0,3,2,0,2
2023-06-01,394001,2,0,2,3,0,3
2023-06-01,135146,2,0,2,1,0,1
2023-06-01,4544,11,0,11,4,0,4
2023-06-01,3551,246,1,247,2,1,2
2023-06-01,52336,2,1,3,2,1,2
2023-06-01,52446,1,0,1,2,0,2
2023-06-01,18300,275,0,275,3,0,3
2023-06-01,202769,1,0,1,1,0,1
2023-06-01,11990,2,2,4,3,2,3
2023-06-01,4387,12,0,12,2,0,2
2023-06-01,10277,8,0,8,1,0,1
2023-06-01,394794,2,0,2,2,0,2
2023-06-01,36665,3,0,3,1,0,1
2023-06-01,2162,2,0,2,2,0,2
2023-06-01,2164,12,0,12,2,0,2
2023-06-01,132121,3,0,3,2,0,2
2023-06-01,132095,1,0,1,1,0,1
2023-06-01,132451,1,0,1,2,0,2
2023-06-01,25867,19,0,19,2,0,2
2023-06-01,265271,4,1,5,1,1,1
2023-06-01,263046,6,2,8,3,2,3
2023-06-01,265263,2,0,2,3,0,3
2023-06-01,265266,7,7,14,5,3,5
2023-06-01,263032,10,2,12,9,5,10
2023-06-01,265314,5,5,10,3,2,3
2023-06-01,265267,3,3,6,1,1,1
2023-06-01,52493,8,0,8,5,0,5
2023-06-01,262988,63,1,64,9,8,10
2023-06-01,265307,4,3,7,1,1,1
2023-06-01,265310,4,0,4,3,0,3
2023-06-01,53175,33,18,51,8,6,8
2023-06-01,265287,5,0,5,1,0,1
2023-06-01,265275,7,1,8,2,2,2
2023-06-01,265276,1,1,2,1,1,1
2023-06-01,265272,3,3,6,6,5,7
2023-06-01,265285,7,1,8,1,1,1
2023-06-01,271183,2,1,3,1,1,1
2023-06-01,264705,4,0,4,3,0,3
2023-06-01,265280,3,0,3,2,0,2
2023-06-01,272421,1,1,2,1,1,1
2023-06-01,265281,7,3,10,4,3,4
2023-06-01,265289,3,3,6,2,2,2
2023-06-01,28135,74,7,81,14,6,14
2023-06-01,265295,4,1,5,3,1,3
2023-06-01,265296,5,2,7,1,1,1
2023-06-01,265309,2,0,2,1,0,1
2023-06-01,265298,3,0,3,1,0,1
2023-06-01,264669,5,0,5,4,0,4
2023-06-01,19217,1,0,1,1,0,1
2023-06-01,397029,1,0,1,3,0,3
2023-06-01,26086,3,0,3,2,0,2
2023-06-01,23377,6,0,6,2,0,2
2023-06-01,17130,4,0,4,4,0,4
2023-06-01,30075,1,0,1,2,0,2
2023-06-01,399224,4,0,4,4,0,4
2023-06-01,19794,1,0,1,3,0,3
2023-06-01,399624,1,0,1,1,0,1
2023-06-01,46405,1,0,1,3,0,3
2023-06-01,36197,1,0,1,1,0,1
2023-06-01,11243,1,0,1,1,0,1
2023-06-01,30562,1,0,1,3,0,3
2023-06-01,397365,1,0,1,1,0,1
2023-06-01,18448,2,0,2,3,0,3
2023-06-01,398710,12,5,17,4,3,4
2023-06-01,7417,14,0,14,5,0,5
2023-06-01,400718,1,1,2,1,1,1
2023-06-01,400236,2,0,2,2,0,2
2023-06-01,398421,2,0,2,2,0,2
2023-06-01,17706,5,0,5,3,0,3
2023-06-01,27285,13,0,13,8,0,8
2023-06-01,39003,0,0,0,2,0,2
2023-06-01,10647,2,0,2,1,0,1
2023-06-01,9753,26,0,26,2,0,2
2023-06-01,4274,108,0,108,1,0,1
2023-06-01,265292,4,1,5,2,3,4
2023-06-01,265304,4,2,6,1,2,2
2023-06-01,265305,1,0,1,2,0,2
2023-06-01,265293,5,1,6,1,1,1
2023-06-01,263072,35,3,38,1,1,1
2023-06-01,272449,0,6,6,6,6,9
2023-06-01,267429,3,1,4,8,5,8
2023-06-01,265306,2,1,3,1,1,1
2023-06-01,61519,5,1,6,3,2,3
2023-06-01,264675,1,0,1,1,0,1
2023-06-01,262838,10,1,11,1,1,1
2023-06-01,265300,3,1,4,2,1,2
2023-06-01,265302,4,1,5,6,2,6
2023-06-01,265301,7,1,8,1,1,1
2023-06-01,264707,4,0,4,1,0,1
2023-06-01,52398,14,0,14,1,0,1
2023-06-01,265317,6,1,7,6,3,6
2023-06-01,265312,5,3,8,2,2,2
2023-06-01,265322,6,0,6,5,0,5
2023-06-01,265313,5,0,5,2,0,2
2023-06-01,263421,42,3,45,9,6,10
2023-06-01,265318,3,3,6,2,1,2
2023-06-01,265321,6,1,7,1,1,1
2023-06-01,265315,2,9,11,6,5,8
2023-06-01,265319,2,1,3,2,3,3
2023-06-01,28000,15,4,19,4,4,5
2023-06-01,265323,3,2,5,3,2,3
2023-06-01,22080,83,4,87,8,3,8
2023-06-01,265506,4,0,4,2,0,2
2023-06-01,270623,37,2,39,8,5,8
2023-06-01,271483,7,1,8,2,1,2
2023-06-01,262966,6,3,9,6,3,6
2023-06-01,28163,31,1,32,5,4,5
2023-06-01,265324,1,16,17,1,1,1
2023-06-01,35889,0,0,0,3,2,3
2023-06-01,9490,2,0,2,2,0,2
2023-06-01,9767,42,0,42,3,0,3
2023-06-01,10197,8,1,9,3,1,3
2023-06-01,18191,5,0,5,1,0,1
2023-06-01,30070,24,0,24,5,0,5
2023-06-01,395000,17,0,17,4,0,4
2023-06-01,10379,4,0,4,3,0,3
2023-06-01,26989,11,0,11,8,0,8
2023-06-01,10128,9,0,9,3,0,3
2023-06-01,53585,7,0,7,3,0,3
2023-06-01,393234,2,0,2,1,0,1
2023-06-01,17029,16,0,16,1,0,1
2023-06-01,27471,5,0,5,2,0,2
2023-06-01,397050,6,0,6,2,0,2
2023-06-01,23444,3,0,3,1,0,1
2023-06-01,3502,44,0,44,1,0,1
2023-06-01,395353,3,0,3,2,0,2
2023-06-01,397408,1,0,1,2,0,2
2023-06-01,18637,3,0,3,3,0,3
2023-06-01,395981,1,0,1,1,0,1
2023-06-01,133036,1,0,1,2,0,2
2023-06-01,17200,5,0,5,1,0,1
2023-06-01,20012,35,0,35,2,0,2
2023-06-01,398284,4,0,4,1,0,1
2023-06-01,38027,15,0,15,1,0,1
2023-06-01,62892,5,0,5,1,0,1
2023-06-01,36032,23,0,23,6,0,6
2023-06-01,11726,1,0,1,1,0,1
2023-06-01,398140,2,0,2,1,0,1
2023-06-01,19038,20,0,20,3,0,3
2023-06-01,393601,5,2,7,1,1,1
2023-06-01,21874,8,0,8,6,0,6
2023-06-01,25935,22,0,22,3,0,3
2023-06-01,2903,1,0,1,3,0,3
2023-06-01,26675,47,0,47,2,0,2
2023-06-01,32501,1,0,1,1,0,1
2023-06-01,5722,50,10,60,1,1,1
2023-06-01,28213,14,3,17,7,4,7
2023-06-01,265326,10,2,12,4,3,4
2023-06-01,264673,5,0,5,1,0,1
2023-06-01,265329,2,1,3,1,1,1
2023-06-01,265327,3,0,3,1,0,1
2023-06-01,53029,17,1,18,2,2,2
2023-06-01,52956,21,18,39,4,3,4
2023-06-01,265328,2,1,3,2,1,3
2023-06-01,265331,1,1,2,1,1,1
2023-06-01,262218,11,0,11,6,0,6
2023-06-01,266470,1,1,2,6,5,6
2023-06-01,271013,7,0,7,1,0,1
2023-06-01,267503,6,0,6,11,4,11
2023-06-01,265334,7,7,14,2,1,2
2023-06-01,265339,4,0,4,1,0,1
2023-06-01,264847,5,1,6,2,1,2
2023-06-01,265356,4,7,11,3,3,3
2023-06-01,265340,1,2,3,2,2,2
2023-06-01,264862,4,1,5,3,1,3
2023-06-01,263648,1,1,2,5,4,5
2023-06-01,265341,1,0,1,1,0,1
2023-06-01,265338,3,1,4,5,1,5
2023-06-01,264936,7,10,17,7,5,7
2023-06-01,265342,5,1,6,1,1,1
2023-06-01,262296,23,1,24,2,1,2
2023-06-01,271450,5,1,6,7,5,7
2023-06-01,265344,7,7,14,2,2,2
2023-06-01,52718,13,1,14,4,1,4
2023-06-01,265351,3,3,6,1,1,1
2023-06-01,265358,2,0,2,2,0,2
2023-06-01,266126,0,1,1,4,1,5
2023-06-01,265359,3,0,3,3,0,3
2023-06-01,271458,2,1,3,7,4,7
2023-06-01,272529,0,7,7,3,2,3
2023-06-01,265349,6,0,6,2,0,2
2023-06-01,265347,13,5,18,4,4,5
2023-06-01,18522,18,0,18,4,0,4
2023-06-01,136604,16,0,16,2,0,2
2023-06-01,57278,2,0,2,1,0,1
2023-06-01,18298,7,0,7,3,0,3
2023-06-01,53526,8,0,8,1,0,1
2023-06-01,46255,28,0,28,2,0,2
2023-06-01,265388,3,0,3,1,0,1
2023-06-01,265390,3,9,12,4,3,4
2023-06-01,265375,5,1,6,3,3,3
2023-06-01,264743,5,0,5,2,0,2
2023-06-01,265378,4,1,5,3,1,3
2023-06-01,265111,4,5,9,8,7,11
2023-06-01,267513,22,1,23,7,5,7
2023-06-01,262706,31,1,32,12,2,12
2023-06-01,265380,2,0,2,2,0,2
2023-06-01,265395,3,7,10,2,2,2
2023-06-01,265386,5,3,8,1,1,1
2023-06-01,264783,4,0,4,2,0,2
2023-06-01,265403,3,1,4,1,1,1
2023-06-01,265387,5,0,5,1,0,1
2023-06-01,265404,7,3,10,1,1,1
2023-06-01,61811,15,1,16,1,2,2
2023-06-01,264754,4,3,7,3,2,3
2023-06-01,265405,7,3,10,3,3,3
2023-06-01,265396,7,1,8,1,1,1
2023-06-01,265393,7,7,14,5,3,6
2023-06-01,265391,3,2,5,4,2,4
2023-06-01,265400,7,3,10,6,3,6
2023-06-01,265397,7,1,8,1,1,1
2023-06-01,265407,1,3,4,4,3,4
2023-06-01,265394,3,1,4,1,1,1
2023-06-01,265409,7,3,10,3,2,3
2023-06-01,264760,1,0,1,4,0,4
2023-06-01,265412,5,3,8,2,3,3
2023-06-01,265401,5,3,8,2,2,2
2023-06-01,264770,14,1,15,2,1,2
2023-06-01,265414,6,1,7,2,2,2
2023-06-01,265415,5,1,6,5,2,6
2023-06-01,52814,15,1,16,7,3,7
2023-06-01,265410,3,18,21,3,3,3
2023-06-01,265418,3,0,3,1,0,1
2023-06-01,53186,4,0,4,2,0,2
2023-06-01,265419,5,5,10,4,2,4
2023-06-01,271181,5,4,9,8,5,8
2023-06-01,265424,7,7,14,6,4,6
2023-06-01,265425,7,1,8,1,1,1
2023-06-01,28128,21,1,22,1,1,1
2023-06-01,264752,1,0,1,2,0,2
2023-06-01,265408,7,1,8,3,1,3
2023-06-01,265420,5,1,6,3,2,3
2023-06-01,61484,8,0,8,2,0,2
2023-06-01,271009,1,1,2,3,3,3
2023-06-01,265411,2,1,3,1,1,1
2023-06-01,265429,7,7,14,4,2,4
2023-06-01,265430,1,1,2,3,1,3
2023-06-01,265443,3,0,3,3,0,3
2023-06-01,264228,14,20,34,8,7,9
2023-06-01,28114,36,1,37,6,2,6
2023-06-01,270057,4,0,4,3,0,3
2023-06-01,263498,14,3,17,1,1,1
2023-06-01,271027,7,1,8,4,4,5
2023-06-01,265423,4,1,5,1,1,1
2023-06-01,265437,7,3,10,3,1,3
2023-06-01,28296,20,2,22,4,1,4
2023-06-01,264761,3,0,3,2,0,2
2023-06-01,271991,1,1,2,2,1,3
2023-06-01,265439,5,1,6,1,1,1
2023-06-01,265427,5,1,6,1,1,1
2023-06-01,265428,1,0,1,1,0,1
2023-06-01,271515,2,3,5,4,3,4
2023-06-01,263799,5,1,6,3,1,3
2023-06-01,264756,4,3,7,1,1,1
2023-06-01,263089,6,1,7,5,3,5
2023-06-01,262982,10,0,10,1,0,1
2023-06-01,264087,2,0,2,1,0,1
2023-06-01,262373,2,1,3,1,1,1
2023-06-01,272155,1,0,1,1,0,1
2023-06-01,264757,1,0,1,2,0,2
2023-06-01,271997,2,0,2,1,0,1
2023-06-01,265453,3,4,7,1,1,1
2023-06-01,262908,5,1,6,3,2,3
2023-06-01,265464,3,3,6,1,1,1
2023-06-01,265455,7,1,8,3,2,3
2023-06-01,265448,3,0,3,2,0,2
2023-06-01,52601,6,1,7,4,1,4
2023-06-01,263054,8,0,8,5,0,5
2023-06-01,265451,3,7,10,1,2,2
2023-06-01,264767,17,0,17,2,0,2
2023-06-01,265460,5,0,5,1,0,1
2023-06-01,263289,10,3,13,4,4,4
2023-06-01,264768,1,0,1,1,0,1
2023-06-01,263640,14,3,17,5,4,5
2023-06-01,265461,6,5,11,1,1,1
2023-06-01,264771,5,0,5,2,0,2
2023-06-01,265465,4,0,4,2,0,2
2023-06-01,265468,7,0,7,2,0,2
2023-06-01,266467,5,0,5,2,0,2
2023-06-01,262469,21,1,22,4,2,4
2023-06-01,265466,1,1,2,1,1,1
2023-06-01,4995,24,0,24,1,0,1
2023-06-01,52848,21,1,22,8,1,8
2023-06-01,270980,3,1,4,3,1,3
2023-06-01,265470,1,0,1,3,0,3
2023-06-01,265471,1,0,1,1,0,1
2023-06-01,265472,5,3,8,2,2,2
2023-06-01,265473,1,0,1,1,0,1
2023-06-01,270941,1,0,1,1,0,1
2023-06-01,265467,1,0,1,1,0,1
2023-06-01,28194,11,4,15,2,1,2
2023-06-01,265474,1,0,1,1,0,1
2023-06-01,265480,5,0,5,1,0,1
2023-06-01,270779,1,1,2,5,2,5
2023-06-01,262909,15,0,15,6,0,6
2023-06-01,264985,5,1,6,2,1,2
2023-06-01,52599,21,1,22,1,1,1
2023-06-01,265476,2,1,3,2,1,2
2023-06-01,264781,2,0,2,2,0,2
2023-06-01,265478,2,1,3,5,2,5
2023-06-01,262646,7,1,8,3,1,3
2023-06-01,265481,7,1,8,1,1,1
2023-06-01,265487,7,1,8,1,1,1
2023-06-01,265483,6,1,7,2,4,4
2023-06-01,265485,7,9,16,4,1,4
2023-06-01,265493,7,1,8,1,1,1
2023-06-01,264786,5,0,5,3,0,3
2023-06-01,264773,8,2,10,1,1,1
2023-06-01,265488,3,1,4,1,1,1
2023-06-01,271267,5,1,6,6,1,6
2023-06-01,272624,0,2,2,2,1,3
2023-06-01,265497,5,1,6,2,1,2
2023-06-01,264787,5,0,5,3,0,3
2023-06-01,53139,12,3,15,5,3,5
2023-06-01,264779,5,0,5,1,0,1
2023-06-01,264784,3,0,3,3,0,3
2023-06-01,265486,3,4,7,5,4,5
2023-06-01,264789,5,1,6,2,1,3
2023-06-01,264776,3,0,3,1,0,1
2023-06-01,18693,3,0,3,3,0,3
2023-06-01,5535,3,0,3,3,0,3
2023-06-01,396492,2,0,2,3,0,3
2023-06-01,7317,3,0,3,2,0,2
2023-06-01,264676,5,1,6,1,1,1
2023-06-01,265361,7,0,7,1,0,1
2023-06-01,264882,7,1,8,2,1,2
2023-06-01,265360,7,0,7,2,0,2
2023-06-01,265350,3,18,21,2,2,2
2023-06-01,263674,14,7,21,1,1,1
2023-06-01,265363,3,1,4,3,2,3
2023-06-01,52528,22,1,23,3,2,3
2023-06-01,16973,13,1,14,5,1,5
2023-06-01,265354,3,1,4,6,4,7
2023-06-01,265355,7,1,8,3,1,3
2023-06-01,265364,5,3,8,2,2,2
2023-06-01,262519,29,3,32,5,6,7
2023-06-01,264678,4,0,4,2,0,2
2023-06-01,263140,14,7,21,1,1,1
2023-06-01,52944,29,7,36,6,4,6
2023-06-01,28250,55,1,56,1,1,1
2023-06-01,265370,5,0,5,1,0,1
2023-06-01,264864,1,1,2,3,1,3
2023-06-01,52794,42,1,43,7,5,8
2023-06-01,264692,3,0,3,1,0,1
2023-06-01,265366,7,0,7,3,0,3
2023-06-01,264868,1,3,4,2,1,2
2023-06-01,272815,5,0,5,3,0,3
2023-06-01,27964,142,0,142,4,0,4
2023-06-01,265371,5,0,5,1,0,1
2023-06-01,264865,6,3,9,2,1,2
2023-06-01,265372,3,2,5,2,2,2
2023-06-01,61920,4,1,5,4,4,4
2023-06-01,264869,3,2,5,1,1,1
2023-06-01,264866,5,3,8,3,1,3
2023-06-01,264867,6,1,7,3,3,3
2023-06-01,264870,2,0,2,1,0,1
2023-06-01,264871,3,0,3,1,0,1
2023-06-01,265367,1,1,2,1,1,1
2023-06-01,61795,8,1,9,4,1,4
2023-06-01,264863,3,3,6,1,2,2
2023-06-01,264892,5,1,6,2,2,2
2023-06-01,19380,8,0,8,5,0,5
2023-06-01,36300,8,0,8,1,0,1
2023-06-01,395789,2,0,2,3,0,3
2023-06-01,54266,2,0,2,2,0,2
2023-06-01,14060,4,0,4,2,0,2
2023-06-01,12210,1,0,1,1,0,1
2023-06-01,32532,1,0,1,1,0,1
2023-06-01,18292,12,0,12,3,0,3
2023-06-01,393303,7,0,7,6,0,6
2023-06-01,8131,2,0,2,2,0,2
2023-06-01,398210,17,0,17,3,0,3
2023-06-01,7202,3,0,3,3,0,3
2023-06-01,29487,3,0,3,1,0,1
2023-06-01,4926,11,0,11,1,0,1
2023-06-01,11311,1,0,1,1,0,1
2023-06-01,264680,4,1,5,1,1,1
2023-06-01,265780,4,1,5,2,2,3
2023-06-01,264683,5,1,6,2,1,2
2023-06-01,264876,3,1,4,4,4,5
2023-06-01,264874,1,1,2,1,1,1
2023-06-01,52940,4,3,7,1,2,2
2023-06-01,52603,7,1,8,5,1,5
2023-06-01,52330,12,0,12,3,0,3
2023-06-01,264891,4,0,4,3,0,3
2023-06-01,264910,2,1,3,2,1,2
2023-06-01,264878,1,1,2,3,1,3
2023-06-01,262934,10,0,10,2,0,2
2023-06-01,53240,111,7,118,7,5,8
2023-06-01,52898,16,1,17,2,2,2
2023-06-01,264885,4,0,4,1,0,1
2023-06-01,264886,14,1,15,2,2,2
2023-06-01,264887,3,3,6,1,1,1
2023-06-01,264893,2,0,2,2,0,2
2023-06-01,264830,57,1,58,3,1,3
2023-06-01,27987,38,1,39,1,2,2
2023-06-01,264896,7,7,14,1,1,1
2023-06-01,264888,7,1,8,1,1,1
2023-06-01,264914,1,0,1,1,0,1
2023-06-01,264889,3,1,4,1,1,1
2023-06-01,264897,3,3,6,1,1,1
2023-06-01,264890,7,2,9,5,3,5
2023-06-01,264904,1,0,1,1,0,1
2023-06-01,264894,5,1,6,3,1,3
2023-06-01,264900,2,1,3,1,1,1
2023-06-01,264901,4,2,6,4,2,4
2023-06-01,263057,21,1,22,3,2,3
2023-06-01,264902,3,3,6,1,2,2
2023-06-01,264903,3,1,4,3,2,4
2023-06-01,270983,4,3,7,2,1,2
2023-06-01,264708,5,1,6,2,2,3
2023-06-01,263020,11,3,14,3,1,3
2023-06-01,264912,5,1,6,1,1,1
2023-06-01,264908,1,1,2,1,1,1
2023-06-01,271031,2,1,3,1,1,1
2023-06-01,264906,7,1,8,3,2,3
2023-06-01,264913,3,3,6,5,4,5
2023-06-01,264917,6,16,22,3,2,4
2023-06-01,264946,3,0,3,3,0,3
2023-06-01,264911,5,14,19,3,3,3
2023-06-01,263341,2,1,3,3,4,4
2023-06-01,264921,5,0,5,2,0,2
2023-06-01,264926,3,7,10,6,3,6
2023-06-01,264928,7,0,7,2,0,2
2023-06-01,264918,3,1,4,3,3,3
2023-06-01,264929,3,1,4,6,4,6
2023-06-01,264915,4,3,7,4,4,5
2023-06-01,264919,5,1,6,3,2,3
2023-06-01,264916,5,1,6,2,1,2
2023-06-01,264937,7,0,7,1,0,1
2023-06-01,394488,6,0,6,1,0,1
2023-06-01,395652,2,0,2,3,0,3
2023-06-01,397176,1,0,1,2,0,2
2023-06-01,32430,5,0,5,2,0,2
2023-06-01,27918,4,0,4,3,0,3
2023-06-01,264923,2,1,3,3,2,3
2023-06-01,264931,4,4,8,1,1,1
2023-06-01,264932,1,0,1,1,0,1
2023-06-01,264938,3,0,3,1,0,1
2023-06-01,264924,1,1,2,1,1,1
2023-06-01,264933,5,0,5,2,0,2
2023-06-01,264720,3,0,3,2,0,2
2023-06-01,264227,1,4,5,4,5,5
2023-06-01,264944,3,1,4,4,1,4
2023-06-01,264934,5,0,5,1,0,1
2023-06-01,264935,6,1,7,7,3,8
2023-06-01,264697,4,0,4,4,0,4
2023-06-01,262787,6,1,7,4,2,4
2023-06-01,52387,16,0,16,4,0,4
2023-06-01,264699,1,0,1,1,0,1
2023-06-01,264940,5,0,5,1,0,1
2023-06-01,264942,7,7,14,3,3,3
2023-06-01,264941,1,1,2,1,1,1
2023-06-01,11815,32,2,34,2,2,2
2023-06-01,52253,11,1,12,5,2,5
2023-06-01,264694,3,1,4,1,2,3
2023-06-01,264696,4,0,4,1,0,1
2023-06-01,264947,1,1,2,1,1,1
2023-06-01,264954,4,7,11,2,2,2
2023-06-01,264960,4,5,9,2,2,2
2023-06-01,264956,7,1,8,6,2,6
2023-06-01,264951,1,0,1,1,0,1
2023-06-01,264701,4,0,4,1,0,1
2023-06-01,270729,1,1,2,2,2,2
2023-06-01,264955,4,1,5,4,1,4
2023-06-01,397074,33,0,33,9,0,9
2023-06-01,40380,0,0,0,3,0,3
2023-06-01,262255,1,0,1,1,0,1
2023-06-01,262166,1,0,1,1,0,1
2023-06-01,28087,12,0,12,4,0,4
2023-06-01,6133,1,0,1,1,0,1
2023-06-01,27910,1,0,1,3,0,3
2023-06-01,6458,0,0,0,5,0,5
2023-06-01,27737,2,0,2,1,0,1
2023-06-01,25601,12,0,12,4,0,4
2023-06-01,26057,19,12,31,11,6,11
2023-06-01,4241,1,0,1,1,0,1
2023-06-01,27708,15,0,15,3,0,3
2023-06-01,262179,8,0,8,3,0,3
2023-06-01,16592,72,1,73,3,2,3
2023-06-01,16668,7,1,8,7,2,7
2023-06-01,3066,1,0,1,1,0,1
2023-06-01,30628,1,0,1,1,0,1
2023-06-01,18599,1,0,1,1,0,1
2023-06-01,54495,1,1,2,1,1,1
2023-06-01,22941,1,0,1,1,0,1
2023-06-01,36338,1,0,1,3,0,3
2023-06-01,400713,1,0,1,1,0,1
2023-06-01,396945,1,0,1,1,0,1
2023-06-01,396887,1,0,1,1,0,1
2023-06-01,396294,1,0,1,1,0,1
2023-06-01,398543,1,0,1,1,0,1
2023-06-01,396537,1,0,1,3,0,3
2023-06-01,19336,1,0,1,2,0,2
2023-06-01,47092,1,0,1,3,0,3
2023-06-01,396275,1,0,1,1,0,1
2023-06-01,395715,1,0,1,1,0,1
2023-06-01,395836,1,0,1,2,0,2
2023-06-01,36651,10,0,10,3,0,3
2023-06-01,4911,1,0,1,1,0,1
2023-06-01,327908,7,0,7,4,0,4
2023-06-01,327850,3,0,3,3,0,3
2023-06-01,62832,1,0,1,3,0,3
2023-06-01,13717,16,0,16,2,0,2
2023-06-01,395137,9,0,9,2,0,2
2023-06-01,4531,6,0,6,2,0,2
2023-06-01,12161,6,1,7,2,2,2
2023-06-01,18815,3,0,3,1,0,1
2023-06-01,18755,2,0,2,3,0,3
2023-06-01,26906,1,0,1,3,0,3
2023-06-01,26121,11,0,11,5,0,5
2023-06-01,21610,1,0,1,1,0,1
2023-06-01,14466,1,0,1,1,0,1
2023-06-01,25972,1,0,1,1,0,1
2023-06-01,270856,3,0,3,2,0,2
2023-06-01,3271,3,0,3,3,0,3
2023-06-01,394946,1,0,1,1,0,1
2023-06-01,22370,5,0,5,2,0,2
2023-06-01,32895,1,0,1,2,0,2
2023-06-01,11659,7,0,7,3,0,3
2023-06-01,23174,1,0,1,1,0,1
2023-06-01,394613,2,0,2,1,0,1
2023-06-01,32922,13,2,15,1,1,1
2023-06-01,7867,27,0,27,7,0,7
2023-06-01,7847,2,1,3,2,1,2
2023-06-01,22767,1,1,2,1,1,1
2023-06-01,10569,1,1,2,1,1,1
2023-06-01,396514,1,0,1,2,0,2
2023-06-01,3838,2,1,3,2,1,2
2023-06-01,398872,3,0,3,3,0,3
2023-06-01,399201,1,4,5,2,2,2
2023-06-01,400757,1,1,2,1,1,1
2023-06-01,32854,2,0,2,3,0,3
2023-06-01,54168,1,0,1,2,0,2
2023-06-01,399941,1,0,1,2,0,2
2023-06-01,398992,1,1,2,2,2,2
2023-06-01,16677,19,0,19,6,0,6
2023-06-01,23309,1,1,2,1,1,1
2023-06-01,14115,48,0,48,6,0,6
2023-06-01,22920,5,1,6,1,1,1
2023-06-01,394640,1,0,1,4,0,4
2023-06-01,3946400,0,0,0,1,0,1
2023-06-01,7321,24,0,24,2,0,2
2023-06-01,14509,5,0,5,1,0,1
2023-06-01,22990,3,2,5,4,3,4
2023-06-01,25971,4,0,4,1,0,1
2023-06-01,327981,2,0,2,3,0,3
2023-06-01,327889,1,1,2,2,1,2
2023-06-01,327922,1,0,1,3,0,3
2023-06-01,328003,5,0,5,1,0,1
2023-06-01,328079,5,0,5,3,0,3
2023-06-01,36881,12,0,12,2,0,2
2023-06-01,328019,4,0,4,2,0,2
2023-06-01,327963,3,1,4,1,1,1
2023-06-01,327972,2,0,2,1,0,1
2023-06-01,202562,2,9,11,7,5,9
2023-06-01,328360,2,0,2,3,0,3
2023-06-01,327985,2,0,2,2,0,2
2023-06-01,327986,4,0,4,3,0,3
2023-06-01,327982,5,1,6,3,2,3
2023-06-01,327990,4,0,4,1,0,1
2023-06-01,327997,3,1,4,2,1,2
2023-06-01,47024,3,0,3,2,0,2
2023-06-01,22164,2,0,2,1,0,1
2023-06-01,6966,8,0,8,3,0,3
2023-06-01,327789,1,0,1,1,0,1
2023-06-01,327812,4,1,5,5,1,5
2023-06-01,327803,5,0,5,1,0,1
2023-06-01,37639,3,0,3,2,0,2
2023-06-01,328844,1,0,1,1,0,1
2023-06-01,37709,2,0,2,2,0,2
2023-06-01,327833,1,0,1,3,0,3
2023-06-01,327859,1,1,2,1,1,1
2023-06-01,327876,4,0,4,1,0,1
2023-06-01,327864,3,0,3,1,0,1
2023-06-01,328055,5,4,9,2,1,2
2023-06-01,327885,37,0,37,4,0,4
2023-06-01,327879,4,0,4,1,0,1
2023-06-01,327880,4,2,6,3,2,3
2023-06-01,37483,1,0,1,1,0,1
2023-06-01,327895,2,0,2,1,0,1
2023-06-01,327894,2,0,2,5,0,5
2023-06-01,327896,7,0,7,4,0,4
2023-06-01,327910,1,0,1,1,0,1
2023-06-01,264957,2,1,3,3,2,4
2023-06-01,270088,2,14,16,1,1,1
2023-06-01,27734,5,0,5,1,0,1
2023-06-01,264961,6,3,9,1,1,1
2023-06-01,263328,6,3,9,6,4,6
2023-06-01,265008,4,3,7,6,3,7
2023-06-01,264976,1,1,2,1,1,1
2023-06-01,264702,5,0,5,3,0,3
2023-06-01,264964,5,0,5,2,0,2
2023-06-01,264704,4,0,4,3,0,3
2023-06-01,264966,7,0,7,2,0,2
2023-06-01,264967,3,1,4,1,1,1
2023-06-01,264968,1,1,2,3,2,4
2023-06-01,264965,3,1,4,1,1,1
2023-06-01,265003,1,0,1,1,0,1
2023-06-01,264970,4,1,5,3,1,3
2023-06-01,264972,11,1,12,5,3,5
2023-06-01,61951,5,4,9,7,3,7
2023-06-01,264982,3,0,3,2,0,2
2023-06-01,52978,7,1,8,7,5,7
2023-06-01,264973,7,11,18,1,1,1
2023-06-01,52745,2,0,2,1,0,1
2023-06-01,271282,3,7,10,1,1,1
2023-06-01,265021,1,1,2,6,2,6
2023-06-01,264978,1,1,2,1,1,1
2023-06-01,264975,3,3,6,3,1,3
2023-06-01,264981,6,0,6,4,0,4
2023-06-01,272707,0,1,1,3,1,3
2023-06-01,271119,3,1,4,3,3,3
2023-06-01,264986,3,1,4,1,1,1
2023-06-01,263015,10,1,11,2,1,2
2023-06-01,265000,4,0,4,3,0,3
2023-06-01,265510,1,0,1,3,0,3
2023-06-01,264983,4,3,7,5,3,5
2023-06-01,262301,22,11,33,6,4,7
2023-06-01,264980,1,1,2,1,1,1
2023-06-01,13598,6,0,6,2,0,2
2023-06-01,205627,3,1,4,7,5,8
2023-06-01,393456,4,0,4,2,0,2
2023-06-01,396093,1,0,1,3,0,3
2023-06-01,25699,2,0,2,2,0,2
2023-06-01,398405,1,0,1,1,0,1
2023-06-01,12171,11,0,11,2,0,2
2023-06-01,205287,6,0,6,3,0,3
2023-06-01,397726,18,2,20,2,2,2
2023-06-01,60492,5,0,5,1,0,1
2023-06-01,1621,10,0,10,3,0,3
2023-06-01,27283,48,0,48,2,0,2
2023-06-01,3762,66,0,66,6,0,6
2023-06-01,63459,4,0,4,1,0,1
2023-06-01,26039,17,1,18,3,1,3
2023-06-01,16780,8,0,8,1,0,1
2023-06-01,23410,313,0,313,6,0,6
2023-06-01,395384,1,0,1,1,0,1
2023-06-01,398251,1,0,1,1,0,1
2023-06-01,19265,17,0,17,3,0,3
2023-06-01,12187,15,0,15,4,0,4
2023-06-01,19507,1,0,1,1,0,1
2023-06-01,397595,1,0,1,1,0,1
2023-06-01,32273,1,0,1,1,0,1
2023-06-01,33551,16,0,16,2,0,2
2023-06-01,20060,6,0,6,1,0,1
2023-06-01,17094,8,0,8,2,0,2
2023-06-01,27534,2,0,2,1,0,1
2023-06-01,26081,14,0,14,3,0,3
2023-06-01,139776,5,1,6,2,1,2
2023-06-01,53734,1,0,1,1,0,1
2023-06-01,399802,1,0,1,1,0,1
2023-06-01,398944,1,0,1,1,0,1
2023-06-01,23156,1,0,1,1,0,1
2023-06-01,400679,2,1,3,2,1,2
2023-06-01,398437,1,1,2,1,1,1
2023-06-01,398554,1,0,1,2,0,2
2023-06-01,398462,1,0,1,2,0,2
2023-06-01,54228,3,0,3,4,0,4
2023-06-01,398544,1,0,1,1,0,1
2023-06-01,396033,2,0,2,2,0,2
2023-06-01,19225,2,0,2,1,0,1
2023-06-01,395381,2,0,2,1,0,1
2023-06-01,400490,1,1,2,1,2,2
2023-06-01,29708,2,0,2,2,0,2
2023-06-01,398702,1,0,1,1,0,1
2023-06-01,398495,1,0,1,1,0,1
2023-06-01,40645,1,0,1,1,0,1
2023-06-01,19743,3,0,3,1,0,1
2023-06-01,17342,2,0,2,2,0,2
2023-06-01,394670,1,0,1,2,0,2
2023-06-01,63279,1,4,5,1,2,2
2023-06-01,397371,1,0,1,2,0,2
2023-06-01,398806,1,0,1,2,0,2
2023-06-01,207609,1,3,4,1,1,1
2023-06-01,53548,4,0,4,1,0,1
2023-06-01,11144,8,0,8,5,0,5
2023-06-01,20139,3,0,3,3,0,3
2023-06-01,14925,12,0,12,3,0,3
2023-06-01,18697,14,0,14,3,0,3
2023-06-01,22178,1,0,1,2,0,2
2023-06-01,11406,16,0,16,3,0,3
2023-06-01,202917,19,0,19,6,0,6
2023-06-01,149996,1,0,1,1,0,1
2023-06-01,141713,1,0,1,1,0,1
2023-06-01,19833,5,8,13,5,3,5
2023-06-01,29887,1,0,1,1,0,1
2023-06-01,19640,1,0,1,1,0,1
2023-06-01,396249,3,0,3,3,0,3
2023-06-01,54640,10,0,10,1,0,1
2023-06-01,4868,17,0,17,7,0,7
2023-06-01,396102,1,0,1,1,0,1
2023-06-01,399683,1,0,1,3,0,3
2023-06-01,399682,1,0,1,2,0,2
2023-06-01,40374,1,0,1,1,0,1
2023-06-01,63073,2,0,2,2,0,2
2023-06-01,46298,1,0,1,1,0,1
2023-06-01,13435,4,0,4,1,0,1
2023-06-01,8012,2,0,2,1,0,1
2023-06-01,40375,2,0,2,1,0,1
2023-06-01,14201,22,0,22,15,0,15
2023-06-01,11993,24,4,28,5,4,5
2023-06-01,22593,8,0,8,7,0,7
2023-06-01,10420,27,0,27,2,0,2
2023-06-01,6973,3,0,3,1,0,1
2023-06-01,54291,2,0,2,2,0,2
2023-06-01,394745,2,1,3,2,2,2
2023-06-01,213272,1,0,1,2,0,2
2023-06-01,197560,2,0,2,1,0,1
2023-06-01,64240,2,0,2,1,0,1
2023-06-01,395770,1,1,2,4,2,4
2023-06-01,396280,1,0,1,2,0,2
2023-06-01,395696,1,0,1,4,0,4
2023-06-01,395708,1,0,1,1,0,1
2023-06-01,395669,1,0,1,2,0,2
2023-06-01,396119,1,0,1,2,0,2
2023-06-01,396162,6,0,6,4,0,4
2023-06-01,395930,1,0,1,3,0,3
2023-06-01,394209,2,0,2,1,0,1
2023-06-01,399026,1,0,1,1,0,1
2023-06-01,13969,2,0,2,3,0,3
2023-06-01,395939,1,0,1,1,0,1
2023-06-01,62636,1,0,1,1,0,1
2023-06-01,396516,1,0,1,1,0,1
2023-06-01,22708,1,0,1,2,0,2
2023-06-01,14887,1,0,1,2,0,2
2023-06-01,54584,1,0,1,3,0,3
2023-06-01,19474,1,0,1,2,0,2
2023-06-01,54421,1,0,1,3,0,3
2023-06-01,19851,1,0,1,3,0,3
2023-06-01,23478,1,0,1,4,0,4
2023-06-01,13957,1,0,1,3,0,3
2023-06-01,40147,2,0,2,3,0,3
2023-06-01,21966,1,0,1,1,0,1
2023-06-01,395340,1,0,1,1,0,1
2023-06-01,46738,0,0,0,3,0,3
2023-06-01,54443,1,0,1,2,0,2
2023-06-01,10308,1,0,1,1,0,1
2023-06-01,46266,2,0,2,1,0,1
2023-06-01,901,1,0,1,1,0,1
2023-06-01,14747,1,1,2,4,1,4
2023-06-01,396910,1,0,1,1,0,1
2023-06-01,395967,1,0,1,1,0,1
2023-06-01,398320,1,0,1,1,0,1
2023-06-01,14565,3,0,3,1,0,1
2023-06-01,397711,1,0,1,1,0,1
2023-06-01,19865,3,0,3,3,0,3
2023-06-01,395112,1,0,1,2,0,2
2023-06-01,27185,12,0,12,5,0,5
2023-06-01,12024,1,0,1,4,0,4
2023-06-01,265491,5,7,12,6,1,6
2023-06-01,28554,100,4,104,7,1,7
2023-06-01,53201,37,4,41,7,5,7
2023-06-01,265492,7,4,11,1,2,2
2023-06-01,266273,1,3,4,2,1,2
2023-06-01,265241,2,7,9,2,2,2
2023-06-01,266274,7,0,7,4,0,4
2023-06-01,264796,4,5,9,2,3,3
2023-06-01,264791,6,0,6,3,0,3
2023-06-01,266271,1,0,1,3,0,3
2023-06-01,265495,4,2,6,4,3,5
2023-06-01,264799,1,0,1,1,0,1
2023-06-01,265496,7,1,8,2,1,2
2023-06-01,265499,2,0,2,3,0,3
2023-06-01,265500,5,3,8,4,3,4
2023-06-01,266277,5,3,8,2,2,2
2023-06-01,266278,2,0,2,3,0,3
2023-06-01,266776,3,1,4,2,2,2
2023-06-01,266279,7,3,10,1,2,2
2023-06-01,266270,3,0,3,2,0,2
2023-06-01,265694,2,0,2,1,0,1
2023-06-01,263002,2,2,4,3,3,4
2023-06-01,266272,5,0,5,6,0,6
2023-06-01,52860,3,1,4,1,1,1
2023-06-01,266292,1,1,2,1,1,1
2023-06-01,266298,3,1,4,2,1,2
2023-06-01,266275,3,7,10,5,4,7
2023-06-01,264785,2,0,2,3,0,3
2023-06-01,264805,1,0,1,1,0,1
2023-06-01,265490,3,1,4,1,1,1
2023-06-01,266305,2,0,2,1,0,1
2023-06-01,28240,7,1,8,1,1,1
2023-06-01,262570,4,0,4,5,0,5
2023-06-01,266286,6,0,6,5,0,5
2023-06-01,266283,7,0,7,1,0,1
2023-06-01,263338,16,3,19,5,4,6
2023-06-01,266289,1,1,2,2,1,2
2023-06-01,264790,2,6,8,2,1,2
2023-06-01,266287,3,4,7,2,2,2
2023-06-01,264096,5,3,8,8,2,8
2023-06-01,266295,5,0,5,1,0,1
2023-06-01,266281,1,0,1,1,0,1
2023-06-01,28252,60,9,69,13,7,15
2023-06-01,266282,4,1,5,6,1,6
2023-06-01,267857,1,0,1,2,0,2
2023-06-01,266296,4,1,5,2,1,2
2023-06-01,266288,2,3,5,1,1,1
2023-06-01,266285,2,1,3,3,1,3
2023-06-01,266291,3,7,10,1,3,3
2023-06-01,265518,2,0,2,2,0,2
2023-06-01,263486,16,32,48,10,8,10
2023-06-01,266293,5,1,6,1,1,1
2023-06-01,266301,7,1,8,1,1,1
2023-06-01,266299,3,3,6,2,3,3
2023-06-01,266294,5,0,5,4,0,4
2023-06-01,266290,3,1,4,3,3,3
2023-06-01,266303,2,0,2,3,0,3
2023-06-01,266309,7,3,10,1,1,1
2023-06-01,266300,3,3,6,1,1,1
2023-06-01,266310,3,1,4,1,1,1
2023-06-01,266297,4,1,5,3,1,3
2023-06-01,265053,11,7,18,9,9,10
2023-06-01,266306,7,4,11,1,1,1
2023-06-01,266311,4,1,5,6,1,6
2023-06-01,264806,7,0,7,2,0,2
2023-06-01,266365,1,1,2,6,2,6
2023-06-01,266373,1,1,2,4,4,4
2023-06-01,266415,3,0,3,5,0,5
2023-06-01,16685,29,1,30,14,3,14
2023-06-01,263603,6,1,7,2,1,2
2023-06-01,27981,6,0,6,2,0,2
2023-06-01,266368,1,1,2,3,3,3
2023-06-01,266375,7,1,8,2,1,2
2023-06-01,266369,5,0,5,2,0,2
2023-06-01,272730,3,2,5,5,2,5
2023-06-01,262514,31,3,34,2,2,2
2023-06-01,266403,5,0,5,2,0,2
2023-06-01,264820,4,0,4,4,0,4
2023-06-01,264829,3,0,3,2,0,2
2023-06-01,266376,3,3,6,3,3,4
2023-06-01,266377,7,0,7,2,0,2
2023-06-01,266378,1,0,1,1,0,1
2023-06-01,263435,12,9,21,5,5,5
2023-06-01,264822,4,0,4,3,0,3
2023-06-01,264819,4,0,4,2,0,2
2023-06-01,266384,3,0,3,1,0,1
2023-06-01,266388,6,7,13,8,4,9
2023-06-01,266379,3,3,6,1,1,1
2023-06-01,262676,8,3,11,12,8,13
2023-06-01,263394,6,1,7,2,1,2
2023-06-01,52447,2,0,2,2,0,2
2023-06-01,266382,3,3,6,4,4,5
2023-06-01,266390,5,1,6,3,1,3
2023-06-01,266391,6,18,24,1,1,1
2023-06-01,266383,5,4,9,1,1,1
2023-06-01,271819,4,0,4,1,0,1
2023-06-01,266385,3,4,7,6,5,6
2023-06-01,266392,5,2,7,3,2,3
2023-06-01,265525,4,0,4,4,0,4
2023-06-01,266381,3,3,6,3,2,3
2023-06-01,53078,66,7,73,3,1,3
2023-06-01,262495,8,2,10,3,1,3
2023-06-01,264817,1,2,3,1,1,1
2023-06-01,266397,5,1,6,1,1,1
2023-06-01,266398,3,1,4,1,1,1
2023-06-01,266387,6,3,9,5,3,5
2023-06-01,264854,5,0,5,4,0,4
2023-06-01,266393,3,3,6,1,1,2
2023-06-01,263634,11,2,13,7,3,7
2023-06-01,266408,1,0,1,1,0,1
2023-06-01,266419,3,0,3,1,0,1
2023-06-01,266394,3,5,8,5,4,5
2023-06-01,266412,3,0,3,2,0,2
2023-06-01,266404,5,0,5,1,0,1
2023-06-01,266405,1,0,1,1,0,1
2023-06-01,266406,1,1,2,2,1,3
2023-06-01,266411,1,0,1,2,0,2
2023-06-01,266426,1,1,2,2,1,2
2023-06-01,266432,1,1,2,4,3,4
2023-06-01,264834,1,0,1,1,0,1
2023-06-01,28418,3,4,7,1,1,1
2023-06-01,266427,3,0,3,2,0,2
2023-06-01,266420,7,1,8,6,3,8
2023-06-01,266418,7,0,7,1,0,1
2023-06-01,266421,5,3,8,3,2,3
2023-06-01,266430,7,1,8,6,2,6
2023-06-01,266422,4,0,4,1,0,1
2023-06-01,264832,4,1,5,5,2,5
2023-06-01,266425,5,1,6,4,1,4
2023-06-01,266429,3,3,6,6,4,6
2023-06-01,269803,3,0,3,3,0,3
2023-06-01,266439,3,3,6,1,1,1
2023-06-01,264842,3,0,3,3,0,3
2023-06-01,266437,3,20,23,2,1,2
2023-06-01,270266,4,0,4,2,0,2
2023-06-01,266431,5,1,6,4,2,4
2023-06-01,269960,4,0,4,1,0,1
2023-06-01,264835,1,1,2,1,1,1
2023-06-01,266443,1,1,2,3,3,3
2023-06-01,266495,1,1,2,1,1,1
2023-06-01,271028,7,1,8,1,1,1
2023-06-01,266434,5,5,10,6,5,6
2023-06-01,266480,5,0,5,3,0,3
2023-06-01,61761,10,5,15,3,3,3
2023-06-01,61943,6,1,7,2,1,2
2023-06-01,263266,4,1,5,4,4,6
2023-06-01,262671,21,4,25,3,2,3
2023-06-01,52670,12,1,13,1,1,1
2023-06-01,266444,7,6,13,6,5,7
2023-06-01,266446,6,0,6,4,0,4
2023-06-01,262588,30,13,43,7,7,9
2023-06-01,266447,4,6,10,2,2,2
2023-06-01,266456,3,1,4,6,2,6
2023-06-01,266458,3,1,4,3,1,3
2023-06-01,266459,2,1,3,1,1,1
2023-06-01,266449,3,3,6,3,2,3
2023-06-01,264858,1,0,1,2,0,2
2023-06-01,266455,1,1,2,3,2,4
2023-06-01,264843,1,1,2,1,2,2
2023-06-01,10391,0,0,0,2,0,2
2023-06-01,266450,7,0,7,1,0,1
2023-06-01,266454,13,3,16,3,4,4
2023-06-01,262149,14,1,15,2,2,2
2023-06-01,266466,2,2,4,3,1,3
2023-06-01,266451,3,1,4,3,3,3
2023-06-01,266452,2,1,3,1,1,1
2023-06-01,266453,6,3,9,5,4,5
2023-06-01,266462,5,1,6,1,1,1
2023-06-01,266471,4,1,5,2,2,3
2023-06-01,264849,7,0,7,2,0,2
2023-06-01,266474,2,1,3,3,1,3
2023-06-01,265651,1,0,1,2,0,2
2023-06-01,265652,1,1,2,1,1,1
2023-06-01,266463,7,1,8,2,1,2
2023-06-01,266485,1,0,1,1,0,1
2023-06-01,53189,7,0,7,1,0,1
2023-06-01,266481,1,1,2,1,1,1
2023-06-01,52817,21,9,30,6,4,7
2023-06-01,271971,1,0,1,1,0,1
2023-06-01,262983,8,5,13,1,1,1
2023-06-01,266486,1,1,2,1,1,1
2023-06-01,266468,7,3,10,5,3,5
2023-06-01,266469,1,2,3,1,1,1
2023-06-01,266483,5,5,10,3,2,3
2023-06-01,53138,12,3,15,3,4,4
2023-06-01,266356,8,3,11,8,4,8
2023-06-01,266484,3,1,4,2,1,2
2023-06-01,266487,3,4,7,6,3,6
2023-06-01,266476,5,1,6,5,3,5
2023-06-01,53236,12,1,13,6,3,6
2023-06-01,52593,14,3,17,6,4,6
2023-06-01,264851,4,14,18,4,1,4
2023-06-01,264852,4,0,4,3,0,3
2023-06-01,266473,1,0,1,1,0,1
2023-06-01,266477,3,1,4,1,1,2
2023-06-01,271531,3,3,6,1,1,1
2023-06-01,265001,5,1,6,2,1,2
2023-06-01,271039,7,7,14,1,1,1
2023-06-01,264987,10,0,10,1,0,1
2023-06-01,264989,4,4,8,2,4,4
2023-06-01,264990,5,2,7,1,1,1
2023-06-01,265029,7,7,14,4,4,5
2023-06-01,265020,5,2,7,3,2,3
2023-06-01,265006,3,0,3,1,0,1
2023-06-01,265009,5,2,7,2,1,2
2023-06-01,264988,6,1,7,5,5,5
2023-06-01,264999,5,5,10,6,4,6
2023-06-01,265007,5,1,6,3,1,3
2023-06-01,264992,7,3,10,3,2,3
2023-06-01,265010,5,20,25,1,1,1
2023-06-01,265023,5,1,6,2,1,2
2023-06-01,263248,8,1,9,3,2,3
2023-06-01,263049,18,12,30,4,2,4
2023-06-01,28073,19,60,79,4,4,4
2023-06-01,265017,7,3,10,4,4,4
2023-06-01,265011,1,0,1,1,0,1
2023-06-01,265026,3,2,5,2,3,3
2023-06-01,265016,5,2,7,4,4,4
2023-06-01,265014,5,1,6,3,2,3
2023-06-01,265004,5,0,5,1,0,1
2023-06-01,28376,66,0,66,2,0,2
2023-06-01,52802,2,1,3,2,2,2
2023-06-01,265005,4,0,4,1,0,1
2023-06-01,265037,1,1,2,3,3,3
2023-06-01,64100,3,1,4,4,1,4
2023-06-01,27756,15,0,15,2,0,2
2023-06-01,265028,6,3,9,3,2,3
2023-06-01,272844,1,0,1,2,0,2
2023-06-01,54478,6,0,6,6,0,6
2023-06-01,23241,2,0,2,1,0,1
2023-06-01,398535,5,0,5,1,0,1
2023-06-01,16595,11,0,11,1,0,1
2023-06-01,15196,7,0,7,1,0,1
2023-06-01,8076,11,2,13,1,1,1
2023-06-01,18495,6,0,6,1,0,1
2023-06-01,398130,14,0,14,1,0,1
2023-06-01,209236,18,0,18,3,0,3
2023-06-01,23305,8,0,8,4,0,4
2023-06-01,59116,5,4,9,4,4,4
2023-06-01,6289,18,0,18,2,0,2
2023-06-01,10360,7,0,7,3,0,3
2023-06-01,33343,1,1,2,1,1,1
2023-06-01,12076,2,0,2,2,0,2
2023-06-01,20311,17,0,17,2,0,2
2023-06-01,22347,2,0,2,4,0,4
2023-06-01,11205,3,0,3,2,0,2
2023-06-01,394451,2,0,2,3,0,3
2023-06-01,394632,1,0,1,1,0,1
2023-06-01,199598,3,0,3,1,0,1
2023-06-01,393330,7,0,7,7,0,7
2023-06-01,17190,5,0,5,5,0,5
2023-06-01,54314,4,0,4,2,0,2
2023-06-01,11685,71,0,71,9,0,9
2023-06-01,54827,1,0,1,1,0,1
2023-06-01,26817,4,0,4,3,0,3
2023-06-01,62964,2,0,2,2,0,2
2023-06-01,3147,5,5,10,4,4,4
2023-06-01,53596,4,0,4,5,0,5
2023-06-01,22583,1,0,1,1,0,1
2023-06-01,396312,2,0,2,2,0,2
2023-06-01,4454,26,0,26,3,0,3
2023-06-01,22812,4,0,4,1,0,1
2023-06-01,32066,7,1,8,4,1,4
2023-06-01,38481,3,0,3,2,0,2
2023-06-01,21568,2,0,2,2,0,2
2023-06-01,396533,2,0,2,2,0,2
2023-06-01,4543,17,0,17,3,0,3
2023-06-01,40833,4,0,4,6,0,6
2023-06-01,204321,2,0,2,3,0,3
2023-06-01,141405,1,0,1,3,0,3
2023-06-01,137857,1,0,1,2,0,2
2023-06-01,204322,2,0,2,3,0,3
2023-06-01,264712,4,1,5,2,1,2
2023-06-01,263003,2,1,3,3,3,3
2023-06-01,264715,9,0,9,1,0,1
2023-06-01,265024,4,2,6,4,2,4
2023-06-01,264716,5,1,6,3,1,3
2023-06-01,265025,7,1,8,5,1,5
2023-06-01,265046,1,1,2,1,1,1
2023-06-01,265750,3,0,3,2,0,2
2023-06-01,262932,27,1,28,3,2,3
2023-06-01,28636,5,1,6,3,3,3
2023-06-01,265032,6,7,13,5,4,5
2023-06-01,263296,9,1,10,2,1,2
2023-06-01,270884,5,2,7,1,1,1
2023-06-01,265027,5,0,5,2,0,2
2023-06-01,52405,19,3,22,6,3,6
2023-06-01,264726,1,0,1,1,0,1
2023-06-01,265033,5,2,7,1,1,1
2023-06-01,265034,4,2,6,2,1,2
2023-06-01,61828,10,1,11,2,1,2
2023-06-01,265041,1,1,2,3,2,3
2023-06-01,265042,3,21,24,1,1,1
2023-06-01,262402,35,1,36,5,2,5
2023-06-01,264719,18,0,18,1,0,1
2023-06-01,271527,2,0,2,1,0,1
2023-06-01,265035,4,0,4,3,0,3
2023-06-01,263506,10,0,10,1,0,1
2023-06-01,265039,1,0,1,1,0,1
2023-06-01,263290,9,1,10,11,3,12
2023-06-01,265040,1,0,1,1,0,1
2023-06-01,265050,6,3,9,4,2,4
2023-06-01,61918,10,1,11,7,1,7
2023-06-01,265044,3,5,8,3,4,4
2023-06-01,52565,38,4,42,6,6,7
2023-06-01,21787,27,0,27,2,0,2
2023-06-01,27265,6,0,6,2,0,2
2023-06-01,27967,5,0,5,3,0,3
2023-06-01,46158,31,0,31,4,0,4
2023-06-01,5767,7,0,7,3,0,3
2023-06-01,22601,2,5,7,4,3,4
2023-06-01,11516,57,0,57,4,0,4
2023-06-01,10583,10,3,13,4,2,4
2023-06-01,23119,1,0,1,1,0,1
2023-06-01,47072,3,0,3,1,0,1
2023-06-01,394802,4,0,4,2,0,2
2023-06-01,63478,1,0,1,1,0,1
2023-06-01,394521,1,0,1,1,0,1
2023-06-01,53854,1,0,1,1,0,1
2023-06-01,396214,1,0,1,1,0,1
2023-06-01,19739,20,0,20,1,0,1
2023-06-01,11283,43,0,43,4,0,4
2023-06-01,395744,1,0,1,3,0,3
2023-06-01,11790,15,0,15,3,0,3
2023-06-01,46790,8,0,8,5,0,5
2023-06-01,40681,1,0,1,1,0,1
2023-06-01,20069,6,0,6,5,0,5
2023-06-01,11544,3,0,3,4,0,4
2023-06-01,395359,16,8,24,11,6,11
2023-06-01,31848,1,0,1,1,0,1
2023-06-01,26764,5,0,5,2,0,2
2023-06-01,393872,2,0,2,1,0,1
2023-06-01,54917,1,0,1,1,0,1
2023-06-01,393836,7,0,7,3,0,3
2023-06-01,21897,1,0,1,1,0,1
2023-06-01,47090,1,0,1,1,0,1
2023-06-01,26517,12,4,16,5,3,6
2023-06-01,30508,2,0,2,2,0,2
2023-06-01,28888,5,0,5,1,0,1
2023-06-01,42536,5,0,5,1,0,1
2023-06-01,47661,7,0,7,2,0,2
2023-06-01,42633,7,1,8,1,1,1
2023-06-01,200005,28,5,33,8,4,8
2023-06-01,17044,10,0,10,10,0,10
2023-06-01,52555,2,0,2,1,0,1
2023-06-01,13416,1,0,1,2,0,2
2023-06-01,36283,1,0,1,2,0,2
2023-06-01,24182,6,2,8,5,2,5
2023-06-01,2418,4,0,4,1,0,1
2023-06-01,46713,5,1,6,3,2,3
2023-06-01,32886,2,0,2,2,0,2
2023-06-01,31743,2,1,3,3,2,3
2023-06-01,395180,5,0,5,1,0,1
2023-06-01,14931,6,0,6,2,0,2
2023-06-01,400159,1,0,1,2,0,2
2023-06-01,63407,7,0,7,3,0,3
2023-06-01,14417,7,0,7,4,0,4
2023-06-01,398056,8,0,8,3,0,3
2023-06-01,17389,22,0,22,3,0,3
2023-06-01,27993,6,0,6,4,0,4
2023-06-01,52424,4,2,6,2,2,2
2023-06-01,263186,2,1,3,1,1,1
2023-06-01,61486,7,1,8,2,2,2
2023-06-01,52442,2,1,3,2,1,2
2023-06-01,27770,2,0,2,3,0,3
2023-06-01,27875,9,2,11,2,2,2
2023-06-01,270033,2,1,3,2,1,2
2023-06-01,28107,3,1,4,2,1,2
2023-06-01,28068,21,2,23,3,2,4
2023-06-01,263235,4,5,9,2,2,3
2023-06-01,52314,11,1,12,3,2,3
2023-06-01,264630,6,2,8,2,2,2
2023-06-01,46274,1,0,1,2,0,2
2023-06-01,12147,10,0,10,4,0,4
2023-06-01,16432,8,0,8,4,0,4
2023-06-01,11740,11,0,11,2,0,2
2023-06-01,27575,2,0,2,1,0,1
2023-06-01,17375,2,0,2,1,0,1
2023-06-01,1956,1,0,1,2,0,2
2023-06-01,19726,4,2,6,4,2,4
2023-06-01,265058,3,3,6,4,2,4
2023-06-01,61802,5,1,6,8,4,8
2023-06-01,265059,6,1,7,4,1,4
2023-06-01,27851,3,1,4,5,1,5
2023-06-01,265051,5,0,5,1,0,1
2023-06-01,53088,10,1,11,2,1,2
2023-06-01,265060,3,0,3,1,0,1
2023-06-01,265070,1,0,1,1,0,1
2023-06-01,265045,7,1,8,1,1,1
2023-06-01,53022,23,1,24,1,1,1
2023-06-01,265052,4,0,4,3,0,3
2023-06-01,265065,6,1,7,3,1,3
2023-06-01,265049,2,1,3,2,1,2
2023-06-01,265054,1,1,2,2,2,2
2023-06-01,265055,3,3,6,4,4,4
2023-06-01,264723,13,0,13,2,0,2
2023-06-01,28182,21,1,22,1,1,1
2023-06-01,265056,1,1,2,2,1,2
2023-06-01,265062,7,1,8,3,1,3
2023-06-01,270724,1,0,1,2,0,2
2023-06-01,264725,5,0,5,3,0,3
2023-06-01,265072,5,1,6,6,2,6
2023-06-01,265063,4,1,5,1,1,1
2023-06-01,262367,6,1,7,3,4,4
2023-06-01,21833,3,0,3,3,0,3
2023-06-01,265085,3,5,8,2,2,2
2023-06-01,265087,4,0,4,2,0,2
2023-06-01,265114,7,1,8,5,3,5
2023-06-01,53057,27,0,27,1,0,1
2023-06-01,262600,8,0,8,6,0,6
2023-06-01,264736,5,0,5,3,0,3
2023-06-01,265077,3,1,4,1,1,1
2023-06-01,265092,4,1,5,2,1,2
2023-06-01,265090,5,1,6,2,1,2
2023-06-01,264737,5,0,5,2,0,2
2023-06-01,265079,6,0,6,1,0,1
2023-06-01,265088,7,7,14,2,2,2
2023-06-01,264730,1,0,1,2,0,2
2023-06-01,263659,10,0,10,1,0,1
2023-06-01,265081,5,0,5,2,0,2
2023-06-01,265082,1,1,2,2,2,2
2023-06-01,265067,3,1,4,4,2,4
2023-06-01,265083,3,0,3,1,0,1
2023-06-01,271265,7,3,10,7,4,7
2023-06-01,264748,5,0,5,2,0,2
2023-06-01,52706,32,17,49,7,6,7
2023-06-01,264741,8,0,8,2,0,2
2023-06-01,265098,7,3,10,5,4,5
2023-06-01,271293,3,1,4,1,1,1
2023-06-01,265091,6,1,7,3,2,3
2023-06-01,265097,6,3,9,2,1,2
2023-06-01,11534,1,0,1,3,0,3
2023-06-01,41555,2,0,2,4,0,4
2023-06-01,61928,38,5,43,4,4,5
2023-06-01,266316,5,4,9,2,2,2
2023-06-01,264807,1,0,1,1,0,1
2023-06-01,264802,4,0,4,2,0,2
2023-06-01,266324,3,3,6,3,2,3
2023-06-01,264795,4,0,4,1,0,1
2023-06-01,266317,4,7,11,6,1,6
2023-06-01,266314,1,1,2,2,2,2
2023-06-01,266312,2,2,4,3,1,3
2023-06-01,264798,1,1,2,4,2,4
2023-06-01,27678,9,6,15,14,7,16
2023-06-01,262249,8,20,28,5,3,5
2023-06-01,266313,2,0,2,1,2,2
2023-06-01,266328,7,5,12,6,2,6
2023-06-01,266325,5,1,6,2,1,2
2023-06-01,266318,3,1,4,1,1,1
2023-06-01,264812,3,0,3,1,0,1
2023-06-01,266322,3,3,6,6,3,6
2023-06-01,266319,6,2,8,3,4,4
2023-06-01,266320,7,7,14,1,1,1
2023-06-01,266321,3,3,6,4,2,4
2023-06-01,266329,4,0,4,1,0,1
2023-06-01,266326,1,0,1,1,0,1
2023-06-01,266323,4,0,4,1,0,1
2023-06-01,266327,3,0,3,1,0,1
2023-06-01,264801,3,0,3,3,0,3
2023-06-01,266331,5,0,5,1,0,1
2023-06-01,262687,9,8,17,8,5,8
2023-06-01,266338,3,1,4,1,1,1
2023-06-01,266332,6,1,7,1,1,1
2023-06-01,264814,3,2,5,3,3,4
2023-06-01,264810,5,0,5,2,0,2
2023-06-01,266334,1,0,1,1,0,1
2023-06-01,273568,3,23,26,6,4,6
2023-06-01,266461,1,1,2,2,2,3
2023-06-01,266407,1,1,2,1,1,1
2023-06-01,264803,2,0,2,3,0,3
2023-06-01,266333,6,1,7,3,1,3
2023-06-01,52428,19,0,19,2,0,2
2023-06-01,28023,15,1,16,2,1,2
2023-06-01,52878,19,6,25,4,4,4
2023-06-01,266343,5,31,36,1,1,1
2023-06-01,266345,4,0,4,3,0,3
2023-06-01,27865,6,8,14,3,3,3
2023-06-01,266339,1,0,1,1,0,1
2023-06-01,266341,5,3,8,3,1,3
2023-06-01,266350,7,3,10,2,2,2
2023-06-01,266351,1,0,1,1,0,1
2023-06-01,266342,3,1,4,1,1,1
2023-06-01,262229,24,0,24,3,0,3
2023-06-01,266346,4,4,8,4,4,4
2023-06-01,266355,3,2,5,3,2,3
2023-06-01,266364,1,0,1,1,0,1
2023-06-01,263110,12,10,22,6,6,7
2023-06-01,266352,3,1,4,3,2,3
2023-06-01,266361,3,1,4,2,1,2
2023-06-01,264815,5,0,5,4,0,4
2023-06-01,264809,5,0,5,3,0,3
2023-06-01,264740,1,0,1,2,0,2
2023-06-01,264838,4,1,5,2,1,2
2023-06-01,266362,4,1,5,3,3,3
2023-06-01,265629,6,2,8,5,2,5
2023-06-01,266357,7,7,14,4,3,5
2023-06-01,266358,5,2,7,6,3,6
2023-06-01,28219,34,1,35,7,2,7
2023-06-01,266359,3,0,3,1,0,1
2023-06-01,266396,1,1,2,1,1,1
2023-06-01,264813,3,1,4,2,1,2
2023-06-01,266386,2,1,3,3,1,3
2023-06-01,61523,3,0,3,2,0,2
2023-06-01,266363,1,0,1,1,0,1
2023-06-01,266360,7,3,10,6,3,6
2023-06-01,266488,4,0,4,1,0,1
2023-06-01,266478,4,2,6,4,3,4
2023-06-01,263608,21,5,26,8,4,8
2023-06-01,266497,3,4,7,1,2,2
2023-06-01,272757,1,1,2,1,1,1
2023-06-01,266479,3,5,8,3,1,3
2023-06-01,265633,6,1,7,2,1,3
2023-06-01,266491,3,1,4,1,1,1
2023-06-01,266492,3,32,35,9,7,9
2023-06-01,266517,1,0,1,1,0,1
2023-06-01,266493,1,1,2,4,4,5
2023-06-01,264844,8,1,9,1,1,1
2023-06-01,264657,16,1,17,2,1,2
2023-06-01,263078,12,1,13,4,1,4
2023-06-01,270253,3,1,4,5,4,6
2023-06-01,266518,3,1,4,5,2,5
2023-06-01,52907,4,1,5,5,2,5
2023-06-01,266522,5,0,5,2,0,2
2023-06-01,266499,3,1,4,4,1,4
2023-06-01,265631,9,0,9,1,0,1
2023-06-01,266504,7,7,14,2,2,2
2023-06-01,266503,1,1,2,1,1,1
2023-06-01,267858,3,0,3,1,0,1
2023-06-01,266507,3,1,4,1,1,1
2023-06-01,266506,2,1,3,3,2,3
2023-06-01,265630,6,1,7,1,1,1
2023-06-01,266500,3,1,4,1,1,1
2023-06-01,266509,3,1,4,1,1,1
2023-06-01,271882,1,0,1,1,0,1
2023-06-01,266508,3,1,4,3,1,3
2023-06-01,263496,10,1,11,3,4,4
2023-06-01,266510,5,3,8,3,3,3
2023-06-01,266523,3,1,4,1,1,1
2023-06-01,266514,3,3,6,3,2,3
2023-06-01,262770,17,0,17,6,0,6
2023-06-01,270978,1,0,1,1,0,1
2023-06-01,266205,7,7,14,4,3,5
2023-06-01,266515,7,7,14,1,1,1
2023-06-01,266511,1,1,2,2,2,2
2023-06-01,266512,1,1,2,1,1,1
2023-06-01,265647,1,0,1,1,0,1
2023-06-01,266021,5,1,6,3,1,3
2023-06-01,266014,7,0,7,2,0,2
2023-06-01,266025,1,0,1,1,0,1
2023-06-01,266521,1,1,2,2,2,2
2023-06-01,266022,3,5,8,5,4,5
2023-06-01,266016,3,0,3,1,0,1
2023-06-01,272445,1,0,1,3,0,3
2023-06-01,270096,2,1,3,1,1,1
2023-06-01,262879,17,0,17,3,0,3
2023-06-01,266026,3,1,4,1,1,1
2023-06-01,266524,3,1,4,2,2,2
2023-06-01,266017,7,1,8,1,1,1
2023-06-01,262504,37,12,49,7,5,7
2023-06-01,266019,1,1,2,1,1,1
2023-06-01,266028,6,0,6,1,0,1
2023-06-01,266023,7,0,7,2,0,2
2023-06-01,265634,1,22,23,3,3,3
2023-06-01,265636,12,0,12,4,0,4
2023-06-01,266030,3,3,6,1,1,1
2023-06-01,266032,5,0,5,3,0,3
2023-06-01,265713,2,0,2,2,0,2
2023-06-01,265653,5,0,5,2,0,2
2023-06-01,265638,1,0,1,1,0,1
2023-06-01,262379,10,3,13,2,1,2
2023-06-01,266029,3,3,6,6,3,6
2023-06-01,28208,19,1,20,2,1,2
2023-06-01,271800,1,0,1,2,0,2
2023-06-01,265640,1,1,2,2,2,2
2023-06-01,265657,5,0,5,3,0,3
2023-06-01,265639,1,1,2,2,1,2
2023-06-01,266034,5,1,6,2,2,2
2023-06-01,52692,6,5,11,3,2,3
2023-06-01,265656,1,1,2,2,1,2
2023-06-01,265648,1,0,1,1,0,1
2023-06-01,265637,4,0,4,3,0,3
2023-06-01,262680,27,10,37,1,2,2
2023-06-01,265654,4,1,5,2,1,2
2023-06-01,266031,4,0,4,4,0,4
2023-06-01,263452,22,0,22,3,0,3
2023-06-01,263479,10,0,10,1,0,1
2023-06-01,262593,6,0,6,3,0,3
2023-06-01,265646,2,0,2,3,0,3
2023-06-01,271435,1,0,1,1,0,1
2023-06-01,52592,3,1,4,1,3,3
2023-06-01,265643,3,0,3,2,0,2
2023-06-01,61805,14,1,15,7,5,7
2023-06-01,265659,5,0,5,2,0,2
2023-06-01,262453,6,1,7,4,2,4
2023-06-01,265527,2,0,2,3,0,3
2023-06-01,265526,1,0,1,1,0,1
2023-06-01,263166,10,1,11,2,3,4
2023-06-01,265698,4,7,11,2,1,2
2023-06-01,265642,19,0,19,2,0,2
2023-06-01,394353,5,11,16,6,7,7
2023-06-01,28561,6,0,6,2,0,2
2023-06-01,271245,2,1,3,1,1,1
2023-06-01,265529,4,0,4,2,0,2
2023-06-01,53014,10,1,11,1,1,1
2023-06-01,263256,8,1,9,1,1,1
2023-06-01,61792,10,3,13,6,4,6
2023-06-01,263391,2,1,3,1,1,1
2023-06-01,18546,4,0,4,2,0,2
2023-06-01,24488,7,0,7,2,0,2
2023-06-01,19971,1,0,1,2,0,2
2023-06-01,30102,1,0,1,1,0,1
2023-06-01,206324,1,1,2,7,5,7
2023-06-01,263528,10,1,11,8,5,8
2023-06-01,265094,5,0,5,1,0,1
2023-06-01,265095,3,0,3,4,0,4
2023-06-01,23414,4,0,4,4,0,4
2023-06-01,61901,21,5,26,8,4,8
2023-06-01,265099,4,0,4,1,0,1
2023-06-01,265109,2,0,2,1,0,1
2023-06-01,265100,5,2,7,3,2,3
2023-06-01,265112,7,0,7,1,0,1
2023-06-01,265102,3,2,5,2,1,2
2023-06-01,265103,5,1,6,2,1,2
2023-06-01,265104,5,1,6,3,3,3
2023-06-01,262322,11,7,18,3,3,3
2023-06-01,271008,4,1,5,5,3,5
2023-06-01,265106,1,1,2,2,2,2
2023-06-01,265107,3,0,3,2,0,2
2023-06-01,265398,6,1,7,6,4,6
2023-06-01,28310,4,1,5,1,1,1
2023-06-01,264739,3,0,3,2,0,2
2023-06-01,263635,7,0,7,2,0,2
2023-06-01,265116,2,3,5,1,1,1
2023-06-01,28184,12,1,13,7,4,9
2023-06-01,265381,1,0,1,1,0,1
2023-06-01,265382,7,0,7,1,0,1
2023-06-01,271007,4,3,7,1,1,2
2023-06-01,265384,7,0,7,1,0,1
2023-06-01,265374,1,1,2,1,1,1
2023-06-01,265385,5,3,8,2,3,3
2023-06-01,52584,14,1,15,5,2,5
2023-06-01,12696,21,0,21,3,0,3
2023-06-01,43722,9,7,16,2,2,2
2023-06-01,10236,6,0,6,3,0,3
2023-06-01,397993,1,0,1,1,0,1
2023-06-01,149481,1,0,1,2,0,2
2023-06-01,3219,1,0,1,1,0,1
2023-06-01,50323,6,0,6,1,0,1
2023-06-01,28806,4,0,4,2,0,2
2023-06-01,209491,1,0,1,1,0,1
2023-06-01,209490,5,0,5,2,0,2
2023-06-01,42874,5,0,5,3,0,3
2023-06-01,211223,1,0,1,1,0,1
2023-06-01,202814,9,0,9,2,0,2
2023-06-01,209465,1,0,1,2,0,2
2023-06-01,209483,4,0,4,3,0,3
2023-06-01,206437,7,0,7,4,0,4
2023-06-01,209329,1,0,1,1,0,1
2023-06-01,209481,18,0,18,2,0,2
2023-06-01,206844,5,0,5,1,0,1
2023-06-01,21331,2,1,3,1,1,1
2023-06-01,34457,3,0,3,3,0,3
2023-06-01,47403,1,0,1,1,0,1
2023-06-01,57701,2,1,3,3,2,4
2023-06-01,29285,3,0,3,1,0,1
2023-06-01,57683,1,1,2,3,3,3
2023-06-01,198093,2,2,4,4,3,4
2023-06-01,57754,1,0,1,1,0,1
2023-06-01,198416,1,0,1,4,0,4
2023-06-01,50048,3,0,3,2,0,2
2023-06-01,34682,5,0,5,4,0,4
2023-06-01,57714,1,0,1,3,0,3
2023-06-01,47322,7,0,7,1,0,1
2023-06-01,198418,2,1,3,4,4,6
2023-06-01,33895,4,0,4,4,0,4
2023-06-01,57700,3,0,3,2,0,2
2023-06-01,57703,1,0,1,1,0,1
2023-06-01,57709,1,0,1,1,0,1
2023-06-01,57708,3,0,3,3,0,3
2023-06-01,57711,1,0,1,3,0,3
2023-06-01,8640,10,0,10,3,0,3
2023-06-01,6784,1,0,1,1,0,1
2023-06-01,64947,0,0,0,2,0,2
2023-06-01,65074,4,0,4,1,0,1
2023-06-01,64990,0,0,0,3,0,3
2023-06-01,64996,2,0,2,1,0,1
2023-06-01,64995,2,0,2,1,0,1
2023-06-01,24497,1,0,1,1,0,1
2023-06-01,24562,1,0,1,1,0,1
2023-06-01,45860,1,0,1,1,0,1
2023-06-01,55514,10,0,10,3,0,3
2023-06-01,58806,1,0,1,1,0,1
2023-06-01,132063,2,0,2,3,0,3
2023-06-01,55490,5,0,5,2,0,2
2023-06-01,10794,210,0,210,18,0,18
2023-06-01,19886,43,0,43,7,0,7
2023-06-01,33730,3,0,3,1,0,1
2023-06-01,65512,2,0,2,1,0,1
2023-06-01,28132,1,1,2,4,4,5
2023-06-01,15739,3,2,5,2,2,2
2023-06-01,327899,1,0,1,2,0,2
2023-06-01,14673,1,0,1,1,0,1
2023-06-01,46480,1,0,1,1,0,1
2023-06-01,399298,3,0,3,1,0,1
2023-06-01,18519,1,0,1,1,0,1
2023-06-01,399194,4,0,4,1,0,1
2023-06-01,399218,1,0,1,3,0,3
2023-06-01,393906,7,0,7,4,0,4
2023-06-01,32924,4,0,4,2,0,2
2023-06-01,399483,1,0,1,3,0,3
2023-06-01,399230,1,0,1,2,0,2
2023-06-01,399455,1,1,2,1,1,1
2023-06-01,40280,2,0,2,4,0,4
2023-06-01,26795,1,1,2,2,1,2
2023-06-01,397725,1,0,1,1,0,1
2023-06-01,399489,1,0,1,1,0,1
2023-06-01,399633,1,0,1,1,0,1
2023-06-01,399488,2,0,2,2,0,2
2023-06-01,23374,2,1,3,3,1,3
2023-06-01,396233,1,1,2,2,2,2
2023-06-01,36267,1,0,1,1,0,1
2023-06-01,19846,1,0,1,2,0,2
2023-06-01,396084,2,0,2,2,0,2
2023-06-01,16661,1,0,1,1,0,1
2023-06-01,395927,4,0,4,2,0,2
2023-06-01,395309,3,1,4,1,1,1
2023-06-01,395885,3,0,3,4,0,4
2023-06-01,397572,3,0,3,1,0,1
2023-06-01,395211,1,0,1,1,0,1
2023-06-01,396898,1,0,1,1,0,1
2023-06-01,396235,1,0,1,2,0,2
2023-06-01,394470,4,1,5,2,1,2
2023-06-01,12053,2,0,2,1,0,1
2023-06-01,396057,1,1,2,3,1,3
2023-06-01,32198,1,0,1,1,0,1
2023-06-01,393375,1,0,1,2,0,2
2023-06-01,26531,4,1,5,4,2,4
2023-06-01,26293,1,0,1,1,0,1
2023-06-01,395601,1,0,1,2,0,2
2023-06-01,47017,1,0,1,1,0,1
2023-06-01,62718,1,0,1,1,0,1
2023-06-01,40062,2,0,2,2,0,2
2023-06-01,33138,3,0,3,2,0,2
2023-06-01,393968,4,0,4,6,0,6
2023-06-01,393909,1,0,1,2,0,2
2023-06-01,13451,2,0,2,1,0,1
2023-06-01,400781,2,0,2,2,0,2
2023-06-01,393535,2,0,2,1,0,1
2023-06-01,31823,2,0,2,4,0,4
2023-06-01,15294,13,2,15,2,2,2
2023-06-01,26549,2,2,4,5,4,5
2023-06-01,19264,1,0,1,1,0,1
2023-06-01,393951,6,0,6,2,0,2
2023-06-01,23080,1,0,1,1,0,1
2023-06-01,19525,1,0,1,3,0,3
2023-06-01,14691,1,0,1,1,0,1
2023-06-01,46708,2,0,2,2,0,2
2023-06-01,11681,4,0,4,3,0,3
2023-06-01,394015,3,3,6,5,4,5
2023-06-01,59564,3,0,3,3,0,3
2023-06-01,26216,8,0,8,2,0,2
2023-06-01,398645,11,0,11,1,0,1
2023-06-01,62785,10,0,10,5,0,5
2023-06-01,30546,1,1,2,1,1,1
2023-06-01,397051,1,0,1,2,0,2
2023-06-01,46178,2,0,2,1,0,1
2023-06-01,394073,8,0,8,3,0,3
2023-06-01,40755,2,0,2,2,0,2
2023-06-01,400044,1,0,1,1,0,1
2023-06-01,399668,3,2,5,7,5,8
2023-06-01,398999,1,0,1,1,0,1
2023-06-01,399771,7,1,8,1,1,1
2023-06-01,399899,2,1,3,2,1,2
2023-06-01,395799,3,0,3,4,0,4
2023-06-01,394011,2,0,2,3,0,3
2023-06-01,394072,3,0,3,3,0,3
2023-06-01,398191,6,0,6,2,0,2
2023-06-01,395014,1,0,1,3,0,3
2023-06-01,397301,1,0,1,1,0,1
2023-06-01,399327,1,0,1,1,0,1
2023-06-01,398982,1,0,1,1,0,1
2023-06-01,35979,2,0,2,1,0,1
2023-06-01,399199,1,0,1,4,0,4
2023-06-01,13838,4,0,4,2,0,2
2023-06-01,399105,1,0,1,1,0,1
2023-06-01,21863,1,0,1,1,0,1
2023-06-01,395075,49,1,50,4,2,4
2023-06-01,31997,16,2,18,4,3,5
2023-06-01,40344,6,1,7,2,1,3
2023-06-01,32106,1,0,1,3,0,3
2023-06-01,394028,1,0,1,1,0,1
2023-06-01,48337,3,1,4,1,1,1
2023-06-01,25926,0,1,1,2,1,2
2023-06-01,21696,1,0,1,2,0,2
2023-06-01,398919,1,0,1,1,0,1
2023-06-01,35924,3,0,3,2,0,2
2023-06-01,394080,5,0,5,4,0,4
2023-06-01,394264,2,0,2,3,0,3
2023-06-01,394138,1,0,1,2,0,2
2023-06-01,399625,1,0,1,1,0,1
2023-06-01,399247,2,0,2,2,0,2
2023-06-01,394962,3,0,3,3,0,3
2023-06-01,6145,1,9,10,3,2,4
2023-06-01,399405,3,0,3,2,0,2
2023-06-01,399544,4,51,55,1,1,1
2023-06-01,399094,2,0,2,1,0,1
2023-06-01,399362,2,0,2,5,0,5
2023-06-01,399623,1,0,1,1,0,1
2023-06-01,1057,4,0,4,1,0,1
2023-06-01,63031,3,0,3,1,0,1
2023-06-01,394105,4,0,4,4,0,4
2023-06-01,33290,2,0,2,2,0,2
2023-06-01,31786,3,3,6,1,1,1
2023-06-01,395322,1,0,1,1,0,1
2023-06-01,399867,1,0,1,1,0,1
2023-06-01,133414,137,12,149,6,2,6
2023-06-01,36183,545,1385,1930,1,1,1
2023-06-01,33330,0,0,0,2,0,2
2023-06-01,141391,1,0,1,1,0,1
2023-06-01,395095,4,0,4,2,0,2
2023-06-01,400605,1,0,1,2,0,2
2023-06-01,36852,2,0,2,1,0,1
2023-06-01,46937,7,0,7,2,0,2
2023-06-01,53628,13,0,13,1,0,1
2023-06-01,15338,1,0,1,1,0,1
2023-06-01,62770,1,0,1,2,0,2
2023-06-01,22523,3,0,3,1,0,1
2023-06-01,33545,9,1,10,1,1,1
2023-06-01,19824,1,0,1,1,0,1
2023-06-01,20167,1,0,1,1,0,1
2023-06-01,393929,2,0,2,4,0,4
2023-06-01,5733,1,0,1,1,0,1
2023-06-01,12239,2,0,2,1,0,1
2023-06-01,22050,1,0,1,1,0,1
2023-06-01,19532,1,0,1,2,0,2
2023-06-01,933,1,0,1,1,0,1
2023-06-01,393605,1,0,1,1,0,1
2023-06-01,46276,19,1,20,5,2,5
2023-06-01,399807,1,0,1,3,0,3
2023-06-01,40746,1,0,1,3,0,3
2023-06-01,40354,1,0,1,1,0,1
2023-06-01,398789,3,1,4,1,1,1
2023-06-01,397781,1,1,2,3,2,3
2023-06-01,20165,5,0,5,3,0,3
2023-06-01,20296,15,0,15,3,0,3
2023-06-01,32508,28,0,28,2,0,2
2023-06-01,22870,1,0,1,3,0,3
2023-06-01,22372,1,0,1,3,0,3
2023-06-01,26875,1,0,1,2,0,2
2023-06-01,14808,1,0,1,1,0,1
2023-06-01,46169,1,0,1,1,0,1
2023-06-01,32426,1,0,1,2,0,2
2023-06-01,11969,2,0,2,1,0,1
2023-06-01,47050,12,0,12,3,0,3
2023-06-01,25715,24,0,24,2,0,2
2023-06-01,393777,2,0,2,2,0,2
2023-06-01,53816,1,0,1,1,0,1
2023-06-01,36740,1,0,1,2,0,2
2023-06-01,30532,4,0,4,5,0,5
2023-06-01,396358,3,0,3,2,0,2
2023-06-01,46340,3,0,3,4,0,4
2023-06-01,40696,1,0,1,1,0,1
2023-06-01,29740,1,0,1,1,0,1
2023-06-01,46142,2,0,2,4,0,4
2023-06-01,22127,1,0,1,1,0,1
2023-06-01,393271,1,0,1,2,0,2
2023-06-01,399932,4,1,5,1,1,1
2023-06-01,16887,9,0,9,1,0,1
2023-06-01,397862,1,0,1,1,0,1
2023-06-01,40477,1,0,1,1,0,1
2023-06-01,32152,10,0,10,3,0,3
2023-06-01,11278,8,1,9,3,1,4
2023-06-01,36188,1,0,1,1,0,1
2023-06-01,26780,1,0,1,2,0,2
2023-06-01,394685,1,0,1,2,0,2
2023-06-01,22403,4,0,4,2,0,2
2023-06-01,396991,1,0,1,1,0,1
2023-06-01,32847,1,0,1,1,0,1
2023-06-01,25744,1,0,1,3,0,3
2023-06-01,25895,2,0,2,2,0,2
2023-06-01,396248,1,0,1,1,0,1
2023-06-01,33511,2,0,2,1,0,1
2023-06-01,62750,1,0,1,1,0,1
2023-06-01,13967,1,0,1,3,0,3
2023-06-01,395659,1,0,1,2,0,2
2023-06-01,25965,1,0,1,2,0,2
2023-06-01,397252,1,0,1,3,0,3
2023-06-01,394687,2,0,2,2,0,2
2023-06-01,395522,2,0,2,1,0,1
2023-06-01,26516,1,0,1,1,0,1
2023-06-01,398119,4,2,6,3,2,3
2023-06-01,27422,5,0,5,4,0,4
2023-06-01,397256,1,0,1,1,0,1
2023-06-01,46552,16,0,16,5,0,5
2023-06-01,30021,12,1,13,4,2,4
2023-06-01,12268,17,0,17,3,0,3
2023-06-01,36068,7,0,7,5,0,5
2023-06-01,36082,1,0,1,1,0,1
2023-06-01,22996,2,0,2,1,0,1
2023-06-01,393919,1,0,1,1,0,1
2023-06-01,32627,1,0,1,1,0,1
2023-06-01,393791,1,0,1,2,0,2
2023-06-01,20227,1,0,1,2,0,2
2023-06-01,36372,2,1,3,3,1,3
2023-06-01,18773,16,0,16,1,0,1
2023-06-01,20125,2,0,2,3,0,3
2023-06-01,139267,1,1,2,1,1,1
2023-06-01,16438,24,0,24,1,0,1
2023-06-01,400478,1,1,2,3,2,3
2023-06-01,63452,4,4,8,4,2,4
2023-06-01,54616,2,0,2,1,0,1
2023-06-01,35974,1,0,1,1,0,1
2023-06-01,58122,8,0,8,2,0,2
2023-06-01,36842,1,0,1,1,0,1
2023-06-01,21668,4,0,4,2,0,2
2023-06-01,209453,8,8,16,11,8,11
2023-06-01,40673,1,0,1,2,0,2
2023-06-01,40771,1,0,1,2,0,2
2023-06-01,400765,1,1,2,1,1,1
2023-06-01,142637,2,0,2,1,0,1
2023-06-01,14221,1,1,2,1,1,1
2023-06-01,11737,2,0,2,1,0,1
2023-06-01,13599,1,0,1,3,0,3
2023-06-01,22225,1,0,1,1,0,1
2023-06-01,16884,1,0,1,2,0,2
2023-06-01,53725,1,0,1,1,0,1
2023-06-01,62751,1,0,1,1,0,1
2023-06-01,53475,1,0,1,1,0,1
2023-06-01,19419,9,6,15,2,1,2
2023-06-01,22428,1,0,1,1,0,1
2023-06-01,19853,2,0,2,1,0,1
2023-06-01,32045,4,0,4,2,0,2
2023-06-01,400224,1,0,1,3,0,3
2023-06-01,204648,8,0,8,6,0,6
2023-06-01,54138,5,0,5,1,0,1
2023-06-01,7829,1,0,1,3,0,3
2023-06-01,40872,1,0,1,3,0,3
2023-06-01,398344,1,0,1,2,0,2
2023-06-01,54377,1,0,1,1,0,1
2023-06-01,399357,1,0,1,3,0,3
2023-06-01,19733,1,0,1,1,0,1
2023-06-01,398389,1,0,1,2,0,2
2023-06-01,396029,1,0,1,1,0,1
2023-06-01,395089,4,1,5,2,4,4
2023-06-01,397801,1,0,1,3,0,3
2023-06-01,16678,1,0,1,1,0,1
2023-06-01,46876,1,0,1,1,0,1
2023-06-01,46928,1,0,1,3,0,3
2023-06-01,3459,1,0,1,2,0,2
2023-06-01,397154,1,0,1,1,0,1
2023-06-01,26050,1,0,1,1,0,1
2023-06-01,393465,2,0,2,2,0,2
2023-06-01,25785,2,0,2,1,0,1
2023-06-01,46921,2,0,2,2,0,2
2023-06-01,14105,1,0,1,2,0,2
2023-06-01,397684,1,0,1,1,0,1
2023-06-01,32115,1,0,1,1,0,1
2023-06-01,1380,1,0,1,2,0,2
2023-06-01,396439,2,0,2,1,0,1
2023-06-01,32916,2,0,2,3,0,3
2023-06-01,25738,1,0,1,3,0,3
2023-06-01,394866,2,0,2,1,0,1
2023-06-01,18602,3,0,3,6,0,6
2023-06-01,11822,1,0,1,2,0,2
2023-06-01,398736,1,3,4,3,2,4
2023-06-01,21567,1,0,1,2,0,2
2023-06-01,17127,1,0,1,1,0,1
2023-06-01,18855,1,0,1,2,0,2
2023-06-01,53614,1,0,1,3,0,3
2023-06-01,14461,1,0,1,1,0,1
2023-06-01,395300,1,0,1,3,0,3
2023-06-01,396837,1,0,1,3,0,3
2023-06-01,14642,13,0,13,5,0,5
2023-06-01,63054,2,0,2,2,0,2
2023-06-01,397815,1,0,1,1,0,1
2023-06-01,14012,2,0,2,3,0,3
2023-06-01,14519,5,0,5,3,0,3
2023-06-01,3722,0,0,0,3,0,3
2023-06-01,1023,1,0,1,1,0,1
2023-06-01,400271,1,0,1,1,0,1
2023-06-01,400239,1,0,1,1,0,1
2023-06-01,400205,5,0,5,3,0,3
2023-06-01,140731,1,31,32,1,13,13
2023-06-01,202888,1,8,9,1,6,6
2023-06-01,141776,1,4,5,1,3,3
2023-06-01,400295,1,1,2,1,1,1
2023-06-01,399406,1,0,1,1,0,1
2023-06-01,54668,6,0,6,3,0,3
2023-06-01,13431,15,0,15,9,0,9
2023-06-01,56019,1,0,1,1,0,1
2023-06-01,131279,4,0,4,2,0,2
2023-06-01,46019,9,1,10,5,2,5
2023-06-01,131628,50,0,50,3,0,3
2023-06-01,135203,6,0,6,1,0,1
2023-06-01,45086,1,0,1,1,0,1
2023-06-01,55306,5,1,6,4,3,4
2023-06-01,45705,10,1,11,3,2,3
2023-06-01,9849,8,0,8,2,0,2
2023-06-01,131882,6,0,6,1,0,1
2023-06-01,45998,1,0,1,1,0,1
2023-06-01,23593,5,0,5,2,0,2
2023-06-01,10065,2,0,2,2,0,2
2023-06-01,45988,2,0,2,2,0,2
2023-06-01,38410,4,0,4,1,0,1
2023-06-01,38409,4,0,4,1,0,1
2023-06-01,9854,2,0,2,2,0,2
2023-06-01,10055,3,0,3,2,0,2
2023-06-01,9699,4,0,4,3,0,3
2023-06-01,17836,1,0,1,3,0,3
2023-06-01,10183,3,0,3,2,0,2
2023-06-01,58644,3,0,3,1,0,1
2023-06-01,7651,13,1,14,3,1,3
2023-06-01,7650,25,1,26,3,1,3
2023-06-01,17764,9,0,9,4,0,4
2023-06-01,55328,8,10,18,3,2,3
2023-06-01,55403,18,6,24,2,2,2
2023-06-01,55428,1,0,1,2,0,2
2023-06-01,131816,2,0,2,2,0,2
2023-06-01,9977,1,0,1,1,0,1
2023-06-01,131850,2,0,2,1,0,1
2023-06-01,131851,1,0,1,1,0,1
2023-06-01,45380,1,0,1,2,0,2
2023-06-01,38706,1,0,1,1,0,1
2023-06-01,56800,5,1,6,7,4,7
2023-06-01,56571,22,0,22,3,0,3
2023-06-01,197829,6,0,6,4,0,4
2023-06-01,197859,7,0,7,1,0,1
2023-06-01,57279,3,1,4,6,2,6
2023-06-01,197893,7,0,7,3,0,3
2023-06-01,207718,4,0,4,1,0,1
2023-06-01,56919,3,0,3,2,0,2
2023-06-01,56822,2,0,2,3,0,3
2023-06-01,197862,3,0,3,1,0,1
2023-06-01,61420,1,0,1,1,0,1
2023-06-01,56924,1,0,1,2,0,2
2023-06-01,197573,1,1,2,2,1,2
2023-06-01,47420,1,1,2,1,1,1
2023-06-01,209775,2,0,2,3,0,3
2023-06-01,212247,1,0,1,1,0,1
2023-06-01,209834,1,1,2,1,1,1
2023-06-01,198580,2,0,2,3,0,3
2023-06-01,34232,2,0,2,1,0,1
2023-06-01,48624,2,0,2,1,0,1
2023-06-01,56861,0,0,0,2,0,2
2023-06-01,48555,4,0,4,1,0,1
2023-06-01,197870,2,0,2,2,0,2
2023-06-01,199634,2,0,2,1,0,1
2023-06-01,49454,2,0,2,1,0,1
2023-06-01,57656,14,1,15,3,1,3
2023-06-01,198230,10,0,10,5,0,5
2023-06-01,203594,1,0,1,1,0,1
2023-06-01,60658,1,0,1,1,0,1
2023-06-01,199252,1,0,1,1,0,1
2023-06-01,56995,20,0,20,3,0,3
2023-06-01,59973,1,0,1,1,0,1
2023-06-01,60762,1,0,1,1,0,1
2023-06-01,57067,1,0,1,1,0,1
2023-06-01,8649,4,0,4,2,0,2
2023-06-01,56973,2,0,2,1,0,1
2023-06-01,198415,1,0,1,3,0,3
2023-06-01,20878,7,0,7,3,0,3
2023-06-01,41000,9,2,11,8,4,8
2023-06-01,197689,1,0,1,3,0,3
2023-06-01,197956,1,0,1,4,0,4
2023-06-01,50029,9,0,9,3,0,3
2023-06-01,48978,7,0,7,4,0,4
2023-06-01,198950,1,0,1,3,0,3
2023-06-01,209517,1,0,1,1,0,1
2023-06-01,207530,1,1,2,1,1,1
2023-06-01,64486,1,1,2,1,1,1
2023-06-01,208890,2,0,2,1,0,1
2023-06-01,203844,1,0,1,2,0,2
2023-06-01,49860,1,0,1,1,0,1
2023-06-01,57655,1,0,1,1,0,1
2023-06-01,43972,1,0,1,2,0,2
2023-06-01,212860,2,0,2,1,0,1
2023-06-01,212919,1,0,1,1,0,1
2023-06-01,199940,1,0,1,4,0,4
2023-06-01,204211,1,0,1,1,0,1
2023-06-01,57288,1,1,2,4,3,4
2023-06-01,197399,1,0,1,2,0,2
2023-06-01,198073,1,0,1,2,0,2
2023-06-01,57320,1,0,1,2,0,2
2023-06-01,59655,6,0,6,13,0,13
2023-06-01,207021,3,3,6,1,1,1
2023-06-01,199199,1,0,1,1,0,1
2023-06-01,57333,5,0,5,3,0,3
2023-06-01,48755,1,1,2,2,2,2
2023-06-01,49189,1,1,2,2,2,2
2023-06-01,211190,2,0,2,4,0,4
2023-06-01,60529,1,0,1,1,0,1
2023-06-01,49889,30,0,30,1,0,1
2023-06-01,210270,5,0,5,4,0,4
2023-06-01,57383,1,0,1,1,0,1
2023-06-01,41096,38,0,38,3,0,3
2023-06-01,198151,1,0,1,4,0,4
2023-06-01,57396,1,0,1,4,0,4
2023-06-01,41520,1,0,1,1,0,1
2023-06-01,205300,1,0,1,1,0,1
2023-06-01,62099,4,2,6,5,2,5
2023-06-01,50121,2,0,2,5,0,5
2023-06-01,59476,1,0,1,1,0,1
2023-06-01,57422,1,0,1,3,0,3
2023-06-01,60081,1,0,1,1,0,1
2023-06-01,210799,1,1,2,1,1,1
2023-06-01,210808,1,0,1,3,0,3
2023-06-01,57460,3,0,3,1,0,1
2023-06-01,197752,1,0,1,1,0,1
2023-06-01,212114,1,0,1,1,0,1
2023-06-01,212272,1,0,1,1,0,1
2023-06-01,206684,1,0,1,1,0,1
2023-06-01,57471,1,0,1,2,0,2
2023-06-01,9185,1,0,1,1,0,1
2023-06-01,5598,11,0,11,3,0,3
2023-06-01,57496,1,1,2,2,2,2
2023-06-01,57566,1,0,1,1,0,1
2023-06-01,43822,5,0,5,1,0,1
2023-06-01,49588,4,1,5,3,1,3
2023-06-01,57534,6,0,6,3,0,3
2023-06-01,198248,2,0,2,2,0,2
2023-06-01,198235,1,1,2,3,3,4
2023-06-01,57564,1,1,2,1,1,1
2023-06-01,56463,6,0,6,2,0,2
2023-06-01,198271,1,0,1,3,0,3
2023-06-01,39822,2,1,3,4,1,4
2023-06-01,57613,8,0,8,6,0,6
2023-06-01,42510,11,0,11,3,0,3
2023-06-01,198389,1,0,1,2,0,2
2023-06-01,211885,1,0,1,1,0,1
2023-06-01,198343,1,0,1,3,0,3
2023-06-01,31000,3,0,3,1,0,1
2023-06-01,41009,1,1,2,11,3,11
2023-06-01,44884,2,0,2,1,0,1
2023-06-01,198360,2,0,2,2,0,2
2023-06-01,198363,1,0,1,1,0,1
2023-06-01,57659,1,0,1,1,0,1
2023-06-01,21376,1,0,1,2,0,2
2023-06-01,210280,1,0,1,1,0,1
2023-06-01,57670,6,0,6,2,0,2
2023-06-01,31388,2,0,2,1,0,1
2023-06-01,199856,1,1,2,1,1,1
2023-06-01,211866,1,0,1,1,0,1
2023-06-01,210066,6,0,6,1,0,1
2023-06-01,201395,1,1,2,2,2,2
2023-06-01,209768,1,4,5,7,7,11
2023-06-01,210779,2,4,6,1,2,2
2023-06-01,44629,3,0,3,6,0,6
2023-06-01,57730,1,0,1,1,0,1
2023-06-01,42998,4,0,4,2,0,2
2023-06-01,57760,14,1,15,4,1,4
2023-06-01,57741,1,0,1,1,0,1
2023-06-01,57823,1,1,2,1,1,1
2023-06-01,57774,1,0,1,1,0,1
2023-06-01,12484,2,0,2,1,0,1
2023-06-01,59975,1,0,1,1,0,1
2023-06-01,57798,8,1,9,4,2,4
2023-06-01,57826,18,0,18,1,0,1
2023-06-01,39431,26,1,27,5,1,5
2023-06-01,39432,0,0,0,1,0,1
2023-06-01,213228,5,0,5,3,0,3
2023-06-01,198490,1,0,1,4,0,4
2023-06-01,57818,24,0,24,3,0,3
2023-06-01,57827,1,0,1,1,0,1
2023-06-01,39422,6,0,6,5,0,5
2023-06-01,57835,1,0,1,1,0,1
2023-06-01,57847,1,0,1,1,0,1
2023-06-01,57824,1,0,1,2,0,2
2023-06-01,49483,2,0,2,1,0,1
2023-06-01,199039,3,0,3,2,0,2
2023-06-01,206853,5,0,5,1,0,1
2023-06-01,61227,1,1,2,1,1,1
2023-06-01,199616,4,0,4,3,0,3
2023-06-01,59498,8,0,8,1,0,1
2023-06-01,57871,12,0,12,4,0,4
2023-06-01,198563,1,0,1,1,0,1
2023-06-01,57960,20,0,20,2,0,2
2023-06-01,210039,1,0,1,2,0,2
2023-06-01,209107,1,0,1,1,0,1
2023-06-01,48725,3,0,3,2,0,2
2023-06-01,47655,2,1,3,5,1,5
2023-06-01,57978,1,0,1,1,0,1
2023-06-01,198577,1,0,1,1,0,1
2023-06-01,201305,1,0,1,1,0,1
2023-06-01,213010,1,0,1,1,0,1
2023-06-01,198642,1,0,1,1,0,1
2023-06-01,210330,1,0,1,2,0,2
2023-06-01,204892,1,0,1,1,0,1
2023-06-01,44988,3,0,3,7,0,7
2023-06-01,198496,1,0,1,1,0,1
2023-06-01,49124,2,1,3,5,2,5
2023-06-01,198616,17,0,17,2,0,2
2023-06-01,57990,1,0,1,3,0,3
2023-06-01,58044,1,0,1,1,0,1
2023-06-01,50911,9,1,10,5,1,5
2023-06-01,211453,1,1,2,2,2,2
2023-06-01,8712,2,0,2,3,0,3
2023-06-01,202275,1,0,1,1,0,1
2023-06-01,62402,1,0,1,3,0,3
2023-06-01,61358,1,0,1,2,0,2
2023-06-01,34492,1,0,1,3,0,3
2023-06-01,209755,1,0,1,1,0,1
2023-06-01,197400,1,0,1,2,0,2
2023-06-01,49439,12,0,12,3,0,3
2023-06-01,197498,4,2,6,2,2,2
2023-06-01,202127,1,0,1,1,0,1
2023-06-01,202618,2,1,3,1,1,1
2023-06-01,198715,1,0,1,1,0,1
2023-06-01,58134,9,0,9,2,0,2
2023-06-01,3203,3,0,3,2,0,2
2023-06-01,41743,3,1,4,6,3,6
2023-06-01,198757,4,0,4,2,0,2
2023-06-01,199042,9,0,9,4,0,4
2023-06-01,198766,2,0,2,6,0,6
2023-06-01,51070,7,0,7,1,0,1
2023-06-01,58130,3,4,7,1,1,1
2023-06-01,202797,3,0,3,1,0,1
2023-06-01,59560,1,0,1,5,0,5
2023-06-01,59575,1,0,1,1,0,1
2023-06-01,199091,1,0,1,5,0,5
2023-06-01,50022,1,0,1,5,0,5
2023-06-01,211240,1,0,1,2,0,2
2023-06-01,51234,6,0,6,4,0,4
2023-06-01,51507,24,0,24,9,0,9
2023-06-01,198791,1,0,1,3,0,3
2023-06-01,50470,0,0,0,2,2,2
2023-06-01,42718,1,1,2,1,1,1
2023-06-01,209664,1,0,1,1,0,1
2023-06-01,24579,2,0,2,5,0,5
2023-06-01,59956,1,0,1,1,0,1
2023-06-01,58151,1,1,2,1,1,1
2023-06-01,58158,7,0,7,4,0,4
2023-06-01,205711,1,0,1,2,0,2
2023-06-01,206608,5,0,5,3,0,3
2023-06-01,51153,21,0,21,3,0,3
2023-06-01,210061,1,0,1,1,0,1
2023-06-01,210052,4,0,4,4,0,4
2023-06-01,41195,3,1,4,1,1,1
2023-06-01,212923,1,0,1,1,0,1
2023-06-01,209657,1,0,1,3,0,3
2023-06-01,209592,1,0,1,3,0,3
2023-06-01,201624,2,0,2,4,0,4
2023-06-01,209873,1,0,1,1,0,1
2023-06-01,42503,3,4,7,5,2,5
2023-06-01,205334,10,0,10,3,0,3
2023-06-01,210055,1,0,1,2,0,2
2023-06-01,59606,1,0,1,2,0,2
2023-06-01,207277,1,0,1,2,0,2
2023-06-01,58285,1,0,1,1,0,1
2023-06-01,51512,1,0,1,2,0,2
2023-06-01,59987,1,0,1,3,0,3
2023-06-01,204858,6,0,6,2,0,2
2023-06-01,62371,6,4,10,8,8,9
2023-06-01,207605,1,1,2,1,1,1
2023-06-01,208103,7,0,7,2,0,2
2023-06-01,207628,1,1,2,1,2,2
2023-06-01,207767,2,1,3,3,3,3
2023-06-01,211700,1,1,2,4,3,4
2023-06-01,60557,1,8,9,5,5,7
2023-06-01,61363,2,0,2,2,0,2
2023-06-01,15756,2,0,2,3,0,3
2023-06-01,58304,7,0,7,1,0,1
2023-06-01,20719,5,0,5,2,0,2
2023-06-01,12754,83,1,84,7,3,8
2023-06-01,51740,5,1,6,3,2,3
2023-06-01,48775,1,0,1,1,0,1
2023-06-01,58332,1,0,1,1,0,1
2023-06-01,60700,2,0,2,2,0,2
2023-06-01,50594,4,0,4,1,0,1
2023-06-01,197485,2,0,2,3,0,3
2023-06-01,207931,1,0,1,1,0,1
2023-06-01,41244,4,0,4,3,0,3
2023-06-01,50579,4,0,4,4,0,4
2023-06-01,41323,1,0,1,2,0,2
2023-06-01,41467,1,0,1,1,0,1
2023-06-01,43981,1,0,1,2,0,2
2023-06-01,57894,1,0,1,1,0,1
2023-06-01,199472,5,0,5,1,0,1
2023-06-01,60216,5,2,7,1,2,2
2023-06-01,199021,2,0,2,3,0,3
2023-06-01,59631,3,0,3,1,0,1
2023-06-01,59444,7,0,7,4,0,4
2023-06-01,199416,1,0,1,2,0,2
2023-06-01,204484,0,0,0,3,0,3
2023-06-01,198718,5,0,5,1,0,1
2023-06-01,205047,1,0,1,1,0,1
2023-06-01,41775,4,0,4,4,0,4
2023-06-01,204520,1,0,1,2,0,2
2023-06-01,202091,1,0,1,2,0,2
2023-06-01,198991,1,0,1,1,0,1
2023-06-01,199008,7,0,7,4,0,4
2023-06-01,199047,1,0,1,3,0,3
2023-06-01,199060,2,0,2,1,0,1
2023-06-01,59517,9,0,9,4,0,4
2023-06-01,21005,6,0,6,1,0,1
2023-06-01,199061,10,1,11,4,4,4
2023-06-01,209921,1,0,1,3,0,3
2023-06-01,30909,2,0,2,2,0,2
2023-06-01,59512,1,0,1,2,0,2
2023-06-01,198076,1,0,1,3,0,3
2023-06-01,59522,1,0,1,1,0,1
2023-06-01,34900,1,0,1,1,0,1
2023-06-01,59529,1,0,1,1,0,1
2023-06-01,56365,1,0,1,1,0,1
2023-06-01,34693,1,0,1,1,0,1
2023-06-01,35200,1,0,1,1,0,1
2023-06-01,51078,1,0,1,1,0,1
2023-06-01,59506,65,0,65,2,0,2
2023-06-01,201817,1,0,1,2,0,2
2023-06-01,59515,9,0,9,2,0,2
2023-06-01,51002,11,0,11,1,0,1
2023-06-01,59681,1,0,1,2,0,2
2023-06-01,39395,1,0,1,1,0,1
2023-06-01,56970,2,2,4,4,4,4
2023-06-01,209856,2,0,2,3,0,3
2023-06-01,51342,2,0,2,2,0,2
2023-06-01,59632,1,1,2,2,1,2
2023-06-01,198412,4,3,7,1,1,1
2023-06-01,211308,1,1,2,1,1,1
2023-06-01,59652,1,0,1,1,0,1
2023-06-01,199078,2,0,2,2,0,2
2023-06-01,59665,6,0,6,1,0,1
2023-06-01,199345,1,0,1,1,0,1
2023-06-01,51596,3,0,3,3,0,3
2023-06-01,59664,1,0,1,1,0,1
2023-06-01,60732,3,0,3,1,0,1
2023-06-01,199197,2,0,2,1,0,1
2023-06-01,199188,2,0,2,1,0,1
2023-06-01,199351,2,0,2,1,0,1
2023-06-01,205363,2,0,2,3,0,3
2023-06-01,206019,1,0,1,2,0,2
2023-06-01,199200,1,0,1,1,0,1
2023-06-01,59672,1,0,1,3,0,3
2023-06-01,49949,3,1,4,1,1,2
2023-06-01,59690,1,0,1,1,0,1
2023-06-01,201766,4,3,7,3,2,3
2023-06-01,59671,5,0,5,1,0,1
2023-06-01,44172,10,0,10,4,0,4
2023-06-01,199112,1,0,1,2,0,2
2023-06-01,41602,1,0,1,1,0,1
2023-06-01,210557,1,0,1,1,0,1
2023-06-01,207586,1,1,2,1,1,2
2023-06-01,210669,1,0,1,2,0,2
2023-06-01,50119,1,1,2,1,1,1
2023-06-01,210570,1,0,1,2,0,2
2023-06-01,56600,32,0,32,4,0,4
2023-06-01,212003,1,0,1,3,0,3
2023-06-01,204240,1,0,1,2,0,2
2023-06-01,62335,1,0,1,1,0,1
2023-06-01,62127,1,0,1,1,0,1
2023-06-01,62101,1,0,1,2,0,2
2023-06-01,57696,2,1,3,1,3,3
2023-06-01,211508,3,0,3,1,0,1
2023-06-01,206338,1,0,1,1,0,1
2023-06-01,200121,2,0,2,2,0,2
2023-06-01,8848,3,0,3,5,0,5
2023-06-01,59792,2,0,2,4,0,4
2023-06-01,208277,1,1,2,1,1,1
2023-06-01,57595,11,0,11,3,0,3
2023-06-01,198270,3,0,3,3,0,3
2023-06-01,209370,6,0,6,2,0,2
2023-06-01,204757,2,0,2,1,0,1
2023-06-01,198282,1,1,2,3,2,3
2023-06-01,20879,2,1,3,1,1,1
2023-06-01,62114,1,0,1,2,0,2
2023-06-01,57746,2,0,2,3,0,3
2023-06-01,44875,2,0,2,1,0,1
2023-06-01,60450,1,0,1,1,0,1
2023-06-01,198336,5,0,5,1,0,1
2023-06-01,44443,4,0,4,4,0,4
2023-06-01,206595,1,0,1,1,0,1
2023-06-01,24667,2,0,2,1,0,1
2023-06-01,208880,1,0,1,2,0,2
2023-06-01,208916,1,0,1,1,0,1
2023-06-01,198335,3,0,3,4,0,4
2023-06-01,262830,13,0,13,4,0,4
2023-06-01,262833,1,0,1,1,0,1
2023-06-01,52890,18,1,19,20,2,20
2023-06-01,262896,1,1,2,4,1,4
2023-06-01,270592,2,0,2,1,0,1
2023-06-01,270582,3,1,4,1,1,1
2023-06-01,270583,7,1,8,3,1,3
2023-06-01,263029,14,0,14,1,0,1
2023-06-01,263286,5,2,7,2,2,2
2023-06-01,263133,5,1,6,1,1,1
2023-06-01,263579,20,3,23,3,1,3
2023-06-01,270788,1,1,2,1,1,1
2023-06-01,262842,7,5,12,4,4,5
2023-06-01,263012,1,1,2,2,1,2
2023-06-01,263591,4,7,11,3,4,4
2023-06-01,270313,6,1,7,1,1,1
2023-06-01,262846,1,1,2,3,2,3
2023-06-01,263014,4,0,4,1,0,1
2023-06-01,263442,12,16,28,2,1,2
2023-06-01,53235,4,0,4,4,0,4
2023-06-01,52917,7,0,7,4,0,4
2023-06-01,52918,7,1,8,1,1,1
2023-06-01,262739,5,0,5,2,0,2
2023-06-01,270667,7,1,8,1,1,1
2023-06-01,271218,2,0,2,2,0,2
2023-06-01,52926,7,0,7,1,0,1
2023-06-01,263016,1,0,1,1,0,1
2023-06-01,61894,4,3,7,4,2,5
2023-06-01,263019,13,3,16,8,2,8
2023-06-01,271012,6,0,6,1,0,1
2023-06-01,52933,4,0,4,1,0,1
2023-06-01,270000,2,0,2,1,0,1
2023-06-01,262302,21,7,28,6,3,6
2023-06-01,262856,15,1,16,8,3,8
2023-06-01,263036,5,1,6,3,2,3
2023-06-01,263602,1,0,1,1,0,1
2023-06-01,262861,6,1,7,3,2,3
2023-06-01,262863,2,0,2,1,0,1
2023-06-01,52962,23,3,26,14,5,14
2023-06-01,262277,9,0,9,2,0,2
2023-06-01,262295,4,0,4,3,0,3
2023-06-01,270697,2,1,3,1,1,1
2023-06-01,270641,2,2,4,4,3,4
2023-06-01,52922,1,0,1,2,0,2
2023-06-01,52754,2,0,2,2,0,2
2023-06-01,53241,10,1,11,2,1,2
2023-06-01,262278,15,1,16,1,1,1
2023-06-01,53243,12,3,15,7,4,7
2023-06-01,262871,7,0,7,1,0,1
2023-06-01,52934,7,2,9,2,1,2
2023-06-01,271624,1,2,3,3,2,3
2023-06-01,53244,1,0,1,1,0,1
2023-06-01,52939,1,1,2,1,1,1
2023-06-01,262874,2,5,7,3,2,3
2023-06-01,52942,5,0,5,1,0,1
2023-06-01,270999,1,1,2,1,1,1
2023-06-01,271464,7,1,8,6,1,6
2023-06-01,52948,4,1,5,3,1,3
2023-06-01,270558,7,2,9,3,2,3
2023-06-01,270514,5,0,5,1,0,1
2023-06-01,270499,5,5,10,4,2,4
2023-06-01,262878,8,1,9,3,1,3
2023-06-01,52856,13,1,14,1,1,1
2023-06-01,52903,4,5,9,2,1,2
2023-06-01,52904,21,13,34,1,1,1
2023-06-01,52945,2,1,3,1,2,2
2023-06-01,270112,1,0,1,1,0,1
2023-06-01,262882,3,0,3,1,0,1
2023-06-01,52905,10,4,14,1,1,1
2023-06-01,262885,1,0,1,3,0,3
2023-06-01,52946,1,1,2,1,1,1
2023-06-01,262895,3,3,6,3,1,3
2023-06-01,52826,1,1,2,1,1,1
2023-06-01,28665,17,25,42,6,3,7
2023-06-01,262845,1,0,1,1,0,1
2023-06-01,270034,4,3,7,3,3,3
2023-06-01,53118,5,5,10,1,1,1
2023-06-01,28299,52,4,56,5,4,5
2023-06-01,53162,6,1,7,10,5,11
2023-06-01,263033,21,1,22,4,3,5
2023-06-01,262855,24,3,27,3,2,3
2023-06-01,270750,5,1,6,4,1,4
2023-06-01,270766,1,1,2,3,3,3
2023-06-01,270015,1,0,1,1,0,1
2023-06-01,270751,5,2,7,6,4,6
2023-06-01,262866,7,3,10,4,3,4
2023-06-01,11338,76,51,127,11,7,11
2023-06-01,53239,4,0,4,2,0,2
2023-06-01,262857,1,0,1,1,0,1
2023-06-01,262891,3,0,3,3,0,3
2023-06-01,262867,8,0,8,5,0,5
2023-06-01,263084,1,0,1,3,0,3
2023-06-01,52836,20,5,25,2,3,3
2023-06-01,262876,4,0,4,3,0,3
2023-06-01,52953,6,0,6,2,0,2
2023-06-01,262890,1,1,2,1,1,1
2023-06-01,263331,2,0,2,1,0,1
2023-06-01,52958,7,2,9,3,2,3
2023-06-01,263121,4,1,5,2,1,2
2023-06-01,262902,4,0,4,1,0,1
2023-06-01,28264,19,5,24,5,3,5
2023-06-01,262357,3,0,3,3,0,3
2023-06-01,271848,4,0,4,3,0,3
2023-06-01,262886,9,0,9,4,0,4
2023-06-01,52757,7,0,7,1,0,1
2023-06-01,270996,4,0,4,2,0,2
2023-06-01,262888,8,0,8,1,0,1
2023-06-01,263038,15,0,15,1,0,1
2023-06-01,263274,6,1,7,4,2,4
2023-06-01,270869,5,5,10,3,1,3
2023-06-01,263039,1,0,1,1,0,1
2023-06-01,262268,13,4,17,5,3,5
2023-06-01,263614,5,5,10,7,3,7
2023-06-01,53103,6,0,6,3,0,3
2023-06-01,269987,1,1,2,2,2,2
2023-06-01,270612,4,0,4,3,0,3
2023-06-01,52911,4,1,5,3,1,3
2023-06-01,52969,2,0,2,2,0,2
2023-06-01,52970,3,0,3,3,0,3
2023-06-01,52963,5,1,6,1,1,1
2023-06-01,52938,11,0,11,7,0,7
2023-06-01,262905,6,3,9,1,2,2
2023-06-01,262269,1,0,1,2,0,2
2023-06-01,262276,1,0,1,2,0,2
2023-06-01,262280,1,0,1,2,0,2
2023-06-01,52915,1,1,2,2,2,2
2023-06-01,262906,7,1,8,1,1,1
2023-06-01,271135,3,1,4,1,1,1
2023-06-01,271052,3,1,4,1,2,2
2023-06-01,271043,4,0,4,1,0,1
2023-06-01,270960,7,7,14,2,2,2
2023-06-01,270951,5,1,6,1,1,1
2023-06-01,271211,7,1,8,3,2,3
2023-06-01,271216,5,1,6,2,1,2
2023-06-01,270917,4,1,5,2,1,2
2023-06-01,52972,19,2,21,5,3,6
2023-06-01,262401,47,0,47,6,0,6
2023-06-01,53070,25,7,32,10,5,10
2023-06-01,263598,18,2,20,2,1,2
2023-06-01,28266,10,0,10,1,0,1
2023-06-01,270606,1,0,1,2,0,2
2023-06-01,270635,5,4,9,1,1,1
2023-06-01,270675,7,1,8,4,3,4
2023-06-01,270594,1,1,2,2,3,3
2023-06-01,270526,1,1,2,1,1,1
2023-06-01,271985,5,0,5,1,0,1
2023-06-01,269968,2,0,2,1,0,1
2023-06-01,270820,3,1,4,8,3,8
2023-06-01,262418,13,10,23,4,2,4
2023-06-01,52964,9,0,9,3,0,3
2023-06-01,52966,3,0,3,1,0,1
2023-06-01,52787,5,0,5,6,0,6
2023-06-01,262911,3,3,6,3,1,3
2023-06-01,52788,7,1,8,7,3,7
2023-06-01,52789,5,0,5,3,0,3
2023-06-01,262774,16,0,16,2,0,2
2023-06-01,52755,3,0,3,2,0,2
2023-06-01,52758,29,1,30,6,4,6
2023-06-01,52759,5,1,6,6,4,7
2023-06-01,28661,66,1,67,3,3,4
2023-06-01,262412,8,0,8,4,0,4
2023-06-01,262413,4,0,4,2,0,2
2023-06-01,52994,2,0,2,4,0,4
2023-06-01,52790,8,0,8,2,0,2
2023-06-01,262415,4,1,5,1,1,1
2023-06-01,263615,3,1,4,1,1,1
2023-06-01,61765,3,3,6,2,1,2
2023-06-01,271615,7,1,8,2,1,2
2023-06-01,52766,21,3,24,2,2,3
2023-06-01,262423,8,0,8,2,0,2
2023-06-01,52548,9,0,9,3,0,3
2023-06-01,52765,6,5,11,6,3,6
2023-06-01,262426,4,0,4,6,0,6
2023-06-01,52767,5,1,6,1,1,1
2023-06-01,262430,3,0,3,2,0,2
2023-06-01,52768,3,1,4,1,1,1
2023-06-01,262431,1,0,1,1,0,1
2023-06-01,262432,2,0,2,3,0,3
2023-06-01,52774,3,2,5,2,1,2
2023-06-01,52797,9,0,9,2,0,2
2023-06-01,53173,2,3,5,1,1,1
2023-06-01,263139,5,5,10,4,3,4
2023-06-01,52982,17,0,17,4,0,4
2023-06-01,262441,4,1,5,6,3,6
2023-06-01,19182,20,0,20,3,0,3
2023-06-01,270385,8,3,11,9,2,9
2023-06-01,28166,80,1,81,8,3,8
2023-06-01,262480,13,6,19,4,3,4
2023-06-01,263294,12,1,13,3,1,3
2023-06-01,52993,7,1,8,1,3,3
2023-06-01,262281,10,0,10,3,0,3
2023-06-01,262283,19,0,19,4,0,4
2023-06-01,52995,2,1,3,2,1,2
2023-06-01,262478,15,2,17,6,3,6
2023-06-01,262435,7,2,9,4,4,4
2023-06-01,262436,14,0,14,1,0,1
2023-06-01,52796,3,0,3,3,0,3
2023-06-01,262438,9,1,10,2,1,2
2023-06-01,52786,9,0,9,3,0,3
2023-06-01,271312,3,1,4,2,1,2
2023-06-01,262439,2,1,3,1,1,1
2023-06-01,61851,7,3,10,9,2,9
2023-06-01,52801,3,0,3,1,0,1
2023-06-01,262442,1,0,1,1,0,1
2023-06-01,262455,1,0,1,1,0,1
2023-06-01,52997,1,1,2,3,2,3
2023-06-01,262508,1,0,1,2,0,2
2023-06-01,262445,9,0,9,3,0,3
2023-06-01,262446,2,0,2,1,0,1
2023-06-01,52782,5,0,5,4,0,4
2023-06-01,271109,3,1,4,1,1,1
2023-06-01,270837,5,1,6,1,1,1
2023-06-01,262449,2,0,2,1,0,1
2023-06-01,263540,1,0,1,3,0,3
2023-06-01,263319,1,1,2,1,1,1
2023-06-01,52820,2,0,2,4,0,4
2023-06-01,262451,1,0,1,1,0,1
2023-06-01,52830,1,1,2,1,1,1
2023-06-01,52986,1,0,1,3,0,3
2023-06-01,263672,3,3,6,4,3,4
2023-06-01,262452,4,2,6,3,1,3
2023-06-01,52831,1,0,1,1,0,1
2023-06-01,271799,2,1,3,3,1,3
2023-06-01,52834,1,1,2,1,1,1
2023-06-01,52839,8,0,8,4,0,4
2023-06-01,262454,7,7,14,4,3,4
2023-06-01,52990,7,0,7,4,0,4
2023-06-01,270864,4,2,6,3,2,3
2023-06-01,270865,4,1,5,3,1,3
2023-06-01,262457,12,1,13,6,4,6
2023-06-01,52809,9,0,9,3,0,3
2023-06-01,52803,4,0,4,1,0,1
2023-06-01,262463,24,2,26,7,4,7
2023-06-01,262568,6,0,6,3,0,3
2023-06-01,262465,5,2,7,4,1,4
2023-06-01,28615,58,0,58,3,0,3
2023-06-01,52804,5,3,8,3,1,3
2023-06-01,269994,1,1,2,2,1,2
2023-06-01,52665,7,1,8,1,1,1
2023-06-01,52806,1,1,2,1,1,1
2023-06-01,270247,1,1,2,2,2,2
2023-06-01,52808,4,0,4,2,0,2
2023-06-01,262475,1,1,2,4,2,5
2023-06-01,271020,7,1,8,2,1,2
2023-06-01,262331,1,0,1,2,0,2
2023-06-01,28292,55,6,61,9,7,10
2023-06-01,262347,1,0,1,2,0,2
2023-06-01,262356,1,0,1,2,0,2
2023-06-01,52867,1,0,1,1,0,1
2023-06-01,53020,4,0,4,6,0,6
2023-06-01,52998,7,1,8,2,1,2
2023-06-01,53000,2,0,2,3,0,3
2023-06-01,262483,6,1,7,3,1,3
2023-06-01,271310,4,1,5,2,2,2
2023-06-01,52667,1,0,1,1,0,1
2023-06-01,52671,11,1,12,4,1,4
2023-06-01,262447,16,0,16,1,0,1
2023-06-01,262889,23,1,24,6,2,6
2023-06-01,262292,16,0,16,3,0,3
2023-06-01,53142,33,0,33,4,0,4
2023-06-01,52991,7,5,12,4,4,5
2023-06-01,28596,17,0,17,5,0,5
2023-06-01,262299,20,4,24,5,3,5
2023-06-01,270331,2,0,2,8,0,8
2023-06-01,28591,10,3,13,3,2,3
2023-06-01,263571,9,0,9,5,0,5
2023-06-01,272724,0,1,1,2,1,3
2023-06-01,53003,15,0,15,4,0,4
2023-06-01,262507,7,1,8,6,2,6
2023-06-01,22085,9,1,10,1,1,1
2023-06-01,52837,1,0,1,3,0,3
2023-06-01,52844,1,0,1,2,0,2
2023-06-01,52649,1,0,1,1,0,1
2023-06-01,271213,1,1,2,1,1,1
2023-06-01,262486,2,0,2,2,0,2
2023-06-01,262487,5,1,6,3,1,3
2023-06-01,52841,1,3,4,4,5,5
2023-06-01,52672,3,0,3,4,0,4
2023-06-01,52676,2,1,3,1,1,1
2023-06-01,52847,7,2,9,1,1,1
2023-06-01,262499,6,1,7,6,2,6
2023-06-01,52656,3,0,3,4,0,4
2023-06-01,262501,5,1,6,5,2,5
2023-06-01,52659,1,3,4,1,1,1
2023-06-01,52675,7,0,7,3,0,3
2023-06-01,52798,7,1,8,3,1,3
2023-06-01,53004,4,1,5,2,1,2
2023-06-01,52677,5,0,5,1,0,1
2023-06-01,53072,6,3,9,4,4,4
2023-06-01,53009,6,1,7,3,1,3
2023-06-01,272430,0,1,1,3,2,3
2023-06-01,272484,1,1,2,2,1,2
2023-06-01,53010,4,0,4,4,0,4
2023-06-01,52684,2,1,3,2,1,2
2023-06-01,262513,2,0,2,4,0,4
2023-06-01,262536,1,0,1,2,0,2
2023-06-01,262477,2,1,3,3,1,3
2023-06-01,53011,3,0,3,2,0,2
2023-06-01,263556,1,0,1,2,0,2
2023-06-01,262524,1,1,2,2,1,2
2023-06-01,271227,1,0,1,1,0,1
2023-06-01,252517,0,0,0,1,0,1
2023-06-01,52663,3,1,4,1,1,1
2023-06-01,271231,12,0,12,2,0,2
2023-06-01,272601,0,1,1,5,3,5
2023-06-01,52679,14,1,15,1,1,1
2023-06-01,262552,1,0,1,2,0,2
2023-06-01,53028,1,0,1,1,0,1
2023-06-01,262583,1,1,2,3,2,3
2023-06-01,262559,2,0,2,2,0,2
2023-06-01,53044,1,0,1,1,0,1
2023-06-01,28209,98,3,101,6,4,6
2023-06-01,262533,1,1,2,1,1,1
2023-06-01,28241,48,2,50,2,1,2
2023-06-01,262545,15,3,18,6,5,6
2023-06-01,263034,16,0,16,1,0,1
2023-06-01,262813,53,1,54,2,4,4
2023-06-01,53217,30,3,33,5,4,5
2023-06-01,263590,5,0,5,1,0,1
2023-06-01,270630,3,1,4,3,1,3
2023-06-01,53052,15,3,18,10,8,10
2023-06-01,271684,1,1,2,1,1,1
2023-06-01,270628,7,11,18,4,2,4
2023-06-01,270629,2,2,4,4,2,4
2023-06-01,28254,38,2,40,6,4,6
2023-06-01,52749,9,0,9,5,0,5
2023-06-01,271336,7,0,7,1,0,1
2023-06-01,271340,5,2,7,4,5,7
2023-06-01,271063,3,3,6,5,4,5
2023-06-01,271397,4,2,6,3,2,3
2023-06-01,52750,9,1,10,3,1,3
2023-06-01,271037,1,0,1,1,0,1
2023-06-01,262539,15,35,50,4,3,4
2023-06-01,262540,7,1,8,5,3,5
2023-06-01,52815,2,1,3,3,2,4
2023-06-01,262542,2,1,3,1,1,1
2023-06-01,262543,9,3,12,4,3,4
2023-06-01,52822,11,0,11,1,0,1
2023-06-01,52828,2,0,2,1,0,1
2023-06-01,262558,10,1,11,8,3,9
2023-06-01,53090,6,3,9,2,1,2
2023-06-01,53017,7,0,7,7,0,7
2023-06-01,53018,26,6,32,7,5,7
2023-06-01,272505,3,5,8,6,4,6
2023-06-01,262414,2,1,3,2,1,2
2023-06-01,52818,10,5,15,6,5,6
2023-06-01,270861,5,0,5,1,0,1
2023-06-01,262548,3,1,4,2,2,2
2023-06-01,52827,6,3,9,6,3,6
2023-06-01,262549,3,1,4,1,1,1
2023-06-01,262551,7,1,8,4,3,4
2023-06-01,52687,4,10,14,2,1,2
2023-06-01,269717,4,0,4,1,0,1
2023-06-01,53039,5,1,6,2,1,2
2023-06-01,262629,1,1,2,2,1,2
2023-06-01,52857,1,0,1,1,0,1
2023-06-01,28637,14,1,15,7,3,7
2023-06-01,262562,15,0,15,1,0,1
2023-06-01,52685,17,1,18,3,2,3
2023-06-01,270590,5,1,6,4,1,4
2023-06-01,263071,8,0,8,1,0,1
2023-06-01,53026,1,0,1,1,0,1
2023-06-01,262566,9,23,32,3,3,3
2023-06-01,52700,6,3,9,4,2,4
2023-06-01,52704,4,7,11,3,1,3
2023-06-01,263502,4,0,4,1,0,1
2023-06-01,271870,2,0,2,1,0,1
2023-06-01,11514,14,0,14,9,0,9
2023-06-01,270105,4,4,8,3,2,3
2023-06-01,52324,1,1,2,4,2,4
2023-06-01,262571,9,5,14,6,4,6
2023-06-01,262574,3,3,6,1,1,1
2023-06-01,270734,1,1,2,2,2,2
2023-06-01,270069,1,0,1,2,0,2
2023-06-01,263378,16,1,17,1,1,1
2023-06-01,270977,5,1,6,1,1,1
2023-06-01,270970,3,7,10,1,1,1
2023-06-01,263380,15,3,18,5,3,5
2023-06-01,271136,1,1,2,2,1,2
2023-06-01,271053,1,0,1,1,0,1
2023-06-01,271054,2,1,3,3,1,3
2023-06-01,270731,1,1,2,1,1,1
2023-06-01,270738,4,1,5,5,1,5
2023-06-01,271888,3,1,4,1,1,1
2023-06-01,28111,18,0,18,2,0,2
2023-06-01,270020,2,20,22,2,2,2
2023-06-01,263652,12,5,17,1,1,1
2023-06-01,263647,6,1,7,1,1,1
2023-06-01,53040,12,0,12,1,0,1
2023-06-01,262601,9,1,10,2,1,3
2023-06-01,262576,4,1,5,3,1,3
2023-06-01,52715,3,0,3,1,0,1
2023-06-01,262577,3,0,3,2,0,2
2023-06-01,262578,9,1,10,5,3,6
2023-06-01,263514,6,1,7,3,3,4
2023-06-01,262579,6,1,7,6,1,6
2023-06-01,52682,34,6,40,8,5,8
2023-06-01,272767,2,6,8,1,1,1
2023-06-01,273727,1,2,3,3,2,3
2023-06-01,52709,3,0,3,1,0,1
2023-06-01,263516,8,1,9,4,3,4
2023-06-01,52719,4,1,5,2,1,2
2023-06-01,273657,0,1,1,2,1,2
2023-06-01,263534,7,3,10,5,3,5
2023-06-01,262581,7,0,7,6,0,6
2023-06-01,262584,1,1,2,1,1,1
2023-06-01,53095,1,3,4,4,4,6
2023-06-01,53041,6,1,7,3,1,3
2023-06-01,262586,5,0,5,1,0,1
2023-06-01,52727,8,4,12,2,1,2
2023-06-01,52740,3,2,5,1,1,1
2023-06-01,52735,2,0,2,4,0,4
2023-06-01,270747,4,0,4,1,0,1
2023-06-01,52731,5,2,7,1,1,1
2023-06-01,271251,7,1,8,3,1,3
2023-06-01,262597,9,0,9,2,0,2
2023-06-01,52737,9,1,10,3,1,3
2023-06-01,262603,3,0,3,2,0,2
2023-06-01,262608,2,1,3,1,1,1
2023-06-01,52552,3,0,3,2,0,2
2023-06-01,52569,1,0,1,3,0,3
2023-06-01,262609,5,4,9,6,4,6
2023-06-01,52743,6,1,7,2,1,2
2023-06-01,262613,3,1,4,1,1,1
2023-06-01,270787,3,1,4,1,1,1
2023-06-01,52558,2,8,10,2,2,2
2023-06-01,262612,46,48,94,1,1,1
2023-06-01,53213,22,1,23,1,1,1
2023-06-01,262515,3,0,3,2,0,2
2023-06-01,271171,1,0,1,2,0,2
2023-06-01,52825,1,0,1,1,0,1
2023-06-01,270602,7,7,14,3,3,3
2023-06-01,270603,1,0,1,1,0,1
2023-06-01,52556,3,1,4,1,1,1
2023-06-01,262620,8,1,9,6,4,6
2023-06-01,271373,5,5,10,7,3,8
2023-06-01,52549,10,3,13,12,4,13
2023-06-01,52550,4,2,6,2,3,3
2023-06-01,52567,7,0,7,2,0,2
2023-06-01,262623,4,0,4,3,0,3
2023-06-01,262625,7,2,9,2,2,2
2023-06-01,262506,6,3,9,3,3,3
2023-06-01,262628,14,4,18,1,1,1
2023-06-01,52570,9,1,10,3,2,3
2023-06-01,52581,1,0,1,1,0,1
2023-06-01,271080,7,1,8,2,1,2
2023-06-01,52582,2,0,2,3,0,3
2023-06-01,270084,3,0,3,2,0,2
2023-06-01,52608,1,1,2,2,2,3
2023-06-01,271639,6,6,12,3,5,5
2023-06-01,52575,1,1,2,1,1,1
2023-06-01,52576,8,0,8,2,0,2
2023-06-01,52854,1,0,1,1,0,1
2023-06-01,52577,3,0,3,1,0,1
2023-06-01,262640,5,0,5,1,0,1
2023-06-01,52578,1,0,1,2,0,2
2023-06-01,263377,6,1,7,4,3,4
2023-06-01,52586,1,0,1,2,0,2
2023-06-01,263383,1,0,1,1,0,1
2023-06-01,52589,1,0,1,1,0,1
2023-06-01,270676,2,0,2,1,0,1
2023-06-01,262648,7,1,8,3,1,3
2023-06-01,52591,5,1,6,1,1,1
2023-06-01,262650,14,1,15,3,3,3
2023-06-01,262652,1,0,1,2,0,2
2023-06-01,270700,1,1,2,2,2,2
2023-06-01,28334,17,5,22,6,5,6
2023-06-01,262654,1,1,2,3,1,3
2023-06-01,262655,1,1,2,3,3,3
2023-06-01,263094,1,0,1,4,0,4
2023-06-01,263095,1,0,1,1,0,1
2023-06-01,52594,4,1,5,4,1,5
2023-06-01,263385,5,3,8,2,1,2
2023-06-01,262303,2,1,3,1,1,1
2023-06-01,263387,2,1,3,5,4,5
2023-06-01,262304,2,1,3,3,3,4
2023-06-01,52583,15,0,15,5,0,5
2023-06-01,262306,7,1,8,6,2,6
2023-06-01,52587,4,0,4,1,0,1
2023-06-01,262309,8,1,9,2,1,2
2023-06-01,61905,1,1,2,1,1,1
2023-06-01,262310,4,0,4,1,0,1
2023-06-01,271155,3,3,6,2,1,2
2023-06-01,270061,2,0,2,1,0,1
2023-06-01,263389,5,1,6,3,2,3
2023-06-01,271030,4,0,4,1,0,1
2023-06-01,61897,3,0,3,2,0,2
2023-06-01,61898,2,0,2,2,0,2
2023-06-01,263425,1,0,1,2,0,2
2023-06-01,263428,1,1,2,3,1,3
2023-06-01,263147,1,0,1,2,0,2
2023-06-01,263488,1,0,1,2,0,2
2023-06-01,263429,1,0,1,1,0,1
2023-06-01,270798,4,0,4,2,0,2
2023-06-01,263293,2,1,3,1,1,1
2023-06-01,263431,3,5,8,4,3,4
2023-06-01,61899,5,0,5,4,0,4
2023-06-01,263437,9,0,9,1,0,1
2023-06-01,263436,16,1,17,1,1,1
2023-06-01,263440,4,2,6,1,1,1
2023-06-01,28225,29,7,36,7,4,7
2023-06-01,263295,6,1,7,3,2,3
2023-06-01,263446,1,0,1,1,0,1
2023-06-01,271035,5,0,5,1,0,1
2023-06-01,270899,4,3,7,3,3,3
2023-06-01,263454,4,1,5,1,1,1
2023-06-01,263449,2,0,2,1,0,1
2023-06-01,263224,12,0,12,2,0,2
2023-06-01,263108,8,1,9,2,1,2
2023-06-01,263120,7,3,10,7,4,7
2023-06-01,263117,2,1,3,1,1,1
2023-06-01,263126,5,1,6,4,1,4
2023-06-01,28586,17,9,26,6,4,6
2023-06-01,23002,8,3,11,4,2,4
2023-06-01,28279,44,3,47,6,3,6
2023-06-01,263130,6,0,6,1,0,1
2023-06-01,263163,8,0,8,1,0,1
2023-06-01,263142,9,3,12,2,2,2
2023-06-01,28366,33,1,34,3,3,4
2023-06-01,52861,6,3,9,4,3,4
2023-06-01,263153,5,1,6,6,6,7
2023-06-01,52869,8,1,9,4,4,4
2023-06-01,53075,29,7,36,5,6,7
2023-06-01,262610,31,1,32,4,3,4
2023-06-01,262615,22,0,22,3,0,3
2023-06-01,262624,19,4,23,5,3,5
2023-06-01,262742,25,13,38,4,4,5
2023-06-01,28640,77,12,89,6,4,7
2023-06-01,52853,1,0,1,1,0,1
2023-06-01,262637,25,1,26,4,3,4
2023-06-01,52855,18,0,18,3,0,3
2023-06-01,262639,8,0,8,2,0,2
2023-06-01,262651,7,1,8,2,2,2
2023-06-01,262653,28,4,32,1,1,1
2023-06-01,262313,23,1,24,5,3,5
2023-06-01,262314,10,4,14,5,3,5
2023-06-01,53006,8,1,9,1,1,1
2023-06-01,52690,10,4,14,4,3,5
2023-06-01,262329,9,1,10,3,1,3
2023-06-01,53101,9,0,9,5,0,5
2023-06-01,65431,0,0,0,2,0,2
2023-06-01,262311,5,3,8,6,4,7
2023-06-01,262312,3,1,4,2,1,2
2023-06-01,262315,5,2,7,2,2,2
2023-06-01,52616,2,0,2,1,0,1
2023-06-01,271305,3,1,4,3,3,3
2023-06-01,28432,8,1,9,4,1,4
2023-06-01,270152,1,0,1,1,0,1
2023-06-01,52602,1,1,2,1,1,1
2023-06-01,262321,5,0,5,2,0,2
2023-06-01,271357,1,1,2,1,1,1
2023-06-01,52618,5,0,5,1,0,1
2023-06-01,52624,8,0,8,7,0,7
2023-06-01,271660,0,1,1,4,3,4
2023-06-01,262325,5,1,6,1,1,1
2023-06-01,270541,7,5,12,3,3,3
2023-06-01,61608,0,5,5,4,4,6
2023-06-01,61602,4,1,5,4,2,5
2023-06-01,272450,0,5,5,2,2,3
2023-06-01,272252,0,7,7,3,3,4
2023-06-01,52629,3,0,3,2,0,2
2023-06-01,262327,27,1,28,3,1,3
2023-06-01,262328,1,2,3,4,2,4
2023-06-01,52633,3,1,4,2,2,2
2023-06-01,52605,7,1,8,3,1,3
2023-06-01,52635,5,1,6,2,2,2
2023-06-01,52642,1,1,2,1,1,1
2023-06-01,52606,4,0,4,1,0,1
2023-06-01,273649,3,3,6,1,1,1
2023-06-01,262334,2,0,2,1,0,1
2023-06-01,262335,3,0,3,1,0,1
2023-06-01,271308,7,1,8,1,1,1
2023-06-01,52628,3,0,3,1,0,1
2023-06-01,52645,1,0,1,2,0,2
2023-06-01,28356,1,0,1,1,0,1
2023-06-01,52611,4,4,8,3,2,3
2023-06-01,52641,2,3,5,1,1,1
2023-06-01,52646,3,0,3,2,0,2
2023-06-01,52886,3,1,4,3,1,3
2023-06-01,262349,5,0,5,2,0,2
2023-06-01,263122,1,0,1,2,0,2
2023-06-01,263045,1,0,1,2,0,2
2023-06-01,262351,5,1,6,2,1,2
2023-06-01,52647,5,0,5,1,0,1
2023-06-01,262699,3,4,7,1,1,1
2023-06-01,271802,1,1,2,1,1,1
2023-06-01,271346,3,1,4,2,1,2
2023-06-01,271401,1,0,1,1,0,1
2023-06-01,271862,3,0,3,3,0,3
2023-06-01,271856,1,0,1,1,0,1
2023-06-01,271392,1,1,2,3,3,3
2023-06-01,271374,3,1,4,3,1,3
2023-06-01,263520,6,1,7,6,5,7
2023-06-01,262363,8,0,8,1,0,1
2023-06-01,262361,8,0,8,2,0,2
2023-06-01,262364,1,0,1,2,0,2
2023-06-01,270691,1,5,6,1,1,1
2023-06-01,270692,4,1,5,1,1,1
2023-06-01,52643,2,3,5,3,5,5
2023-06-01,262805,17,0,17,8,0,8
2023-06-01,262368,4,0,4,1,0,1
2023-06-01,262385,12,3,15,4,3,4
2023-06-01,269988,6,0,6,2,0,2
2023-06-01,28148,1,0,1,2,0,2
2023-06-01,28253,2,0,2,3,0,3
2023-06-01,28196,3,0,3,7,0,7
2023-06-01,28337,5,1,6,1,1,1
2023-06-01,263131,5,0,5,1,0,1
2023-06-01,52523,1,0,1,2,0,2
2023-06-01,28587,8,1,9,2,1,2
2023-06-01,270813,2,0,2,1,0,1
2023-06-01,270086,3,0,3,1,0,1
2023-06-01,263418,1,0,1,1,0,1
2023-06-01,262661,2,1,3,1,1,1
2023-06-01,28592,7,0,7,1,0,1
2023-06-01,262381,11,1,12,4,3,5
2023-06-01,262383,6,0,6,4,0,4
2023-06-01,270578,5,0,5,1,0,1
2023-06-01,270588,6,0,6,1,0,1
2023-06-01,271153,4,0,4,1,0,1
2023-06-01,262389,3,0,3,1,0,1
2023-06-01,28639,16,6,22,6,5,6
2023-06-01,262390,3,0,3,4,0,4
2023-06-01,263061,1,1,2,1,1,1
2023-06-01,263063,1,0,1,2,0,2
2023-06-01,52883,1,0,1,3,0,3
2023-06-01,263088,1,0,1,1,0,1
2023-06-01,52885,1,1,2,4,3,4
2023-06-01,263630,1,0,1,3,0,3
2023-06-01,262395,7,5,12,1,1,1
2023-06-01,271003,6,0,6,1,0,1
2023-06-01,52529,2,0,2,1,0,1
2023-06-01,52538,1,0,1,1,0,1
2023-06-01,262397,1,0,1,1,0,1
2023-06-01,52874,9,1,10,2,1,2
2023-06-01,263584,9,1,10,1,1,1
2023-06-01,52520,4,1,5,2,2,2
2023-06-01,263041,1,1,2,2,2,2
2023-06-01,262798,14,3,17,3,2,3
2023-06-01,262937,3,3,6,1,1,1
2023-06-01,52876,12,0,12,3,0,3
2023-06-01,262938,3,3,6,1,1,1
2023-06-01,263048,3,0,3,1,0,1
2023-06-01,271644,3,3,6,3,1,3
2023-06-01,271038,7,1,8,1,1,1
2023-06-01,270888,5,4,9,5,4,5
2023-06-01,270889,5,1,6,1,1,1
2023-06-01,28335,7,11,18,5,5,6
2023-06-01,28342,9,0,9,1,0,1
2023-06-01,262382,13,1,14,2,1,2
2023-06-01,262388,16,0,16,2,0,2
2023-06-01,263393,8,2,10,3,2,3
2023-06-01,270791,4,2,6,1,1,1
2023-06-01,270782,5,0,5,1,0,1
2023-06-01,270783,4,0,4,3,0,3
2023-06-01,271185,1,1,2,3,4,5
2023-06-01,270797,1,0,1,1,0,1
2023-06-01,52875,7,1,8,5,1,5
2023-06-01,263600,4,0,4,1,0,1
2023-06-01,263606,5,0,5,6,0,6
2023-06-01,263109,6,2,8,7,3,7
2023-06-01,271784,5,0,5,3,0,3
2023-06-01,28277,9,2,11,2,3,3
2023-06-01,263594,5,0,5,3,0,3
2023-06-01,61911,5,0,5,2,0,2
2023-06-01,263595,14,3,17,7,3,7
2023-06-01,53050,23,2,25,5,4,5
2023-06-01,53225,11,1,12,5,1,5
2023-06-01,262700,33,2,35,2,2,3
2023-06-01,263053,31,24,55,6,4,6
2023-06-01,263066,13,0,13,2,0,2
2023-06-01,263087,46,1,47,11,4,11
2023-06-01,52614,7,0,7,3,0,3
2023-06-01,52748,9,4,13,1,1,1
2023-06-01,65434,0,0,0,2,0,2
2023-06-01,61912,3,3,6,1,1,1
2023-06-01,52519,3,0,3,1,0,1
2023-06-01,52535,2,1,3,3,4,5
2023-06-01,270585,3,3,6,1,1,1
2023-06-01,270587,4,0,4,2,0,2
2023-06-01,270595,5,5,10,3,1,4
2023-06-01,270710,3,1,4,2,1,2
2023-06-01,271477,5,5,10,8,5,8
2023-06-01,52542,7,5,12,1,1,1
2023-06-01,61889,15,2,17,1,1,1
2023-06-01,263106,1,0,1,1,0,1
2023-06-01,262942,5,7,12,1,1,1
2023-06-01,263373,7,1,8,5,6,6
2023-06-01,262947,3,1,4,2,2,2
2023-06-01,28349,64,1,65,3,2,4
2023-06-01,262963,1,1,2,3,1,3
2023-06-01,270952,1,1,2,1,1,1
2023-06-01,263560,1,0,1,2,0,2
2023-06-01,263376,1,0,1,2,0,2
2023-06-01,262959,4,0,4,2,0,2
2023-06-01,262298,14,0,14,2,0,2
2023-06-01,52752,15,2,17,5,1,5
2023-06-01,262828,24,2,26,6,3,6
2023-06-01,52773,2,0,2,2,0,2
2023-06-01,263620,8,1,9,6,1,6
2023-06-01,52778,2,0,2,2,0,2
2023-06-01,263119,4,1,5,1,1,1
2023-06-01,65401,0,10,10,2,1,3
2023-06-01,65436,0,0,0,2,0,2
2023-06-01,28362,4,1,5,1,1,1
2023-06-01,52896,3,1,4,3,3,3
2023-06-01,52902,3,1,4,2,2,3
2023-06-01,271811,1,0,1,1,0,1
2023-06-01,271785,2,2,4,1,1,1
2023-06-01,262673,165,3,168,1,1,1
2023-06-01,52920,7,8,15,5,4,5
2023-06-01,52923,16,0,16,3,0,3
2023-06-01,271589,1,1,2,1,1,1
2023-06-01,263112,5,1,6,2,1,2
2023-06-01,263116,6,1,7,1,1,1
2023-06-01,52924,7,1,8,4,3,4
2023-06-01,270817,1,1,2,2,2,2
2023-06-01,52927,9,3,12,2,2,2
2023-06-01,52930,21,1,22,5,3,5
2023-06-01,52931,13,0,13,7,0,7
2023-06-01,52932,7,9,16,4,4,4
2023-06-01,263577,1,0,1,1,0,1
2023-06-01,266228,1,1,2,5,5,5
2023-06-01,52936,6,1,7,2,1,2
2023-06-01,263419,3,0,3,1,0,1
2023-06-01,53008,15,1,16,6,2,6
2023-06-01,267452,20,1,21,6,2,6
2023-06-01,263135,1,1,2,1,1,1
2023-06-01,262977,24,5,29,6,5,6
2023-06-01,263455,1,1,2,2,2,2
2023-06-01,263453,4,1,5,1,1,1
2023-06-01,263461,7,1,8,6,2,6
2023-06-01,263457,8,2,10,2,1,2
2023-06-01,273650,0,1,1,4,3,4
2023-06-01,263459,7,1,8,4,5,5
2023-06-01,263313,1,0,1,1,0,1
2023-06-01,263403,1,0,1,1,0,1
2023-06-01,263406,1,0,1,3,0,3
2023-06-01,263464,8,2,10,2,1,2
2023-06-01,263465,16,1,17,1,1,2
2023-06-01,263118,3,0,3,2,0,2
2023-06-01,61933,1,0,1,1,0,1
2023-06-01,263303,1,1,2,1,1,1
2023-06-01,65449,0,0,0,2,0,2
2023-06-01,52775,1,1,2,1,1,1
2023-06-01,263628,7,1,8,2,2,2
2023-06-01,52781,30,3,33,5,3,6
2023-06-01,263636,9,0,9,2,0,2
2023-06-01,270913,2,0,2,1,0,1
2023-06-01,270969,1,1,2,1,1,1
2023-06-01,270916,7,7,14,4,3,4
2023-06-01,52793,9,2,11,3,1,3
2023-06-01,270620,7,0,7,1,0,1
2023-06-01,270605,4,1,5,1,1,1
2023-06-01,270685,1,0,1,1,0,1
2023-06-01,269983,2,2,4,1,1,1
2023-06-01,52824,7,7,14,5,5,5
2023-06-01,263660,3,0,3,4,0,4
2023-06-01,52654,20,1,21,3,4,5
2023-06-01,52668,10,0,10,6,0,6
2023-06-01,262789,25,0,25,2,0,2
2023-06-01,270727,3,3,6,3,2,3
2023-06-01,264436,5,4,9,1,2,2
2023-06-01,270737,3,1,4,2,1,2
2023-06-01,270019,2,0,2,1,0,1
2023-06-01,270742,4,2,6,1,1,1
2023-06-01,270730,7,7,14,1,1,1
2023-06-01,52673,13,0,13,3,0,3
2023-06-01,270627,7,4,11,5,2,5
2023-06-01,270678,3,3,6,1,1,1
2023-06-01,263467,21,0,21,4,0,4
2023-06-01,263382,10,4,14,3,4,4
2023-06-01,263388,8,3,11,2,2,2
2023-06-01,61906,7,1,8,4,2,4
2023-06-01,263398,6,0,6,3,0,3
2023-06-01,263399,4,1,5,1,1,1
2023-06-01,52562,11,32,43,4,5,5
2023-06-01,271000,3,7,10,1,1,1
2023-06-01,271001,3,3,6,1,1,1
2023-06-01,271172,3,1,4,1,1,1
2023-06-01,271209,1,1,2,1,1,1
2023-06-01,271002,4,3,7,4,3,4
2023-06-01,271006,3,1,4,1,1,1
2023-06-01,271228,3,3,6,2,2,2
2023-06-01,271016,3,3,6,5,3,5
2023-06-01,272268,0,1,1,3,1,3
2023-06-01,27672,24,4,28,1,1,1
2023-06-01,28481,44,6,50,1,1,1
2023-06-01,28531,6,3,9,2,3,3
2023-06-01,28536,5,12,17,1,1,1
2023-06-01,28532,5,3,8,2,1,2
2023-06-01,28535,5,3,8,1,2,2
2023-06-01,53055,35,3,38,2,1,2
2023-06-01,271874,2,1,3,2,1,2
2023-06-01,271837,2,5,7,1,1,1
2023-06-01,28538,7,0,7,1,0,1
2023-06-01,28548,183,109,292,4,2,4
2023-06-01,28512,54,15,69,2,1,2
2023-06-01,28541,11,0,11,1,0,1
2023-06-01,270161,52,33,85,4,3,4
2023-06-01,28523,8,1,9,2,1,2
2023-06-01,64712,3,0,3,1,0,1
2023-06-01,27866,17,0,17,1,0,1
2023-06-01,27831,9,1,10,1,1,1
2023-06-01,198489,1,0,1,3,0,3
2023-06-01,34656,2,0,2,3,0,3
2023-06-01,199371,1,0,1,1,0,1
2023-06-01,209168,1,0,1,1,0,1
2023-06-01,208750,1,0,1,1,0,1
2023-06-01,56872,1,0,1,1,0,1
2023-06-01,205748,1,0,1,2,0,2
2023-06-01,20956,3,0,3,1,0,1
2023-06-01,48474,3,0,3,1,0,1
2023-06-01,43038,7,0,7,1,0,1
2023-06-01,210279,1,0,1,1,0,1
2023-06-01,210085,1,0,1,1,0,1
2023-06-01,205257,1,0,1,3,0,3
2023-06-01,207311,1,0,1,2,0,2
2023-06-01,200519,5,4,9,1,1,1
2023-06-01,51118,1,0,1,1,0,1
2023-06-01,199338,2,0,2,6,0,6
2023-06-01,196966,9,0,9,3,0,3
2023-06-01,50653,3,0,3,3,0,3
2023-06-01,50655,2,3,5,5,3,7
2023-06-01,198691,1,0,1,1,0,1
2023-06-01,50693,1,0,1,1,0,1
2023-06-01,50834,1,0,1,2,0,2
2023-06-01,203258,2,0,2,1,0,1
2023-06-01,52070,2,0,2,1,0,1
2023-06-01,52155,4,0,4,2,0,2
2023-06-01,16338,0,0,0,2,0,2
2023-06-01,35454,9,0,9,3,0,3
2023-06-01,50713,1,0,1,1,0,1
2023-06-01,39806,20,2,22,4,1,4
2023-06-01,20574,3,1,4,1,1,1
2023-06-01,206826,1,0,1,1,0,1
2023-06-01,197480,2,0,2,3,0,3
2023-06-01,203560,4,4,8,1,1,1
2023-06-01,21419,5,0,5,2,0,2
2023-06-01,43635,1,0,1,1,0,1
2023-06-01,196997,2,1,3,6,4,6
2023-06-01,48631,3,0,3,2,0,2
2023-06-01,210797,1,0,1,1,0,1
2023-06-01,57641,1,0,1,2,0,2
2023-06-01,50858,3,2,5,8,5,8
2023-06-01,203987,2,0,2,1,0,1
2023-06-01,51899,7,0,7,1,0,1
2023-06-01,50901,1,0,1,1,0,1
2023-06-01,50894,3,0,3,1,0,1
2023-06-01,51294,1,0,1,2,0,2
2023-06-01,50953,1,0,1,2,0,2
2023-06-01,197036,7,5,12,3,2,3
2023-06-01,196724,3,1,4,3,2,3
2023-06-01,204057,2,0,2,3,0,3
2023-06-01,198916,7,0,7,6,0,6
2023-06-01,50971,1,1,2,1,1,1
2023-06-01,6836,5,0,5,3,0,3
2023-06-01,212318,3,0,3,3,0,3
2023-06-01,201275,1,0,1,2,0,2
2023-06-01,200762,1,0,1,2,0,2
2023-06-01,208165,1,0,1,1,0,1
2023-06-01,61403,7,0,7,2,0,2
2023-06-01,60139,10,0,10,6,0,6
2023-06-01,6019,0,0,0,1,0,1
2023-06-01,43550,20,0,20,4,0,4
2023-06-01,199949,1,0,1,1,0,1
2023-06-01,196991,53,0,53,5,0,5
2023-06-01,48506,19,0,19,3,0,3
2023-06-01,60261,1,0,1,2,0,2
2023-06-01,198818,3,1,4,4,4,4
2023-06-01,28902,10,1,11,2,1,2
2023-06-01,210064,1,0,1,1,0,1
2023-06-01,206325,1,0,1,1,0,1
2023-06-01,201474,3,0,3,2,0,2
2023-06-01,206791,1,0,1,4,0,4
2023-06-01,44750,2,0,2,1,0,1
2023-06-01,202390,1,0,1,3,0,3
2023-06-01,59744,7,0,7,1,0,1
2023-06-01,50823,2,0,2,7,0,7
2023-06-01,201092,1,0,1,1,0,1
2023-06-01,200503,1,1,2,3,2,3
2023-06-01,204277,1,0,1,1,0,1
2023-06-01,203992,1,0,1,1,0,1
2023-06-01,203516,1,0,1,1,0,1
2023-06-01,203697,1,0,1,2,0,2
2023-06-01,203699,1,0,1,1,0,1
2023-06-01,206653,3,0,3,5,0,5
2023-06-01,61326,1,0,1,2,0,2
2023-06-01,206812,5,0,5,2,0,2
2023-06-01,200152,1,0,1,2,0,2
2023-06-01,60556,1,0,1,3,0,3
2023-06-01,12841,1,0,1,3,0,3
2023-06-01,201774,1,0,1,3,0,3
2023-06-01,20946,1,0,1,3,0,3
2023-06-01,201797,1,0,1,2,0,2
2023-06-01,200215,1,0,1,3,0,3
2023-06-01,208503,1,0,1,2,0,2
2023-06-01,20527,1,0,1,1,0,1
2023-06-01,203784,1,1,2,7,1,7
2023-06-01,60085,1,0,1,3,0,3
2023-06-01,49351,1,0,1,2,0,2
2023-06-01,199261,1,0,1,4,0,4
2023-06-01,60857,1,0,1,1,0,1
2023-06-01,62208,1,0,1,1,0,1
2023-06-01,51584,1,0,1,1,0,1
2023-06-01,49091,6,0,6,2,0,2
2023-06-01,50205,1,0,1,1,0,1
2023-06-01,59860,1,1,2,1,1,1
2023-06-01,60770,2,0,2,1,0,1
2023-06-01,57192,1,0,1,1,0,1
2023-06-01,28737,1,0,1,1,0,1
2023-06-01,39426,1,0,1,1,0,1
2023-06-01,41793,1,0,1,1,0,1
2023-06-01,207587,2,1,3,3,3,3
2023-06-01,58076,1,0,1,1,0,1
2023-06-01,47759,44,1,45,1,1,2
2023-06-01,1756,96,0,96,5,0,5
2023-06-01,51246,1,0,1,1,0,1
2023-06-01,202965,1,0,1,1,0,1
2023-06-01,202960,1,0,1,1,0,1
2023-06-01,211279,8,0,8,1,0,1
2023-06-01,35534,1,0,1,3,0,3
2023-06-01,62337,2,0,2,1,0,1
2023-06-01,48205,1,0,1,1,0,1
2023-06-01,211504,1,0,1,1,0,1
2023-06-01,61208,2,0,2,1,0,1
2023-06-01,205835,2,0,2,1,0,1
2023-06-01,8263,3,0,3,1,0,1
2023-06-01,24866,4,0,4,1,0,1
2023-06-01,200504,2,0,2,3,0,3
2023-06-01,203456,1,0,1,1,0,1
2023-06-01,15614,2,1,3,5,2,5
2023-06-01,202485,1,0,1,1,0,1
2023-06-01,56958,2,1,3,4,4,5
2023-06-01,210092,2,0,2,1,0,1
2023-06-01,205401,1,0,1,1,0,1
2023-06-01,201416,1,1,2,2,2,2
2023-06-01,212695,1,1,2,2,1,2
2023-06-01,49276,1,0,1,1,0,1
2023-06-01,62026,1,0,1,2,0,2
2023-06-01,44173,10,0,10,1,0,1
2023-06-01,41098,3,0,3,1,0,1
2023-06-01,197047,1,0,1,2,0,2
2023-06-01,197186,1,0,1,2,0,2
2023-06-01,41517,3,0,3,3,0,3
2023-06-01,197025,8,0,8,2,0,2
2023-06-01,210801,1,1,2,1,1,1
2023-06-01,211926,1,0,1,1,0,1
2023-06-01,24893,2,0,2,2,0,2
2023-06-01,51379,1,0,1,2,0,2
2023-06-01,51624,2,0,2,3,0,3
2023-06-01,64492,1,1,2,4,1,4
2023-06-01,197233,1,0,1,1,0,1
2023-06-01,39065,6,0,6,5,0,5
2023-06-01,197262,1,0,1,4,0,4
2023-06-01,59658,3,0,3,1,0,1
2023-06-01,203732,2,1,3,2,2,2
2023-06-01,33806,10,0,10,4,0,4
2023-06-01,12438,5,0,5,3,0,3
2023-06-01,51524,1,0,1,1,0,1
2023-06-01,35676,8,5,13,6,4,6
2023-06-01,200714,1,0,1,3,0,3
2023-06-01,204045,1,0,1,2,0,2
2023-06-01,57906,2,0,2,2,0,2
2023-06-01,203542,1,0,1,2,0,2
2023-06-01,51552,5,0,5,3,0,3
2023-06-01,204126,1,0,1,6,0,6
2023-06-01,51864,1,0,1,1,0,1
2023-06-01,51590,1,0,1,4,0,4
2023-06-01,200755,1,0,1,2,0,2
2023-06-01,51636,1,1,2,3,3,5
2023-06-01,51705,8,0,8,3,0,3
2023-06-01,3325,9,0,9,2,0,2
2023-06-01,51390,4,0,4,5,0,5
2023-06-01,51343,1,0,1,8,0,8
2023-06-01,42546,1,0,1,5,0,5
2023-06-01,57366,1,0,1,1,0,1
2023-06-01,56426,17,0,17,3,0,3
2023-06-01,48927,4,1,5,7,6,9
2023-06-01,209955,4,0,4,1,0,1
2023-06-01,196994,8,0,8,3,0,3
2023-06-01,50815,2,0,2,2,0,2
2023-06-01,50539,2,0,2,3,0,3
2023-06-01,196735,2,1,3,6,1,6
2023-06-01,197542,1,0,1,1,0,1
2023-06-01,197049,1,0,1,3,0,3
2023-06-01,204531,1,0,1,1,0,1
2023-06-01,35695,1,0,1,3,0,3
2023-06-01,41062,5,1,6,1,1,1
2023-06-01,201475,1,0,1,2,0,2
2023-06-01,204587,1,0,1,2,0,2
2023-06-01,206103,2,0,2,3,0,3
2023-06-01,205325,1,0,1,3,0,3
2023-06-01,59853,4,0,4,1,0,1
2023-06-01,29245,2,0,2,3,0,3
2023-06-01,51112,4,0,4,1,0,1
2023-06-01,212873,1,0,1,2,0,2
2023-06-01,212153,1,0,1,2,0,2
2023-06-01,210518,1,0,1,1,0,1
2023-06-01,51133,1,0,1,3,0,3
2023-06-01,197119,1,0,1,1,0,1
2023-06-01,34192,10,0,10,2,0,2
2023-06-01,50331,1,0,1,6,0,6
2023-06-01,51216,1,0,1,2,0,2
2023-06-01,62188,1,1,2,1,1,1
2023-06-01,57454,1,0,1,1,0,1
2023-06-01,51210,1,1,2,1,1,1
2023-06-01,50752,3,0,3,2,0,2
2023-06-01,49777,5,0,5,2,0,2
2023-06-01,43826,1,1,2,4,2,4
2023-06-01,50789,1,0,1,1,0,1
2023-06-01,34824,1,0,1,2,0,2
2023-06-01,204389,5,0,5,5,0,5
2023-06-01,212922,1,0,1,1,0,1
2023-06-01,208507,3,0,3,3,0,3
2023-06-01,197494,1,0,1,3,0,3
2023-06-01,50987,1,0,1,1,0,1
2023-06-01,47739,1,0,1,1,0,1
2023-06-01,51077,5,0,5,2,0,2
2023-06-01,51079,1,0,1,3,0,3
2023-06-01,202281,11,0,11,4,0,4
2023-06-01,62236,2,0,2,2,0,2
2023-06-01,50553,3,0,3,5,0,5
2023-06-01,197129,1,0,1,1,0,1
2023-06-01,204447,1,0,1,2,0,2
2023-06-01,204559,1,0,1,3,0,3
2023-06-01,51411,1,0,1,2,0,2
2023-06-01,42775,3,1,4,1,1,1
2023-06-01,205297,2,0,2,2,0,2
2023-06-01,207872,2,0,2,1,0,1
2023-06-01,56727,1,0,1,1,0,1
2023-06-01,56710,1,0,1,1,0,1
2023-06-01,134679,1,0,1,1,0,1
2023-06-01,134408,1,0,1,4,0,4
2023-06-01,51665,10,0,10,3,0,3
2023-06-01,211347,2,2,4,1,1,1
2023-06-01,211515,1,0,1,2,0,2
2023-06-01,56666,1,0,1,2,0,2
2023-06-01,197150,1,0,1,1,0,1
2023-06-01,15848,3,1,4,3,2,4
2023-06-01,210232,4,1,5,6,2,7
2023-06-01,39448,1,0,1,1,0,1
2023-06-01,397246,1,0,1,2,0,2
2023-06-01,197201,1,0,1,2,0,2
2023-06-01,198023,6,0,6,4,0,4
2023-06-01,209162,1,0,1,1,0,1
2023-06-01,206865,3,0,3,2,0,2
2023-06-01,33801,1,0,1,1,0,1
2023-06-01,212941,9,0,9,2,0,2
2023-06-01,197083,1,0,1,4,0,4
2023-06-01,197046,2,1,3,4,1,4
2023-06-01,50966,8,1,9,6,3,6
2023-06-01,25225,4,1,5,3,3,3
2023-06-01,50998,3,2,5,4,3,4
2023-06-01,49653,3,0,3,8,0,8
2023-06-01,44099,1,0,1,1,0,1
2023-06-01,197063,8,0,8,6,0,6
2023-06-01,51010,6,0,6,2,0,2
2023-06-01,60958,1,0,1,1,0,1
2023-06-01,51037,1,0,1,3,0,3
2023-06-01,21161,5,1,6,8,5,10
2023-06-01,57420,6,0,6,8,0,8
2023-06-01,197157,1,0,1,2,0,2
2023-06-01,31132,1,0,1,1,0,1
2023-06-01,51080,3,0,3,3,0,3
2023-06-01,51139,2,0,2,3,0,3
2023-06-01,208927,1,1,2,2,2,2
2023-06-01,51097,1,0,1,1,0,1
2023-06-01,12290,1,1,2,5,2,5
2023-06-01,51114,6,0,6,3,0,3
2023-06-01,51128,1,0,1,1,0,1
2023-06-01,51137,1,1,2,1,3,3
2023-06-01,207733,2,0,2,1,0,1
2023-06-01,39730,2,1,3,1,1,1
2023-06-01,34535,1,2,3,2,1,2
2023-06-01,51961,2,0,2,1,0,1
2023-06-01,200993,1,2,3,1,1,1
2023-06-01,42812,2,1,3,8,4,8
2023-06-01,60820,2,1,3,1,1,1
2023-06-01,51417,2,1,3,2,1,2
2023-06-01,51182,8,1,9,3,3,5
2023-06-01,205499,5,0,5,2,0,2
2023-06-01,210094,1,1,2,1,1,1
2023-06-01,62291,4,0,4,4,0,4
2023-06-01,197008,4,0,4,3,0,3
2023-06-01,58193,3,0,3,1,0,1
2023-06-01,51319,2,1,3,2,3,3
2023-06-01,51311,1,0,1,2,0,2
2023-06-01,51243,5,2,7,1,1,1
2023-06-01,200209,2,2,4,3,3,3
2023-06-01,42019,1,0,1,1,0,1
2023-06-01,205786,1,0,1,1,0,1
2023-06-01,15388,3,1,4,3,3,4
2023-06-01,47479,1,0,1,4,0,4
2023-06-01,202749,1,0,1,1,0,1
2023-06-01,207069,1,0,1,1,0,1
2023-06-01,199565,7,0,7,1,0,1
2023-06-01,51127,2,1,3,3,3,3
2023-06-01,198012,1,0,1,4,0,4
2023-06-01,42890,2,0,2,2,0,2
2023-06-01,51409,14,0,14,9,0,9
2023-06-01,35838,2,1,3,2,2,2
2023-06-01,200689,2,2,4,3,1,3
2023-06-01,29605,4,1,5,7,5,7
2023-06-01,196932,1,1,2,2,2,2
2023-06-01,262174,3,0,3,2,0,2
2023-06-01,52460,3,0,3,1,0,1
2023-06-01,52459,2,0,2,3,0,3
2023-06-01,52464,1,0,1,1,0,1
2023-06-01,52480,1,0,1,1,0,1
2023-06-01,52472,1,0,1,3,0,3
2023-06-01,52275,4,0,4,8,0,8
2023-06-01,262261,1,0,1,1,0,1
2023-06-01,271235,1,1,2,1,1,1
2023-06-01,262265,1,0,1,1,0,1
2023-06-01,263169,1,0,1,1,0,1
2023-06-01,27989,6,0,6,5,0,5
2023-06-01,269885,1,0,1,1,0,1
2023-06-01,263193,1,0,1,1,0,1
2023-06-01,271362,4,2,6,2,1,2
2023-06-01,271408,5,1,6,3,2,3
2023-06-01,271415,5,1,6,1,1,1
2023-06-01,271318,5,0,5,1,0,1
2023-06-01,271498,4,1,5,3,1,3
2023-06-01,271368,3,3,6,1,1,1
2023-06-01,271459,7,2,9,5,3,5
2023-06-01,271319,3,1,4,1,1,1
2023-06-01,271361,4,0,4,2,2,3
2023-06-01,271317,1,2,3,1,1,1
2023-06-01,271364,7,3,10,3,1,3
2023-06-01,271876,1,0,1,1,0,1
2023-06-01,270140,1,1,2,1,1,1
2023-06-01,271909,4,0,4,1,0,1
2023-06-01,271634,3,1,4,2,1,2
2023-06-01,271306,5,1,6,3,1,3
2023-06-01,271325,4,1,5,5,2,5
2023-06-01,271048,1,0,1,2,0,2
2023-06-01,267907,1,0,1,1,0,1
2023-06-01,27894,2,0,2,2,0,2
2023-06-01,263200,1,0,1,1,0,1
2023-06-01,263204,1,1,2,1,1,1
2023-06-01,27879,19,1,20,4,1,4
2023-06-01,263206,1,0,1,2,0,2
2023-06-01,263217,3,0,3,2,0,2
2023-06-01,52494,5,0,5,7,0,7
2023-06-01,19747,4,0,4,5,0,5
2023-06-01,270832,3,0,3,1,0,1
2023-06-01,270833,7,3,10,1,1,1
2023-06-01,270840,3,3,6,2,2,2
2023-06-01,270839,3,0,3,1,0,1
2023-06-01,270846,2,1,3,1,1,1
2023-06-01,270044,4,0,4,3,0,3
2023-06-01,270047,4,0,4,1,0,1
2023-06-01,270858,5,0,5,3,0,3
2023-06-01,263231,2,0,2,1,0,1
2023-06-01,52371,8,0,8,2,0,2
2023-06-01,262933,2,0,2,3,0,3
2023-06-01,263220,1,0,1,1,0,1
2023-06-01,264666,1,0,1,1,0,1
2023-06-01,262930,1,0,1,3,0,3
2023-06-01,61835,3,0,3,1,0,1
2023-06-01,263232,2,1,3,1,2,3
2023-06-01,263230,5,1,6,1,1,1
2023-06-01,6535,66,2,68,2,1,2
2023-06-01,27995,51,0,51,3,0,3
2023-06-01,46090,3,0,3,4,0,4
2023-06-01,22698,43,1,44,2,1,2
2023-06-01,271773,23,6,29,6,4,6
2023-06-01,272945,2,0,2,1,0,1
2023-06-01,271103,1,1,2,1,1,1
2023-06-01,271104,3,4,7,1,1,1
2023-06-01,271121,7,6,13,1,1,1
2023-06-01,271154,5,5,10,4,4,4
2023-06-01,271162,2,1,3,2,1,2
2023-06-01,271105,7,0,7,1,0,1
2023-06-01,271106,3,1,4,1,1,1
2023-06-01,271124,3,3,6,1,1,1
2023-06-01,272278,1,1,2,1,1,1
2023-06-01,271125,7,1,8,1,1,1
2023-06-01,271144,3,3,6,1,1,1
2023-06-01,271127,1,3,4,1,1,1
2023-06-01,271128,3,1,4,3,3,4
2023-06-01,271156,1,1,2,1,1,1
2023-06-01,271774,1,0,1,1,0,1
2023-06-01,271129,4,1,5,1,1,1
2023-06-01,271147,5,0,5,2,0,2
2023-06-01,272466,3,4,7,1,1,1
2023-06-01,271130,3,0,3,1,0,1
2023-06-01,271131,5,4,9,4,3,4
2023-06-01,271789,1,0,1,1,0,1
2023-06-01,270090,3,0,3,2,0,2
2023-06-01,271132,5,0,5,3,3,5
2023-06-01,271226,2,1,3,6,1,6
2023-06-01,271107,3,1,4,2,1,2
2023-06-01,271146,3,4,7,2,2,2
2023-06-01,271825,2,8,10,2,2,3
2023-06-01,271198,4,6,10,4,4,4
2023-06-01,271148,7,9,16,3,5,5
2023-06-01,271164,1,1,2,1,1,1
2023-06-01,271150,2,4,6,6,6,8
2023-06-01,271149,7,3,10,1,1,1
2023-06-01,271151,3,1,4,2,1,2
2023-06-01,271190,2,9,11,3,1,3
2023-06-01,271206,1,1,2,3,1,3
2023-06-01,271178,5,1,6,2,2,2
2023-06-01,271166,6,0,6,2,0,2
2023-06-01,271207,5,0,5,2,0,2
2023-06-01,271152,4,3,7,2,1,2
2023-06-01,271184,4,5,9,1,1,1
2023-06-01,271192,4,4,8,5,4,6
2023-06-01,270928,2,1,3,5,4,6
2023-06-01,271165,4,0,4,3,0,3
2023-06-01,263195,3,1,4,3,1,3
2023-06-01,52369,32,0,32,3,0,3
2023-06-01,270051,1,0,1,2,0,2
2023-06-01,270850,7,0,7,1,0,1
2023-06-01,270859,5,4,9,4,2,4
2023-06-01,271324,6,1,7,4,3,6
2023-06-01,270274,3,1,4,3,3,3
2023-06-01,270841,5,1,6,4,1,4
2023-06-01,270976,4,1,5,4,3,4
2023-06-01,271011,7,5,12,8,6,8
2023-06-01,270847,5,1,6,2,2,2
2023-06-01,270848,3,1,4,3,1,3
2023-06-01,270851,5,5,10,6,4,6
2023-06-01,270914,5,1,6,1,2,2
2023-06-01,270852,4,0,4,2,0,2
2023-06-01,270853,1,0,1,1,0,1
2023-06-01,270854,3,2,5,2,1,2
2023-06-01,270872,4,1,5,2,1,2
2023-06-01,270855,5,0,5,4,0,4
2023-06-01,270873,5,1,6,2,1,2
2023-06-01,264659,12,0,12,3,0,3
2023-06-01,271062,6,0,6,3,0,3
2023-06-01,271113,5,1,6,3,1,3
2023-06-01,271065,4,0,4,2,0,2
2023-06-01,271159,5,0,5,1,0,1
2023-06-01,271064,7,5,12,5,4,5
2023-06-01,271070,1,1,2,1,1,1
2023-06-01,271075,7,1,8,4,2,4
2023-06-01,271114,3,1,4,2,2,3
2023-06-01,271240,3,1,4,1,1,1
2023-06-01,270082,1,1,2,1,1,1
2023-06-01,271139,7,1,8,1,1,1
2023-06-01,271140,7,6,13,1,1,1
2023-06-01,271066,5,0,5,1,0,1
2023-06-01,271068,1,1,2,1,1,2
2023-06-01,271116,6,3,9,5,3,5
2023-06-01,271241,4,1,5,2,1,2
2023-06-01,271074,5,2,7,4,3,4
2023-06-01,271117,5,5,10,5,4,5
2023-06-01,271071,1,1,2,1,1,1
2023-06-01,271047,7,1,8,3,1,3
2023-06-01,271073,4,4,8,1,1,1
2023-06-01,271085,4,1,5,1,1,1
2023-06-01,271244,5,1,6,2,1,2
2023-06-01,271086,1,0,1,1,0,1
2023-06-01,271097,1,1,2,1,1,1
2023-06-01,271087,5,1,6,1,1,1
2023-06-01,271215,4,1,5,5,1,5
2023-06-01,271088,2,0,2,1,0,1
2023-06-01,271089,3,0,3,1,0,1
2023-06-01,271122,4,0,4,4,0,4
2023-06-01,270077,4,0,4,2,0,2
2023-06-01,271090,6,1,7,2,1,2
2023-06-01,271118,4,7,11,5,2,5
2023-06-01,271168,5,0,5,2,0,2
2023-06-01,271161,1,0,1,1,0,1
2023-06-01,271091,1,1,2,1,1,1
2023-06-01,271092,7,1,8,4,2,4
2023-06-01,271096,7,0,7,3,0,3
2023-06-01,271142,1,1,2,1,1,1
2023-06-01,271143,5,2,7,5,3,5
2023-06-01,271094,3,1,4,2,1,2
2023-06-01,271095,4,1,5,1,1,1
2023-06-01,271169,3,1,4,2,2,2
2023-06-01,271098,5,0,5,1,0,1
2023-06-01,271123,4,3,7,3,1,3
2023-06-01,271099,2,1,3,1,1,1
2023-06-01,271100,1,0,1,1,0,1
2023-06-01,271101,1,1,2,2,2,2
2023-06-01,271102,7,1,8,1,1,1
2023-06-01,271021,7,6,13,1,1,1
2023-06-01,271057,1,7,8,1,1,1
2023-06-01,271059,1,1,2,1,1,1
2023-06-01,271060,7,10,17,1,1,1
2023-06-01,271083,7,0,7,1,0,1
2023-06-01,26613,5,1,6,9,3,9
2023-06-01,52474,8,0,8,2,0,2
2023-06-01,271394,7,0,7,1,0,1
2023-06-01,271445,3,2,5,1,1,1
2023-06-01,271447,3,2,5,3,1,3
2023-06-01,271384,5,2,7,3,2,3
2023-06-01,271187,3,1,4,2,3,3
2023-06-01,263056,11,1,12,5,2,5
2023-06-01,271196,5,0,5,2,0,2
2023-06-01,271199,3,2,5,3,2,3
2023-06-01,271193,4,1,5,1,1,1
2023-06-01,271194,5,3,8,3,3,3
2023-06-01,271195,1,0,1,1,0,1
2023-06-01,270081,5,1,6,2,2,2
2023-06-01,271210,1,1,2,1,1,1
2023-06-01,271202,3,0,3,1,0,1
2023-06-01,271203,7,1,8,5,4,5
2023-06-01,271197,3,1,4,1,1,1
2023-06-01,271278,7,0,7,4,0,4
2023-06-01,271261,4,2,6,2,2,2
2023-06-01,270092,4,14,18,1,1,1
2023-06-01,271212,7,1,8,5,1,5
2023-06-01,271224,1,1,2,1,1,1
2023-06-01,271225,7,1,8,2,2,2
2023-06-01,271269,4,1,5,4,1,4
2023-06-01,271903,4,2,6,1,1,1
2023-06-01,271798,4,0,4,1,0,1
2023-06-01,271219,7,0,7,1,0,1
2023-06-01,271220,3,1,4,4,3,5
2023-06-01,271221,4,0,4,1,0,1
2023-06-01,271230,3,3,6,1,1,1
2023-06-01,26619,85,1,86,8,1,8
2023-06-01,265682,1,0,1,1,0,1
2023-06-01,263210,32,12,44,7,5,7
2023-06-01,271191,4,0,4,1,0,1
2023-06-01,271205,4,1,5,2,1,2
2023-06-01,270095,1,1,2,2,1,2
2023-06-01,271179,3,1,4,3,2,3
2023-06-01,271182,6,2,8,3,2,3
2023-06-01,271805,1,0,1,1,0,1
2023-06-01,272008,1,0,1,1,0,1
2023-06-01,271173,7,1,8,1,1,1
2023-06-01,271817,5,0,5,2,0,2
2023-06-01,271175,5,5,10,5,5,5
2023-06-01,271176,7,1,8,2,1,2
2023-06-01,271177,1,1,2,1,1,1
2023-06-01,271214,6,3,9,1,1,1
2023-06-01,271259,1,0,1,1,0,1
2023-06-01,271796,1,0,1,1,0,1
2023-06-01,270108,1,0,1,2,0,2
2023-06-01,271897,1,0,1,1,0,1
2023-06-01,271360,1,0,1,4,0,4
2023-06-01,271781,1,0,1,1,0,1
2023-06-01,271790,1,0,1,1,0,1
2023-06-01,271242,1,0,1,1,0,1
2023-06-01,271243,3,1,4,1,1,1
2023-06-01,52352,36,0,36,3,0,3
2023-06-01,263190,7,0,7,3,0,3
2023-06-01,52332,2,0,2,3,0,3
2023-06-01,263778,8,0,8,4,0,4
2023-06-01,266145,7,0,7,5,0,5
2023-06-01,263187,2,0,2,1,0,1
2023-06-01,52435,9,0,9,1,0,1
2023-06-01,28058,7,0,7,1,0,1
2023-06-01,27960,19,1,20,3,2,3
2023-06-01,270672,7,1,8,4,1,4
2023-06-01,269992,4,0,4,3,0,3
2023-06-01,270669,7,1,8,1,1,1
2023-06-01,211179,2,1,3,1,1,1
2023-06-01,52380,12,0,12,4,0,4
2023-06-01,263179,1,0,1,1,0,1
2023-06-01,263172,5,1,6,2,2,2
2023-06-01,64120,7,2,9,1,1,1
2023-06-01,52491,5,0,5,4,0,4
2023-06-01,27870,12,0,12,2,0,2
2023-06-01,270036,4,1,5,1,1,1
2023-06-01,52458,5,17,22,2,1,2
2023-06-01,52503,4,0,4,3,0,3
2023-06-01,16921,31,31,62,23,8,23
2023-06-01,264656,18,0,18,2,0,2
2023-06-01,212687,1,0,1,1,0,1
2023-06-01,211301,4,2,6,1,1,1
2023-06-01,271637,1,3,4,1,1,1
2023-06-01,270006,4,0,4,3,0,3
2023-06-01,272801,1,0,1,1,0,1
2023-06-01,271597,2,2,4,4,2,4
2023-06-01,271525,3,0,3,6,0,6
2023-06-01,272554,5,7,12,2,2,2
2023-06-01,271569,7,2,9,1,1,1
2023-06-01,272042,3,1,4,1,2,2
2023-06-01,272134,1,1,2,1,1,1
2023-06-01,271535,5,1,6,1,1,1
2023-06-01,271551,1,1,2,1,1,1
2023-06-01,272674,5,1,6,1,1,1
2023-06-01,271922,5,1,6,2,2,2
2023-06-01,271576,1,1,2,1,1,1
2023-06-01,271580,7,5,12,1,1,1
2023-06-01,271549,4,0,4,1,0,1
2023-06-01,272678,3,0,3,1,0,1
2023-06-01,272810,1,0,1,1,0,1
2023-06-01,271543,1,1,2,1,1,1
2023-06-01,272677,5,1,6,4,2,4
2023-06-01,271540,3,1,4,2,3,3
2023-06-01,271612,3,5,8,6,5,7
2023-06-01,271554,7,1,8,2,1,2
2023-06-01,272113,8,1,9,4,2,4
2023-06-01,271546,7,1,8,1,1,1
2023-06-01,271904,9,1,10,3,2,3
2023-06-01,271538,3,1,4,2,2,2
2023-06-01,271544,7,7,14,4,4,5
2023-06-01,271601,1,1,2,1,1,1
2023-06-01,271575,7,3,10,5,4,5
2023-06-01,271604,7,4,11,5,4,5
2023-06-01,271560,3,1,4,1,1,1
2023-06-01,271561,3,3,6,6,3,6
2023-06-01,271630,5,1,6,1,1,1
2023-06-01,271873,1,1,2,1,1,1
2023-06-01,271619,7,1,8,2,1,2
2023-06-01,263545,1,1,2,2,1,2
2023-06-01,271602,1,1,2,1,1,1
2023-06-01,271650,3,1,4,2,1,2
2023-06-01,271563,1,1,2,3,2,3
2023-06-01,272824,1,0,1,1,0,1
2023-06-01,271566,4,1,5,2,1,2
2023-06-01,61605,3,3,6,6,3,6
2023-06-01,272681,1,0,1,1,0,1
2023-06-01,271570,1,1,2,1,1,1
2023-06-01,264640,4,0,4,2,0,2
2023-06-01,271439,4,1,5,1,1,1
2023-06-01,52475,1,0,1,1,0,1
2023-06-01,65448,0,0,0,2,0,2
2023-06-01,52640,6,0,6,4,0,4
2023-06-01,263407,10,0,10,2,0,2
2023-06-01,263408,9,1,10,1,2,2
2023-06-01,28181,8,1,9,3,1,3
2023-06-01,272575,3,3,6,3,2,3
2023-06-01,263413,7,3,10,3,3,5
2023-06-01,28601,3,3,6,1,1,1
2023-06-01,65429,0,0,0,2,0,2
2023-06-01,52524,22,0,22,1,0,1
2023-06-01,52525,9,3,12,3,2,3
2023-06-01,52533,7,0,7,6,0,6
2023-06-01,52537,16,0,16,1,0,1
2023-06-01,52539,27,1,28,5,3,5
2023-06-01,263083,12,6,18,6,5,6
2023-06-01,263284,8,1,9,4,2,4
2023-06-01,52543,7,4,11,1,1,1
2023-06-01,263275,6,0,6,2,0,2
2023-06-01,262948,1,0,1,1,0,1
2023-06-01,263277,5,8,13,6,3,6
2023-06-01,26377,4,0,4,1,0,1
2023-06-01,263267,5,7,12,6,2,6
2023-06-01,263268,6,6,12,1,1,1
2023-06-01,263271,9,1,10,3,3,4
2023-06-01,263562,10,2,12,2,2,2
2023-06-01,263567,4,3,7,6,4,6
2023-06-01,263280,6,5,11,3,1,3
2023-06-01,270753,4,1,5,4,2,4
2023-06-01,270029,5,0,5,1,0,1
2023-06-01,270739,2,3,5,2,1,2
2023-06-01,270740,6,6,12,4,3,4
2023-06-01,270760,7,17,24,5,3,5
2023-06-01,270771,4,0,4,6,0,6
2023-06-01,273686,0,1,1,2,1,2
2023-06-01,270748,5,1,6,1,1,1
2023-06-01,263585,17,3,20,3,3,5
2023-06-01,61916,2,6,8,3,3,4
2023-06-01,263611,16,2,18,8,2,8
2023-06-01,263104,8,0,8,1,0,1
2023-06-01,263111,15,1,16,1,1,1
2023-06-01,263610,2,1,3,1,1,1
2023-06-01,263612,31,7,38,1,1,1
2023-06-01,263613,3,1,4,2,2,2
2023-06-01,271581,7,1,8,1,1,1
2023-06-01,263322,7,7,14,3,2,3
2023-06-01,271510,1,1,2,1,1,1
2023-06-01,271605,5,1,6,2,2,2
2023-06-01,271542,6,1,7,3,1,3
2023-06-01,61914,1,1,2,1,2,2
2023-06-01,263617,7,7,14,5,4,5
2023-06-01,263618,5,0,5,2,0,2
2023-06-01,271616,4,7,11,7,1,7
2023-06-01,263624,9,3,12,3,1,3
2023-06-01,270897,5,1,6,1,1,1
2023-06-01,270898,4,3,7,3,2,3
2023-06-01,272274,1,2,3,1,1,1
2023-06-01,263281,5,0,5,2,0,2
2023-06-01,263637,7,2,9,3,3,3
2023-06-01,263283,4,5,9,4,3,4
2023-06-01,263105,5,0,5,1,0,1
2023-06-01,263639,3,1,4,2,2,2
2023-06-01,263670,1,0,1,3,0,3
2023-06-01,263673,1,0,1,3,0,3
2023-06-01,263642,10,5,15,4,3,4
2023-06-01,263643,9,0,9,2,0,2
2023-06-01,263645,9,12,21,1,1,1
2023-06-01,11419,27,3,30,2,2,2
2023-06-01,65439,0,0,0,2,0,2
2023-06-01,270943,7,2,9,3,3,3
2023-06-01,270942,5,1,6,3,2,3
2023-06-01,61945,7,10,17,5,2,5
2023-06-01,28133,10,2,12,4,4,5
2023-06-01,52411,3,0,3,6,0,6
2023-06-01,272028,3,1,4,2,1,2
2023-06-01,270053,4,0,4,3,0,3
2023-06-01,270895,1,0,1,1,0,1
2023-06-01,52574,4,1,5,2,1,2
2023-06-01,270657,5,0,5,1,0,1
2023-06-01,270658,7,7,14,2,1,2
2023-06-01,52596,12,1,13,8,3,8
2023-06-01,52580,29,19,48,21,17,22
2023-06-01,263420,8,0,8,3,0,3
2023-06-01,263422,1,5,6,2,1,2
2023-06-01,23571,71,0,71,1,0,1
2023-06-01,45854,13,3,16,5,2,5
2023-06-01,56059,5,1,6,6,2,6
2023-06-01,55521,8,0,8,5,0,5
2023-06-01,45865,1,0,1,1,0,1
2023-06-01,45868,2,0,2,1,0,1
2023-06-01,45871,1,0,1,1,0,1
2023-06-01,45873,1,1,2,1,1,1
2023-06-01,137569,1,0,1,1,0,1
2023-06-01,46069,1,0,1,1,0,1
2023-06-01,59206,3,0,3,1,0,1
2023-06-01,136589,8,0,8,2,0,2
2023-06-01,45953,1,0,1,1,0,1
2023-06-01,134417,3,0,3,1,2,2
2023-06-01,45223,23,0,23,4,0,4
2023-06-01,45906,1,0,1,1,0,1
2023-06-01,56061,1,0,1,3,0,3
2023-06-01,38125,4,0,4,2,0,2
2023-06-01,55334,20,0,20,6,0,6
2023-06-01,24210,8,1,9,3,1,4
2023-06-01,133347,1,0,1,1,0,1
2023-06-01,38053,4,0,4,2,0,2
2023-06-01,24341,4,1,5,2,2,2
2023-06-01,45911,1,0,1,3,0,3
2023-06-01,24007,12,0,12,3,0,3
2023-06-01,18227,8,1,9,2,1,2
2023-06-01,23893,9,0,9,2,0,2
2023-06-01,59236,1,0,1,1,0,1
2023-06-01,135047,9,0,9,2,0,2
2023-06-01,13389,20,0,20,1,0,1
2023-06-01,56076,2,0,2,1,0,1
2023-06-01,136448,5,0,5,1,0,1
2023-06-01,45728,4,0,4,1,0,1
2023-06-01,45729,1,0,1,1,0,1
2023-06-01,133833,2,0,2,3,0,3
2023-06-01,131741,1,0,1,2,0,2
2023-06-01,23775,5,1,6,5,1,5
2023-06-01,133125,10,0,10,3,0,3
2023-06-01,58513,1,0,1,1,0,1
2023-06-01,64505,2,2,4,1,1,1
2023-06-01,264753,2,0,2,1,0,1
2023-06-01,264808,2,0,2,1,0,1
2023-06-01,265737,4,0,4,3,0,3
2023-06-01,27889,42,0,42,1,0,1
2023-06-01,52229,0,0,0,2,0,2
2023-06-01,11816,123,1,124,4,2,4
2023-06-01,52356,6,0,6,2,0,2
2023-06-01,204629,1,0,1,1,0,1
2023-06-01,140972,1,0,1,1,0,1
2023-06-01,27754,22,0,22,3,0,3
2023-06-01,10620,3520,143,3663,2,1,2
2023-06-01,264642,43,3,46,2,1,2
2023-06-01,28006,611,168,779,4,1,4
2023-06-01,27948,6,0,6,1,0,1
2023-06-01,264831,1,0,1,2,0,2
2023-06-01,267765,10,3,13,2,2,2
2023-06-01,52492,16,0,16,3,0,3
2023-06-01,65081,0,0,0,2,0,2
2023-06-01,23416,1,0,1,1,0,1
2023-06-01,52362,34,195,229,1,1,1
2023-06-01,52501,3,0,3,3,0,3
2023-06-01,52469,8,0,8,1,0,1
2023-06-01,262192,26,0,26,4,0,4
2023-06-01,271473,3,3,6,3,1,3
2023-06-01,271548,5,3,8,7,4,7
2023-06-01,271832,4,0,4,3,0,3
2023-06-01,271562,4,3,7,3,4,5
2023-06-01,272059,3,0,3,1,0,1
2023-06-01,271463,5,3,8,2,2,2
2023-06-01,271451,1,4,5,1,1,1
2023-06-01,271453,1,1,2,1,1,1
2023-06-01,271529,3,1,4,3,3,4
2023-06-01,271448,1,1,2,3,3,3
2023-06-01,52433,4,0,4,1,0,1
2023-06-01,52331,2,0,2,1,0,1
2023-06-01,272552,4,0,4,1,0,1
2023-06-01,271389,5,6,11,1,1,1
2023-06-01,271380,7,5,12,6,5,6
2023-06-01,271519,6,1,7,1,1,1
2023-06-01,272076,1,0,1,1,0,1
2023-06-01,272031,5,1,6,2,1,2
2023-06-01,272024,4,2,6,2,2,2
2023-06-01,272061,3,0,3,2,0,2
2023-06-01,271404,1,1,2,3,2,3
2023-06-01,271382,4,7,11,1,1,1
2023-06-01,271363,5,2,7,4,1,4
2023-06-01,272626,0,3,3,2,1,2
2023-06-01,271416,5,1,6,2,1,2
2023-06-01,272776,0,1,1,2,1,2
2023-06-01,271378,4,3,7,2,2,2
2023-06-01,271403,4,1,5,3,1,3
2023-06-01,61606,0,1,1,2,1,2
2023-06-01,271522,4,0,4,2,0,2
2023-06-01,272081,1,0,1,1,0,1
2023-06-01,271345,1,1,2,3,1,4
2023-06-01,271350,1,3,4,1,1,1
2023-06-01,271422,5,3,8,2,2,2
2023-06-01,271400,1,1,2,1,1,1
2023-06-01,271626,5,3,8,5,3,5
2023-06-01,271395,7,4,11,2,3,3
2023-06-01,271488,7,3,10,4,3,4
2023-06-01,271377,2,6,8,2,2,2
2023-06-01,271475,4,3,7,2,2,2
2023-06-01,271398,5,1,6,5,3,5
2023-06-01,271390,7,1,8,1,1,1
2023-06-01,272465,0,1,1,3,3,4
2023-06-01,271533,3,3,6,6,5,6
2023-06-01,271470,4,2,6,1,1,1
2023-06-01,271393,1,1,2,1,1,1
2023-06-01,267436,3,1,4,1,1,1
2023-06-01,265984,4,1,5,1,1,1
2023-06-01,265981,4,1,5,1,1,1
2023-06-01,271041,7,0,7,1,0,1
2023-06-01,52425,9,0,9,4,0,4
2023-06-01,265783,4,0,4,1,0,1
2023-06-01,265986,5,1,6,4,3,4
2023-06-01,266767,4,0,4,2,0,2
2023-06-01,266000,3,0,3,3,0,3
2023-06-01,265987,2,1,3,1,1,1
2023-06-01,267453,2,1,3,1,1,1
2023-06-01,267526,3,3,6,2,2,2
2023-06-01,267428,5,2,7,4,4,4
2023-06-01,52317,6,1,7,4,1,4
2023-06-01,265779,4,0,4,2,0,2
2023-06-01,271651,4,1,5,4,1,4
2023-06-01,265790,5,0,5,3,0,3
2023-06-01,265998,7,3,10,6,5,6
2023-06-01,265994,1,1,2,1,1,1
2023-06-01,266002,5,2,7,3,2,4
2023-06-01,266012,3,0,3,1,0,1
2023-06-01,266004,2,0,2,1,0,1
2023-06-01,262792,7,1,8,4,2,4
2023-06-01,266010,1,1,2,1,1,1
2023-06-01,267423,3,2,5,1,1,1
2023-06-01,266005,5,1,6,2,3,3
2023-06-01,265796,4,0,4,1,0,1
2023-06-01,266011,7,3,10,1,1,1
2023-06-01,263264,2,4,6,2,1,2
2023-06-01,271079,5,1,6,4,1,4
2023-06-01,267425,1,1,2,2,2,2
2023-06-01,53219,4,1,5,4,4,5
2023-06-01,267438,3,1,4,2,1,2
2023-06-01,265802,4,0,4,1,0,1
2023-06-01,267426,3,1,4,6,1,6
2023-06-01,267478,3,3,6,3,3,4
2023-06-01,267444,3,1,4,3,3,3
2023-06-01,267434,7,1,8,2,1,2
2023-06-01,267445,3,0,3,4,0,4
2023-06-01,265806,2,0,2,3,0,3
2023-06-01,267457,7,0,7,1,0,1
2023-06-01,267439,3,3,6,5,2,5
2023-06-01,267437,6,0,6,4,0,4
2023-06-01,267450,5,13,18,7,5,7
2023-06-01,267560,3,2,5,6,5,6
2023-06-01,267449,7,3,10,2,2,2
2023-06-01,266839,4,0,4,3,0,3
2023-06-01,267446,5,2,7,4,2,4
2023-06-01,267456,2,2,4,1,1,1
2023-06-01,271709,1,1,2,1,1,1
2023-06-01,269997,2,0,2,2,0,2
2023-06-01,270636,1,0,1,1,0,1
2023-06-01,270637,6,1,7,1,1,1
2023-06-01,270244,4,1,5,5,2,5
2023-06-01,270695,3,1,4,1,1,1
2023-06-01,270638,4,1,5,3,1,3
2023-06-01,270639,7,1,8,6,4,6
2023-06-01,270648,4,0,4,2,0,2
2023-06-01,27757,15,0,15,1,0,1
2023-06-01,52257,1,324,325,1,1,1
2023-06-01,28088,3,0,3,2,0,2
2023-06-01,27680,20,0,20,2,0,2
2023-06-01,19196,1,0,1,1,0,1
2023-06-01,210356,2,1,3,1,1,2
2023-06-01,16589,1,0,1,2,0,2
2023-06-01,271700,1,1,2,3,1,3
2023-06-01,272696,2,1,3,3,3,3
2023-06-01,203647,2,1,3,1,1,1
2023-06-01,271960,1,1,2,1,1,1
2023-06-01,270764,5,17,22,7,7,10
2023-06-01,399709,1,0,1,1,0,1
2023-06-01,271978,1,1,2,1,1,2
2023-06-01,212177,1,0,1,1,0,1
2023-06-01,271414,7,1,8,4,3,4
2023-06-01,272272,2,1,3,1,1,1
2023-06-01,271424,1,1,2,3,1,3
2023-06-01,271468,7,1,8,1,1,1
2023-06-01,271486,5,4,9,2,2,2
2023-06-01,271474,5,0,5,7,0,7
2023-06-01,272060,2,1,3,2,1,2
2023-06-01,272249,0,7,7,3,1,3
2023-06-01,271418,7,0,7,1,0,1
2023-06-01,270155,6,0,6,3,0,3
2023-06-01,271496,4,2,6,1,1,1
2023-06-01,271532,1,1,2,1,1,1
2023-06-01,271405,1,1,2,1,1,1
2023-06-01,272025,7,0,7,1,0,1
2023-06-01,271411,1,1,2,1,1,1
2023-06-01,271492,3,5,8,2,3,4
2023-06-01,271520,7,1,8,1,1,1
2023-06-01,272032,2,4,6,2,1,2
2023-06-01,271598,1,1,2,2,1,2
2023-06-01,270912,4,2,6,1,1,1
2023-06-01,263742,10,0,10,1,0,1
2023-06-01,52453,8,1,9,1,1,1
2023-06-01,271513,1,1,2,1,1,1
2023-06-01,271491,3,5,8,1,1,1
2023-06-01,272080,1,0,1,1,0,1
2023-06-01,272067,1,1,2,1,1,1
2023-06-01,271396,1,1,2,2,2,2
2023-06-01,272068,1,0,1,1,0,1
2023-06-01,52412,5,1,6,4,1,4
2023-06-01,272973,6,0,6,1,0,1
2023-06-01,52489,2,6,8,1,1,1
2023-06-01,270689,7,1,8,5,3,5
2023-06-01,270690,5,3,8,5,2,5
2023-06-01,271032,5,1,6,1,1,1
2023-06-01,270965,5,5,10,1,1,2
2023-06-01,270968,3,1,4,3,1,3
2023-06-01,270990,5,3,8,1,1,1
2023-06-01,270981,3,0,3,1,0,1
2023-06-01,271112,3,1,4,2,1,2
2023-06-01,272139,1,1,2,1,1,1
2023-06-01,271512,3,1,4,2,1,2
2023-06-01,271444,1,1,2,1,1,1
2023-06-01,271301,1,1,2,1,1,1
2023-06-01,271379,4,1,5,3,1,3
2023-06-01,272062,3,1,4,1,1,1
2023-06-01,272064,2,0,2,1,0,1
2023-06-01,271311,3,3,6,1,1,1
2023-06-01,271352,1,1,2,1,1,1
2023-06-01,271516,1,1,2,3,3,3
2023-06-01,271812,4,1,5,2,1,2
2023-06-01,271969,2,0,2,1,0,1
2023-06-01,271935,5,0,5,1,0,1
2023-06-01,272797,1,1,2,1,1,1
2023-06-01,272053,7,1,8,3,2,3
2023-06-01,271489,2,2,4,3,2,3
2023-06-01,271493,3,7,10,2,2,2
2023-06-01,271568,1,1,2,2,1,2
2023-06-01,271555,7,5,12,2,2,2
2023-06-01,271552,7,1,8,2,2,2
2023-06-01,272542,3,1,4,2,1,2
2023-06-01,271517,3,1,4,1,1,1
2023-06-01,271577,1,1,2,1,1,1
2023-06-01,272548,3,3,6,2,2,2
2023-06-01,271944,3,0,3,3,0,3
2023-06-01,271550,1,1,2,1,1,1
2023-06-01,271553,7,1,8,3,2,3
2023-06-01,271567,3,7,10,2,2,2
2023-06-01,271541,3,3,6,3,4,4
2023-06-01,272147,2,0,2,1,0,1
2023-06-01,271467,1,1,2,2,2,2
2023-06-01,272035,1,1,2,1,1,1
2023-06-01,271339,5,7,12,7,4,7
2023-06-01,272597,0,3,3,3,2,4
2023-06-01,271454,1,1,2,1,1,1
2023-06-01,272033,1,1,2,1,1,1
2023-06-01,271433,2,1,3,2,1,2
2023-06-01,271484,5,1,6,5,3,6
2023-06-01,271485,1,1,2,1,1,1
2023-06-01,271835,5,2,7,4,2,4
2023-06-01,271471,6,1,7,2,2,2
2023-06-01,64138,5,0,5,1,0,1
2023-06-01,64137,3,0,3,2,0,2
2023-06-01,271420,7,1,8,1,1,1
2023-06-01,272094,3,3,6,2,1,2
2023-06-01,271499,4,4,8,2,2,2
2023-06-01,271436,4,2,6,3,2,3
2023-06-01,271818,1,1,2,1,1,1
2023-06-01,271399,1,1,2,1,1,1
2023-06-01,271434,4,1,5,2,2,2
2023-06-01,272034,4,0,4,1,0,1
2023-06-01,271482,2,1,3,2,2,2
2023-06-01,271565,1,1,2,5,4,5
2023-06-01,271441,4,4,8,6,4,6
2023-06-01,272099,4,3,7,3,1,3
2023-06-01,270099,5,1,6,4,1,5
2023-06-01,271465,3,1,4,1,1,1
2023-06-01,271559,1,1,2,1,1,1
2023-06-01,271456,1,3,4,4,3,4
2023-06-01,271462,1,7,8,1,4,5
2023-06-01,271476,2,1,3,3,3,3
2023-06-01,271505,7,7,14,2,1,2
2023-06-01,271490,7,7,14,1,1,1
2023-06-01,271503,7,1,8,4,1,4
2023-06-01,271829,2,1,3,1,1,1
2023-06-01,272050,1,0,1,1,0,1
2023-06-01,272051,1,1,2,1,1,1
2023-06-01,271558,2,2,4,2,1,2
2023-06-01,272048,1,0,1,1,0,1
2023-06-01,272544,3,1,4,1,1,1
2023-06-01,272072,1,0,1,1,0,1
2023-06-01,271500,7,3,10,4,3,4
2023-06-01,272038,2,0,2,2,0,2
2023-06-01,271497,3,1,4,1,2,2
2023-06-01,271557,4,0,4,1,0,1
2023-06-01,23878,7,0,7,3,0,3
2023-06-01,55415,5,0,5,3,0,3
2023-06-01,18272,9,0,9,2,0,2
2023-06-01,131169,9,0,9,4,0,4
2023-06-01,55422,4,0,4,3,0,3
2023-06-01,55784,1,0,1,1,0,1
2023-06-01,55486,4,0,4,4,0,4
2023-06-01,133547,2,0,2,1,0,1
2023-06-01,131826,9,0,9,3,0,3
2023-06-01,131644,1,0,1,1,0,1
2023-06-01,149844,8,0,8,1,0,1
2023-06-01,55308,1,1,2,2,2,2
2023-06-01,55512,4,0,4,4,0,4
2023-06-01,38060,2,0,2,1,0,1
2023-06-01,46049,7,0,7,2,0,2
2023-06-01,55520,4,0,4,2,0,2
2023-06-01,46014,2,1,3,2,1,2
2023-06-01,46068,4,0,4,3,0,3
2023-06-01,131126,5,0,5,2,0,2
2023-06-01,10212,37,2,39,9,3,10
2023-06-01,38693,2,0,2,2,0,2
2023-06-01,23556,7,0,7,2,0,2
2023-06-01,38111,1,0,1,1,0,1
2023-06-01,45987,2,0,2,1,0,1
2023-06-01,131838,1,0,1,2,0,2
2023-06-01,55304,1,0,1,1,0,1
2023-06-01,46016,3,0,3,1,0,1
2023-06-01,132510,9,4,13,1,1,1
2023-06-01,141425,1,4,5,1,1,2
2023-06-01,397597,1,0,1,3,0,3
2023-06-01,12202,1,0,1,1,0,1
2023-06-01,32186,2,0,2,1,0,1
2023-06-01,396851,3,0,3,1,0,1
2023-06-01,393323,1,0,1,3,0,3
2023-06-01,16627,1,0,1,3,0,3
2023-06-01,53929,2,0,2,1,0,1
2023-06-01,394668,1,0,1,2,0,2
2023-06-01,53931,1,0,1,1,0,1
2023-06-01,396327,1,0,1,1,0,1
2023-06-01,32474,1,0,1,1,0,1
2023-06-01,46883,9,0,9,2,0,2
2023-06-01,36305,3,0,3,1,0,1
2023-06-01,33522,3,6,9,2,5,6
2023-06-01,53730,1,0,1,1,0,1
2023-06-01,46692,2,1,3,1,1,1
2023-06-01,207254,4,2,6,3,1,3
2023-06-01,395007,1,0,1,1,0,1
2023-06-01,397088,2,1,3,1,1,1
2023-06-01,212465,5,8,13,3,4,4
2023-06-01,47065,4,8,12,13,14,21
2023-06-01,399092,1,1,2,1,1,1
2023-06-01,199404,1,0,1,1,0,1
2023-06-01,19218,9,4,13,1,1,1
2023-06-01,63276,2,0,2,3,0,3
2023-06-01,21795,3,0,3,1,0,1
2023-06-01,32883,1,0,1,2,0,2
2023-06-01,998,2,0,2,2,0,2
2023-06-01,395352,1,0,1,1,0,1
2023-06-01,395179,1,0,1,1,0,1
2023-06-01,43755,1,0,1,2,0,2
2023-06-01,53881,1,0,1,1,0,1
2023-06-01,33496,2,1,3,2,2,2
2023-06-01,55188,1,0,1,3,0,3
2023-06-01,36214,1,0,1,1,0,1
2023-06-01,20417,1,0,1,3,0,3
2023-06-01,393521,4,0,4,2,0,2
2023-06-01,394336,2,0,2,3,0,3
2023-06-01,32224,2,0,2,2,0,2
2023-06-01,394580,1,0,1,1,0,1
2023-06-01,23490,2,0,2,2,0,2
2023-06-01,394158,1,0,1,1,0,1
2023-06-01,393867,1,0,1,1,0,1
2023-06-01,42953,2,1,3,1,1,1
2023-06-01,208425,23,4,27,1,1,1
2023-06-01,197745,5,10,15,1,1,1
2023-06-01,203461,3,1,4,1,1,1
2023-06-01,199645,1,1,2,3,1,3
2023-06-01,199229,2,0,2,1,0,1
2023-06-01,209796,1,0,1,2,0,2
2023-06-01,205005,6,1,7,4,3,4
2023-06-01,21034,11,1,12,4,4,4
2023-06-01,49562,1,1,2,1,1,1
2023-06-01,2043,1,1,2,1,1,1
2023-06-01,199159,3,2,5,1,1,1
2023-06-01,60185,5,1,6,3,1,3
2023-06-01,61132,1,0,1,2,0,2
2023-06-01,12466,5,1,6,2,3,3
2023-06-01,59686,2,0,2,2,0,2
2023-06-01,59689,1,1,2,5,3,5
2023-06-01,59959,2,1,3,5,3,5
2023-06-01,210306,4,1,5,1,1,2
2023-06-01,201639,2,0,2,2,0,2
2023-06-01,201063,1,0,1,2,0,2
2023-06-01,204241,1,0,1,1,0,1
2023-06-01,204194,1,0,1,3,0,3
2023-06-01,59691,1,0,1,1,0,1
2023-06-01,206156,1,0,1,3,0,3
2023-06-01,199635,1,0,1,4,0,4
2023-06-01,199455,4,0,4,1,0,1
2023-06-01,199246,3,1,4,2,1,2
2023-06-01,199255,2,0,2,1,0,1
2023-06-01,60372,7,1,8,1,1,1
2023-06-01,199644,1,1,2,2,1,2
2023-06-01,34303,2,0,2,2,0,2
2023-06-01,61170,2,1,3,4,3,5
2023-06-01,49838,4,0,4,2,0,2
2023-06-01,209746,4,0,4,1,0,1
2023-06-01,199619,1,0,1,4,0,4
2023-06-01,6911,2,0,2,1,0,1
2023-06-01,59715,4,3,7,2,2,2
2023-06-01,199254,1,1,2,1,1,1
2023-06-01,199405,1,1,2,5,4,5
2023-06-01,59720,2,0,2,1,0,1
2023-06-01,209964,1,0,1,1,0,1
2023-06-01,44566,5,0,5,1,0,1
2023-06-01,56324,3,0,3,1,0,1
2023-06-01,2128,3,2,5,4,5,5
2023-06-01,35435,19,1,20,3,1,3
2023-06-01,199989,1,0,1,1,0,1
2023-06-01,61428,1,1,2,2,2,2
2023-06-01,28999,4,1,5,5,5,6
2023-06-01,47321,10,0,10,8,0,8
2023-06-01,22208,3,2,5,7,3,7
2023-06-01,64999,2,0,2,1,2,3
2023-06-01,43436,2,0,2,3,0,3
2023-06-01,44645,4,0,4,1,0,1
2023-06-01,41956,9,0,9,2,0,2
2023-06-01,16350,2,1,3,7,4,7
2023-06-01,199661,1,0,1,1,0,1
2023-06-01,203603,4,0,4,1,0,1
2023-06-01,60863,1,0,1,1,0,1
2023-06-01,39583,2,0,2,3,0,3
2023-06-01,199657,2,0,2,4,0,4
2023-06-01,60724,1,0,1,1,0,1
2023-06-01,61415,1,0,1,2,0,2
2023-06-01,199660,6,1,7,5,2,5
2023-06-01,61402,1,0,1,1,0,1
2023-06-01,199643,1,0,1,1,0,1
2023-06-01,21008,1,0,1,1,0,1
2023-06-01,199588,1,1,2,1,1,1
2023-06-01,211197,2,1,3,3,1,3
2023-06-01,60578,1,0,1,3,0,3
2023-06-01,199672,1,1,2,1,1,1
2023-06-01,61345,12,2,14,1,1,1
2023-06-01,199617,1,0,1,2,0,2
2023-06-01,43076,12,0,12,4,0,4
2023-06-01,199659,3,1,4,9,5,9
2023-06-01,205147,4,0,4,1,0,1
2023-06-01,61145,2,0,2,3,0,3
2023-06-01,61377,1,0,1,2,0,2
2023-06-01,61380,1,0,1,3,0,3
2023-06-01,201812,1,0,1,2,0,2
2023-06-01,199931,6,0,6,3,0,3
2023-06-01,8613,3,1,4,1,1,1
2023-06-01,199567,6,1,7,1,1,1
2023-06-01,199611,2,0,2,2,0,2
2023-06-01,199627,1,0,1,1,0,1
2023-06-01,61373,12,0,12,7,0,7
2023-06-01,61354,2,0,2,3,0,3
2023-06-01,61068,6,0,6,4,0,4
2023-06-01,62460,3,0,3,2,0,2
2023-06-01,199600,1,1,2,1,1,1
2023-06-01,60186,2,0,2,4,0,4
2023-06-01,59955,4,0,4,1,0,1
2023-06-01,202892,2,0,2,3,0,3
2023-06-01,61394,1,1,2,2,1,3
2023-06-01,43893,17,6,23,9,4,10
2023-06-01,62224,1,0,1,2,0,2
2023-06-01,203510,1,0,1,1,0,1
2023-06-01,61089,5,0,5,3,0,3
2023-06-01,199593,1,0,1,1,0,1
2023-06-01,61347,5,0,5,2,0,2
2023-06-01,61171,12,0,12,2,0,2
2023-06-01,13054,5,2,7,10,8,12
2023-06-01,61343,6,1,7,4,2,4
2023-06-01,199587,1,1,2,1,1,1
2023-06-01,207098,1,1,2,2,1,2
2023-06-01,61055,3,0,3,3,0,3
2023-06-01,199481,4,0,4,8,0,8
2023-06-01,199559,2,0,2,2,0,2
2023-06-01,199629,3,3,6,3,1,3
2023-06-01,61318,1,0,1,2,0,2
2023-06-01,61331,1,1,2,3,1,3
2023-06-01,61340,4,0,4,1,0,1
2023-06-01,61316,2,1,3,1,1,1
2023-06-01,42865,1,0,1,1,0,1
2023-06-01,200666,1,0,1,1,0,1
2023-06-01,199562,4,1,5,4,3,6
2023-06-01,61266,1,29,30,2,2,2
2023-06-01,198931,1,0,1,1,0,1
2023-06-01,61091,1,0,1,1,0,1
2023-06-01,13260,1,0,1,1,0,1
2023-06-01,211771,1,0,1,1,0,1
2023-06-01,199477,1,0,1,3,0,3
2023-06-01,199831,3,0,3,5,0,5
2023-06-01,209399,1,0,1,1,0,1
2023-06-01,203483,5,0,5,3,0,3
2023-06-01,199589,4,0,4,3,0,3
2023-06-01,202105,31,0,31,3,0,3
2023-06-01,199342,1,0,1,3,0,3
2023-06-01,204478,4,0,4,1,0,1
2023-06-01,203304,1,1,2,1,1,1
2023-06-01,205324,1,0,1,3,0,3
2023-06-01,205482,1,0,1,3,0,3
2023-06-01,205567,1,0,1,3,0,3
2023-06-01,60601,1,1,2,1,1,1
2023-06-01,57193,2,0,2,3,0,3
2023-06-01,199447,1,0,1,2,0,2
2023-06-01,35717,9,1,10,6,4,7
2023-06-01,58059,9,0,9,1,0,1
2023-06-01,15800,3,3,6,4,2,4
2023-06-01,61287,1,1,2,5,4,5
2023-06-01,199286,3,0,3,3,0,3
2023-06-01,61293,3,0,3,1,0,1
2023-06-01,60050,2,0,2,2,0,2
2023-06-01,61281,1,1,2,1,1,1
2023-06-01,210366,1,0,1,2,0,2
2023-06-01,203663,1,0,1,1,0,1
2023-06-01,205578,1,0,1,2,0,2
2023-06-01,209219,2,0,2,2,0,2
2023-06-01,211639,1,0,1,1,0,1
2023-06-01,6779,2,0,2,1,0,1
2023-06-01,205541,1,0,1,1,0,1
2023-06-01,60851,2,0,2,1,0,1
2023-06-01,199516,5,1,6,3,2,3
2023-06-01,8663,5,0,5,2,0,2
2023-06-01,207392,1,0,1,2,0,2
2023-06-01,50144,1,0,1,1,0,1
2023-06-01,199502,3,0,3,2,0,2
2023-06-01,49606,1,0,1,1,0,1
2023-06-01,47255,1,0,1,1,0,1
2023-06-01,207545,5,0,5,1,0,1
2023-06-01,35408,1,1,2,2,1,2
2023-06-01,199412,1,0,1,1,0,1
2023-06-01,42482,1,0,1,4,0,4
2023-06-01,199272,4,0,4,3,0,3
2023-06-01,61246,3,0,3,2,0,2
2023-06-01,203226,2,9,11,3,3,3
2023-06-01,199441,3,3,6,3,2,3
2023-06-01,61233,1,1,2,4,5,6
2023-06-01,3250,1,1,2,4,3,5
2023-06-01,206037,2,0,2,1,0,1
2023-06-01,60620,1,0,1,3,0,3
2023-06-01,20672,6,1,7,2,2,3
2023-06-01,202084,1,0,1,1,0,1
2023-06-01,60621,2,0,2,1,0,1
2023-06-01,60597,8,0,8,1,0,1
2023-06-01,61217,2,0,2,2,0,2
2023-06-01,199490,1,1,2,6,3,7
2023-06-01,61221,6,2,8,5,4,5
2023-06-01,199475,2,0,2,6,0,6
2023-06-01,61212,4,1,5,2,1,2
2023-06-01,60595,3,1,4,2,2,2
2023-06-01,203290,6,0,6,3,0,3
2023-06-01,199469,5,0,5,2,0,2
2023-06-01,208237,1,0,1,2,0,2
2023-06-01,199473,1,0,1,3,0,3
2023-06-01,42694,4,1,5,1,1,1
2023-06-01,206005,1,0,1,1,0,1
2023-06-01,211136,1,0,1,1,0,1
2023-06-01,207729,1,1,2,1,1,1
2023-06-01,41049,2,0,2,2,0,2
2023-06-01,211487,1,0,1,1,0,1
2023-06-01,49806,1,0,1,1,0,1
2023-06-01,62197,1,0,1,3,0,3
2023-06-01,60655,1,0,1,1,0,1
2023-06-01,197727,6,2,8,7,5,8
2023-06-01,61021,1,0,1,2,0,2
2023-06-01,201520,7,0,7,1,0,1
2023-06-01,60045,7,0,7,3,0,3
2023-06-01,60923,1,0,1,2,0,2
2023-06-01,61200,3,1,4,4,6,7
2023-06-01,199449,1,0,1,4,0,4
2023-06-01,199456,4,1,5,2,1,2
2023-06-01,61168,2,0,2,2,0,2
2023-06-01,61143,11,0,11,2,0,2
2023-06-01,213209,1,0,1,1,0,1
2023-06-01,205885,1,1,2,1,1,1
2023-06-01,207398,1,0,1,2,0,2
2023-06-01,61177,4,0,4,1,0,1
2023-06-01,400001,3,0,3,3,0,3
2023-06-01,34764,2,2,4,2,1,2
2023-06-01,199380,2,0,2,2,0,2
2023-06-01,61128,3,0,3,1,0,1
2023-06-01,199370,7,4,11,2,1,2
2023-06-01,199350,1,1,2,1,1,1
2023-06-01,196904,3,1,4,2,2,4
2023-06-01,203520,3,3,6,4,4,4
2023-06-01,199419,4,0,4,1,0,1
2023-06-01,207356,1,0,1,1,0,1
2023-06-01,207385,1,0,1,1,0,1
2023-06-01,44802,1,0,1,1,0,1
2023-06-01,199362,2,0,2,2,0,2
2023-06-01,61140,1,0,1,1,0,1
2023-06-01,61161,5,8,13,1,1,1
2023-06-01,199278,1,0,1,3,0,3
2023-06-01,60479,5,0,5,2,0,2
2023-06-01,61156,1,0,1,1,0,1
2023-06-01,199339,3,1,4,2,1,2
2023-06-01,58316,3,0,3,3,0,3
2023-06-01,202675,12,1,13,6,5,7
2023-06-01,38952,2,0,2,1,0,1
2023-06-01,200761,2,0,2,2,0,2
2023-06-01,199411,2,0,2,3,0,3
2023-06-01,201236,9,1,10,3,2,3
2023-06-01,43287,6,1,7,3,2,4
2023-06-01,199403,1,0,1,2,0,2
2023-06-01,61025,1,1,2,1,1,1
2023-06-01,61136,3,0,3,2,0,2
2023-06-01,199277,1,1,2,3,2,3
2023-06-01,200828,1,1,2,2,1,2
2023-06-01,199356,1,0,1,1,0,1
2023-06-01,49449,2,0,2,1,0,1
2023-06-01,20783,2,2,4,8,7,10
2023-06-01,50179,3,0,3,3,0,3
2023-06-01,199390,3,0,3,4,0,4
2023-06-01,60885,4,0,4,2,0,2
2023-06-01,199372,1,0,1,4,0,4
2023-06-01,61107,5,2,7,6,6,6
2023-06-01,47855,1,0,1,1,0,1
2023-06-01,60736,3,0,3,3,0,3
2023-06-01,202796,5,2,7,1,1,1
2023-06-01,197990,3,3,6,3,2,3
2023-06-01,61001,1,0,1,1,0,1
2023-06-01,199375,3,0,3,2,0,2
2023-06-01,199374,1,1,2,1,1,1
2023-06-01,61086,3,0,3,2,0,2
2023-06-01,198349,1,0,1,2,0,2
2023-06-01,199367,1,0,1,4,0,4
2023-06-01,198722,3,7,10,7,6,8
2023-06-01,199359,1,0,1,1,0,1
2023-06-01,60686,5,0,5,5,0,5
2023-06-01,61079,4,0,4,1,0,1
2023-06-01,60975,3,0,3,2,0,2
2023-06-01,51362,4,0,4,1,0,1
2023-06-01,212579,8,0,8,5,0,5
2023-06-01,199332,5,1,6,8,6,10
2023-06-01,211737,1,1,2,2,1,2
2023-06-01,48390,1,1,2,2,2,2
2023-06-01,60815,8,0,8,4,0,4
2023-06-01,199401,1,0,1,1,0,1
2023-06-01,61067,1,0,1,1,0,1
2023-06-01,199361,7,1,8,3,2,3
2023-06-01,202804,2,0,2,3,0,3
2023-06-01,207005,1,0,1,1,0,1
2023-06-01,61054,3,0,3,3,0,3
2023-06-01,199328,4,0,4,3,0,3
2023-06-01,60865,1,0,1,1,0,1
2023-06-01,201577,2,1,3,1,1,1
2023-06-01,61043,7,0,7,1,0,1
2023-06-01,60953,2,0,2,5,0,5
2023-06-01,61034,2,0,2,3,0,3
2023-06-01,51498,1,0,1,1,0,1
2023-06-01,51329,1,0,1,3,0,3
2023-06-01,58144,3,0,3,3,0,3
2023-06-01,199267,1,0,1,1,0,1
2023-06-01,199324,10,2,12,6,2,6
2023-06-01,60941,1,1,2,1,1,1
2023-06-01,61015,1,1,2,1,1,1
2023-06-01,61012,1,1,2,6,3,6
2023-06-01,25009,1,1,2,1,1,1
2023-06-01,205411,3,1,4,2,2,2
2023-06-01,212841,1,0,1,1,0,1
2023-06-01,211037,1,1,2,5,3,6
2023-06-01,61005,2,10,12,1,1,1
2023-06-01,61007,2,10,12,1,1,1
2023-06-01,200191,1,0,1,1,0,1
2023-06-01,38582,1,0,1,2,0,2
2023-06-01,49879,4,0,4,1,0,1
2023-06-01,200052,1,0,1,8,0,8
2023-06-01,199298,1,1,2,4,3,4
2023-06-01,199289,4,3,7,3,3,4
2023-06-01,42858,2,1,3,1,1,1
2023-06-01,202916,2,1,3,1,1,1
2023-06-01,43329,4,6,10,2,2,2
2023-06-01,62353,11,1,12,2,1,2
2023-06-01,198638,1,1,2,1,1,1
2023-06-01,209456,1,2,3,2,2,2
2023-06-01,60979,7,0,7,8,0,8
2023-06-01,207765,5,0,5,1,0,1
2023-06-01,200155,1,1,2,8,5,8
2023-06-01,60964,1,1,2,2,2,3
2023-06-01,49477,2,1,3,2,1,2
2023-06-01,203500,5,9,14,8,8,8
2023-06-01,60970,1,0,1,1,0,1
2023-06-01,199057,1,0,1,2,0,2
2023-06-01,199271,1,0,1,2,0,2
2023-06-01,199269,1,0,1,1,0,1
2023-06-01,60821,3,0,3,1,0,1
2023-06-01,60961,4,0,4,1,0,1
2023-06-01,20917,6,0,6,2,0,2
2023-06-01,60962,2,0,2,2,0,2
2023-06-01,210744,1,0,1,1,0,1
2023-06-01,211165,1,0,1,1,0,1
2023-06-01,59462,2,1,3,1,2,3
2023-06-01,200124,5,0,5,3,0,3
2023-06-01,60950,8,1,9,1,1,1
2023-06-01,60994,2,0,2,1,0,1
2023-06-01,60933,1,0,1,3,0,3
2023-06-01,31202,2,0,2,3,0,3
2023-06-01,60936,4,0,4,3,0,3
2023-06-01,31054,2,1,3,1,1,1
2023-06-01,212889,20,0,20,3,0,3
2023-06-01,60677,2,0,2,1,0,1
2023-06-01,211458,1,1,2,1,1,1
2023-06-01,60895,2,0,2,1,0,1
2023-06-01,48391,9,0,9,1,0,1
2023-06-01,60830,1,1,2,1,1,2
2023-06-01,60929,5,0,5,2,0,2
2023-06-01,60723,1,0,1,3,0,3
2023-06-01,16383,22,0,22,5,0,5
2023-06-01,210585,2,0,2,1,0,1
2023-06-01,60493,3,0,3,1,0,1
2023-06-01,60898,2,0,2,2,0,2
2023-06-01,25122,25,3,28,9,3,9
2023-06-01,24627,2,0,2,1,0,1
2023-06-01,60914,1,0,1,1,0,1
2023-06-01,60884,1,0,1,4,0,4
2023-06-01,200050,1,0,1,3,0,3
2023-06-01,60871,4,0,4,1,0,1
2023-06-01,33797,1,0,1,2,0,2
2023-06-01,210209,1,0,1,1,0,1
2023-06-01,51666,2,0,2,1,0,1
2023-06-01,47481,4,9,13,13,12,16
2023-06-01,60852,5,0,5,2,0,2
2023-06-01,60890,1,1,2,4,4,4
2023-06-01,42044,4,6,10,7,7,8
2023-06-01,203961,1,1,2,3,4,4
2023-06-01,202254,19,0,19,2,0,2
2023-06-01,60896,1,0,1,1,0,1
2023-06-01,60416,1,0,1,1,0,1
2023-06-01,61993,1,0,1,1,0,1
2023-06-01,62290,3,0,3,3,0,3
2023-06-01,60838,2,0,2,3,0,3
2023-06-01,62140,2,0,2,2,0,2
2023-06-01,60697,4,0,4,2,0,2
2023-06-01,60864,1,0,1,3,0,3
2023-06-01,206061,1,0,1,1,0,1
2023-06-01,60751,4,4,8,3,3,4
2023-06-01,47785,1,0,1,1,0,1
2023-06-01,47857,1,0,1,1,0,1
2023-06-01,209150,11,0,11,1,0,1
2023-06-01,60868,4,1,5,8,3,8
2023-06-01,60825,2,0,2,2,0,2
2023-06-01,60832,5,1,6,5,1,5
2023-06-01,207509,1,1,2,2,2,2
2023-06-01,207231,1,1,2,1,1,1
2023-06-01,12431,3,0,3,3,0,3
2023-06-01,202330,6,1,7,2,1,2
2023-06-01,210966,1,1,2,2,3,3
2023-06-01,60810,4,0,4,4,0,4
2023-06-01,210605,1,0,1,1,0,1
2023-06-01,60814,5,0,5,2,0,2
2023-06-01,204652,1,1,2,3,1,3
2023-06-01,34134,4,1,5,1,1,1
2023-06-01,203649,9,1,10,4,1,4
2023-06-01,60765,1,0,1,2,0,2
2023-06-01,60605,1,0,1,1,0,1
2023-06-01,60804,5,2,7,7,4,9
2023-06-01,201557,1,0,1,1,0,1
2023-06-01,60785,1,0,1,1,0,1
2023-06-01,60783,8,2,10,5,2,5
2023-06-01,42853,2,0,2,2,0,2
2023-06-01,60791,1,4,5,1,1,1
2023-06-01,60752,4,0,4,3,0,3
2023-06-01,60780,3,0,3,1,0,1
2023-06-01,60789,1,0,1,2,0,2
2023-06-01,25479,5,0,5,3,0,3
2023-06-01,60756,1,0,1,3,0,3
2023-06-01,60760,1,0,1,1,0,1
2023-06-01,60740,11,0,11,5,0,5
2023-06-01,62082,10,0,10,3,0,3
2023-06-01,202005,12,0,12,2,0,2
2023-06-01,60288,1,0,1,2,0,2
2023-06-01,202191,4,0,4,3,0,3
2023-06-01,60703,3,2,5,2,2,2
2023-06-01,60669,5,0,5,2,0,2
2023-06-01,60244,1,0,1,1,0,1
2023-06-01,25415,6,3,9,8,6,10
2023-06-01,60671,3,1,4,3,2,3
2023-06-01,60224,1,0,1,1,0,1
2023-06-01,34843,2,0,2,2,0,2
2023-06-01,60673,4,0,4,4,0,4
2023-06-01,57581,5,0,5,2,0,2
2023-06-01,57615,3,0,3,1,0,1
2023-06-01,211563,1,0,1,1,0,1
2023-06-01,60680,2,2,4,2,2,2
2023-06-01,60688,2,0,2,1,0,1
2023-06-01,207030,3,0,3,3,0,3
2023-06-01,57761,2,0,2,2,0,2
2023-06-01,203030,1,0,1,2,0,2
2023-06-01,60632,1,0,1,2,0,2
2023-06-01,12581,2,2,4,3,1,3
2023-06-01,60499,3,0,3,1,0,1
2023-06-01,8265,7,3,10,9,6,11
2023-06-01,201021,11,0,11,3,0,3
2023-06-01,49937,5,0,5,1,0,1
2023-06-01,200183,4,4,8,2,1,2
2023-06-01,206999,8,0,8,8,0,8
2023-06-01,202149,2,0,2,3,0,3
2023-06-01,59845,1,0,1,1,0,1
2023-06-01,60228,2,2,4,1,1,1
2023-06-01,60608,2,0,2,3,0,3
2023-06-01,60585,1,1,2,1,1,1
2023-06-01,60596,1,0,1,1,0,1
2023-06-01,12426,3,0,3,1,0,1
2023-06-01,60574,2,1,3,3,2,3
2023-06-01,60607,2,0,2,1,0,1
2023-06-01,201020,5,1,6,4,2,4
2023-06-01,207218,1,0,1,4,0,4
2023-06-01,60565,1,0,1,2,0,2
2023-06-01,208527,4,0,4,1,0,1
2023-06-01,31639,1,0,1,2,0,2
2023-06-01,206910,2,0,2,2,0,2
2023-06-01,200128,1,1,2,1,1,1
2023-06-01,60599,2,0,2,3,0,3
2023-06-01,60563,1,0,1,4,0,4
2023-06-01,204099,3,0,3,1,0,1
2023-06-01,203640,4,0,4,1,0,1
2023-06-01,60212,1,2,3,2,1,2
2023-06-01,62243,1,1,2,3,1,3
2023-06-01,47187,4,0,4,2,0,2
2023-06-01,60533,3,1,4,4,1,4
2023-06-01,60559,10,0,10,1,0,1
2023-06-01,39495,2,0,2,2,0,2
2023-06-01,60541,4,0,4,1,0,1
2023-06-01,149288,1,0,1,1,0,1
2023-06-01,60758,1,0,1,2,0,2
2023-06-01,207039,3,0,3,2,0,2
2023-06-01,60527,4,0,4,6,0,6
2023-06-01,201947,1,0,1,2,0,2
2023-06-01,60491,1,1,2,1,1,1
2023-06-01,62210,1,1,2,3,3,3
2023-06-01,60465,3,0,3,1,0,1
2023-06-01,203787,1,0,1,1,0,1
2023-06-01,200659,1,0,1,1,0,1
2023-06-01,60174,5,0,5,2,0,2
2023-06-01,199581,2,1,3,2,1,2
2023-06-01,205958,4,0,4,1,0,1
2023-06-01,60497,4,1,5,7,1,7
2023-06-01,60451,10,0,10,1,0,1
2023-06-01,60459,2,0,2,4,0,4
2023-06-01,199917,3,0,3,2,0,2
2023-06-01,60437,5,0,5,2,0,2
2023-06-01,205579,1,0,1,1,0,1
2023-06-01,31511,3,1,4,2,2,2
2023-06-01,43525,2,0,2,2,0,2
2023-06-01,60425,3,0,3,3,0,3
2023-06-01,60422,2,2,4,3,3,3
2023-06-01,60419,1,0,1,1,0,1
2023-06-01,51323,5,0,5,2,0,2
2023-06-01,60415,1,0,1,4,0,4
2023-06-01,60478,1,1,2,1,1,1
2023-06-01,60407,4,0,4,2,0,2
2023-06-01,54312,7,0,7,4,0,4
2023-06-01,35790,36,3,39,2,1,2
2023-06-01,60645,1,0,1,1,0,1
2023-06-01,60433,4,0,4,1,0,1
2023-06-01,60352,3,0,3,2,0,2
2023-06-01,12926,4,1,5,3,2,3
2023-06-01,47784,3,4,7,1,1,1
2023-06-01,200244,1,0,1,1,0,1
2023-06-01,203998,1,0,1,2,0,2
2023-06-01,204688,1,0,1,1,0,1
2023-06-01,60357,2,1,3,4,2,4
2023-06-01,60218,1,1,2,1,2,2
2023-06-01,60489,2,0,2,3,0,3
2023-06-01,62749,1,0,1,4,0,4
2023-06-01,200597,1,0,1,2,0,2
2023-06-01,202230,1,1,2,1,1,1
2023-06-01,43573,1,0,1,1,0,1
2023-06-01,201715,1,0,1,1,0,1
2023-06-01,59891,9,18,27,1,2,3
2023-06-01,60340,1,0,1,1,0,1
2023-06-01,201265,2,1,3,1,1,1
2023-06-01,62159,5,0,5,2,0,2
2023-06-01,202611,1,1,2,1,1,1
2023-06-01,207207,1,1,2,2,1,2
2023-06-01,62416,2,1,3,9,4,9
2023-06-01,60321,1,0,1,3,0,3
2023-06-01,198326,1,0,1,1,0,1
2023-06-01,60325,5,1,6,3,2,3
2023-06-01,199876,1,1,2,3,2,3
2023-06-01,60277,4,0,4,5,0,5
2023-06-01,49584,4,1,5,7,1,7
2023-06-01,200741,3,0,3,1,0,1
2023-06-01,60302,4,0,4,3,0,3
2023-06-01,60323,1,1,2,3,2,3
2023-06-01,199826,3,0,3,3,0,3
2023-06-01,49896,1,0,1,1,0,1
2023-06-01,213070,1,0,1,1,0,1
2023-06-01,60297,12,2,14,1,1,1
2023-06-01,204032,1,1,2,1,1,1
2023-06-01,204907,2,0,2,1,0,1
2023-06-01,60266,2,2,4,1,2,2
2023-06-01,60353,2,0,2,2,0,2
2023-06-01,62027,2,0,2,2,0,2
2023-06-01,203905,3,0,3,2,0,2
2023-06-01,50313,2,1,3,6,6,8
2023-06-01,51491,2,0,2,1,0,1
2023-06-01,60252,1,0,1,1,0,1
2023-06-01,60316,5,1,6,3,3,3
2023-06-01,206301,1,0,1,2,0,2
2023-06-01,16055,3,0,3,2,0,2
2023-06-01,200061,1,0,1,1,0,1
2023-06-01,8922,2,1,3,6,4,6
2023-06-01,60237,1,0,1,1,0,1
2023-06-01,60243,4,7,11,1,1,1
2023-06-01,60241,3,1,4,2,2,2
2023-06-01,60333,1,0,1,2,0,2
2023-06-01,211166,1,0,1,1,0,1
2023-06-01,60229,2,0,2,1,0,1
2023-06-01,60214,2,0,2,1,0,1
2023-06-01,212538,4,0,4,2,0,2
2023-06-01,60172,6,0,6,2,0,2
2023-06-01,60200,3,0,3,4,0,4
2023-06-01,398273,2,0,2,1,0,1
2023-06-01,60239,1,1,2,3,3,3
2023-06-01,62154,1,1,2,1,1,1
2023-06-01,60260,4,0,4,2,0,2
2023-06-01,60173,1,0,1,6,0,6
2023-06-01,62123,4,0,4,1,0,1
2023-06-01,15755,3,1,4,1,1,1
2023-06-01,200164,3,0,3,1,0,1
2023-06-01,201365,3,2,5,2,1,2
2023-06-01,42570,1,1,2,1,1,1
2023-06-01,206288,1,1,2,1,1,1
2023-06-01,62145,4,0,4,1,0,1
2023-06-01,8249,7,0,7,1,0,1
2023-06-01,62440,22,0,22,4,0,4
2023-06-01,62450,1,0,1,1,0,1
2023-06-01,199996,1,0,1,1,0,1
2023-06-01,200168,5,2,7,1,1,1
2023-06-01,62251,3,1,4,1,2,2
2023-06-01,39842,1,0,1,1,0,1
2023-06-01,202186,1,0,1,1,0,1
2023-06-01,29792,1,1,2,1,1,1
2023-06-01,204095,3,0,3,2,0,2
2023-06-01,35733,4,2,6,1,2,3
2023-06-01,43204,2,0,2,2,0,2
2023-06-01,200147,7,0,7,3,0,3
2023-06-01,201780,1,0,1,1,0,1
2023-06-01,62403,3,0,3,1,0,1
2023-06-01,59661,3,0,3,1,0,1
2023-06-01,199752,3,1,4,3,2,3
2023-06-01,35368,1,1,2,1,1,1
2023-06-01,62405,1,1,2,1,1,1
2023-06-01,200133,3,1,4,2,1,2
2023-06-01,200129,2,2,4,3,3,3
2023-06-01,212855,1,1,2,3,3,4
2023-06-01,200127,8,0,8,4,0,4
2023-06-01,199872,1,0,1,1,0,1
2023-06-01,210806,1,1,2,3,3,3
2023-06-01,199895,2,0,2,1,0,1
2023-06-01,210704,1,0,1,1,0,1
2023-06-01,199727,7,0,7,1,0,1
2023-06-01,16222,1,0,1,3,0,3
2023-06-01,3227,1,0,1,1,0,1
2023-06-01,62381,2,0,2,1,0,1
2023-06-01,62368,1,0,1,1,0,1
2023-06-01,200073,4,0,4,3,0,3
2023-06-01,200097,4,0,4,3,0,3
2023-06-01,62391,1,1,2,1,1,1
2023-06-01,200089,1,0,1,6,0,6
2023-06-01,200087,1,0,1,3,0,3
2023-06-01,51324,6,5,11,7,7,9
2023-06-01,200086,1,1,2,4,3,4
2023-06-01,210156,3,1,4,1,1,1
2023-06-01,199903,2,0,2,1,0,1
2023-06-01,199946,3,0,3,1,0,1
2023-06-01,62172,1,0,1,1,0,1
2023-06-01,210318,4,0,4,2,0,2
2023-06-01,200047,1,0,1,2,0,2
2023-06-01,200071,2,0,2,1,0,1
2023-06-01,62373,3,1,4,5,2,5
2023-06-01,8361,4,0,4,1,0,1
2023-06-01,199999,2,1,3,1,1,1
2023-06-01,200049,4,0,4,4,0,4
2023-06-01,200251,1,0,1,1,0,1
2023-06-01,62141,1,0,1,1,0,1
2023-06-01,62297,7,1,8,2,2,2
2023-06-01,58005,1,1,2,1,1,1
2023-06-01,200008,2,1,3,2,1,2
2023-06-01,62363,2,1,3,4,2,5
2023-06-01,205235,1,1,2,2,3,3
2023-06-01,200035,2,0,2,2,0,2
2023-06-01,199828,2,0,2,2,0,2
2023-06-01,200037,4,0,4,1,0,1
2023-06-01,395184,1,0,1,1,0,1
2023-06-01,395651,1,1,2,1,1,1
2023-06-01,62356,1,0,1,1,0,1
2023-06-01,30767,3,0,3,4,0,4
2023-06-01,199757,1,0,1,2,0,2
2023-06-01,212994,3,0,3,5,0,5
2023-06-01,200025,4,0,4,2,0,2
2023-06-01,49034,2,1,3,1,1,1
2023-06-01,199905,5,0,5,2,0,2
2023-06-01,62332,21,1,22,3,2,3
2023-06-01,200015,1,0,1,6,0,6
2023-06-01,207472,1,0,1,3,0,3
2023-06-01,200003,5,1,6,1,1,1
2023-06-01,199998,3,1,4,2,1,2
2023-06-01,202180,1,0,1,2,0,2
2023-06-01,57977,4,0,4,2,0,2
2023-06-01,48899,1,0,1,1,0,1
2023-06-01,199993,3,3,6,6,5,6
2023-06-01,59933,3,1,4,10,5,11
2023-06-01,206063,3,0,3,2,0,2
2023-06-01,205660,2,0,2,2,0,2
2023-06-01,199992,2,0,2,2,0,2
2023-06-01,211799,1,0,1,3,0,3
2023-06-01,199987,3,5,8,1,1,1
2023-06-01,62286,1,0,1,1,0,1
2023-06-01,49677,2,3,5,3,3,3
2023-06-01,199427,1,0,1,2,0,2
2023-06-01,212881,1,1,2,1,1,1
2023-06-01,203096,4,0,4,3,0,3
2023-06-01,199981,1,0,1,7,0,7
2023-06-01,199966,1,0,1,2,0,2
2023-06-01,62317,4,0,4,1,0,1
2023-06-01,39899,11,1,12,3,2,3
2023-06-01,62276,1,0,1,1,0,1
2023-06-01,8769,11,1,12,2,2,2
2023-06-01,62301,2,0,2,1,0,1
2023-06-01,202264,1,0,1,1,0,1
2023-06-01,199859,1,0,1,1,0,1
2023-06-01,201764,1,1,2,9,6,10
2023-06-01,199900,1,0,1,1,0,1
2023-06-01,61101,1,0,1,1,0,1
2023-06-01,52045,1,0,1,1,0,1
2023-06-01,44294,1,0,1,2,0,2
2023-06-01,212761,1,0,1,1,0,1
2023-06-01,211847,1,0,1,1,0,1
2023-06-01,197491,11,1,12,2,1,2
2023-06-01,199953,4,2,6,4,2,4
2023-06-01,199938,5,2,7,8,5,9
2023-06-01,199933,1,1,2,3,3,3
2023-06-01,62252,5,0,5,1,0,1
2023-06-01,199951,1,0,1,1,0,1
2023-06-01,212490,1,0,1,1,0,1
2023-06-01,62293,2,0,2,3,0,3
2023-06-01,62274,1,0,1,1,0,1
2023-06-01,199869,5,0,5,2,0,2
2023-06-01,208703,4,0,4,2,0,2
2023-06-01,47693,3,1,4,1,1,1
2023-06-01,199942,1,0,1,1,0,1
2023-06-01,202060,1,1,2,1,1,1
2023-06-01,199321,3,1,4,1,1,1
2023-06-01,56784,3,1,4,1,1,1
2023-06-01,48601,1,0,1,1,0,1
2023-06-01,201314,1,0,1,2,0,2
2023-06-01,199937,2,1,3,5,3,5
2023-06-01,206250,1,2,3,3,1,3
2023-06-01,201835,3,0,3,2,0,2
2023-06-01,203361,2,2,4,1,1,1
2023-06-01,12924,5,1,6,3,3,5
2023-06-01,199913,2,0,2,1,0,1
2023-06-01,200939,3,0,3,2,0,2
2023-06-01,34869,1,0,1,1,0,1
2023-06-01,62248,7,3,10,4,2,4
2023-06-01,199907,5,1,6,1,1,2
2023-06-01,208426,1,0,1,3,0,3
2023-06-01,201958,6,4,10,2,3,5
2023-06-01,62223,3,0,3,3,0,3
2023-06-01,199710,6,0,6,3,0,3
2023-06-01,41991,1,0,1,1,0,1
2023-06-01,212880,1,1,2,1,1,1
2023-06-01,212771,1,0,1,1,0,1
2023-06-01,62227,1,1,2,7,6,8
2023-06-01,202746,4,2,6,7,6,7
2023-06-01,54876,8,2,10,5,1,5
2023-06-01,201084,1,0,1,1,0,1
2023-06-01,204002,4,0,4,1,0,1
2023-06-01,62218,1,0,1,1,0,1
2023-06-01,62244,1,1,2,1,2,2
2023-06-01,25496,2,1,3,4,2,4
2023-06-01,45033,6,1,7,3,1,3
2023-06-01,25192,10,8,18,22,14,26
2023-06-01,200070,5,5,10,6,3,6
2023-06-01,20701,2,2,4,1,1,1
2023-06-01,199810,1,0,1,3,0,3
2023-06-01,199848,1,0,1,1,0,1
2023-06-01,202037,5,0,5,3,0,3
2023-06-01,199880,3,1,4,2,2,2
2023-06-01,21151,4,0,4,6,0,6
2023-06-01,61959,1,0,1,2,0,2
2023-06-01,62221,4,1,5,5,1,5
2023-06-01,62137,3,0,3,1,0,1
2023-06-01,62202,1,0,1,1,0,1
2023-06-01,24824,2,3,5,3,2,3
2023-06-01,198290,3,1,4,8,5,10
2023-06-01,203218,1,1,2,2,2,2
2023-06-01,59788,2,1,3,1,1,1
2023-06-01,199850,2,0,2,2,0,2
2023-06-01,62186,1,1,2,3,2,3
2023-06-01,62198,4,0,4,2,0,2
2023-06-01,62193,1,1,2,5,4,5
2023-06-01,199849,4,0,4,1,0,1
2023-06-01,204639,1,0,1,5,0,5
2023-06-01,8485,1,1,2,1,1,1
2023-06-01,203467,1,0,1,2,0,2
2023-06-01,206097,1,0,1,1,0,1
2023-06-01,208857,6,0,6,2,0,2
2023-06-01,57394,2,1,3,3,2,3
2023-06-01,56974,2,0,2,3,0,3
2023-06-01,206543,1,0,1,2,0,2
2023-06-01,199844,1,0,1,1,0,1
2023-06-01,62138,1,0,1,1,0,1
2023-06-01,60259,0,0,0,2,2,2
2023-06-01,62199,1,1,2,1,1,1
2023-06-01,199799,1,1,2,1,2,3
2023-06-01,201301,3,3,6,2,2,2
2023-06-01,52088,1,1,2,1,1,1
2023-06-01,199722,1,0,1,2,0,2
2023-06-01,199800,2,1,3,1,1,1
2023-06-01,199805,3,3,6,7,5,7
2023-06-01,202041,3,0,3,2,0,2
2023-06-01,59469,0,0,0,2,0,2
2023-06-01,199795,1,0,1,1,0,1
2023-06-01,201903,1,0,1,1,0,1
2023-06-01,199783,2,3,5,1,1,1
2023-06-01,212976,3,0,3,2,0,2
2023-06-01,199782,5,0,5,3,0,3
2023-06-01,201220,1,0,1,2,0,2
2023-06-01,199864,1,0,1,1,0,1
2023-06-01,62090,4,0,4,2,0,2
2023-06-01,211401,1,0,1,1,0,1
2023-06-01,201556,1,0,1,3,0,3
2023-06-01,203810,4,0,4,1,0,1
2023-06-01,41735,2,0,2,2,0,2
2023-06-01,62139,3,0,3,1,0,1
2023-06-01,42600,9,0,9,6,0,6
2023-06-01,62134,1,0,1,2,0,2
2023-06-01,199776,2,0,2,1,0,1
2023-06-01,41451,2,1,3,1,1,1
2023-06-01,62125,6,0,6,1,0,1
2023-06-01,5484,6,0,6,1,0,1
2023-06-01,60126,1,0,1,1,0,1
2023-06-01,62117,2,0,2,1,0,1
2023-06-01,204130,1,0,1,2,0,2
2023-06-01,206960,3,0,3,3,0,3
2023-06-01,199756,1,0,1,1,0,1
2023-06-01,60156,1,1,2,2,2,2
2023-06-01,202339,2,0,2,4,0,4
2023-06-01,61956,2,1,3,3,1,3
2023-06-01,62102,3,1,4,2,2,2
2023-06-01,52059,3,0,3,3,0,3
2023-06-01,49198,1,0,1,1,0,1
2023-06-01,62104,10,0,10,2,0,2
2023-06-01,199733,2,2,4,3,2,3
2023-06-01,206665,1,0,1,1,0,1
2023-06-01,199711,2,2,4,3,1,3
2023-06-01,30758,1,0,1,1,0,1
2023-06-01,59887,1,0,1,1,0,1
2023-06-01,59868,1,0,1,1,0,1
2023-06-01,8299,3,0,3,2,0,2
2023-06-01,202210,1,0,1,1,0,1
2023-06-01,62086,5,8,13,4,5,5
2023-06-01,199728,3,0,3,2,0,2
2023-06-01,199744,3,0,3,3,0,3
2023-06-01,205276,2,0,2,1,0,1
2023-06-01,212225,3,0,3,2,0,2
2023-06-01,59621,1,0,1,1,0,1
2023-06-01,198000,2,0,2,3,0,3
2023-06-01,199729,1,0,1,1,0,1
2023-06-01,199708,4,1,5,7,1,7
2023-06-01,199725,6,1,7,2,1,2
2023-06-01,202174,1,0,1,2,0,2
2023-06-01,201946,2,0,2,1,0,1
2023-06-01,25516,3,1,4,8,1,8
2023-06-01,204066,1,0,1,2,0,2
2023-06-01,59886,7,0,7,2,0,2
2023-06-01,201405,1,1,2,2,2,2
2023-06-01,201403,2,1,3,2,2,2
2023-06-01,42783,2,0,2,1,0,1
2023-06-01,199706,2,0,2,1,0,1
2023-06-01,29316,2,1,3,3,1,3
2023-06-01,202235,1,1,2,1,1,2
2023-06-01,202234,4,0,4,4,0,4
2023-06-01,202217,1,0,1,2,0,2
2023-06-01,211321,2,4,6,2,2,2
2023-06-01,56494,4,0,4,1,0,1
2023-06-01,202223,4,0,4,3,0,3
2023-06-01,202178,1,0,1,1,0,1
2023-06-01,202073,1,0,1,1,0,1
2023-06-01,62002,1,1,2,1,1,1
2023-06-01,202215,4,0,4,2,0,2
2023-06-01,212726,4,0,4,1,0,1
2023-06-01,211690,1,1,2,2,2,2
2023-06-01,212731,1,1,2,2,2,2
2023-06-01,201187,1,0,1,1,0,1
2023-06-01,204020,1,3,4,7,2,7
2023-06-01,61995,1,0,1,1,0,1
2023-06-01,202212,1,1,2,2,2,2
2023-06-01,212978,1,0,1,1,0,1
2023-06-01,62031,4,1,5,3,2,4
2023-06-01,212572,1,0,1,1,0,1
2023-06-01,201866,1,1,2,5,3,6
2023-06-01,202202,1,0,1,3,0,3
2023-06-01,200711,1,1,2,2,2,2
2023-06-01,62024,3,0,3,2,0,2
2023-06-01,203906,1,0,1,1,0,1
2023-06-01,202148,2,0,2,4,0,4
2023-06-01,201876,2,0,2,1,0,1
2023-06-01,201808,2,2,4,3,2,3
2023-06-01,199786,1,1,2,2,1,2
2023-06-01,200381,1,0,1,2,0,2
2023-06-01,50203,3,0,3,2,0,2
2023-06-01,202075,3,0,3,2,0,2
2023-06-01,202179,4,0,4,2,0,2
2023-06-01,202194,2,1,3,6,7,7
2023-06-01,61042,2,1,3,3,2,3
2023-06-01,62022,1,1,2,1,1,1
2023-06-01,39147,1,0,1,1,0,1
2023-06-01,208582,1,1,2,1,1,1
2023-06-01,202163,4,0,4,1,0,1
2023-06-01,212680,1,0,1,1,0,1
2023-06-01,205424,16,1,17,3,2,4
2023-06-01,211717,2,0,2,1,0,1
2023-06-01,202123,3,0,3,2,0,2
2023-06-01,201169,1,0,1,3,0,3
2023-06-01,203310,1,0,1,1,0,1
2023-06-01,62050,1,0,1,2,0,2
2023-06-01,205911,1,1,2,1,1,1
2023-06-01,61073,2,0,2,3,0,3
2023-06-01,202164,3,1,4,4,1,4
2023-06-01,201940,1,0,1,2,0,2
2023-06-01,61963,1,0,1,1,0,1
2023-06-01,60162,3,1,4,1,2,2
2023-06-01,62017,1,0,1,1,0,1
2023-06-01,64444,1,1,2,5,3,5
2023-06-01,61984,1,1,2,1,1,1
2023-06-01,59666,3,0,3,1,0,1
2023-06-01,198621,1,0,1,2,0,2
2023-06-01,197519,1,1,2,2,2,2
2023-06-01,62011,2,0,2,5,0,5
2023-06-01,208860,1,0,1,1,0,1
2023-06-01,202146,4,1,5,3,3,3
2023-06-01,47644,4,0,4,3,0,3
2023-06-01,210001,2,0,2,1,0,1
2023-06-01,49956,6,0,6,3,0,3
2023-06-01,60091,1,0,1,2,0,2
2023-06-01,61987,3,0,3,1,0,1
2023-06-01,202131,1,1,2,1,1,1
2023-06-01,59789,3,1,4,2,1,2
2023-06-01,60102,3,0,3,5,0,5
2023-06-01,198101,6,2,8,7,5,7
2023-06-01,61966,2,0,2,1,0,1
2023-06-01,202094,1,0,1,2,0,2
2023-06-01,202114,4,1,5,2,1,2
2023-06-01,59984,1,1,2,6,1,6
2023-06-01,61981,2,1,3,1,1,2
2023-06-01,201828,4,0,4,2,0,2
2023-06-01,201277,5,1,6,8,5,9
2023-06-01,202095,4,0,4,2,0,2
2023-06-01,210946,1,0,1,1,0,1
2023-06-01,39172,4,0,4,2,0,2
2023-06-01,202093,5,0,5,4,0,4
2023-06-01,15691,21,1,22,7,2,7
2023-06-01,59770,1,1,2,2,2,2
2023-06-01,60158,1,0,1,3,0,3
2023-06-01,211196,5,8,13,1,1,1
2023-06-01,204118,1,0,1,1,0,1
2023-06-01,202096,2,2,4,4,3,5
2023-06-01,39217,5,1,6,5,2,5
2023-06-01,60094,1,1,2,2,2,2
2023-06-01,61969,1,1,2,3,2,3
2023-06-01,202311,5,0,5,1,0,1
2023-06-01,60161,5,0,5,4,0,4
2023-06-01,43800,3,0,3,1,0,1
2023-06-01,60163,4,5,9,1,2,2
2023-06-01,202078,1,0,1,1,0,1
2023-06-01,201883,1,0,1,1,0,1
2023-06-01,201954,1,0,1,2,0,2
2023-06-01,60015,5,0,5,4,0,4
2023-06-01,202040,2,1,3,2,2,2
2023-06-01,202032,1,1,2,7,4,7
2023-06-01,203993,1,3,4,6,6,8
2023-06-01,208492,1,1,2,1,1,1
2023-06-01,201723,1,2,3,1,5,5
2023-06-01,51938,4,0,4,3,0,3
2023-06-01,205810,1,0,1,6,0,6
2023-06-01,199906,1,0,1,3,0,3
2023-06-01,208357,1,0,1,3,0,3
2023-06-01,60164,3,1,4,3,3,3
2023-06-01,202055,2,0,2,1,0,1
2023-06-01,49760,1,0,1,1,0,1
2023-06-01,204249,4,1,5,2,1,3
2023-06-01,60157,6,3,9,2,2,2
2023-06-01,202606,1,0,1,1,0,1
2023-06-01,201984,4,1,5,4,1,4
2023-06-01,12315,4,1,5,4,7,8
2023-06-01,6793,0,0,0,2,0,2
2023-06-01,20542,1,0,1,1,0,1
2023-06-01,202063,2,0,2,1,0,1
2023-06-01,60755,1,0,1,1,0,1
2023-06-01,201968,1,0,1,3,0,3
2023-06-01,204659,1,1,2,2,2,2
2023-06-01,206299,1,0,1,1,0,1
2023-06-01,60153,5,0,5,3,0,3
2023-06-01,60155,1,0,1,1,0,1
2023-06-01,51432,22,0,22,2,0,2
2023-06-01,28918,7,0,7,1,0,1
2023-06-01,201981,1,0,1,3,0,3
2023-06-01,201152,1,0,1,1,0,1
2023-06-01,58150,3,0,3,5,0,5
2023-06-01,202030,5,0,5,3,0,3
2023-06-01,202026,3,0,3,4,0,4
2023-06-01,49827,2,0,2,4,0,4
2023-06-01,60129,2,2,4,4,4,4
2023-06-01,202022,3,0,3,4,0,4
2023-06-01,201787,5,4,9,2,2,2
2023-06-01,202021,5,0,5,2,0,2
2023-06-01,200699,1,0,1,1,0,1
2023-06-01,211720,1,1,2,1,1,1
2023-06-01,60140,12,1,13,2,2,2
2023-06-01,60138,3,1,4,1,1,1
2023-06-01,49130,1,1,2,1,1,1
2023-06-01,43902,1,1,2,1,1,1
2023-06-01,202017,5,1,6,2,1,2
2023-06-01,60132,3,1,4,2,1,2
2023-06-01,201720,1,0,1,2,0,2
2023-06-01,60130,4,1,5,1,1,1
2023-06-01,201180,1,0,1,3,0,3
2023-06-01,201927,3,0,3,2,0,2
2023-06-01,49402,4,0,4,6,0,6
2023-06-01,49914,4,0,4,3,0,3
2023-06-01,201985,2,0,2,1,0,1
2023-06-01,213180,1,0,1,1,0,1
2023-06-01,199788,1,0,1,1,0,1
2023-06-01,59779,2,1,3,1,1,1
2023-06-01,201939,5,1,6,4,3,4
2023-06-01,9215,6,0,6,4,0,4
2023-06-01,201854,1,0,1,1,0,1
2023-06-01,201982,3,0,3,3,0,3
2023-06-01,31449,2,0,2,8,0,8
2023-06-01,60103,3,0,3,2,0,2
2023-06-01,203354,2,1,3,2,1,2
2023-06-01,60044,1,1,2,3,1,3
2023-06-01,60049,5,3,8,4,2,6
2023-06-01,201955,1,1,2,1,1,1
2023-06-01,60056,2,0,2,2,0,2
2023-06-01,8793,5,1,6,4,4,5
2023-06-01,51333,3,2,5,7,6,10
2023-06-01,201699,4,0,4,3,0,3
2023-06-01,201960,1,0,1,1,0,1
2023-06-01,201959,1,0,1,3,0,3
2023-06-01,201563,5,0,5,4,0,4
2023-06-01,201523,4,0,4,1,0,1
2023-06-01,20655,10,1,11,6,6,6
2023-06-01,51798,1,0,1,1,0,1
2023-06-01,201595,6,0,6,2,0,2
2023-06-01,201875,1,0,1,1,0,1
2023-06-01,201721,1,0,1,1,0,1
2023-06-01,205849,1,0,1,2,0,2
2023-06-01,59740,1,0,1,1,0,1
2023-06-01,60086,1,1,2,2,2,2
2023-06-01,48487,4,0,4,5,0,5
2023-06-01,201932,2,1,3,1,1,1
2023-06-01,201906,4,1,5,3,3,3
2023-06-01,16281,4,1,5,2,1,2
2023-06-01,201896,3,1,4,1,1,1
2023-06-01,201928,8,0,8,1,0,1
2023-06-01,200286,1,0,1,2,0,2
2023-06-01,211844,5,0,5,2,0,2
2023-06-01,207514,5,0,5,2,0,2
2023-06-01,57736,6,1,7,2,1,2
2023-06-01,31480,3,1,4,2,2,2
2023-06-01,204238,1,0,1,2,0,2
2023-06-01,206547,4,0,4,2,0,2
2023-06-01,24740,3,0,3,3,0,3
2023-06-01,201919,5,0,5,3,0,3
2023-06-01,206688,1,0,1,1,0,1
2023-06-01,201997,1,0,1,1,0,1
2023-06-01,60055,3,0,3,2,0,2
2023-06-01,201894,3,2,5,1,1,1
2023-06-01,201916,1,0,1,2,0,2
2023-06-01,212213,1,0,1,2,0,2
2023-06-01,206146,1,0,1,2,0,2
2023-06-01,42644,1,0,1,2,0,2
2023-06-01,201897,3,0,3,3,0,3
2023-06-01,60063,1,0,1,2,0,2
2023-06-01,201259,4,0,4,3,0,3
2023-06-01,44450,5,0,5,1,0,1
2023-06-01,202843,1,0,1,2,0,2
2023-06-01,202737,1,0,1,1,0,1
2023-06-01,201568,2,0,2,3,0,3
2023-06-01,50030,1,1,2,5,5,6
2023-06-01,60003,1,1,2,1,1,1
2023-06-01,211483,6,1,7,2,1,2
2023-06-01,201898,1,1,2,1,1,1
2023-06-01,201905,1,1,2,1,1,1
2023-06-01,47704,3,2,5,7,6,9
2023-06-01,201806,1,0,1,5,0,5
2023-06-01,201858,1,0,1,1,0,1
2023-06-01,201895,3,0,3,5,0,5
2023-06-01,50033,3,1,4,2,1,2
2023-06-01,201857,5,0,5,1,0,1
2023-06-01,201891,3,0,3,1,0,1
2023-06-01,207234,5,1,6,3,2,3
2023-06-01,202665,1,0,1,1,0,1
2023-06-01,201889,2,0,2,1,0,1
2023-06-01,16218,2,1,3,7,2,8
2023-06-01,204131,1,0,1,3,0,3
2023-06-01,60046,5,0,5,2,0,2
2023-06-01,60039,2,0,2,4,0,4
2023-06-01,201860,3,0,3,1,0,1
2023-06-01,201209,1,0,1,1,0,1
2023-06-01,199584,5,0,5,3,0,3
2023-06-01,201878,3,1,4,1,1,1
2023-06-01,60043,1,0,1,1,0,1
2023-06-01,47719,4,0,4,2,0,2
2023-06-01,201873,3,3,6,2,1,2
2023-06-01,212492,1,0,1,2,0,2
2023-06-01,201859,2,1,3,3,1,3
2023-06-01,209662,3,0,3,3,0,3
2023-06-01,204563,2,0,2,2,0,2
2023-06-01,59970,3,2,5,5,2,5
2023-06-01,60038,3,0,3,2,0,2
2023-06-01,202238,1,0,1,1,0,1
2023-06-01,201862,7,0,7,2,0,2
2023-06-01,201659,1,1,2,1,2,2
2023-06-01,201424,2,1,3,1,1,1
2023-06-01,201855,3,0,3,1,0,1
2023-06-01,209617,3,0,3,1,0,1
2023-06-01,204627,1,0,1,1,0,1
2023-06-01,47366,4,0,4,2,0,2
2023-06-01,201234,1,0,1,1,0,1
2023-06-01,200512,1,0,1,1,0,1
2023-06-01,204233,1,0,1,1,0,1
2023-06-01,201852,1,0,1,1,0,1
2023-06-01,206856,4,0,4,3,0,3
2023-06-01,60023,1,0,1,1,0,1
2023-06-01,211406,1,0,1,3,0,3
2023-06-01,206785,2,1,3,1,1,1
2023-06-01,201833,2,0,2,1,0,1
2023-06-01,201834,2,0,2,1,0,1
2023-06-01,205811,1,0,1,2,0,2
2023-06-01,39482,1,0,1,1,0,1
2023-06-01,59992,2,0,2,1,0,1
2023-06-01,201888,2,1,3,2,1,2
2023-06-01,20594,3,1,4,1,1,1
2023-06-01,201832,2,4,6,2,3,3
2023-06-01,201831,1,0,1,3,0,3
2023-06-01,40490,3,2,5,3,3,3
2023-06-01,12287,3,2,5,3,2,3
2023-06-01,200925,2,2,4,1,1,1
2023-06-01,201708,3,0,3,1,0,1
2023-06-01,212758,4,0,4,3,0,3
2023-06-01,210365,1,0,1,1,0,1
2023-06-01,201718,1,1,2,1,1,1
2023-06-01,59897,1,1,2,3,3,3
2023-06-01,59971,1,1,2,2,2,2
2023-06-01,200691,1,1,2,1,1,1
2023-06-01,201803,1,0,1,2,0,2
2023-06-01,206821,5,0,5,7,0,7
2023-06-01,201794,3,0,3,2,0,2
2023-06-01,59985,1,1,2,6,3,7
2023-06-01,204732,4,0,4,2,0,2
2023-06-01,201821,1,0,1,3,0,3
2023-06-01,56805,9,0,9,3,0,3
2023-06-01,207281,1,0,1,1,0,1
2023-06-01,207289,1,1,2,2,2,2
2023-06-01,204947,6,1,7,6,3,6
2023-06-01,209540,1,0,1,2,0,2
2023-06-01,29549,5,0,5,3,0,3
2023-06-01,201841,5,0,5,3,0,3
2023-06-01,209646,1,0,1,1,0,1
2023-06-01,200435,5,1,6,1,1,1
2023-06-01,201782,1,1,2,4,1,4
2023-06-01,201609,1,0,1,2,0,2
2023-06-01,59978,1,0,1,2,0,2
2023-06-01,201772,1,0,1,1,0,1
2023-06-01,207406,1,0,1,1,0,1
2023-06-01,49647,1,0,1,1,0,1
2023-06-01,201607,1,0,1,1,0,1
2023-06-01,59968,1,0,1,1,0,1
2023-06-01,42287,2,0,2,2,0,2
2023-06-01,42073,3,0,3,1,0,1
2023-06-01,201679,1,0,1,1,0,1
2023-06-01,49864,3,1,4,2,2,2
2023-06-01,62012,4,0,4,2,0,2
2023-06-01,201756,3,0,3,1,0,1
2023-06-01,50152,3,0,3,3,0,3
2023-06-01,59820,2,0,2,4,0,4
2023-06-01,62130,1,0,1,2,0,2
2023-06-01,201740,2,0,2,2,0,2
2023-06-01,21235,3,1,4,3,3,3
2023-06-01,201745,4,0,4,1,0,1
2023-06-01,39567,6,1,7,2,1,2
2023-06-01,209536,1,0,1,1,0,1
2023-06-01,201747,1,0,1,2,0,2
2023-06-01,210948,1,0,1,1,0,1
2023-06-01,59950,2,0,2,1,0,1
2023-06-01,211195,1,0,1,1,0,1
2023-06-01,207467,2,2,4,1,1,1
2023-06-01,210424,1,0,1,1,0,1
2023-06-01,201493,4,0,4,6,0,6
2023-06-01,59944,1,1,2,2,2,2
2023-06-01,199525,1,0,1,1,0,1
2023-06-01,201738,1,0,1,1,0,1
2023-06-01,201719,5,0,5,3,0,3
2023-06-01,48708,1,0,1,2,0,2
2023-06-01,201358,3,0,3,2,0,2
2023-06-01,203988,1,0,1,1,0,1
2023-06-01,207367,2,1,3,2,2,2
2023-06-01,47289,1,1,2,1,1,1
2023-06-01,212927,1,0,1,1,0,1
2023-06-01,36239,4,0,4,1,0,1
2023-06-01,200550,1,0,1,1,0,1
2023-06-01,201731,1,0,1,3,0,3
2023-06-01,201175,4,1,5,2,1,2
2023-06-01,48689,3,1,4,1,1,1
2023-06-01,33968,1,0,1,1,0,1
2023-06-01,202329,1,3,4,2,2,2
2023-06-01,207160,1,1,2,2,1,2
2023-06-01,201668,3,0,3,1,0,1
2023-06-01,59904,1,0,1,1,0,1
2023-06-01,59925,1,1,2,1,1,1
2023-06-01,59949,4,1,5,4,2,4
2023-06-01,204773,1,3,4,2,2,3
2023-06-01,35507,5,2,7,3,2,3
2023-06-01,201597,3,2,5,1,1,1
2023-06-01,201710,1,0,1,1,0,1
2023-06-01,35040,2,0,2,1,0,1
2023-06-01,200713,4,1,5,3,1,3
2023-06-01,41379,3,0,3,3,0,3
2023-06-01,203836,12,0,12,2,0,2
2023-06-01,204832,8,0,8,3,0,3
2023-06-01,59918,1,0,1,1,0,1
2023-06-01,201375,1,0,1,2,0,2
2023-06-01,201702,1,1,2,1,2,2
2023-06-01,59811,1,2,3,7,6,8
2023-06-01,59914,2,0,2,1,0,1
2023-06-01,201689,3,0,3,1,0,1
2023-06-01,44833,1,1,2,1,1,1
2023-06-01,203381,4,0,4,1,0,1
2023-06-01,201688,3,1,4,2,1,2
2023-06-01,19630,1,0,1,1,0,1
2023-06-01,200870,4,0,4,3,0,3
2023-06-01,57348,6,0,6,4,0,4
2023-06-01,61129,4,0,4,2,0,2
2023-06-01,59883,1,0,1,4,0,4
2023-06-01,30943,5,0,5,3,0,3
2023-06-01,201654,2,1,3,2,1,2
2023-06-01,200647,1,2,3,2,2,2
2023-06-01,59884,4,0,4,2,0,2
2023-06-01,201652,4,0,4,4,0,4
2023-06-01,201736,1,0,1,3,0,3
2023-06-01,59821,2,0,2,2,0,2
2023-06-01,201646,2,1,3,1,1,1
2023-06-01,43875,1,0,1,1,0,1
2023-06-01,61230,1,0,1,2,0,2
2023-06-01,43680,3,0,3,2,0,2
2023-06-01,200683,3,0,3,1,0,1
2023-06-01,201535,1,0,1,3,0,3
2023-06-01,201651,5,0,5,4,0,4
2023-06-01,201629,1,0,1,2,0,2
2023-06-01,39548,1,0,1,1,0,1
2023-06-01,201648,2,1,3,1,1,1
2023-06-01,201590,3,2,5,2,1,2
2023-06-01,59874,8,4,12,6,3,6
2023-06-01,201649,4,0,4,1,0,1
2023-06-01,59871,1,5,6,4,3,4
2023-06-01,59870,2,0,2,3,0,3
2023-06-01,201644,4,0,4,3,0,3
2023-06-01,201650,5,4,9,6,5,7
2023-06-01,201643,5,0,5,3,0,3
2023-06-01,209772,4,0,4,1,0,1
2023-06-01,59866,4,0,4,6,0,6
2023-06-01,202077,1,2,3,3,3,3
2023-06-01,206179,1,0,1,2,0,2
2023-06-01,59859,5,1,6,2,1,2
2023-06-01,201625,1,1,2,1,1,1
2023-06-01,201627,2,0,2,3,0,3
2023-06-01,205644,1,1,2,1,1,1
2023-06-01,208823,1,0,1,2,0,2
2023-06-01,59800,1,3,4,1,1,1
2023-06-01,59802,1,3,4,1,1,1
2023-06-01,203208,2,3,5,1,1,1
2023-06-01,201594,1,1,2,4,1,4
2023-06-01,205535,3,3,6,5,4,6
2023-06-01,201618,4,0,4,2,0,2
2023-06-01,201621,1,0,1,1,0,1
2023-06-01,201370,1,1,2,1,1,1
2023-06-01,209567,2,0,2,1,0,1
2023-06-01,44624,1,0,1,1,0,1
2023-06-01,41679,1,0,1,2,0,2
2023-06-01,201608,1,1,2,2,2,2
2023-06-01,201605,1,0,1,1,0,1
2023-06-01,201606,5,0,5,3,0,3
2023-06-01,201521,4,0,4,1,0,1
2023-06-01,59836,6,0,6,3,0,3
2023-06-01,201599,1,0,1,1,0,1
2023-06-01,59834,2,0,2,1,0,1
2023-06-01,206254,1,0,1,1,0,1
2023-06-01,212241,2,1,3,2,1,2
2023-06-01,11185,1,0,1,1,0,1
2023-06-01,201598,1,0,1,2,0,2
2023-06-01,201545,2,1,3,3,1,3
2023-06-01,205471,1,0,1,1,0,1
2023-06-01,59974,1,0,1,2,0,2
2023-06-01,201558,1,0,1,1,0,1
2023-06-01,16138,5,0,5,3,0,3
2023-06-01,59830,3,0,3,2,0,2
2023-06-01,62149,1,1,2,1,1,1
2023-06-01,203734,1,0,1,2,0,2
2023-06-01,57135,1,0,1,1,0,1
2023-06-01,62351,1,1,2,1,1,1
2023-06-01,207015,1,1,2,1,2,2
2023-06-01,59828,1,0,1,2,0,2
2023-06-01,59817,1,1,2,1,1,1
2023-06-01,59827,1,1,2,4,5,5
2023-06-01,204482,2,0,2,6,0,6
2023-06-01,13173,13,1,14,2,1,2
2023-06-01,59806,1,0,1,1,0,1
2023-06-01,57022,9,0,9,4,0,4
2023-06-01,200661,4,0,4,1,0,1
2023-06-01,35798,2,0,2,3,0,3
2023-06-01,201559,1,1,2,1,1,1
2023-06-01,208923,1,0,1,1,0,1
2023-06-01,48522,4,1,5,6,3,6
2023-06-01,59803,1,0,1,3,0,3
2023-06-01,59810,8,0,8,1,0,1
2023-06-01,49296,5,0,5,2,0,2
2023-06-01,59755,1,1,2,1,1,1
2023-06-01,203707,1,0,1,1,0,1
2023-06-01,51621,3,0,3,3,0,3
2023-06-01,210217,2,0,2,1,0,1
2023-06-01,201362,1,0,1,2,0,2
2023-06-01,211276,1,0,1,1,0,1
2023-06-01,201045,1,0,1,1,0,1
2023-06-01,204025,6,0,6,4,0,4
2023-06-01,56552,3,0,3,3,0,3
2023-06-01,201554,4,0,4,1,0,1
2023-06-01,9000,9,0,9,5,0,5
2023-06-01,211057,4,0,4,3,0,3
2023-06-01,202499,8,1,9,4,5,5
2023-06-01,201522,5,1,6,1,1,1
2023-06-01,201524,2,0,2,1,0,1
2023-06-01,201540,27,0,27,2,0,2
2023-06-01,201533,1,0,1,1,0,1
2023-06-01,59786,1,0,1,1,0,1
2023-06-01,204190,2,0,2,2,0,2
2023-06-01,201352,4,0,4,3,0,3
2023-06-01,200906,4,0,4,4,0,4
2023-06-01,59649,1,1,2,1,2,3
2023-06-01,205914,1,0,1,1,0,1
2023-06-01,59781,1,0,1,2,0,2
2023-06-01,64406,1,0,1,3,0,3
2023-06-01,208652,1,0,1,2,0,2
2023-06-01,60916,1,0,1,1,0,1
2023-06-01,209142,1,0,1,2,0,2
2023-06-01,64464,1,0,1,1,0,1
2023-06-01,59777,1,0,1,3,0,3
2023-06-01,203400,2,0,2,2,0,2
2023-06-01,202092,1,0,1,1,0,1
2023-06-01,204103,3,0,3,1,0,1
2023-06-01,59776,1,1,2,1,1,1
2023-06-01,200705,4,0,4,2,0,2
2023-06-01,201499,3,1,4,4,3,4
2023-06-01,201449,1,0,1,1,0,1
2023-06-01,201506,1,1,2,3,2,3
2023-06-01,201656,1,1,2,1,1,1
2023-06-01,201460,2,1,3,1,1,1
2023-06-01,201494,1,0,1,2,0,2
2023-06-01,201491,1,1,2,2,1,2
2023-06-01,59725,1,0,1,2,0,2
2023-06-01,59754,7,0,7,1,0,1
2023-06-01,201809,7,1,8,1,1,1
2023-06-01,201510,3,1,4,4,2,4
2023-06-01,201436,1,1,2,2,1,2
2023-06-01,207799,5,0,5,3,0,3
2023-06-01,201478,2,0,2,3,0,3
2023-06-01,204709,1,0,1,1,0,1
2023-06-01,58246,2,1,3,3,3,3
2023-06-01,59748,1,1,2,2,2,2
2023-06-01,203292,5,0,5,2,0,2
2023-06-01,201653,1,0,1,2,0,2
2023-06-01,207365,1,1,2,1,1,1
2023-06-01,203150,1,0,1,2,0,2
2023-06-01,30761,2,0,2,2,0,2
2023-06-01,60576,1,1,2,1,1,1
2023-06-01,52335,4,0,4,3,0,3
2023-06-01,202529,1,0,1,1,0,1
2023-06-01,207227,1,2,3,4,3,4
2023-06-01,199487,3,1,4,1,1,2
2023-06-01,201464,1,0,1,2,0,2
2023-06-01,59737,3,0,3,3,0,3
2023-06-01,41640,2,0,2,1,0,1
2023-06-01,200641,1,0,1,1,0,1
2023-06-01,201442,4,0,4,2,0,2
2023-06-01,203468,1,1,2,1,1,1
2023-06-01,201453,31,10,41,3,2,3
2023-06-01,204175,7,0,7,1,0,1
2023-06-01,203933,2,0,2,1,0,1
2023-06-01,201457,4,3,7,1,1,1
2023-06-01,58260,1,1,2,1,1,1
2023-06-01,201438,1,0,1,2,0,2
2023-06-01,31106,1,0,1,2,0,2
2023-06-01,211625,2,0,2,4,0,4
2023-06-01,58025,6,0,6,1,0,1
2023-06-01,20679,1,1,2,3,1,3
2023-06-01,201434,2,0,2,2,0,2
2023-06-01,62222,4,2,6,3,2,3
2023-06-01,50192,1,0,1,1,0,1
2023-06-01,39888,1,0,1,1,0,1
2023-06-01,49907,1,0,1,2,0,2
2023-06-01,204638,3,0,3,3,0,3
2023-06-01,58037,4,0,4,2,0,2
2023-06-01,207225,3,1,4,2,2,2
2023-06-01,56898,8,5,13,3,1,3
2023-06-01,208729,1,0,1,1,0,1
2023-06-01,201145,2,0,2,1,0,1
2023-06-01,201420,4,0,4,1,0,1
2023-06-01,59397,4,1,5,1,1,1
2023-06-01,201422,2,0,2,1,0,1
2023-06-01,44500,2,1,3,1,1,1
2023-06-01,201396,1,1,2,1,1,1
2023-06-01,200491,1,1,2,1,1,1
2023-06-01,197066,1,0,1,3,0,3
2023-06-01,25341,3,2,5,4,1,4
2023-06-01,201417,2,0,2,1,0,1
2023-06-01,208154,1,1,2,2,2,2
2023-06-01,62173,2,0,2,1,0,1
2023-06-01,58331,5,1,6,1,1,2
2023-06-01,208649,1,0,1,2,0,2
2023-06-01,211118,1,0,1,1,0,1
2023-06-01,211171,1,0,1,1,0,1
2023-06-01,201408,3,0,3,3,0,3
2023-06-01,26338,2,1,3,3,3,3
2023-06-01,49911,3,0,3,1,0,1
2023-06-01,201367,4,0,4,1,0,1
2023-06-01,201402,1,0,1,1,0,1
2023-06-01,200441,1,0,1,1,0,1
2023-06-01,200420,3,0,3,1,0,1
2023-06-01,204259,2,0,2,1,0,1
2023-06-01,34178,3,0,3,1,0,1
2023-06-01,200839,1,0,1,2,0,2
2023-06-01,201393,4,0,4,1,0,1
2023-06-01,205919,3,1,4,5,3,5
2023-06-01,47593,1,0,1,2,0,2
2023-06-01,212813,1,1,2,1,1,1
2023-06-01,213212,1,0,1,1,0,1
2023-06-01,21080,2,1,3,2,1,2
2023-06-01,51630,1,1,2,1,3,3
2023-06-01,49177,1,0,1,1,0,1
2023-06-01,29144,7,0,7,3,0,3
2023-06-01,201340,5,0,5,4,0,4
2023-06-01,201913,1,0,1,1,0,1
2023-06-01,201366,2,2,4,2,2,2
2023-06-01,201356,4,0,4,2,0,2
2023-06-01,31525,11,0,11,2,0,2
2023-06-01,48576,1,1,2,2,1,2
2023-06-01,48491,1,0,1,2,0,2
2023-06-01,201029,1,7,8,2,2,3
2023-06-01,24906,2,0,2,1,0,1
2023-06-01,201032,4,0,4,1,0,1
2023-06-01,48360,1,1,2,1,1,1
2023-06-01,201347,1,0,1,3,0,3
2023-06-01,201346,4,0,4,1,0,1
2023-06-01,397833,2,0,2,2,0,2
2023-06-01,8290,4,0,4,1,0,1
2023-06-01,203170,2,1,3,1,1,1
2023-06-01,48260,8,7,15,1,3,3
2023-06-01,201338,4,0,4,1,0,1
2023-06-01,29240,10,1,11,1,1,1
2023-06-01,203680,2,1,3,1,1,1
2023-06-01,28851,4,1,5,1,1,1
2023-06-01,60481,1,2,3,2,2,2
2023-06-01,47736,2,1,3,2,2,3
2023-06-01,201289,4,0,4,3,0,3
2023-06-01,200858,2,0,2,3,0,3
2023-06-01,203778,2,0,2,5,0,5
2023-06-01,201900,2,2,4,1,1,1
2023-06-01,213301,5,0,5,1,0,1
2023-06-01,201330,1,1,2,4,2,5
2023-06-01,47551,1,1,2,3,3,3
2023-06-01,201324,1,2,3,2,3,3
2023-06-01,200863,2,0,2,3,0,3
2023-06-01,49959,4,4,8,4,4,4
2023-06-01,202128,1,1,2,3,2,3
2023-06-01,34822,2,1,3,2,1,2
2023-06-01,206351,1,1,2,2,1,2
2023-06-01,212962,1,0,1,1,0,1
2023-06-01,201298,1,0,1,3,0,3
2023-06-01,210033,2,0,2,2,0,2
2023-06-01,201311,1,0,1,3,0,3
2023-06-01,212183,2,0,2,1,0,1
2023-06-01,201274,1,0,1,1,0,1
2023-06-01,44210,1,0,1,1,0,1
2023-06-01,200561,4,2,6,3,3,3
2023-06-01,35486,5,0,5,3,0,3
2023-06-01,44045,5,0,5,4,0,4
2023-06-01,201157,1,1,2,1,1,1
2023-06-01,31690,1,0,1,2,0,2
2023-06-01,49509,1,1,2,1,1,1
2023-06-01,50136,1,0,1,1,0,1
2023-06-01,59673,1,0,1,1,0,1
2023-06-01,201283,3,1,4,1,1,1
2023-06-01,200603,1,1,2,1,1,1
2023-06-01,397338,1,0,1,1,0,1
2023-06-01,6895,4,2,6,5,2,6
2023-06-01,201481,2,0,2,2,0,2
2023-06-01,201293,5,1,6,3,1,3
2023-06-01,43445,2,0,2,6,0,6
2023-06-01,39892,9,4,13,4,4,5
2023-06-01,205029,1,1,2,2,2,2
2023-06-01,57676,1,1,2,2,1,2
2023-06-01,206768,1,1,2,3,3,4
2023-06-01,200928,1,0,1,2,0,2
2023-06-01,202824,1,0,1,3,0,3
2023-06-01,211446,1,0,1,3,0,3
2023-06-01,50255,1,0,1,2,0,2
2023-06-01,201430,1,0,1,3,0,3
2023-06-01,209757,1,0,1,5,0,5
2023-06-01,60795,1,0,1,1,0,1
2023-06-01,42075,1,0,1,1,0,1
2023-06-01,198799,0,0,0,2,0,2
2023-06-01,9079,2,0,2,2,0,2
2023-06-01,201261,1,0,1,6,0,6
2023-06-01,60768,1,1,2,2,1,2
2023-06-01,201249,4,0,4,1,0,1
2023-06-01,201248,1,1,2,2,1,2
2023-06-01,208831,1,0,1,2,0,2
2023-06-01,39292,2,1,3,1,2,3
2023-06-01,43645,2,1,3,3,1,3
2023-06-01,35333,1,0,1,2,0,2
2023-06-01,201227,3,0,3,1,0,1
2023-06-01,59662,1,0,1,3,0,3
2023-06-01,205136,1,0,1,3,0,3
2023-06-01,205594,1,0,1,2,0,2
2023-06-01,209118,5,0,5,2,0,2
2023-06-01,201059,1,1,2,1,1,1
2023-06-01,198375,1,0,1,1,0,1
2023-06-01,210433,1,1,2,1,1,1
2023-06-01,200990,2,0,2,1,0,1
2023-06-01,207426,1,1,2,2,1,2
2023-06-01,200473,1,0,1,3,0,3
2023-06-01,43243,6,0,6,3,0,3
2023-06-01,200947,2,0,2,1,0,1
2023-06-01,12798,26,0,26,5,0,5
2023-06-01,9137,2,1,3,8,4,8
2023-06-01,15020,1,1,2,1,1,1
2023-06-01,203187,10,0,10,2,0,2
2023-06-01,42183,5,0,5,2,0,2
2023-06-01,201199,3,2,5,2,2,2
2023-06-01,203675,5,0,5,1,0,1
2023-06-01,201722,7,4,11,5,2,5
2023-06-01,51502,1,0,1,2,0,2
2023-06-01,41993,1,1,2,1,1,1
2023-06-01,41605,2,0,2,1,0,1
2023-06-01,210267,2,0,2,1,0,1
2023-06-01,201102,3,0,3,4,0,4
2023-06-01,42120,1,1,2,3,2,3
2023-06-01,201111,2,0,2,3,0,3
2023-06-01,201221,1,0,1,1,0,1
2023-06-01,201177,1,0,1,1,0,1
2023-06-01,201174,3,0,3,2,0,2
2023-06-01,202748,2,0,2,2,0,2
2023-06-01,201168,3,0,3,1,0,1
2023-06-01,50795,4,0,4,1,0,1
2023-06-01,64462,5,0,5,1,0,1
2023-06-01,207922,2,1,3,2,1,2
2023-06-01,213328,1,0,1,1,0,1
2023-06-01,204640,2,0,2,1,0,1
2023-06-01,2733,1,0,1,1,0,1
2023-06-01,202166,4,0,4,2,0,2
2023-06-01,204712,1,0,1,1,0,1
2023-06-01,201166,1,0,1,1,0,1
2023-06-01,42468,4,0,4,1,0,1
2023-06-01,210374,1,6,7,1,1,2
2023-06-01,201156,2,0,2,1,0,1
2023-06-01,211079,1,0,1,3,0,3
2023-06-01,205967,1,1,2,1,1,1
2023-06-01,44322,4,0,4,3,0,3
2023-06-01,8467,1,0,1,1,0,1
2023-06-01,43652,2,1,3,1,1,1
2023-06-01,201146,2,1,3,3,2,3
2023-06-01,51092,3,2,5,6,4,6
2023-06-01,50418,2,0,2,4,0,4
2023-06-01,41174,2,2,4,3,3,3
2023-06-01,200402,3,1,4,2,1,2
2023-06-01,59625,9,7,16,3,3,3
2023-06-01,33975,2,0,2,2,0,2
2023-06-01,57532,1,0,1,1,0,1
2023-06-01,42828,4,0,4,3,0,3
2023-06-01,201140,1,0,1,2,0,2
2023-06-01,57979,3,0,3,1,0,1
2023-06-01,48760,2,0,2,1,0,1
2023-06-01,21432,1,0,1,1,0,1
2023-06-01,211270,5,0,5,2,0,2
2023-06-01,41054,6,0,6,1,0,1
2023-06-01,201137,2,0,2,5,0,5
2023-06-01,201135,2,0,2,1,0,1
2023-06-01,29424,1,1,2,3,2,3
2023-06-01,20765,7,4,11,3,3,3
2023-06-01,202687,1,1,2,4,2,4
2023-06-01,15682,6,1,7,3,3,3
2023-06-01,200500,3,0,3,4,0,4
2023-06-01,207029,13,0,13,3,0,3
2023-06-01,208877,5,0,5,2,0,2
2023-06-01,39455,1,0,1,2,0,2
2023-06-01,200541,4,0,4,2,0,2
2023-06-01,200538,1,1,2,2,2,2
2023-06-01,201139,1,0,1,1,0,1
2023-06-01,206626,5,0,5,6,0,6
2023-06-01,201185,1,0,1,3,0,3
2023-06-01,200905,4,0,4,2,0,2
2023-06-01,48895,5,0,5,2,0,2
2023-06-01,201118,2,0,2,4,0,4
2023-06-01,206083,1,1,2,1,1,1
2023-06-01,205886,1,0,1,1,0,1
2023-06-01,41723,4,1,5,4,1,4
2023-06-01,39466,1,0,1,1,0,1
2023-06-01,201013,6,0,6,2,0,2
2023-06-01,43684,5,0,5,2,0,2
2023-06-01,42155,2,0,2,1,0,1
2023-06-01,201100,1,0,1,1,0,1
2023-06-01,201026,5,1,6,5,3,5
2023-06-01,8453,2,8,10,3,3,3
2023-06-01,211943,1,0,1,2,0,2
2023-06-01,211913,1,0,1,1,0,1
2023-06-01,202334,5,1,6,3,1,3
2023-06-01,213107,1,0,1,1,0,1
2023-06-01,13008,10,1,11,1,1,1
2023-06-01,39176,3,2,5,4,3,4
2023-06-01,201086,5,6,11,2,2,3
2023-06-01,203550,1,1,2,2,2,2
2023-06-01,201095,1,0,1,2,0,2
2023-06-01,201081,3,0,3,2,0,2
2023-06-01,60991,3,1,4,1,1,1
2023-06-01,212749,1,0,1,3,0,3
2023-06-01,201073,1,1,2,1,1,2
2023-06-01,200868,2,0,2,1,0,1
2023-06-01,208763,1,2,3,2,2,2
2023-06-01,56357,2,1,3,1,1,1
2023-06-01,29264,2,3,5,1,1,1
2023-06-01,42221,4,2,6,2,2,2
2023-06-01,201067,4,0,4,3,0,3
2023-06-01,397100,1,0,1,1,0,1
2023-06-01,24792,5,0,5,4,0,4
2023-06-01,201686,1,0,1,1,0,1
2023-06-01,201064,1,0,1,1,0,1
2023-06-01,8916,4,2,6,1,1,1
2023-06-01,34487,1,1,2,1,1,1
2023-06-01,201057,1,4,5,1,1,1
2023-06-01,201050,2,2,4,2,1,2
2023-06-01,201049,1,0,1,2,0,2
2023-06-01,57721,1,0,1,1,0,1
2023-06-01,211253,3,0,3,1,0,1
2023-06-01,200846,1,1,2,2,2,2
2023-06-01,204536,1,0,1,4,0,4
2023-06-01,203851,8,0,8,6,0,6
2023-06-01,201038,1,1,2,1,1,1
2023-06-01,39841,3,0,3,1,0,1
2023-06-01,200706,7,0,7,3,0,3
2023-06-01,209147,1,0,1,1,0,1
2023-06-01,201031,4,0,4,1,0,1
2023-06-01,60515,5,0,5,2,0,2
2023-06-01,65500,0,0,0,4,0,4
2023-06-01,200980,1,0,1,2,0,2
2023-06-01,43013,2,0,2,3,0,3
2023-06-01,210111,1,1,2,5,3,6
2023-06-01,202691,2,0,2,1,0,1
2023-06-01,203479,1,0,1,1,0,1
2023-06-01,41906,3,1,4,2,1,2
2023-06-01,200911,3,0,3,3,0,3
2023-06-01,28721,2,0,2,1,0,1
2023-06-01,42043,5,0,5,2,0,2
2023-06-01,201022,2,0,2,1,0,1
2023-06-01,206631,1,0,1,2,0,2
2023-06-01,201024,1,0,1,1,0,1
2023-06-01,42345,1,0,1,3,0,3
2023-06-01,200988,2,0,2,2,0,2
2023-06-01,47487,2,3,5,2,2,2
2023-06-01,201014,1,1,2,1,2,2
2023-06-01,57077,2,1,3,1,1,1
2023-06-01,51355,2,0,2,1,0,1
2023-06-01,204226,5,0,5,2,0,2
2023-06-01,50097,1,0,1,4,0,4
2023-06-01,211103,1,0,1,1,0,1
2023-06-01,201010,1,0,1,1,0,1
2023-06-01,29231,2,0,2,4,0,4
2023-06-01,61181,1,0,1,2,0,2
2023-06-01,201001,1,0,1,3,0,3
2023-06-01,51287,1,0,1,1,0,1
2023-06-01,200991,1,4,5,3,3,3
2023-06-01,50531,1,0,1,1,0,1
2023-06-01,210028,6,0,6,2,0,2
2023-06-01,41856,13,0,13,1,0,1
2023-06-01,200874,1,1,2,1,1,1
2023-06-01,201528,1,1,2,1,4,4
2023-06-01,201529,1,1,2,1,2,3
2023-06-01,200979,2,0,2,2,0,2
2023-06-01,60749,5,0,5,2,0,2
2023-06-01,29246,2,1,3,2,2,2
2023-06-01,203037,2,0,2,2,0,2
2023-06-01,200920,1,0,1,1,0,1
2023-06-01,200942,2,0,2,1,0,1
2023-06-01,201222,2,2,4,5,4,6
2023-06-01,200981,3,1,4,1,1,1
2023-06-01,41121,4,0,4,2,0,2
2023-06-01,200585,2,0,2,2,0,2
2023-06-01,200973,1,0,1,1,0,1
2023-06-01,34987,4,0,4,1,0,1
2023-06-01,200956,4,0,4,1,0,1
2023-06-01,200963,2,0,2,1,0,1
2023-06-01,200962,5,0,5,2,0,2
2023-06-01,204643,5,0,5,3,0,3
2023-06-01,41015,1,0,1,1,0,1
2023-06-01,51595,2,0,2,1,0,1
2023-06-01,200944,4,0,4,2,0,2
2023-06-01,61417,1,0,1,1,0,1
2023-06-01,48807,1,0,1,1,0,1
2023-06-01,200937,4,0,4,1,0,1
2023-06-01,60999,5,0,5,2,0,2
2023-06-01,200941,3,3,6,2,2,2
2023-06-01,207185,6,0,6,3,0,3
2023-06-01,202305,1,0,1,1,0,1
2023-06-01,200835,1,0,1,2,0,2
2023-06-01,200977,2,1,3,1,1,1
2023-06-01,200932,1,1,2,2,2,2
2023-06-01,200931,4,1,5,2,1,2
2023-06-01,39114,5,0,5,3,0,3
2023-06-01,12954,9,0,9,3,0,3
2023-06-01,41410,11,0,11,1,0,1
2023-06-01,41103,2,2,4,3,3,3
2023-06-01,200915,3,3,6,1,1,1
2023-06-01,200914,1,1,2,2,1,2
2023-06-01,49485,15,0,15,2,0,2
2023-06-01,202523,1,1,2,1,1,1
2023-06-01,202536,4,0,4,1,0,1
2023-06-01,48903,4,0,4,2,0,2
2023-06-01,35690,5,0,5,2,0,2
2023-06-01,205062,3,0,3,2,0,2
2023-06-01,200883,5,0,5,3,0,3
2023-06-01,200428,5,5,10,5,4,5
2023-06-01,35677,1,1,2,1,1,1
2023-06-01,200896,4,1,5,1,1,1
2023-06-01,208689,2,1,3,3,3,3
2023-06-01,200892,4,0,4,3,0,3
2023-06-01,30884,2,2,4,1,1,1
2023-06-01,29426,2,0,2,2,0,2
2023-06-01,200849,4,15,19,3,1,3
2023-06-01,205416,1,0,1,2,0,2
2023-06-01,6707,2,0,2,2,0,2
2023-06-01,200765,2,0,2,3,0,3
2023-06-01,206654,4,0,4,1,0,1
2023-06-01,211713,1,1,2,7,4,8
2023-06-01,200700,5,0,5,6,0,6
2023-06-01,203816,1,0,1,1,0,1
2023-06-01,13199,1,1,2,1,1,1
2023-06-01,199964,1,0,1,1,0,1
2023-06-01,200855,4,0,4,2,0,2
2023-06-01,205512,4,0,4,2,0,2
2023-06-01,35353,1,0,1,4,0,4
2023-06-01,204250,1,0,1,1,0,1
2023-06-01,1850,2,1,3,2,2,2
2023-06-01,43456,9,0,9,3,0,3
2023-06-01,200854,5,0,5,2,0,2
2023-06-01,33927,3,0,3,2,0,2
2023-06-01,199801,1,0,1,1,0,1
2023-06-01,200852,5,0,5,3,0,3
2023-06-01,58160,1,1,2,1,1,1
2023-06-01,211901,1,0,1,1,0,1
2023-06-01,206192,3,0,3,1,0,1
2023-06-01,200848,2,1,3,1,1,2
2023-06-01,42509,1,0,1,1,0,1
2023-06-01,200820,4,2,6,2,1,2
2023-06-01,200844,2,1,3,3,1,3
2023-06-01,200836,1,1,2,1,1,1
2023-06-01,56647,4,2,6,2,2,2
2023-06-01,200804,2,0,2,1,0,1
2023-06-01,34499,4,1,5,4,2,4
2023-06-01,209508,2,0,2,2,0,2
2023-06-01,56875,2,0,2,1,0,1
2023-06-01,200813,5,0,5,2,0,2
2023-06-01,15951,6,0,6,2,0,2
2023-06-01,35220,1,1,2,6,1,6
2023-06-01,34768,1,1,2,7,5,7
2023-06-01,202879,1,0,1,3,0,3
2023-06-01,43880,2,0,2,1,0,1
2023-06-01,35166,2,0,2,2,0,2
2023-06-01,197890,2,2,4,1,1,1
2023-06-01,203273,1,0,1,1,0,1
2023-06-01,200821,1,0,1,2,0,2
2023-06-01,200837,1,1,2,1,1,1
2023-06-01,205631,1,1,2,1,1,1
2023-06-01,200824,3,0,3,2,0,2
2023-06-01,48263,1,1,2,1,1,1
2023-06-01,211175,1,1,2,1,1,1
2023-06-01,48519,9,6,15,11,6,12
2023-06-01,50611,14,14,28,2,2,2
2023-06-01,200802,3,0,3,1,0,1
2023-06-01,200806,1,0,1,1,0,1
2023-06-01,41827,7,1,8,4,3,4
2023-06-01,35086,3,0,3,3,0,3
2023-06-01,35066,1,0,1,3,0,3
2023-06-01,200796,1,0,1,1,0,1
2023-06-01,34515,4,8,12,2,1,2
2023-06-01,207097,4,0,4,3,0,3
2023-06-01,200798,3,0,3,1,0,1
2023-06-01,39540,1,1,2,1,2,2
2023-06-01,200786,1,0,1,2,0,2
2023-06-01,28791,4,0,4,1,0,1
2023-06-01,60972,1,0,1,1,0,1
2023-06-01,34855,1,1,2,1,1,1
2023-06-01,200792,1,0,1,3,0,3
2023-06-01,24800,11,2,13,1,1,1
2023-06-01,200783,1,0,1,3,0,3
2023-06-01,34593,3,0,3,3,0,3
2023-06-01,200767,5,0,5,4,0,4
2023-06-01,206312,2,1,3,3,2,3
2023-06-01,31486,1,0,1,1,0,1
2023-06-01,39443,1,0,1,4,0,4
2023-06-01,200770,6,3,9,4,2,4
2023-06-01,29237,2,0,2,3,0,3
2023-06-01,34461,1,1,2,1,1,1
2023-06-01,204001,4,0,4,1,0,1
2023-06-01,43944,1,0,1,1,0,1
2023-06-01,200571,2,0,2,1,0,1
2023-06-01,200460,4,1,5,2,2,2
2023-06-01,205346,2,0,2,3,0,3
2023-06-01,200758,2,2,4,2,2,2
2023-06-01,15995,2,0,2,2,0,2
2023-06-01,34447,1,0,1,2,0,2
2023-06-01,203382,1,0,1,2,0,2
2023-06-01,34113,4,0,4,1,0,1
2023-06-01,200742,3,1,4,3,3,3
2023-06-01,204164,1,0,1,1,0,1
2023-06-01,62407,1,1,2,2,1,2
2023-06-01,20948,2,0,2,4,0,4
2023-06-01,64424,1,1,2,1,1,1
2023-06-01,64440,1,0,1,1,0,1
2023-06-01,31087,1,0,1,3,0,3
2023-06-01,200739,1,1,2,2,2,2
2023-06-01,41293,1,0,1,2,0,2
2023-06-01,196616,1,0,1,1,0,1
2023-06-01,34271,1,0,1,1,0,1
2023-06-01,200727,1,1,2,1,1,1
2023-06-01,200726,1,0,1,1,0,1
2023-06-01,200707,1,1,2,1,1,1
2023-06-01,197898,4,2,6,9,4,9
2023-06-01,41400,2,1,3,2,2,2
2023-06-01,34032,4,0,4,2,0,2
2023-06-01,30929,1,1,2,5,4,6
2023-06-01,211467,5,0,5,2,0,2
2023-06-01,200696,2,0,2,1,0,1
2023-06-01,33932,9,1,10,6,2,6
2023-06-01,200695,4,0,4,2,0,2
2023-06-01,15725,2,1,3,5,3,5
2023-06-01,49941,5,3,8,7,6,7
2023-06-01,33856,3,3,6,2,2,2
2023-06-01,34062,2,0,2,2,0,2
2023-06-01,51814,2,0,2,1,0,1
2023-06-01,29099,1,3,4,1,1,1
2023-06-01,50667,4,0,4,3,0,3
2023-06-01,204524,3,0,3,1,0,1
2023-06-01,200648,3,3,6,2,1,2
2023-06-01,202899,1,0,1,2,0,2
2023-06-01,200618,2,0,2,1,0,1
2023-06-01,200688,5,0,5,3,0,3
2023-06-01,207257,1,1,2,4,3,4
2023-06-01,60376,2,0,2,1,0,1
2023-06-01,59471,3,0,3,3,0,3
2023-06-01,205082,0,0,0,2,0,2
2023-06-01,200667,1,0,1,1,0,1
2023-06-01,200498,1,0,1,2,0,2
2023-06-01,31587,2,0,2,1,0,1
2023-06-01,207519,1,0,1,1,0,1
2023-06-01,22547,11,0,11,2,0,2
2023-06-01,32651,4,0,4,2,0,2
2023-06-01,396826,9,13,22,2,2,2
2023-06-01,396583,6,0,6,2,0,2
2023-06-01,20172,8,8,16,2,2,2
2023-06-01,396543,9,5,14,2,2,2
2023-06-01,200653,2,0,2,2,0,2
2023-06-01,34942,2,1,3,5,3,5
2023-06-01,200645,7,0,7,1,0,1
2023-06-01,200652,1,1,2,1,1,1
2023-06-01,133757,1,0,1,1,0,1
2023-06-01,16195,2,0,2,1,0,1
2023-06-01,57307,2,0,2,1,0,1
2023-06-01,205032,1,0,1,4,0,4
2023-06-01,6759,4,0,4,1,0,1
2023-06-01,31433,1,0,1,1,0,1
2023-06-01,200635,1,1,2,1,1,1
2023-06-01,31390,4,0,4,1,0,1
2023-06-01,16297,2,0,2,5,0,5
2023-06-01,200542,1,0,1,1,0,1
2023-06-01,64415,3,0,3,3,0,3
2023-06-01,16076,3,0,3,3,0,3
2023-06-01,31050,1,0,1,1,0,1
2023-06-01,31037,5,0,5,3,0,3
2023-06-01,56337,1,0,1,1,0,1
2023-06-01,203901,2,0,2,2,0,2
2023-06-01,203762,1,1,2,3,1,3
2023-06-01,30919,4,3,7,3,3,4
2023-06-01,29135,1,0,1,2,0,2
2023-06-01,199462,4,9,13,4,6,6
2023-06-01,204458,1,0,1,1,0,1
2023-06-01,30875,1,1,2,1,1,1
2023-06-01,206597,4,1,5,3,3,3
2023-06-01,30786,1,1,2,3,3,3
2023-06-01,202780,9,0,9,3,0,3
2023-06-01,203562,1,0,1,3,0,3
2023-06-01,203632,1,0,1,3,0,3
2023-06-01,207603,2,0,2,1,0,1
2023-06-01,29615,1,0,1,3,0,3
2023-06-01,200607,4,0,4,3,0,3
2023-06-01,43208,1,0,1,2,0,2
2023-06-01,200600,1,1,2,1,1,1
2023-06-01,203621,5,0,5,3,0,3
2023-06-01,29585,1,0,1,2,0,2
2023-06-01,5459,3,1,4,10,7,11
2023-06-01,41753,3,0,3,5,0,5
2023-06-01,208917,2,0,2,1,0,1
2023-06-01,203736,1,0,1,2,0,2
2023-06-01,48220,2,1,3,6,2,6
2023-06-01,29483,1,0,1,1,0,1
2023-06-01,29458,1,1,2,1,1,1
2023-06-01,34531,2,0,2,2,0,2
2023-06-01,198171,1,1,2,1,1,1
2023-06-01,43249,2,0,2,1,0,1
2023-06-01,204165,2,2,4,1,1,1
2023-06-01,201641,4,2,6,4,2,4
2023-06-01,204215,2,0,2,3,0,3
2023-06-01,201138,5,0,5,3,0,3
2023-06-01,29242,1,0,1,1,0,1
2023-06-01,201588,2,0,2,3,0,3
2023-06-01,212092,2,0,2,1,0,1
2023-06-01,200582,1,1,2,5,1,5
2023-06-01,200576,1,1,2,2,1,2
2023-06-01,25281,5,0,5,1,0,1
2023-06-01,29070,4,0,4,1,0,1
2023-06-01,205855,1,0,1,1,0,1
2023-06-01,204387,1,0,1,1,0,1
2023-06-01,200560,3,0,3,4,0,4
2023-06-01,29027,4,0,4,2,0,2
2023-06-01,57380,3,0,3,4,0,4
2023-06-01,203549,3,0,3,2,0,2
2023-06-01,200552,1,1,2,1,1,1
2023-06-01,204171,4,1,5,3,2,3
2023-06-01,200421,2,0,2,1,0,1
2023-06-01,57191,1,1,2,6,3,6
2023-06-01,200539,5,0,5,6,0,6
2023-06-01,21496,1,0,1,3,0,3
2023-06-01,35018,1,0,1,3,0,3
2023-06-01,201553,8,0,8,2,0,2
2023-06-01,28931,1,1,2,6,4,6
2023-06-01,200540,1,0,1,3,0,3
2023-06-01,28746,8,0,8,5,0,5
2023-06-01,28774,3,0,3,3,0,3
2023-06-01,200470,3,0,3,3,0,3
2023-06-01,28715,2,9,11,1,1,1
2023-06-01,209220,1,3,4,1,1,1
2023-06-01,398830,2,0,2,2,0,2
2023-06-01,206190,7,0,7,2,0,2
2023-06-01,211033,1,0,1,1,0,1
2023-06-01,200449,1,0,1,1,0,1
2023-06-01,25491,4,0,4,1,0,1
2023-06-01,25471,4,0,4,2,0,2
2023-06-01,211862,1,0,1,1,0,1
2023-06-01,211855,1,0,1,1,0,1
2023-06-01,200518,1,0,1,1,0,1
2023-06-01,25451,1,1,2,3,2,3
2023-06-01,25450,4,0,4,2,0,2
2023-06-01,25335,11,0,11,1,0,1
2023-06-01,206681,1,0,1,1,0,1
2023-06-01,57317,5,2,7,3,3,3
2023-06-01,204813,3,0,3,1,0,1
2023-06-01,200437,5,1,6,6,1,6
2023-06-01,200488,7,0,7,2,0,2
2023-06-01,62190,1,0,1,3,0,3
2023-06-01,206912,3,0,3,1,0,1
2023-06-01,49621,2,1,3,1,1,1
2023-06-01,200448,4,0,4,1,0,1
2023-06-01,47285,1,1,2,1,1,2
2023-06-01,212248,2,0,2,3,0,3
2023-06-01,200480,1,0,1,7,0,7
2023-06-01,25094,2,0,2,2,0,2
2023-06-01,203978,6,0,6,1,0,1
2023-06-01,200465,2,0,2,2,0,2
2023-06-01,210281,3,2,5,1,1,1
2023-06-01,204173,1,0,1,3,0,3
2023-06-01,201734,1,1,2,1,1,1
2023-06-01,207335,1,1,2,2,1,2
2023-06-01,204212,1,0,1,1,0,1
2023-06-01,200457,5,0,5,4,0,4
2023-06-01,202871,1,0,1,1,0,1
2023-06-01,42703,2,0,2,1,0,1
2023-06-01,45034,2,0,2,1,0,1
2023-06-01,206376,3,1,4,3,2,3
2023-06-01,24892,1,0,1,2,0,2
2023-06-01,200432,3,0,3,4,0,4
2023-06-01,212781,1,0,1,4,0,4
2023-06-01,204019,3,0,3,4,0,4
2023-06-01,204479,1,0,1,2,0,2
2023-06-01,200430,4,1,5,5,1,5
2023-06-01,200434,8,1,9,9,3,10
2023-06-01,200433,4,0,4,2,0,2
2023-06-01,200934,1,1,2,1,1,1
2023-06-01,60878,2,0,2,1,0,1
2023-06-01,203641,6,0,6,1,0,1
2023-06-01,204280,3,0,3,2,0,2
2023-06-01,200425,2,1,3,3,1,3
2023-06-01,200416,1,1,2,3,2,3
2023-06-01,209324,1,0,1,2,0,2
2023-06-01,206655,8,0,8,6,0,6
2023-06-01,200412,1,0,1,1,0,1
2023-06-01,200423,1,1,2,2,1,2
2023-06-01,202861,1,1,2,1,1,1
2023-06-01,200418,3,0,3,1,0,1
2023-06-01,49262,1,1,2,2,2,2
2023-06-01,211897,1,0,1,1,0,1
2023-06-01,51093,4,1,5,4,3,4
2023-06-01,198167,7,1,8,7,1,7
2023-06-01,43930,5,1,6,3,1,4
2023-06-01,200189,2,0,2,3,0,3
2023-06-01,204838,3,0,3,1,0,1
2023-06-01,203262,3,0,3,2,0,2
2023-06-01,208994,1,1,2,2,2,2
2023-06-01,209390,1,1,2,2,1,2
2023-06-01,206028,1,1,2,3,3,3
2023-06-01,210550,2,1,3,1,1,1
2023-06-01,43385,1,1,2,2,2,2
2023-06-01,207354,1,0,1,2,0,2
2023-06-01,204236,4,0,4,2,0,2
2023-06-01,21447,1,0,1,1,0,1
2023-06-01,204239,4,0,4,1,0,1
2023-06-01,204276,3,0,3,3,0,3
2023-06-01,24837,2,0,2,3,0,3
2023-06-01,212096,4,0,4,1,0,1
2023-06-01,206426,1,0,1,1,0,1
2023-06-01,24633,1,1,2,3,1,3
2023-06-01,204178,1,0,1,2,0,2
2023-06-01,204260,15,0,15,3,0,3
2023-06-01,211641,1,0,1,2,0,2
2023-06-01,204258,4,0,4,1,0,1
2023-06-01,204264,1,0,1,7,0,7
2023-06-01,206737,6,0,6,5,0,5
2023-06-01,202750,1,0,1,1,0,1
2023-06-01,20832,1,0,1,4,0,4
2023-06-01,213062,6,0,6,3,0,3
2023-06-01,8395,1,1,2,4,2,4
2023-06-01,49702,1,0,1,1,0,1
2023-06-01,8356,2,1,3,1,1,1
2023-06-01,47578,1,1,2,1,1,1
2023-06-01,204445,2,0,2,1,0,1
2023-06-01,39423,5,0,5,1,0,1
2023-06-01,204253,5,1,6,3,2,3
2023-06-01,200746,1,3,4,1,1,1
2023-06-01,15791,1,0,1,1,0,1
2023-06-01,204248,1,1,2,1,1,1
2023-06-01,204082,1,1,2,1,2,2
2023-06-01,204085,9,0,9,1,0,1
2023-06-01,204246,3,0,3,1,0,1
2023-06-01,204243,1,1,2,1,1,1
2023-06-01,204234,1,0,1,1,0,1
2023-06-01,62284,4,0,4,1,0,1
2023-06-01,62341,1,1,2,1,1,1
2023-06-01,204232,1,1,2,1,1,2
2023-06-01,21212,3,0,3,1,0,1
2023-06-01,21145,2,2,4,1,1,2
2023-06-01,206130,1,1,2,3,1,3
2023-06-01,25063,1,0,1,1,0,1
2023-06-01,204218,1,0,1,1,0,1
2023-06-01,210947,3,2,5,1,1,1
2023-06-01,21067,1,1,2,1,1,1
2023-06-01,203969,3,0,3,5,0,5
2023-06-01,204193,2,0,2,1,0,1
2023-06-01,196798,2,0,2,2,0,2
2023-06-01,21002,4,0,4,2,0,2
2023-06-01,62250,8,0,8,2,0,2
2023-06-01,44979,4,0,4,2,0,2
2023-06-01,204202,2,0,2,2,0,2
2023-06-01,20986,3,0,3,4,0,4
2023-06-01,204201,1,0,1,1,0,1
2023-06-01,201015,2,0,2,1,0,1
2023-06-01,204198,4,0,4,4,0,4
2023-06-01,43998,1,0,1,1,0,1
2023-06-01,200580,1,0,1,2,0,2
2023-06-01,204101,1,1,2,2,2,2
2023-06-01,20874,4,0,4,1,0,1
2023-06-01,204147,1,1,2,3,3,3
2023-06-01,20818,5,0,5,1,0,1
2023-06-01,20802,1,1,2,1,1,1
2023-06-01,204207,1,0,1,3,0,3
2023-06-01,204180,5,0,5,5,0,5
2023-06-01,212866,3,0,3,1,0,1
2023-06-01,204158,1,0,1,2,0,2
2023-06-01,56867,2,1,3,1,1,1
2023-06-01,12984,1,1,2,2,2,2
2023-06-01,20643,1,1,2,1,1,1
2023-06-01,34893,4,3,7,3,2,3
2023-06-01,397568,1,2,3,1,1,1
2023-06-01,204176,4,0,4,2,0,2
2023-06-01,202382,3,0,3,3,0,3
2023-06-01,203983,1,0,1,1,0,1
2023-06-01,212988,11,0,11,1,0,1
2023-06-01,206811,2,0,2,7,0,7
2023-06-01,211740,1,0,1,1,0,1
2023-06-01,50605,4,0,4,2,0,2
2023-06-01,205508,1,0,1,1,0,1
2023-06-01,204138,7,6,13,2,2,2
2023-06-01,204573,1,0,1,7,0,7
2023-06-01,212440,1,2,3,3,3,3
2023-06-01,204149,4,0,4,2,0,2
2023-06-01,212943,3,1,4,2,1,2
2023-06-01,44419,1,0,1,2,0,2
2023-06-01,204530,1,0,1,1,0,1
2023-06-01,203185,8,0,8,3,0,3
2023-06-01,212077,1,1,2,1,1,1
2023-06-01,20582,2,0,2,2,0,2
2023-06-01,20596,1,1,2,4,2,4
2023-06-01,16286,4,0,4,2,0,2
2023-06-01,39594,1,0,1,2,0,2
2023-06-01,206080,1,0,1,2,0,2
2023-06-01,204094,5,2,7,3,3,5
2023-06-01,20493,3,1,4,1,1,1
2023-06-01,204072,1,0,1,2,0,2
2023-06-01,204121,1,0,1,6,0,6
2023-06-01,204124,2,0,2,1,0,1
2023-06-01,12372,5,4,9,3,1,3
2023-06-01,206749,2,0,2,1,0,1
2023-06-01,204120,2,1,3,2,1,2
2023-06-01,50500,5,0,5,1,0,1
2023-06-01,204100,2,0,2,2,0,2
2023-06-01,197164,7,3,10,2,2,2
2023-06-01,204108,5,0,5,2,0,2
2023-06-01,56567,2,0,2,1,0,1
2023-06-01,13117,2,0,2,1,0,1
2023-06-01,197183,1,0,1,1,0,1
2023-06-01,48520,4,1,5,3,2,3
2023-06-01,15907,1,0,1,1,0,1
2023-06-01,15426,3,1,4,3,1,3
2023-06-01,203474,1,0,1,1,0,1
2023-06-01,207894,1,2,3,1,1,1
2023-06-01,204529,1,0,1,1,0,1
2023-06-01,198849,2,0,2,1,0,1
2023-06-01,204096,3,1,4,2,2,2
2023-06-01,204075,2,0,2,2,0,2
2023-06-01,9053,1,3,4,4,4,5
2023-06-01,51025,1,0,1,1,0,1
2023-06-01,204090,1,0,1,1,0,1
2023-06-01,61069,4,0,4,1,0,1
2023-06-01,31234,2,0,2,3,0,3
2023-06-01,203460,1,1,2,1,1,1
2023-06-01,204080,2,0,2,3,0,3
2023-06-01,203845,4,0,4,4,0,4
2023-06-01,205177,1,0,1,2,0,2
2023-06-01,57473,2,0,2,1,0,1
2023-06-01,15718,1,0,1,1,0,1
2023-06-01,15449,1,0,1,1,0,1
2023-06-01,204038,1,3,4,2,2,2
2023-06-01,51683,1,0,1,1,0,1
2023-06-01,15622,4,2,6,2,1,3
2023-06-01,204195,1,1,2,2,1,2
2023-06-01,54598,0,0,0,2,0,2
2023-06-01,42495,2,0,2,1,0,1
2023-06-01,207564,1,1,2,4,2,4
2023-06-01,204060,1,0,1,3,0,3
2023-06-01,203798,1,0,1,1,0,1
2023-06-01,29085,6,0,6,2,0,2
2023-06-01,204052,1,1,2,3,1,3
2023-06-01,204050,3,2,5,3,3,3
2023-06-01,203060,2,0,2,2,0,2
2023-06-01,204030,1,0,1,1,0,1
2023-06-01,204046,1,1,2,1,1,1
2023-06-01,204044,1,0,1,1,0,1
2023-06-01,203769,2,0,2,3,0,3
2023-06-01,64416,2,0,2,1,0,1
2023-06-01,13204,2,0,2,1,0,1
2023-06-01,198659,1,0,1,1,0,1
2023-06-01,204139,11,0,11,1,0,1
2023-06-01,41332,2,0,2,2,0,2
2023-06-01,15556,1,0,1,2,0,2
2023-06-01,47816,1,2,3,1,1,1
2023-06-01,211657,3,1,4,1,1,1
2023-06-01,204011,3,0,3,2,0,2
2023-06-01,16312,1,0,1,1,0,1
2023-06-01,51786,1,1,2,3,3,4
2023-06-01,42978,1,1,2,1,1,1
2023-06-01,203708,1,0,1,1,0,1
2023-06-01,34183,2,1,3,5,3,5
2023-06-01,49681,1,1,2,2,1,3
2023-06-01,49176,1,0,1,3,0,3
2023-06-01,202177,4,1,5,2,1,3
2023-06-01,207264,1,0,1,1,0,1
2023-06-01,198463,5,3,8,7,4,7
2023-06-01,31043,2,0,2,3,0,3
2023-06-01,205451,1,0,1,3,0,3
2023-06-01,203990,2,0,2,2,0,2
2023-06-01,203378,6,1,7,2,1,2
2023-06-01,209180,1,0,1,1,2,2
2023-06-01,203972,25,0,25,3,0,3
2023-06-01,13190,1,0,1,2,0,2
2023-06-01,12557,1,4,5,1,1,1
2023-06-01,47685,1,0,1,1,0,1
2023-06-01,31175,3,0,3,3,0,3
2023-06-01,212892,2,0,2,1,0,1
2023-06-01,3624,1,2,3,4,2,4
2023-06-01,6719,2,0,2,1,0,1
2023-06-01,203982,5,0,5,2,0,2
2023-06-01,203904,3,0,3,1,0,1
2023-06-01,203971,6,0,6,3,0,3
2023-06-01,13006,3,0,3,3,0,3
2023-06-01,203962,5,0,5,2,0,2
2023-06-01,3311,4,0,4,3,0,3
2023-06-01,206708,1,0,1,1,0,1
2023-06-01,12952,4,0,4,1,0,1
2023-06-01,49805,1,0,1,1,0,1
2023-06-01,35739,3,1,4,2,2,2
2023-06-01,203965,5,3,8,3,3,3
2023-06-01,51710,2,0,2,2,0,2
2023-06-01,203925,5,0,5,3,0,3
2023-06-01,204028,6,6,12,2,5,5
2023-06-01,203894,2,0,2,2,0,2
2023-06-01,203944,3,0,3,3,0,3
2023-06-01,12590,4,0,4,1,0,1
2023-06-01,15786,1,0,1,1,0,1
2023-06-01,203955,2,0,2,2,0,2
2023-06-01,31293,7,70,77,6,7,9
2023-06-01,203954,1,1,2,2,1,2
2023-06-01,12517,4,2,6,1,1,1
2023-06-01,203951,5,0,5,2,0,2
2023-06-01,12546,1,0,1,2,0,2
2023-06-01,211331,2,2,4,4,4,4
2023-06-01,203544,1,1,2,3,1,3
2023-06-01,15645,1,0,1,1,7,8
2023-06-01,203892,1,0,1,2,0,2
2023-06-01,207604,4,1,5,2,1,2
2023-06-01,12344,1,1,2,3,1,3
2023-06-01,204418,1,1,2,1,1,1
2023-06-01,57166,1,1,2,1,1,1
2023-06-01,202364,1,0,1,2,0,2
2023-06-01,211854,1,0,1,1,0,1
2023-06-01,8336,4,0,4,4,0,4
2023-06-01,20652,4,0,4,2,0,2
2023-06-01,43253,2,0,2,2,0,2
2023-06-01,213331,3,0,3,2,0,2
2023-06-01,207221,2,0,2,3,0,3
2023-06-01,34141,2,1,3,8,3,8
2023-06-01,203927,1,0,1,2,0,2
2023-06-01,50016,1,0,1,4,0,4
2023-06-01,203923,1,0,1,1,0,1
2023-06-01,203073,4,0,4,1,0,1
2023-06-01,208069,1,1,2,1,1,2
2023-06-01,206479,1,4,5,5,6,7
2023-06-01,203343,1,0,1,1,0,1
2023-06-01,8699,4,0,4,2,0,2
2023-06-01,212351,1,1,2,1,1,1
2023-06-01,6843,4,0,4,1,0,1
2023-06-01,202610,2,0,2,1,0,1
2023-06-01,8646,1,0,1,6,0,6
2023-06-01,197152,4,0,4,2,0,2
2023-06-01,203896,5,0,5,3,0,3
2023-06-01,16007,2,0,2,8,0,8
2023-06-01,203895,3,0,3,2,0,2
2023-06-01,212850,1,0,1,1,0,1
2023-06-01,204778,1,1,2,3,3,3
2023-06-01,212848,1,0,1,1,0,1
2023-06-01,60254,4,2,6,1,1,2
2023-06-01,212039,1,0,1,2,0,2
2023-06-01,8868,10,0,10,2,0,2
2023-06-01,211147,1,2,3,2,2,2
2023-06-01,211141,1,0,1,1,0,1
2023-06-01,203891,1,0,1,3,0,3
2023-06-01,196854,2,0,2,1,0,1
2023-06-01,8791,3,0,3,2,0,2
2023-06-01,8639,1,0,1,1,0,1
2023-06-01,196654,2,0,2,2,0,2
2023-06-01,203876,3,0,3,2,0,2
2023-06-01,199975,1,0,1,3,0,3
2023-06-01,202630,1,0,1,1,0,1
2023-06-01,205887,1,0,1,1,0,1
2023-06-01,208735,2,0,2,2,0,2
2023-06-01,60401,1,0,1,4,0,4
2023-06-01,64418,1,0,1,2,0,2
2023-06-01,8494,1,0,1,1,0,1
2023-06-01,49599,1,0,1,1,0,1
2023-06-01,44873,1,0,1,2,0,2
2023-06-01,49145,1,0,1,1,0,1
2023-06-01,8589,1,0,1,1,0,1
2023-06-01,20324,4,2,6,2,2,2
2023-06-01,203745,1,0,1,1,0,1
2023-06-01,38966,2,0,2,1,0,1
2023-06-01,207220,1,1,2,1,1,1
2023-06-01,43016,2,0,2,1,0,1
2023-06-01,209119,1,0,1,2,0,2
2023-06-01,203898,1,1,2,3,1,3
2023-06-01,203854,3,1,4,2,2,2
2023-06-01,208611,8,0,8,1,0,1
2023-06-01,203795,2,0,2,5,0,5
2023-06-01,49117,8,2,10,1,1,1
2023-06-01,62328,1,0,1,2,0,2
2023-06-01,51778,1,1,2,3,2,3
2023-06-01,203200,1,1,2,1,1,2
2023-06-01,24707,4,0,4,3,0,3
2023-06-01,203817,1,0,1,1,0,1
2023-06-01,203839,1,0,1,1,0,1
2023-06-01,206694,5,0,5,1,0,1
2023-06-01,43151,2,0,2,1,0,1
2023-06-01,43888,2,0,2,4,0,4
2023-06-01,203996,1,0,1,2,0,2
2023-06-01,60646,1,0,1,3,0,3
2023-06-01,199787,1,0,1,2,0,2
2023-06-01,203825,3,0,3,2,0,2
2023-06-01,203823,1,0,1,1,0,1
2023-06-01,203818,5,1,6,2,1,2
2023-06-01,203812,3,0,3,1,0,1
2023-06-01,203882,4,0,4,3,0,3
2023-06-01,39498,3,0,3,10,0,10
2023-06-01,203811,1,0,1,1,0,1
2023-06-01,203814,1,0,1,1,0,1
2023-06-01,6704,1,0,1,3,0,3
2023-06-01,5627,1,0,1,1,0,1
2023-06-01,203797,1,0,1,1,0,1
2023-06-01,208047,1,0,1,1,0,1
2023-06-01,212277,1,0,1,1,0,1
2023-06-01,198382,21,0,21,1,0,1
2023-06-01,205427,1,2,3,1,1,1
2023-06-01,203800,1,0,1,1,0,1
2023-06-01,203606,1,0,1,1,0,1
2023-06-01,203813,1,0,1,1,0,1
2023-06-01,12462,4,0,4,2,0,2
2023-06-01,204653,5,0,5,2,0,2
2023-06-01,205709,1,0,1,1,0,1
2023-06-01,5514,1,0,1,2,0,2
2023-06-01,43232,1,1,2,2,2,2
2023-06-01,203791,1,0,1,1,0,1
2023-06-01,8296,3,0,3,1,0,1
2023-06-01,49371,2,1,3,3,2,4
2023-06-01,205497,2,0,2,1,0,1
2023-06-01,203775,1,0,1,2,0,2
2023-06-01,52051,1,1,2,2,2,2
2023-06-01,203776,2,1,3,2,2,2
2023-06-01,203228,2,2,4,4,4,4
2023-06-01,207436,0,0,0,2,2,2
2023-06-01,48727,1,0,1,4,0,4
2023-06-01,207915,5,0,5,1,0,1
2023-06-01,209199,4,0,4,5,0,5
2023-06-01,210609,1,0,1,1,0,1
2023-06-01,203760,1,0,1,3,0,3
2023-06-01,3337,2,0,2,1,0,1
2023-06-01,203754,1,0,1,3,0,3
2023-06-01,51916,1,0,1,2,0,2
2023-06-01,43326,1,0,1,1,0,1
2023-06-01,3290,4,0,4,1,0,1
2023-06-01,206302,2,0,2,1,0,1
2023-06-01,203205,2,0,2,2,0,2
2023-06-01,203740,1,1,2,2,3,3
2023-06-01,207064,3,0,3,3,0,3
2023-06-01,203608,2,1,3,2,3,4
2023-06-01,203752,1,1,2,5,3,5
2023-06-01,203747,1,0,1,2,0,2
2023-06-01,30150,5,4,9,4,4,4
2023-06-01,50042,1,1,2,2,1,2
2023-06-01,203742,1,0,1,3,0,3
2023-06-01,203678,2,0,2,1,0,1
2023-06-01,203733,3,0,3,2,0,2
2023-06-01,203939,2,1,3,3,1,3
2023-06-01,50849,2,0,2,2,0,2
2023-06-01,203722,1,0,1,2,0,2
2023-06-01,203721,1,0,1,1,0,1
2023-06-01,206706,1,1,2,1,1,1
2023-06-01,57778,2,0,2,2,0,2
2023-06-01,203715,2,0,2,1,0,1
2023-06-01,202268,1,0,1,2,0,2
2023-06-01,210331,1,0,1,2,0,2
2023-06-01,200505,1,0,1,2,0,2
2023-06-01,205720,1,0,1,4,0,4
2023-06-01,48281,1,0,1,1,0,1
2023-06-01,197660,3,1,4,3,1,3
2023-06-01,203443,9,1,10,4,2,4
2023-06-01,207248,2,0,2,2,0,2
2023-06-01,44749,1,9,10,5,3,5
2023-06-01,209782,1,0,1,1,0,1
2023-06-01,60487,1,0,1,1,0,1
2023-06-01,203702,4,0,4,1,0,1
2023-06-01,56899,4,0,4,4,0,4
2023-06-01,61997,1,0,1,1,0,1
2023-06-01,31685,6,0,6,1,0,1
2023-06-01,202546,1,0,1,1,0,1
2023-06-01,50440,6,0,6,3,0,3
2023-06-01,203658,1,0,1,4,0,4
2023-06-01,199517,1,0,1,4,0,4
2023-06-01,203683,1,0,1,3,0,3
2023-06-01,203681,1,0,1,1,0,1
2023-06-01,203623,4,3,7,2,2,2
2023-06-01,203677,2,0,2,2,0,2
2023-06-01,202987,8,0,8,2,0,2
2023-06-01,212054,5,2,7,4,1,4
2023-06-01,203152,2,0,2,1,0,1
2023-06-01,206686,4,0,4,5,0,5
2023-06-01,203449,1,1,2,1,1,1
2023-06-01,203119,3,1,4,1,1,1
2023-06-01,203615,3,1,4,1,1,1
2023-06-01,41193,2,0,2,2,0,2
2023-06-01,203637,4,0,4,2,0,2
2023-06-01,203672,1,1,2,1,1,1
2023-06-01,209793,4,0,4,2,0,2
2023-06-01,203612,4,0,4,2,0,2
2023-06-01,208719,3,1,4,2,2,2
2023-06-01,203659,1,1,2,1,1,1
2023-06-01,211074,1,0,1,3,0,3
2023-06-01,2606,4,1,5,1,1,1
2023-06-01,198777,7,0,7,5,0,5
2023-06-01,203601,1,0,1,1,0,1
2023-06-01,203336,1,0,1,1,0,1
2023-06-01,203653,5,0,5,3,0,3
2023-06-01,205889,11,0,11,2,0,2
2023-06-01,203409,2,0,2,1,0,1
2023-06-01,212830,6,0,6,1,0,1
2023-06-01,203614,2,0,2,1,0,1
2023-06-01,207680,5,0,5,1,0,1
2023-06-01,60797,4,0,4,1,0,1
2023-06-01,61404,1,0,1,2,0,2
2023-06-01,203106,1,0,1,1,0,1
2023-06-01,203592,1,0,1,1,0,1
2023-06-01,58080,6,0,6,2,0,2
2023-06-01,60903,1,0,1,1,0,1
2023-06-01,203604,4,1,5,2,1,2
2023-06-01,57184,1,1,2,2,2,2
2023-06-01,51953,1,0,1,1,0,1
2023-06-01,209082,2,2,4,3,2,3
2023-06-01,203254,2,0,2,2,0,2
2023-06-01,203625,1,0,1,1,0,1
2023-06-01,203628,2,0,2,3,0,3
2023-06-01,206230,3,0,3,1,0,1
2023-06-01,44772,2,0,2,2,0,2
2023-06-01,57860,2,1,3,1,1,1
2023-06-01,210731,1,1,2,1,1,1
2023-06-01,203610,1,0,1,1,0,1
2023-06-01,203616,5,0,5,4,0,4
2023-06-01,57786,4,0,4,1,0,1
2023-06-01,201511,2,2,4,7,6,8
2023-06-01,9516,1,0,1,1,2,2
2023-06-01,203512,1,0,1,1,0,1
2023-06-01,203609,1,0,1,3,0,3
2023-06-01,205989,1,1,2,1,1,1
2023-06-01,57687,4,0,4,2,0,2
2023-06-01,202395,5,0,5,4,0,4
2023-06-01,206408,2,0,2,1,0,1
2023-06-01,204527,3,11,14,3,3,3
2023-06-01,205249,1,0,1,2,0,2
2023-06-01,206752,1,0,1,1,0,1
2023-06-01,203325,3,0,3,2,0,2
2023-06-01,203580,1,1,2,1,1,1
2023-06-01,203159,3,0,3,2,0,2
2023-06-01,210655,1,0,1,1,0,1
2023-06-01,212811,1,0,1,1,0,1
2023-06-01,203573,1,0,1,3,0,3
2023-06-01,203334,1,0,1,1,0,1
2023-06-01,203572,5,0,5,1,0,1
2023-06-01,203571,2,0,2,2,0,2
2023-06-01,57133,4,0,4,1,0,1
2023-06-01,60059,4,3,7,2,2,2
2023-06-01,203630,5,0,5,3,0,3
2023-06-01,203568,6,2,8,7,2,7
2023-06-01,203137,1,0,1,1,0,1
2023-06-01,203556,1,0,1,2,0,2
2023-06-01,56697,5,1,6,1,2,2
2023-06-01,203256,1,0,1,2,0,2
2023-06-01,56773,2,0,2,1,0,1
2023-06-01,203552,1,0,1,1,0,1
2023-06-01,203547,4,1,5,4,1,4
2023-06-01,56643,8,0,8,3,0,3
2023-06-01,49833,1,0,1,2,0,2
2023-06-01,203352,5,1,6,2,2,2
2023-06-01,47907,3,0,3,2,0,2
2023-06-01,49474,3,0,3,3,0,3
2023-06-01,203538,5,3,8,2,2,2
2023-06-01,49086,1,0,1,2,0,2
2023-06-01,205050,2,0,2,2,0,2
2023-06-01,205358,1,0,1,4,0,4
2023-06-01,48005,1,0,1,1,0,1
2023-06-01,211701,3,0,3,2,0,2
2023-06-01,203317,1,0,1,1,0,1
2023-06-01,204871,1,0,1,2,0,2
2023-06-01,203525,1,0,1,3,0,3
2023-06-01,56346,3,0,3,2,0,2
2023-06-01,15418,1,1,2,1,2,2
2023-06-01,203143,2,1,3,2,2,2
2023-06-01,202898,1,1,2,2,1,2
2023-06-01,57081,1,1,2,1,1,1
2023-06-01,203457,1,0,1,1,0,1
2023-06-01,203186,1,0,1,2,0,2
2023-06-01,203452,1,0,1,1,0,1
2023-06-01,203009,1,0,1,1,0,1
2023-06-01,203506,1,0,1,1,0,1
2023-06-01,51618,6,0,6,3,0,3
2023-06-01,203441,2,1,3,2,2,2
2023-06-01,204657,4,0,4,3,0,3
2023-06-01,203204,2,0,2,1,0,1
2023-06-01,202784,3,2,5,2,1,2
2023-06-01,273584,1,0,1,1,0,1
2023-06-01,203495,1,0,1,2,0,2
2023-06-01,203491,1,0,1,1,0,1
2023-06-01,203485,5,1,6,3,2,3
2023-06-01,51257,5,2,7,3,3,3
2023-06-01,203455,4,2,6,1,1,1
2023-06-01,44055,1,0,1,1,0,1
2023-06-01,35757,1,0,1,2,0,2
2023-06-01,50826,1,0,1,1,0,1
2023-06-01,50930,2,0,2,1,0,1
2023-06-01,204771,1,0,1,2,0,2
2023-06-01,199971,1,2,3,2,2,2
2023-06-01,203645,2,12,14,1,1,1
2023-06-01,211486,1,1,2,1,3,3
2023-06-01,50980,1,0,1,1,0,1
2023-06-01,209344,7,0,7,4,0,4
2023-06-01,207631,2,1,3,2,2,2
2023-06-01,48550,1,2,3,1,1,1
2023-06-01,207537,1,1,2,1,1,2
2023-06-01,203251,1,0,1,1,0,1
2023-06-01,213089,8,0,8,5,0,5
2023-06-01,202252,1,0,1,1,0,1
2023-06-01,200474,2,1,3,1,1,1
2023-06-01,60315,4,0,4,2,0,2
2023-06-01,47671,2,2,4,1,1,1
2023-06-01,205609,1,0,1,1,0,1
2023-06-01,206458,1,0,1,1,0,1
2023-06-01,50642,3,1,4,1,1,1
2023-06-01,208950,3,0,3,5,0,5
2023-06-01,50754,3,3,6,2,2,2
2023-06-01,211326,3,0,3,2,0,2
2023-06-01,50749,2,0,2,3,0,3
2023-06-01,205765,3,0,3,2,0,2
2023-06-01,50520,5,1,6,7,1,7
2023-06-01,203402,1,0,1,2,0,2
2023-06-01,30852,2,1,3,2,1,2
2023-06-01,39293,2,2,4,2,2,2
2023-06-01,206205,1,0,1,3,0,3
2023-06-01,203450,1,1,2,1,3,3
2023-06-01,204504,2,1,3,6,3,6
2023-06-01,203448,4,1,5,2,1,3
2023-06-01,212599,1,0,1,2,0,2
2023-06-01,62528,1,0,1,2,0,2
2023-06-01,205725,3,0,3,1,0,1
2023-06-01,203444,4,0,4,1,0,1
2023-06-01,56722,1,1,2,2,2,2
2023-06-01,49829,3,0,3,3,0,3
2023-06-01,57950,1,0,1,1,0,1
2023-06-01,203439,4,0,4,3,0,3
2023-06-01,203435,2,0,2,1,0,1
2023-06-01,203299,1,1,2,1,1,1
2023-06-01,12531,3,1,4,9,4,10
2023-06-01,203916,1,0,1,1,0,1
2023-06-01,203427,1,1,2,2,2,2
2023-06-01,204918,2,0,2,1,0,1
2023-06-01,203399,1,0,1,1,0,1
2023-06-01,203411,4,0,4,2,0,2
2023-06-01,203413,1,0,1,2,0,2
2023-06-01,206330,1,2,3,1,1,1
2023-06-01,49935,2,0,2,3,0,3
2023-06-01,203357,2,0,2,1,0,1
2023-06-01,203404,1,0,1,2,0,2
2023-06-01,203386,1,0,1,1,0,1
2023-06-01,203387,5,1,6,3,2,3
2023-06-01,208332,1,1,2,4,3,4
2023-06-01,203398,1,0,1,2,0,2
2023-06-01,50055,1,0,1,3,0,3
2023-06-01,50018,3,0,3,2,0,2
2023-06-01,60977,1,0,1,3,0,3
2023-06-01,203393,4,0,4,1,0,1
2023-06-01,49448,1,0,1,2,0,2
2023-06-01,204860,5,9,14,9,6,10
2023-06-01,203385,3,2,5,1,2,2
2023-06-01,210604,2,0,2,1,2,2
2023-06-01,204793,1,1,2,1,1,1
2023-06-01,204631,3,0,3,3,0,3
2023-06-01,203089,4,0,4,5,0,5
2023-06-01,201452,1,0,1,1,0,1
2023-06-01,204836,1,0,1,2,0,2
2023-06-01,203366,3,0,3,5,0,5
2023-06-01,203365,1,0,1,2,0,2
2023-06-01,203376,1,1,2,2,1,2
2023-06-01,205476,2,1,3,2,2,2
2023-06-01,203375,1,0,1,1,0,1
2023-06-01,209276,1,0,1,2,0,2
2023-06-01,208331,1,0,1,2,0,2
2023-06-01,210837,1,0,1,1,0,1
2023-06-01,203374,1,0,1,1,0,1
2023-06-01,48970,4,0,4,3,0,3
2023-06-01,203372,3,0,3,7,0,7
2023-06-01,202787,2,0,2,4,0,4
2023-06-01,43439,4,1,5,4,1,4
2023-06-01,203175,5,0,5,3,0,3
2023-06-01,203368,1,1,2,2,2,2
2023-06-01,202848,3,1,4,1,1,1
2023-06-01,203255,1,1,2,6,4,6
2023-06-01,204369,2,0,2,1,0,1
2023-06-01,203209,1,0,1,1,0,1
2023-06-01,203367,1,1,2,2,1,2
2023-06-01,203216,3,1,4,1,1,1
2023-06-01,62119,4,1,5,2,2,2
2023-06-01,208446,1,0,1,1,0,1
2023-06-01,205575,10,0,10,2,0,2
2023-06-01,38980,2,0,2,1,0,1
2023-06-01,210198,1,1,2,1,1,1
2023-06-01,62302,1,0,1,2,0,2
2023-06-01,206343,1,0,1,2,0,2
2023-06-01,210601,1,0,1,2,0,2
2023-06-01,49473,1,0,1,2,0,2
2023-06-01,62116,1,1,2,2,1,2
2023-06-01,203294,1,0,1,1,0,1
2023-06-01,203351,2,0,2,4,0,4
2023-06-01,208002,3,0,3,1,0,1
2023-06-01,206476,2,0,2,6,0,6
2023-06-01,48325,1,0,1,1,0,1
2023-06-01,203356,1,0,1,1,0,1
2023-06-01,25279,2,1,3,9,7,11
2023-06-01,49253,14,0,14,3,0,3
2023-06-01,203328,1,1,2,1,1,1
2023-06-01,34766,2,2,4,3,1,3
2023-06-01,202679,1,0,1,2,0,2
2023-06-01,197393,2,1,3,1,1,1
2023-06-01,49175,1,0,1,3,0,3
2023-06-01,203338,2,1,3,1,1,1
2023-06-01,25231,5,1,6,5,2,5
2023-06-01,50451,2,0,2,1,0,1
2023-06-01,203327,2,0,2,2,0,2
2023-06-01,204140,1,0,1,2,0,2
2023-06-01,204598,2,0,2,3,0,3
2023-06-01,203110,4,0,4,3,0,3
2023-06-01,203077,2,0,2,2,0,2
2023-06-01,203322,3,1,4,1,1,1
2023-06-01,49013,2,0,2,4,0,4
2023-06-01,203316,6,2,8,4,1,4
2023-06-01,49196,1,0,1,1,0,1
2023-06-01,52179,1,0,1,1,0,1
2023-06-01,48557,1,0,1,2,0,2
2023-06-01,202126,5,0,5,2,0,2
2023-06-01,203234,1,1,2,2,2,2
2023-06-01,207108,1,3,4,1,1,1
2023-06-01,49020,8,0,8,4,0,4
2023-06-01,202628,1,0,1,2,0,2
2023-06-01,35660,6,0,6,1,0,1
2023-06-01,208000,2,0,2,2,0,2
2023-06-01,203301,1,0,1,3,0,3
2023-06-01,48898,3,0,3,1,0,1
2023-06-01,24853,2,1,3,1,1,1
2023-06-01,203293,3,1,4,3,2,3
2023-06-01,59626,1,1,2,1,1,1
2023-06-01,211981,3,0,3,1,0,1
2023-06-01,203302,1,0,1,3,0,3
2023-06-01,205761,1,0,1,1,0,1
2023-06-01,50948,3,0,3,2,0,2
2023-06-01,203300,1,0,1,1,0,1
2023-06-01,203298,1,0,1,1,0,1
2023-06-01,203297,1,0,1,1,0,1
2023-06-01,203296,1,0,1,2,0,2
2023-06-01,203295,1,0,1,1,0,1
2023-06-01,203289,2,0,2,1,0,1
2023-06-01,203278,1,0,1,1,0,1
2023-06-01,51560,1,1,2,1,1,1
2023-06-01,49142,2,0,2,3,0,3
2023-06-01,203288,1,0,1,1,0,1
2023-06-01,64405,1,0,1,1,0,1
2023-06-01,203311,1,1,2,2,2,2
2023-06-01,203266,1,0,1,1,0,1
2023-06-01,203280,5,0,5,2,0,2
2023-06-01,48767,1,1,2,1,1,1
2023-06-01,207051,1,0,1,2,0,2
2023-06-01,48804,3,3,6,6,4,6
2023-06-01,203272,1,0,1,6,0,6
2023-06-01,57825,2,1,3,1,1,1
2023-06-01,39047,3,0,3,1,0,1
2023-06-01,206521,5,3,8,3,3,3
2023-06-01,210431,1,1,2,1,1,1
2023-06-01,48270,1,0,1,2,0,2
2023-06-01,29337,18,0,18,4,0,4
2023-06-01,203257,4,0,4,3,0,3
2023-06-01,207179,2,0,2,2,0,2
2023-06-01,48091,2,2,4,4,3,4
2023-06-01,210498,1,0,1,1,0,1
2023-06-01,56815,5,0,5,1,0,1
2023-06-01,48602,2,1,3,4,3,4
2023-06-01,208678,2,0,2,2,0,2
2023-06-01,199834,1,0,1,1,0,1
2023-06-01,203247,4,0,4,1,0,1
2023-06-01,205741,12,1,13,6,1,6
2023-06-01,203243,1,0,1,1,0,1
2023-06-01,203241,1,0,1,1,0,1
2023-06-01,203195,1,1,2,1,1,1
2023-06-01,203240,1,0,1,1,0,1
2023-06-01,204877,1,1,2,1,2,2
2023-06-01,52146,1,0,1,1,0,1
2023-06-01,48402,1,1,2,1,1,1
2023-06-01,203235,2,1,3,1,1,1
2023-06-01,48374,2,2,4,6,5,8
2023-06-01,203225,1,0,1,1,0,1
2023-06-01,204056,4,0,4,1,0,1
2023-06-01,204396,2,0,2,3,0,3
2023-06-01,34650,3,0,3,1,0,1
2023-06-01,203100,4,0,4,2,0,2
2023-06-01,203221,2,0,2,2,0,2
2023-06-01,15490,3,1,4,4,2,4
2023-06-01,60004,0,0,0,3,2,3
2023-06-01,206160,1,1,2,1,1,1
2023-06-01,203126,1,0,1,4,0,4
2023-06-01,204204,2,0,2,3,0,3
2023-06-01,208851,3,0,3,2,0,2
2023-06-01,48253,4,0,4,2,0,2
2023-06-01,48206,4,0,4,2,0,2
2023-06-01,203212,2,0,2,2,0,2
2023-06-01,47546,6,0,6,3,0,3
2023-06-01,203099,1,1,2,2,2,2
2023-06-01,203213,1,0,1,1,0,1
2023-06-01,202730,1,1,2,3,2,3
2023-06-01,199963,1,0,1,1,0,1
2023-06-01,203035,3,0,3,2,0,2
2023-06-01,202826,4,0,4,1,0,1
2023-06-01,44541,1,2,3,2,2,2
2023-06-01,203184,2,0,2,1,0,1
2023-06-01,203180,1,1,2,3,2,3
2023-06-01,48545,5,0,5,2,0,2
2023-06-01,48111,1,1,2,1,1,1
2023-06-01,203132,3,3,6,2,2,2
2023-06-01,41954,1,1,2,2,2,2
2023-06-01,203161,10,0,10,2,0,2
2023-06-01,47688,2,1,3,1,1,1
2023-06-01,203194,1,0,1,1,0,1
2023-06-01,203193,1,0,1,1,0,1
2023-06-01,203192,1,0,1,1,0,1
2023-06-01,203191,1,0,1,1,0,1
2023-06-01,203116,1,1,2,3,2,3
2023-06-01,57090,10,4,14,4,4,4
2023-06-01,47348,1,0,1,2,0,2
2023-06-01,49110,4,0,4,1,0,1
2023-06-01,20742,1,1,2,2,1,2
2023-06-01,197997,5,3,8,3,3,3
2023-06-01,47896,1,0,1,1,0,1
2023-06-01,204706,3,1,4,3,1,3
2023-06-01,203179,1,1,2,1,1,1
2023-06-01,203136,5,5,10,5,2,5
2023-06-01,47318,4,0,4,2,0,2
2023-06-01,203171,4,0,4,2,0,2
2023-06-01,205585,5,0,5,3,0,3
2023-06-01,47754,2,0,2,5,0,5
2023-06-01,203123,1,0,1,4,0,4
2023-06-01,49118,1,0,1,1,0,1
2023-06-01,47701,5,0,5,2,0,2
2023-06-01,203102,3,0,3,3,0,3
2023-06-01,211417,1,1,2,2,2,2
2023-06-01,203122,1,0,1,2,0,2
2023-06-01,200186,1,0,1,2,0,2
2023-06-01,210749,1,0,1,1,0,1
2023-06-01,203111,1,0,1,1,0,1
2023-06-01,57219,2,0,2,2,0,2
2023-06-01,203121,1,0,1,1,0,1
2023-06-01,203103,1,1,2,1,1,1
2023-06-01,203124,3,0,3,1,0,1
2023-06-01,204263,1,0,1,5,0,5
2023-06-01,202626,1,0,1,5,0,5
2023-06-01,203117,1,0,1,1,0,1
2023-06-01,203115,4,0,4,2,0,2
2023-06-01,41644,2,0,2,2,0,2
2023-06-01,203063,4,0,4,4,0,4
2023-06-01,203081,1,0,1,1,0,1
2023-06-01,205870,4,0,4,2,0,2
2023-06-01,39072,5,0,5,8,0,8
2023-06-01,57140,1,0,1,3,0,3
2023-06-01,203984,2,0,2,3,0,3
2023-06-01,205939,1,0,1,1,0,1
2023-06-01,204868,1,0,1,1,0,1
2023-06-01,212629,1,1,2,2,1,2
2023-06-01,51949,1,0,1,1,0,1
2023-06-01,202809,1,0,1,1,0,1
2023-06-01,62043,4,0,4,2,0,2
2023-06-01,206173,1,1,2,5,3,6
2023-06-01,203064,1,0,1,3,0,3
2023-06-01,206332,3,2,5,1,4,5
2023-06-01,204073,9,0,9,2,0,2
2023-06-01,41386,2,0,2,2,0,2
2023-06-01,203054,1,0,1,1,0,1
2023-06-01,203052,6,1,7,5,3,5
2023-06-01,208622,1,0,1,1,0,1
2023-06-01,203505,2,0,2,3,0,3
2023-06-01,203043,4,1,5,1,1,1
2023-06-01,25426,2,0,2,2,0,2
2023-06-01,203041,3,0,3,1,0,1
2023-06-01,51262,8,0,8,2,0,2
2023-06-01,203034,1,1,2,2,2,2
2023-06-01,210152,1,6,7,2,2,3
2023-06-01,41619,1,0,1,2,0,2
2023-06-01,203019,1,0,1,3,0,3
2023-06-01,209963,1,0,1,1,0,1
2023-06-01,202822,1,0,1,1,0,1
2023-06-01,60127,1,0,1,2,0,2
2023-06-01,205933,3,0,3,1,0,1
2023-06-01,203028,1,0,1,4,0,4
2023-06-01,203026,2,0,2,2,0,2
2023-06-01,206992,5,0,5,2,0,2
2023-06-01,203021,1,0,1,2,0,2
2023-06-01,211734,3,0,3,1,0,1
2023-06-01,44652,1,1,2,1,1,1
2023-06-01,202644,1,0,1,1,0,1
2023-06-01,203007,1,0,1,2,0,2
2023-06-01,203003,2,0,2,2,0,2
2023-06-01,62398,1,0,1,2,0,2
2023-06-01,60021,1,0,1,2,0,2
2023-06-01,202947,1,0,1,1,0,1
2023-06-01,202936,2,0,2,8,0,8
2023-06-01,48809,1,1,2,2,1,2
2023-06-01,202991,2,0,2,1,0,1
2023-06-01,202889,1,0,1,3,0,3
2023-06-01,39372,2,0,2,1,0,1
2023-06-01,206914,1,0,1,1,0,1
2023-06-01,202979,1,1,2,3,2,3
2023-06-01,206035,4,0,4,3,0,3
2023-06-01,202978,3,0,3,2,0,2
2023-06-01,202977,2,0,2,1,0,1
2023-06-01,34290,3,2,5,3,2,3
2023-06-01,202970,3,3,6,2,2,2
2023-06-01,50547,2,0,2,1,0,1
2023-06-01,44784,6,0,6,4,0,4
2023-06-01,202953,1,0,1,1,0,1
2023-06-01,211873,1,1,2,1,2,2
2023-06-01,202812,1,1,2,2,1,2
2023-06-01,202961,4,0,4,3,0,3
2023-06-01,209247,2,0,2,1,0,1
2023-06-01,49920,5,2,7,7,6,7
2023-06-01,202956,2,0,2,1,0,1
2023-06-01,202954,1,1,2,10,8,12
2023-06-01,206616,4,1,5,3,1,3
2023-06-01,204507,4,0,4,2,0,2
2023-06-01,209128,1,0,1,1,0,1
2023-06-01,59633,1,0,1,2,0,2
2023-06-01,202835,1,0,1,1,0,1
2023-06-01,202872,2,1,3,2,1,2
2023-06-01,44778,3,0,3,1,0,1
2023-06-01,44771,1,0,1,1,0,1
2023-06-01,43740,6,0,6,3,0,3
2023-06-01,209786,1,0,1,2,0,2
2023-06-01,202544,2,0,2,1,0,1
2023-06-01,198426,2,1,3,3,3,3
2023-06-01,62408,2,0,2,2,0,2
2023-06-01,202894,4,0,4,4,0,4
2023-06-01,202714,1,1,2,2,2,2
2023-06-01,51172,2,2,4,4,2,4
2023-06-01,44358,5,5,10,13,7,13
2023-06-01,205807,4,3,7,2,2,2
2023-06-01,6776,17,1,18,4,2,4
2023-06-01,58253,5,0,5,2,0,2
2023-06-01,210664,1,1,2,1,1,1
2023-06-01,44598,1,0,1,1,0,1
2023-06-01,202915,1,1,2,2,2,4
2023-06-01,44531,4,0,4,1,0,1
2023-06-01,202922,1,0,1,1,0,1
2023-06-01,202874,1,0,1,1,0,1
2023-06-01,202919,1,0,1,1,0,1
2023-06-01,202907,1,1,2,3,2,3
2023-06-01,202918,2,2,4,3,3,3
2023-06-01,34197,5,3,8,2,1,2
2023-06-01,25398,4,3,7,1,1,1
2023-06-01,203147,3,0,3,3,0,3
2023-06-01,202823,2,0,2,2,0,2
2023-06-01,202901,3,0,3,1,0,1
2023-06-01,206758,1,0,1,5,0,5
2023-06-01,203908,1,1,2,2,2,2
2023-06-01,44404,1,2,3,2,2,2
2023-06-01,207073,2,0,2,3,0,3
2023-06-01,202670,2,0,2,4,0,4
2023-06-01,62395,1,0,1,1,0,1
2023-06-01,62296,3,3,6,6,6,8
2023-06-01,202910,1,0,1,1,0,1
2023-06-01,64420,2,0,2,2,0,2
2023-06-01,51152,4,0,4,2,0,2
2023-06-01,44653,3,0,3,4,0,4
2023-06-01,39433,2,0,2,2,0,2
2023-06-01,39534,4,0,4,4,0,4
2023-06-01,202713,1,0,1,1,0,1
2023-06-01,199378,1,0,1,2,0,2
2023-06-01,204346,1,0,1,5,0,5
2023-06-01,49535,12,0,12,9,0,9
2023-06-01,202885,4,1,5,8,1,8
2023-06-01,205959,1,0,1,1,0,1
2023-06-01,202862,6,0,6,2,0,2
2023-06-01,34670,2,1,3,1,1,1
2023-06-01,212246,1,0,1,1,0,1
2023-06-01,61273,6,2,8,3,3,4
2023-06-01,202884,2,0,2,1,0,1
2023-06-01,202883,3,0,3,1,0,1
2023-06-01,202531,1,0,1,1,0,1
2023-06-01,202882,1,1,2,2,2,2
2023-06-01,207390,1,1,2,1,1,1
2023-06-01,202877,6,1,7,6,4,6
2023-06-01,202454,7,0,7,1,0,1
2023-06-01,202867,1,0,1,1,0,1
2023-06-01,61090,4,0,4,2,0,2
2023-06-01,61232,8,3,11,2,3,3
2023-06-01,202859,4,0,4,2,0,2
2023-06-01,202876,1,1,2,1,1,1
2023-06-01,202870,24,3,27,10,7,11
2023-06-01,202869,1,1,2,1,1,1
2023-06-01,206562,4,0,4,3,0,3
2023-06-01,211969,2,1,3,2,1,2
2023-06-01,202865,1,1,2,3,3,3
2023-06-01,202680,1,1,2,2,2,2
2023-06-01,202790,5,0,5,2,0,2
2023-06-01,206528,1,0,1,2,0,2
2023-06-01,210205,1,0,1,1,0,1
2023-06-01,47597,1,1,2,2,1,2
2023-06-01,6717,4,1,5,7,1,7
2023-06-01,202853,1,0,1,3,0,3
2023-06-01,202850,1,0,1,1,0,1
2023-06-01,212714,2,1,3,1,1,1
2023-06-01,60715,4,0,4,1,0,1
2023-06-01,202567,3,0,3,1,0,1
2023-06-01,206990,2,0,2,1,0,1
2023-06-01,205691,2,1,3,1,1,1
2023-06-01,60526,2,0,2,1,0,1
2023-06-01,202847,7,5,12,1,1,1
2023-06-01,57537,8,1,9,8,7,10
2023-06-01,202840,3,0,3,4,0,4
2023-06-01,62058,3,0,3,2,0,2
2023-06-01,52188,7,0,7,2,0,2
2023-06-01,44224,1,0,1,3,3,3
2023-06-01,5379,5,1,6,4,1,4
2023-06-01,202681,1,0,1,2,0,2
2023-06-01,203713,5,1,6,3,2,3
2023-06-01,60524,1,0,1,1,0,1
2023-06-01,204703,1,0,1,1,0,1
2023-06-01,208129,1,0,1,2,0,2
2023-06-01,212600,1,0,1,2,0,2
2023-06-01,21405,2,1,3,2,1,2
2023-06-01,56992,3,0,3,2,0,2
2023-06-01,202825,5,1,6,1,1,1
2023-06-01,49769,7,0,7,2,0,2
2023-06-01,211466,3,0,3,2,0,2
2023-06-01,202793,1,1,2,1,1,1
2023-06-01,61110,2,3,5,2,2,2
2023-06-01,207785,1,0,1,2,0,2
2023-06-01,59882,1,0,1,1,0,1
2023-06-01,212574,1,1,2,2,2,2
2023-06-01,57833,1,0,1,1,0,1
2023-06-01,202817,1,1,2,1,1,1
2023-06-01,207122,4,0,4,1,0,1
2023-06-01,58220,1,1,2,1,1,1
2023-06-01,39500,4,2,6,3,2,3
2023-06-01,43790,1,0,1,3,0,3
2023-06-01,12649,5,0,5,3,0,3
2023-06-01,206896,4,0,4,1,0,1
2023-06-01,20988,14,1,15,3,2,3
2023-06-01,202789,1,1,2,2,1,2
2023-06-01,57697,2,0,2,1,0,1
2023-06-01,202788,1,0,1,1,0,1
2023-06-01,202686,1,0,1,1,0,1
2023-06-01,202718,1,0,1,1,0,1
2023-06-01,202289,1,0,1,1,0,1
2023-06-01,202743,2,1,3,1,1,1
2023-06-01,202771,3,1,4,1,1,1
2023-06-01,202774,1,1,2,1,1,1
2023-06-01,42050,1,0,1,1,0,1
2023-06-01,272470,2,1,3,2,2,2
2023-06-01,202810,3,2,5,2,2,2
2023-06-01,202767,1,0,1,1,0,1
2023-06-01,203815,1,1,2,4,4,6
2023-06-01,204475,1,1,2,4,1,4
2023-06-01,240475,0,0,0,1,0,1
2023-06-01,204788,1,0,1,2,0,2
2023-06-01,50480,1,0,1,1,0,1
2023-06-01,206964,1,0,1,1,0,1
2023-06-01,202577,2,1,3,1,1,1
2023-06-01,213299,1,2,3,2,2,2
2023-06-01,205932,1,0,1,1,0,1
2023-06-01,202755,1,0,1,1,0,1
2023-06-01,42037,1,1,2,1,1,1
2023-06-01,205607,5,0,5,3,0,3
2023-06-01,49992,0,1,1,3,2,3
2023-06-01,202705,1,1,2,2,1,2
2023-06-01,202735,5,0,5,2,0,2
2023-06-01,202715,2,0,2,1,0,1
2023-06-01,202594,5,0,5,3,0,3
2023-06-01,52093,1,0,1,2,0,2
2023-06-01,208871,2,0,2,3,0,3
2023-06-01,202605,1,1,2,5,1,5
2023-06-01,202598,2,0,2,1,0,1
2023-06-01,202640,1,1,2,1,1,1
2023-06-01,202698,1,1,2,1,1,1
2023-06-01,206940,4,0,4,2,0,2
2023-06-01,202727,8,0,8,5,0,5
2023-06-01,207934,4,2,6,5,3,5
2023-06-01,202719,1,1,2,3,2,3
2023-06-01,202716,1,1,2,2,2,2
2023-06-01,202707,5,0,5,2,0,2
2023-06-01,19875,5,0,5,1,0,1
2023-06-01,52054,2,0,2,2,0,2
2023-06-01,56388,4,0,4,5,0,5
2023-06-01,202701,6,3,9,4,2,4
2023-06-01,200486,2,2,4,1,1,1
2023-06-01,202692,1,0,1,2,0,2
2023-06-01,48575,2,0,2,1,0,1
2023-06-01,44911,1,0,1,1,0,1
2023-06-01,9108,4,1,5,2,2,2
2023-06-01,60017,1,0,1,2,0,2
2023-06-01,206423,1,1,2,3,3,4
2023-06-01,51554,3,0,3,1,0,1
2023-06-01,207247,1,0,1,2,0,2
2023-06-01,202524,1,1,2,1,1,1
2023-06-01,202694,3,1,4,2,2,2
2023-06-01,38990,2,2,4,1,1,1
2023-06-01,207232,5,0,5,3,0,3
2023-06-01,206612,1,0,1,1,0,1
2023-06-01,51913,1,0,1,2,0,2
2023-06-01,60122,1,0,1,4,0,4
2023-06-01,204724,1,8,9,1,1,1
2023-06-01,204349,1,0,1,1,0,1
2023-06-01,202652,2,0,2,3,0,3
2023-06-01,205979,2,0,2,1,0,1
2023-06-01,202009,1,0,1,2,0,2
2023-06-01,39568,6,0,6,2,0,2
2023-06-01,204702,1,0,1,2,0,2
2023-06-01,206563,1,0,1,2,0,2
2023-06-01,202672,2,0,2,2,0,2
2023-06-01,200323,1,0,1,1,0,1
2023-06-01,202669,3,0,3,1,0,1
2023-06-01,207211,1,0,1,1,0,1
2023-06-01,51392,1,1,2,1,1,1
2023-06-01,51389,3,0,3,2,0,2
2023-06-01,61183,3,2,5,1,1,1
2023-06-01,210022,3,0,3,2,0,2
2023-06-01,198843,1,0,1,1,0,1
2023-06-01,202657,1,1,2,1,1,1
2023-06-01,206997,1,0,1,2,0,2
2023-06-01,202566,2,0,2,2,0,2
2023-06-01,206772,4,0,4,3,0,3
2023-06-01,202587,1,0,1,1,0,1
2023-06-01,51299,4,3,7,1,1,1
2023-06-01,51274,3,0,3,1,0,1
2023-06-01,206274,1,0,1,2,0,2
2023-06-01,202625,1,1,2,1,1,1
2023-06-01,205843,1,1,2,2,1,2
2023-06-01,212991,1,1,2,1,1,1
2023-06-01,213401,1,0,1,2,0,2
2023-06-01,205435,1,1,2,2,2,2
2023-06-01,202549,1,0,1,1,0,1
2023-06-01,207157,3,0,3,3,0,3
2023-06-01,51001,4,0,4,6,0,6
2023-06-01,35902,1,1,2,1,1,1
2023-06-01,50963,1,1,2,2,1,2
2023-06-01,58115,0,0,0,4,2,6
2023-06-01,50394,1,0,1,2,0,2
2023-06-01,211111,1,0,1,1,0,1
2023-06-01,202556,1,0,1,1,0,1
2023-06-01,202604,3,1,4,2,2,2
2023-06-01,211428,1,1,2,1,1,1
2023-06-01,210984,1,1,2,1,1,2
2023-06-01,202608,5,0,5,1,0,1
2023-06-01,198970,5,0,5,2,0,2
2023-06-01,64439,8,1,9,1,1,2
2023-06-01,213063,6,2,8,7,4,7
2023-06-01,209103,3,5,8,1,1,1
2023-06-01,50784,1,0,1,3,0,3
2023-06-01,202601,1,0,1,1,0,1
2023-06-01,200157,1,1,2,1,1,1
2023-06-01,48628,1,1,2,1,1,1
2023-06-01,396501,1,1,2,2,2,2
2023-06-01,202599,8,0,8,2,0,2
2023-06-01,64397,2,0,2,2,0,2
2023-06-01,202597,3,0,3,3,0,3
2023-06-01,51661,3,1,4,1,1,1
2023-06-01,42258,4,0,4,3,0,3
2023-06-01,210287,1,0,1,1,0,1
2023-06-01,35681,4,0,4,2,0,2
2023-06-01,199306,1,0,1,1,0,1
2023-06-01,202579,1,0,1,1,0,1
2023-06-01,207085,1,1,2,3,2,3
2023-06-01,57804,1,0,1,1,0,1
2023-06-01,212257,5,0,5,2,0,2
2023-06-01,202571,3,0,3,2,0,2
2023-06-01,49460,4,1,5,5,1,5
2023-06-01,213181,1,0,1,1,0,1
2023-06-01,50528,1,0,1,1,0,1
2023-06-01,207245,1,0,1,1,0,1
2023-06-01,35146,4,2,6,2,2,2
2023-06-01,202569,2,0,2,1,0,1
2023-06-01,202085,5,1,6,2,2,3
2023-06-01,31723,2,1,3,2,2,2
2023-06-01,202565,1,0,1,1,0,1
2023-06-01,206702,16,1,17,2,1,2
2023-06-01,205694,13,0,13,1,0,1
2023-06-01,212773,1,1,2,2,2,2
2023-06-01,44466,12,0,12,2,0,2
2023-06-01,207900,1,0,1,1,0,1
2023-06-01,207173,2,0,2,1,0,1
2023-06-01,207213,2,0,2,1,0,1
2023-06-01,202551,1,1,2,1,1,1
2023-06-01,205561,4,0,4,2,0,2
2023-06-01,206936,3,1,4,2,1,2
2023-06-01,64485,1,0,1,2,0,2
2023-06-01,49643,1,0,1,1,0,1
2023-06-01,48952,1,0,1,1,0,1
2023-06-01,207192,3,0,3,4,0,4
2023-06-01,49951,2,0,2,3,0,3
2023-06-01,205652,4,0,4,1,0,1
2023-06-01,210928,4,0,4,1,0,1
2023-06-01,212776,1,0,1,1,0,1
2023-06-01,207180,4,0,4,1,0,1
2023-06-01,205697,9,8,17,6,4,7
2023-06-01,64442,1,1,2,3,2,3
2023-06-01,50057,5,0,5,3,0,3
2023-06-01,207060,7,0,7,2,0,2
2023-06-01,50017,1,1,2,1,1,1
2023-06-01,48501,4,1,5,2,2,2
2023-06-01,202526,1,1,2,2,1,2
2023-06-01,49264,1,0,1,1,0,1
2023-06-01,44350,1,0,1,2,0,2
2023-06-01,207087,5,0,5,6,0,6
2023-06-01,400486,1,0,1,2,0,2
2023-06-01,50178,5,1,6,3,2,3
2023-06-01,207255,4,0,4,1,0,1
2023-06-01,208299,2,0,2,1,0,1
2023-06-01,9104,18,0,18,3,0,3
2023-06-01,207219,1,0,1,1,0,1
2023-06-01,49202,1,0,1,1,0,1
2023-06-01,201273,1,1,2,1,1,1
2023-06-01,197221,2,0,2,6,0,6
2023-06-01,207242,5,5,10,1,1,1
2023-06-01,207237,1,1,2,1,1,1
2023-06-01,207222,1,0,1,1,0,1
2023-06-01,34407,2,1,3,2,6,6
2023-06-01,207223,4,0,4,1,0,1
2023-06-01,12450,1,0,1,1,0,1
2023-06-01,34380,4,0,4,2,0,2
2023-06-01,196640,3,0,3,2,0,2
2023-06-01,207216,1,0,1,1,0,1
2023-06-01,207215,4,0,4,1,0,1
2023-06-01,64472,1,1,2,1,1,1
2023-06-01,202786,1,1,2,1,1,1
2023-06-01,205156,1,0,1,1,0,1
2023-06-01,207181,5,0,5,4,0,4
2023-06-01,207210,1,1,2,3,2,3
2023-06-01,51433,4,0,4,1,0,1
2023-06-01,58289,2,0,2,3,0,3
2023-06-01,26088,4,0,4,4,0,4
2023-06-01,64478,4,1,5,2,1,2
2023-06-01,207202,1,1,2,1,1,1
2023-06-01,207201,1,0,1,1,0,1
2023-06-01,64466,4,2,6,1,1,1
2023-06-01,207198,3,1,4,2,2,2
2023-06-01,213178,1,0,1,3,0,3
2023-06-01,205449,2,0,2,1,0,1
2023-06-01,207195,3,1,4,4,1,4
2023-06-01,207040,1,0,1,2,0,2
2023-06-01,207104,4,2,6,4,3,6
2023-06-01,49240,7,0,7,4,0,4
2023-06-01,206157,1,1,2,1,1,2
2023-06-01,212507,1,0,1,1,0,1
2023-06-01,25288,2,0,2,1,0,1
2023-06-01,207128,2,0,2,2,0,2
2023-06-01,210567,1,0,1,1,0,1
2023-06-01,207135,2,0,2,1,0,1
2023-06-01,35525,1,0,1,1,0,1
2023-06-01,207007,2,0,2,3,0,3
2023-06-01,207169,1,0,1,1,0,1
2023-06-01,47716,3,1,4,2,1,2
2023-06-01,207153,2,0,2,5,0,5
2023-06-01,34370,4,0,4,3,0,3
2023-06-01,207145,2,0,2,2,0,2
2023-06-01,64443,3,0,3,2,0,2
2023-06-01,206966,4,0,4,3,0,3
2023-06-01,206846,3,0,3,5,0,5
2023-06-01,206878,2,0,2,1,0,1
2023-06-01,206657,21,0,21,2,0,2
2023-06-01,206942,3,0,3,3,0,3
2023-06-01,207141,6,0,6,1,0,1
2023-06-01,212763,3,0,3,4,0,4
2023-06-01,44188,1,0,1,1,0,1
2023-06-01,50264,5,0,5,4,0,4
2023-06-01,64434,2,0,2,1,0,1
2023-06-01,64428,4,0,4,1,0,1
2023-06-01,203248,2,0,2,1,0,1
2023-06-01,49597,4,0,4,2,0,2
2023-06-01,207151,5,0,5,2,0,2
2023-06-01,206464,1,0,1,3,0,3
2023-06-01,206512,2,0,2,1,0,1
2023-06-01,207022,2,0,2,1,0,1
2023-06-01,59620,4,0,4,3,0,3
2023-06-01,207112,4,0,4,2,0,2
2023-06-01,207125,3,0,3,2,0,2
2023-06-01,42240,1,1,2,1,3,3
2023-06-01,206961,5,0,5,2,0,2
2023-06-01,64431,1,0,1,1,0,1
2023-06-01,50497,1,0,1,1,0,1
2023-06-01,207014,3,0,3,1,0,1
2023-06-01,59924,1,0,1,1,0,1
2023-06-01,206370,1,0,1,2,0,2
2023-06-01,207102,5,0,5,1,0,1
2023-06-01,207032,1,0,1,1,0,1
2023-06-01,56788,1,0,1,1,0,1
2023-06-01,207100,1,0,1,2,0,2
2023-06-01,13302,3,0,3,3,0,3
2023-06-01,20514,4,1,5,1,1,1
2023-06-01,207096,4,1,5,2,1,2
2023-06-01,206730,1,1,2,2,3,3
2023-06-01,207095,3,0,3,3,0,3
2023-06-01,52052,6,1,7,2,1,2
2023-06-01,207038,1,1,2,2,2,2
2023-06-01,21466,8,1,9,3,2,3
2023-06-01,209051,1,0,1,1,0,1
2023-06-01,202319,1,0,1,1,0,1
2023-06-01,64414,2,0,2,2,0,2
2023-06-01,207068,1,0,1,1,0,1
2023-06-01,207074,1,0,1,1,0,1
2023-06-01,207072,1,1,2,1,1,1
2023-06-01,205068,1,1,2,2,2,2
2023-06-01,64403,1,0,1,3,0,3
2023-06-01,49222,4,3,7,2,2,2
2023-06-01,207541,1,1,2,1,1,1
2023-06-01,207322,3,1,4,3,1,3
2023-06-01,43817,1,0,1,1,0,1
2023-06-01,49796,5,0,5,3,0,3
2023-06-01,207058,4,0,4,3,0,3
2023-06-01,207057,2,0,2,1,0,1
2023-06-01,209138,5,0,5,4,0,4
2023-06-01,61386,5,0,5,2,0,2
2023-06-01,202933,3,0,3,1,0,1
2023-06-01,49257,5,0,5,4,0,4
2023-06-01,203687,3,1,4,7,5,7
2023-06-01,60689,4,2,6,1,1,1
2023-06-01,44071,3,0,3,6,0,6
2023-06-01,51344,1,1,2,1,1,1
2023-06-01,48690,2,0,2,5,0,5
2023-06-01,207042,4,1,5,2,2,2
2023-06-01,213317,1,1,2,3,2,3
2023-06-01,213308,1,0,1,1,0,1
2023-06-01,213101,1,1,2,3,2,3
2023-06-01,42186,6,0,6,1,0,1
2023-06-01,207018,3,0,3,3,0,3
2023-06-01,207034,1,0,1,1,0,1
2023-06-01,207031,1,1,2,1,1,1
2023-06-01,206952,1,0,1,1,0,1
2023-06-01,28674,8,3,11,2,1,2
2023-06-01,207028,4,4,8,1,2,2
2023-06-01,206778,2,0,2,1,0,1
2023-06-01,207026,1,1,2,1,1,1
2023-06-01,203263,2,0,2,4,0,4
2023-06-01,206581,1,0,1,4,0,4
2023-06-01,44926,1,0,1,1,0,1
2023-06-01,47735,1,0,1,1,0,1
2023-06-01,207013,3,1,4,6,1,6
2023-06-01,51892,2,2,4,3,1,4
2023-06-01,207016,1,0,1,2,0,2
2023-06-01,207017,1,0,1,2,0,2
2023-06-01,204521,2,0,2,2,0,2
2023-06-01,213319,1,1,2,2,2,2
2023-06-01,18708,4,0,4,3,0,3
2023-06-01,206933,1,0,1,1,0,1
2023-06-01,206497,5,1,6,3,2,3
2023-06-01,205930,1,1,2,2,1,2
2023-06-01,206799,3,1,4,2,2,2
2023-06-01,31537,2,0,2,1,0,1
2023-06-01,200190,1,0,1,2,0,2
2023-06-01,206958,2,0,2,2,0,2
2023-06-01,207002,2,0,2,1,0,1
2023-06-01,207001,1,0,1,1,0,1
2023-06-01,395855,8,0,8,2,0,2
2023-06-01,207139,1,0,1,1,0,1
2023-06-01,49898,4,1,5,2,1,2
2023-06-01,206993,9,0,9,4,0,4
2023-06-01,206979,1,0,1,2,0,2
2023-06-01,13012,2,1,3,3,3,3
2023-06-01,29008,2,1,3,4,3,4
2023-06-01,206984,2,1,3,1,1,1
2023-06-01,60967,1,0,1,1,0,1
2023-06-01,50339,2,0,2,4,0,4
2023-06-01,41185,3,0,3,3,0,3
2023-06-01,206982,1,0,1,2,0,2
2023-06-01,48934,5,0,5,1,0,1
2023-06-01,49097,1,0,1,1,0,1
2023-06-01,206969,1,0,1,2,0,2
2023-06-01,209985,3,2,5,1,1,1
2023-06-01,48529,1,0,1,1,0,1
2023-06-01,48038,9,4,13,3,3,3
2023-06-01,206954,3,0,3,1,0,1
2023-06-01,206906,1,1,2,1,2,2
2023-06-01,209381,1,0,1,2,0,2
2023-06-01,211628,1,0,1,2,0,2
2023-06-01,210952,1,0,1,3,0,3
2023-06-01,211630,1,0,1,2,0,2
2023-06-01,59733,0,0,0,2,0,2
2023-06-01,62369,1,0,1,1,0,1
2023-06-01,60906,12,4,16,2,2,2
2023-06-01,206959,1,0,1,1,0,1
2023-06-01,206956,1,0,1,1,0,1
2023-06-01,206955,4,1,5,1,2,3
2023-06-01,203907,1,0,1,1,0,1
2023-06-01,206401,1,0,1,2,0,2
2023-06-01,206108,1,1,2,1,2,2
2023-06-01,206951,1,1,2,1,1,1
2023-06-01,16189,3,0,3,2,0,2
2023-06-01,206767,3,1,4,3,2,3
2023-06-01,206944,1,0,1,1,0,1
2023-06-01,206646,3,0,3,3,0,3
2023-06-01,43768,4,0,4,2,0,2
2023-06-01,61111,1,1,2,4,2,5
2023-06-01,200290,1,0,1,1,0,1
2023-06-01,206911,2,0,2,2,0,2
2023-06-01,206771,1,0,1,1,0,1
2023-06-01,206928,1,1,2,4,1,4
2023-06-01,206927,3,1,4,3,3,3
2023-06-01,34221,2,0,2,1,0,1
2023-06-01,206864,5,0,5,2,0,2
2023-06-01,48704,4,0,4,1,0,1
2023-06-01,206922,2,0,2,1,0,1
2023-06-01,206917,2,0,2,1,0,1
2023-06-01,203912,6,0,6,1,0,1
2023-06-01,48761,2,0,2,1,0,1
2023-06-01,206886,5,2,7,1,2,3
2023-06-01,206909,1,0,1,1,0,1
2023-06-01,202948,2,0,2,3,0,3
2023-06-01,206908,2,0,2,2,0,2
2023-06-01,206905,1,0,1,3,0,3
2023-06-01,206903,1,0,1,1,0,1
2023-06-01,206830,3,0,3,1,0,1
2023-06-01,8208,5,2,7,5,2,5
2023-06-01,61144,2,0,2,1,0,1
2023-06-01,208018,3,0,3,2,0,2
2023-06-01,206579,2,0,2,2,0,2
2023-06-01,206854,4,0,4,1,0,1
2023-06-01,204661,1,0,1,2,0,2
2023-06-01,206893,4,1,5,2,1,2
2023-06-01,206890,1,0,1,4,0,4
2023-06-01,12935,5,1,6,2,2,2
2023-06-01,206763,1,1,2,1,1,1
2023-06-01,206879,3,0,3,3,0,3
2023-06-01,44102,2,0,2,2,0,2
2023-06-01,206857,1,0,1,1,0,1
2023-06-01,62231,1,0,1,1,0,1
2023-06-01,57777,1,1,2,3,4,5
2023-06-01,206861,4,0,4,3,0,3
2023-06-01,206876,4,0,4,1,0,1
2023-06-01,47983,1,0,1,2,0,2
2023-06-01,206561,2,0,2,1,0,1
2023-06-01,212388,2,0,2,1,0,1
2023-06-01,206389,6,0,6,4,0,4
2023-06-01,206789,2,0,2,2,0,2
2023-06-01,60581,2,0,2,2,0,2
2023-06-01,206859,1,1,2,1,1,1
2023-06-01,47630,2,0,2,2,0,2
2023-06-01,206593,1,1,2,2,2,2
2023-06-01,206478,2,1,3,1,1,2
2023-06-01,29308,2,0,2,1,0,1
2023-06-01,202949,4,0,4,1,0,1
2023-06-01,201098,1,1,2,1,1,1
2023-06-01,206673,2,0,2,6,0,6
2023-06-01,206722,1,0,1,1,0,1
2023-06-01,209689,4,0,4,3,0,3
2023-06-01,204870,1,0,1,1,0,1
2023-06-01,206712,3,3,6,1,1,1
2023-06-01,206468,1,0,1,2,0,2
2023-06-01,206842,1,0,1,1,0,1
2023-06-01,206255,4,0,4,3,0,3
2023-06-01,210294,1,0,1,2,0,2
2023-06-01,47768,2,0,2,5,0,5
2023-06-01,34741,3,2,5,1,1,1
2023-06-01,204668,1,1,2,1,1,1
2023-06-01,211461,1,0,1,1,0,1
2023-06-01,206836,1,1,2,3,3,4
2023-06-01,206372,2,0,2,2,0,2
2023-06-01,206828,3,1,4,1,1,1
2023-06-01,204488,5,0,5,1,0,1
2023-06-01,44984,1,1,2,1,1,1
2023-06-01,212808,1,1,2,2,2,2
2023-06-01,212693,2,1,3,1,1,1
2023-06-01,35057,5,1,6,2,1,2
2023-06-01,42533,1,0,1,1,0,1
2023-06-01,44808,1,1,2,1,3,3
2023-06-01,206756,5,0,5,3,0,3
2023-06-01,62392,1,1,2,2,2,2
2023-06-01,204567,1,0,1,1,0,1
2023-06-01,206711,1,1,2,2,2,2
2023-06-01,206635,5,0,5,1,0,1
2023-06-01,206795,4,1,5,1,1,1
2023-06-01,206798,5,0,5,3,0,3
2023-06-01,206797,1,0,1,1,0,1
2023-06-01,206746,4,2,6,3,2,3
2023-06-01,21016,1,0,1,1,0,1
2023-06-01,206793,3,1,4,3,1,3
2023-06-01,211156,2,0,2,4,0,4
2023-06-01,206784,1,1,2,4,2,5
2023-06-01,206568,3,3,6,3,4,4
2023-06-01,206773,1,0,1,1,0,1
2023-06-01,206759,1,0,1,1,0,1
2023-06-01,44452,1,0,1,1,0,1
2023-06-01,206769,1,0,1,1,0,1
2023-06-01,206765,1,0,1,1,0,1
2023-06-01,208282,2,0,2,3,0,3
2023-06-01,212582,3,0,3,1,0,1
2023-06-01,206121,3,0,3,6,0,6
2023-06-01,49755,1,0,1,2,0,2
2023-06-01,206743,3,0,3,1,0,1
2023-06-01,206606,2,1,3,1,1,1
2023-06-01,206741,2,0,2,2,0,2
2023-06-01,206738,1,0,1,2,0,2
2023-06-01,206490,1,0,1,1,0,1
2023-06-01,212520,1,2,3,1,1,1
2023-06-01,60729,3,3,6,6,5,6
2023-06-01,209246,1,0,1,3,0,3
2023-06-01,50770,1,0,1,1,0,1
2023-06-01,206693,13,0,13,4,0,4
2023-06-01,206196,1,0,1,2,0,2
2023-06-01,206508,4,0,4,2,0,2
2023-06-01,212676,1,0,1,1,0,1
2023-06-01,212606,1,0,1,1,0,1
2023-06-01,212089,1,0,1,1,0,1
2023-06-01,47490,2,2,4,1,2,2
2023-06-01,39485,2,1,3,1,2,2
2023-06-01,206701,8,0,8,2,0,2
2023-06-01,20592,3,1,4,4,1,4
2023-06-01,44243,2,0,2,2,0,2
2023-06-01,206709,1,0,1,1,0,1
2023-06-01,21182,4,1,5,1,1,1
2023-06-01,206697,5,0,5,3,0,3
2023-06-01,206377,1,1,2,1,1,1
2023-06-01,206398,1,1,2,1,1,1
2023-06-01,206692,5,0,5,3,0,3
2023-06-01,210927,1,0,1,1,0,1
2023-06-01,44199,2,0,2,2,0,2
2023-06-01,206682,4,0,4,1,0,1
2023-06-01,208143,1,2,3,1,2,2
2023-06-01,201922,1,2,3,2,2,3
2023-06-01,204102,2,0,2,4,0,4
2023-06-01,201255,1,0,1,1,0,1
2023-06-01,206309,1,0,1,2,0,2
2023-06-01,206677,4,4,8,3,1,3
2023-06-01,208568,1,0,1,3,0,3
2023-06-01,29453,0,0,0,2,0,2
2023-06-01,206674,1,0,1,3,0,3
2023-06-01,205871,1,0,1,2,0,2
2023-06-01,206672,1,1,2,2,2,2
2023-06-01,206669,5,0,5,1,0,1
2023-06-01,203203,4,2,6,4,2,5
2023-06-01,207344,1,0,1,3,0,3
2023-06-01,207092,3,1,4,6,2,7
2023-06-01,200348,1,0,1,3,0,3
2023-06-01,212269,2,0,2,2,0,2
2023-06-01,212668,1,0,1,1,0,1
2023-06-01,206668,4,0,4,3,0,3
2023-06-01,206667,5,2,7,2,2,2
2023-06-01,206651,1,0,1,1,0,1
2023-06-01,206642,4,0,4,2,0,2
2023-06-01,24823,13,0,13,6,0,6
2023-06-01,44108,4,0,4,1,0,1
2023-06-01,206656,1,1,2,1,1,1
2023-06-01,57182,1,0,1,3,0,3
2023-06-01,43676,2,0,2,4,0,4
2023-06-01,210526,1,0,1,1,0,1
2023-06-01,212438,1,0,1,2,0,2
2023-06-01,213024,1,0,1,2,0,2
2023-06-01,206078,4,0,4,2,0,2
2023-06-01,62061,1,0,1,1,0,1
2023-06-01,209704,2,0,2,1,0,1
2023-06-01,206641,5,0,5,1,0,1
2023-06-01,206643,1,0,1,2,0,2
2023-06-01,206640,1,0,1,2,0,2
2023-06-01,29400,14,0,14,3,0,3
2023-06-01,206598,2,0,2,2,0,2
2023-06-01,39774,2,0,2,1,0,1
2023-06-01,206530,1,0,1,6,0,6
2023-06-01,57198,1,1,2,1,1,1
2023-06-01,206637,3,1,4,3,2,3
2023-06-01,209888,2,0,2,1,0,1
2023-06-01,213369,5,0,5,5,0,5
2023-06-01,206620,7,1,8,3,2,3
2023-06-01,206624,1,1,2,1,1,1
2023-06-01,43977,6,0,6,1,0,1
2023-06-01,206619,1,0,1,1,0,1
2023-06-01,206588,5,0,5,2,0,2
2023-06-01,12564,8,0,8,2,0,2
2023-06-01,44673,1,0,1,1,0,1
2023-06-01,208433,1,0,1,2,0,2
2023-06-01,47931,2,0,2,3,0,3
2023-06-01,206591,1,0,1,1,0,1
2023-06-01,206596,5,0,5,2,0,2
2023-06-01,8859,5,0,5,12,0,12
2023-06-01,64427,2,0,2,1,0,1
2023-06-01,206605,1,1,2,1,1,1
2023-06-01,206549,1,1,2,2,2,2
2023-06-01,206678,1,0,1,1,0,1
2023-06-01,206475,1,0,1,1,0,1
2023-06-01,206602,2,0,2,3,0,3
2023-06-01,50647,4,0,4,3,0,3
2023-06-01,39212,2,2,4,2,1,2
2023-06-01,43308,1,0,1,1,0,1
2023-06-01,211340,1,0,1,1,0,1
2023-06-01,211476,1,1,2,1,1,1
2023-06-01,206589,2,1,3,2,1,2
2023-06-01,210494,1,0,1,2,0,2
2023-06-01,202903,1,0,1,1,0,1
2023-06-01,206550,1,0,1,2,0,2
2023-06-01,206553,4,0,4,3,0,3
2023-06-01,43988,1,1,2,1,1,1
2023-06-01,43924,4,0,4,3,0,3
2023-06-01,206584,1,0,1,1,0,1
2023-06-01,211104,1,0,1,1,0,1
2023-06-01,211080,1,0,1,2,0,2
2023-06-01,42687,8,0,8,4,0,4
2023-06-01,206571,1,0,1,3,0,3
2023-06-01,206556,4,0,4,3,0,3
2023-06-01,206566,1,1,2,1,1,1
2023-06-01,43886,1,1,2,5,2,5
2023-06-01,206559,2,0,2,3,0,3
2023-06-01,209308,8,0,8,1,0,1
2023-06-01,206537,2,1,3,3,1,3
2023-06-01,205790,2,2,4,4,1,4
2023-06-01,211068,1,0,1,2,0,2
2023-06-01,43677,5,0,5,2,0,2
2023-06-01,206529,1,1,2,3,1,4
2023-06-01,51952,4,0,4,3,0,3
2023-06-01,206525,4,0,4,1,0,1
2023-06-01,204371,2,0,2,3,0,3
2023-06-01,61064,1,0,1,6,0,6
2023-06-01,206454,1,0,1,2,0,2
2023-06-01,43653,2,0,2,4,0,4
2023-06-01,39535,1,1,2,1,1,1
2023-06-01,206311,1,0,1,3,0,3
2023-06-01,203690,1,1,2,3,2,3
2023-06-01,206522,3,0,3,1,0,1
2023-06-01,61365,4,0,4,1,0,1
2023-06-01,43657,3,0,3,1,0,1
2023-06-01,206520,1,1,2,1,1,1
2023-06-01,206504,1,0,1,2,0,2
2023-06-01,204784,1,0,1,1,0,1
2023-06-01,213093,2,0,2,1,0,1
2023-06-01,206009,1,0,1,1,0,1
2023-06-01,206519,2,0,2,1,0,1
2023-06-01,211336,1,0,1,1,0,1
2023-06-01,205918,1,0,1,3,0,3
2023-06-01,206007,1,0,1,1,0,1
2023-06-01,212376,1,0,1,1,0,1
2023-06-01,211098,1,0,1,2,0,2
2023-06-01,206441,1,0,1,2,0,2
2023-06-01,212605,1,0,1,1,0,1
2023-06-01,198627,1,1,2,1,1,1
2023-06-01,212828,1,2,3,6,3,6
2023-06-01,62334,7,0,7,2,0,2
2023-06-01,212653,2,1,3,1,1,2
2023-06-01,206498,2,0,2,1,0,1
2023-06-01,209635,1,1,2,2,1,2
2023-06-01,206491,1,1,2,1,1,1
2023-06-01,206418,4,0,4,1,0,1
2023-06-01,206486,1,0,1,1,0,1
2023-06-01,35301,2,0,2,1,0,1
2023-06-01,58127,3,0,3,1,0,1
2023-06-01,57091,1,0,1,1,0,1
2023-06-01,205599,1,0,1,1,0,1
2023-06-01,206472,5,0,5,3,0,3
2023-06-01,52165,4,0,4,1,0,1
2023-06-01,205854,1,0,1,2,0,2
2023-06-01,48145,2,0,2,3,0,3
2023-06-01,206318,2,1,3,1,1,1
2023-06-01,204007,4,1,5,2,1,2
2023-06-01,206467,3,0,3,2,0,2
2023-06-01,49964,1,0,1,1,0,1
2023-06-01,206466,6,1,7,2,2,2
2023-06-01,43409,3,0,3,6,0,6
2023-06-01,50103,1,0,1,1,0,1
2023-06-01,34640,1,0,1,3,0,3
2023-06-01,200639,1,3,4,1,1,1
2023-06-01,200365,0,2,2,2,6,6
2023-06-01,206421,1,0,1,4,0,4
2023-06-01,206145,1,0,1,1,0,1
2023-06-01,206397,3,0,3,1,0,1
2023-06-01,210659,1,2,3,1,1,1
2023-06-01,206456,4,0,4,3,0,3
2023-06-01,206449,4,0,4,5,0,5
2023-06-01,59889,1,1,2,1,1,1
2023-06-01,206432,1,0,1,3,0,3
2023-06-01,206438,5,1,6,2,3,3
2023-06-01,60580,3,0,3,4,0,4
2023-06-01,206429,2,2,4,1,1,1
2023-06-01,206428,1,0,1,1,0,1
2023-06-01,44033,5,1,6,3,2,4
2023-06-01,209257,1,1,2,2,1,2
2023-06-01,200393,1,1,2,1,1,1
2023-06-01,206399,5,0,5,2,0,2
2023-06-01,16235,1,0,1,1,0,1
2023-06-01,206420,2,2,4,1,1,1
2023-06-01,206414,4,0,4,2,0,2
2023-06-01,206220,1,0,1,4,0,4
2023-06-01,206002,1,1,2,1,1,2
2023-06-01,207578,2,0,2,2,0,2
2023-06-01,58152,1,0,1,1,0,1
2023-06-01,206404,1,0,1,4,0,4
2023-06-01,212907,2,0,2,1,0,1
2023-06-01,41257,1,0,1,2,0,2
2023-06-01,206406,4,0,4,2,0,2
2023-06-01,43239,1,0,1,1,0,1
2023-06-01,205971,1,0,1,1,0,1
2023-06-01,43023,1,0,1,1,0,1
2023-06-01,43170,1,0,1,1,0,1
2023-06-01,41831,1,0,1,2,0,2
2023-06-01,206391,1,0,1,1,0,1
2023-06-01,206390,1,0,1,1,0,1
2023-06-01,206310,2,1,3,2,1,2
2023-06-01,206720,9,0,9,5,0,5
2023-06-01,206527,1,0,1,1,0,1
2023-06-01,206380,1,0,1,1,0,1
2023-06-01,43231,4,0,4,2,0,2
2023-06-01,206291,1,1,2,2,2,2
2023-06-01,205829,4,0,4,1,0,1
2023-06-01,42924,1,1,2,1,1,1
2023-06-01,205225,1,0,1,2,0,2
2023-06-01,206270,1,1,2,1,1,1
2023-06-01,43211,4,0,4,1,0,1
2023-06-01,206369,1,0,1,4,0,4
2023-06-01,206374,2,2,4,2,2,3
2023-06-01,206322,4,0,4,3,0,3
2023-06-01,51030,1,0,1,1,0,1
2023-06-01,206342,1,0,1,2,0,2
2023-06-01,206194,3,0,3,2,0,2
2023-06-01,205747,4,1,5,2,1,2
2023-06-01,206265,3,0,3,1,0,1
2023-06-01,206358,4,0,4,2,0,2
2023-06-01,50925,4,0,4,1,0,1
2023-06-01,206339,2,1,3,1,1,1
2023-06-01,211555,1,0,1,2,0,2
2023-06-01,206352,12,0,12,2,0,2
2023-06-01,206333,1,0,1,2,0,2
2023-06-01,41001,3,2,5,2,2,2
2023-06-01,207162,3,0,3,3,0,3
2023-06-01,211953,2,0,2,2,0,2
2023-06-01,64482,2,0,2,1,0,1
2023-06-01,205015,3,0,3,2,0,2
2023-06-01,206331,6,8,14,1,1,1
2023-06-01,204807,1,0,1,2,0,2
2023-06-01,206328,4,0,4,1,0,1
2023-06-01,211832,1,0,1,1,0,1
2023-06-01,41220,1,0,1,1,0,1
2023-06-01,51842,1,0,1,1,0,1
2023-06-01,39697,1,0,1,1,0,1
2023-06-01,41922,10,0,10,3,0,3
2023-06-01,202241,1,0,1,3,0,3
2023-06-01,51142,3,1,4,1,1,1
2023-06-01,49016,1,0,1,1,0,1
2023-06-01,206289,4,0,4,3,0,3
2023-06-01,61379,1,0,1,2,0,2
2023-06-01,42889,1,0,1,1,0,1
2023-06-01,12812,7,1,8,4,1,4
2023-06-01,211309,1,1,2,1,1,1
2023-06-01,211468,3,0,3,2,0,2
2023-06-01,206303,1,1,2,2,2,2
2023-06-01,206298,1,1,2,1,1,1
2023-06-01,43126,1,3,4,2,2,3
2023-06-01,212637,1,1,2,1,1,1
2023-06-01,43228,2,0,2,2,0,2
2023-06-01,21140,3,1,4,4,2,4
2023-06-01,211637,1,0,1,1,0,1
2023-06-01,206287,1,0,1,1,0,1
2023-06-01,206295,7,0,7,8,0,8
2023-06-01,207132,1,0,1,1,0,1
2023-06-01,205957,2,0,2,1,0,1
2023-06-01,205513,1,0,1,1,0,1
2023-06-01,205703,2,0,2,1,0,1
2023-06-01,206135,5,0,5,1,0,1
2023-06-01,43516,3,1,4,1,1,1
2023-06-01,206268,2,1,3,1,1,1
2023-06-01,211241,1,0,1,1,0,1
2023-06-01,205922,2,0,2,2,0,2
2023-06-01,206266,5,0,5,3,0,3
2023-06-01,200948,1,0,1,1,0,1
2023-06-01,205284,4,0,4,1,0,1
2023-06-01,16298,2,1,3,9,5,11
2023-06-01,206261,1,0,1,2,0,2
2023-06-01,43129,1,1,2,1,1,1
2023-06-01,206280,1,0,1,2,0,2
2023-06-01,206278,7,0,7,1,0,1
2023-06-01,196743,2,0,2,1,0,1
2023-06-01,43532,1,1,2,1,1,1
2023-06-01,205880,1,0,1,1,0,1
2023-06-01,206147,3,1,4,3,2,3
2023-06-01,205926,3,0,3,2,0,2
2023-06-01,206231,2,1,3,3,3,3
2023-06-01,49317,2,0,2,1,0,1
2023-06-01,60942,1,0,1,1,0,1
2023-06-01,47681,1,0,1,1,0,1
2023-06-01,57004,1,0,1,1,0,1
2023-06-01,42628,1,0,1,3,0,3
2023-06-01,50151,1,0,1,3,0,3
2023-06-01,208596,1,0,1,2,0,2
2023-06-01,42990,6,0,6,2,0,2
2023-06-01,42977,3,1,4,1,2,2
2023-06-01,209299,1,0,1,1,0,1
2023-06-01,206245,1,0,1,1,0,1
2023-06-01,60167,1,1,2,3,2,3
2023-06-01,206197,3,0,3,2,0,2
2023-06-01,9182,2,1,3,3,3,3
2023-06-01,205389,1,1,2,7,5,7
2023-06-01,42945,1,0,1,2,0,2
2023-06-01,206234,2,0,2,1,0,1
2023-06-01,212453,2,0,2,3,0,3
2023-06-01,200614,1,0,1,2,0,2
2023-06-01,208444,1,1,2,3,3,5
2023-06-01,206232,5,3,8,2,2,2
2023-06-01,206137,1,1,2,2,1,2
2023-06-01,206133,1,0,1,2,0,2
2023-06-01,206094,1,0,1,3,0,3
2023-06-01,205756,2,0,2,1,0,1
2023-06-01,206219,3,0,3,2,0,2
2023-06-01,211081,1,0,1,1,0,1
2023-06-01,42398,3,0,3,2,0,2
2023-06-01,206098,1,0,1,1,0,1
2023-06-01,34541,3,0,3,3,0,3
2023-06-01,29504,1,1,2,5,2,5
2023-06-01,54990,1,1,2,1,1,2
2023-06-01,42661,1,0,1,2,0,2
2023-06-01,42913,1,0,1,5,0,5
2023-06-01,206204,2,0,2,1,0,1
2023-06-01,211797,2,0,2,1,0,1
2023-06-01,206201,2,2,4,1,3,3
2023-06-01,206200,1,0,1,1,0,1
2023-06-01,42872,3,0,3,3,0,3
2023-06-01,212645,1,0,1,1,0,1
2023-06-01,62035,1,1,2,4,3,4
2023-06-01,206181,4,0,4,5,0,5
2023-06-01,49186,2,0,2,3,0,3
2023-06-01,206187,3,0,3,1,0,1
2023-06-01,206177,5,6,11,1,1,1
2023-06-01,197869,1,1,2,3,3,3
2023-06-01,206178,1,1,2,2,1,2
2023-06-01,206754,1,2,3,1,1,1
2023-06-01,207846,1,2,3,1,2,2
2023-06-01,205517,1,0,1,1,0,1
2023-06-01,206169,2,0,2,3,0,3
2023-06-01,206168,1,1,2,1,1,1
2023-06-01,206713,3,0,3,1,0,1
2023-06-01,206062,1,0,1,1,0,1
2023-06-01,206163,8,11,19,4,1,4
2023-06-01,24995,6,1,7,7,3,7
2023-06-01,205099,2,0,2,6,5,7
2023-06-01,200274,1,0,1,3,0,3
2023-06-01,208034,5,0,5,6,0,6
2023-06-01,49775,1,0,1,1,0,1
2023-06-01,51662,2,0,2,2,0,2
2023-06-01,206143,2,0,2,2,0,2
2023-06-01,60545,1,0,1,1,0,1
2023-06-01,56803,1,1,2,2,2,3
2023-06-01,42750,1,0,1,1,0,1
2023-06-01,206046,3,0,3,3,0,3
2023-06-01,206142,2,0,2,2,0,2
2023-06-01,206102,4,0,4,2,0,2
2023-06-01,206136,1,0,1,1,0,1
2023-06-01,212696,1,1,2,3,3,3
2023-06-01,200353,4,1,5,3,1,3
2023-06-01,205976,1,1,2,1,1,1
2023-06-01,39068,1,0,1,2,0,2
2023-06-01,42696,1,0,1,2,0,2
2023-06-01,206132,1,0,1,3,0,3
2023-06-01,42686,1,1,2,1,1,2
2023-06-01,207159,1,0,1,1,0,1
2023-06-01,51415,2,0,2,2,0,2
2023-06-01,57411,2,0,2,1,0,1
2023-06-01,41022,1,0,1,1,0,1
2023-06-01,41122,1,0,1,1,0,1
2023-06-01,206120,4,0,4,1,0,1
2023-06-01,211496,3,0,3,2,0,2
2023-06-01,42624,1,0,1,1,0,1
2023-06-01,20530,3,1,4,2,2,3
2023-06-01,207584,1,0,1,1,0,1
2023-06-01,201285,3,0,3,2,0,2
2023-06-01,42658,1,0,1,3,0,3
2023-06-01,211212,2,0,2,1,0,1
2023-06-01,212583,2,0,2,3,0,3
2023-06-01,212576,1,0,1,2,0,2
2023-06-01,206110,5,0,5,1,0,1
2023-06-01,205760,1,0,1,3,0,3
2023-06-01,16065,3,1,4,2,1,2
2023-06-01,206101,4,0,4,2,0,2
2023-06-01,60593,3,0,3,1,0,1
2023-06-01,60887,1,0,1,1,0,1
2023-06-01,204686,1,0,1,1,0,1
2023-06-01,209462,1,0,1,1,0,1
2023-06-01,206091,2,0,2,1,0,1
2023-06-01,206088,5,0,5,1,0,1
2023-06-01,207006,1,1,2,1,1,1
2023-06-01,212491,1,0,1,2,0,2
2023-06-01,211076,1,0,1,2,0,2
2023-06-01,206077,8,0,8,1,0,1
2023-06-01,42133,1,0,1,3,0,3
2023-06-01,202661,1,0,1,6,0,6
2023-06-01,206021,1,1,2,2,1,2
2023-06-01,206049,6,1,7,3,2,3
2023-06-01,34285,20,0,20,5,0,5
2023-06-01,20625,2,2,4,1,1,1
2023-06-01,204511,1,0,1,1,0,1
2023-06-01,210464,1,16,17,1,1,1
2023-06-01,213151,1,5,6,6,4,7
2023-06-01,211783,4,0,4,2,0,2
2023-06-01,206060,5,0,5,3,0,3
2023-06-01,48062,1,1,2,1,1,1
2023-06-01,212316,1,0,1,1,0,1
2023-06-01,206056,1,1,2,1,1,1
2023-06-01,205925,1,1,2,3,1,3
2023-06-01,212861,1,0,1,1,0,1
2023-06-01,211941,2,0,2,3,0,3
2023-06-01,202837,4,0,4,1,0,1
2023-06-01,212553,1,0,1,1,0,1
2023-06-01,205757,2,0,2,2,0,2
2023-06-01,206043,1,0,1,1,0,1
2023-06-01,211083,1,16,17,3,6,6
2023-06-01,206040,1,0,1,1,0,1
2023-06-01,205851,1,1,2,1,1,1
2023-06-01,35051,10,0,10,2,0,2
2023-06-01,206008,1,0,1,1,0,1
2023-06-01,205633,4,0,4,2,0,2
2023-06-01,206029,4,0,4,1,0,1
2023-06-01,206010,1,1,2,2,1,2
2023-06-01,30915,2,1,3,2,1,2
2023-06-01,201636,1,0,1,1,0,1
2023-06-01,206022,4,0,4,5,0,5
2023-06-01,205622,1,0,1,1,0,1
2023-06-01,49934,1,0,1,3,0,3
2023-06-01,60987,2,2,4,1,1,1
2023-06-01,203605,4,3,7,6,5,6
2023-06-01,56859,1,1,2,1,1,2
2023-06-01,203932,1,1,2,5,3,5
2023-06-01,201543,3,1,4,2,1,2
2023-06-01,205985,3,0,3,5,0,5
2023-06-01,205997,2,0,2,1,0,1
2023-06-01,208571,3,1,4,2,2,2
2023-06-01,205968,1,0,1,1,0,1
2023-06-01,207681,2,0,2,1,0,1
2023-06-01,135004,2,0,2,1,0,1
2023-06-01,42603,1,0,1,1,0,1
2023-06-01,25585,2,0,2,3,0,3
2023-06-01,42035,1,1,2,1,1,1
2023-06-01,205992,5,2,7,2,1,2
2023-06-01,56548,2,0,2,1,0,1
2023-06-01,201584,1,0,1,2,0,2
2023-06-01,41955,4,2,6,2,2,2
2023-06-01,205443,1,0,1,3,0,3
2023-06-01,42593,1,0,1,1,0,1
2023-06-01,56923,4,0,4,5,0,5
2023-06-01,205961,1,1,2,1,1,1
2023-06-01,205783,2,0,2,4,0,4
2023-06-01,205988,2,2,4,3,2,4
2023-06-01,205982,1,0,1,1,0,1
2023-06-01,205704,5,0,5,2,0,2
2023-06-01,205507,2,0,2,1,0,1
2023-06-01,57371,4,0,4,3,0,3
2023-06-01,205963,5,0,5,5,0,5
2023-06-01,34146,4,1,5,1,1,1
2023-06-01,58265,3,0,3,3,0,3
2023-06-01,205514,2,0,2,3,0,3
2023-06-01,205928,5,0,5,3,0,3
2023-06-01,209841,1,0,1,1,0,1
2023-06-01,42178,1,0,1,1,0,1
2023-06-01,205217,1,0,1,1,0,1
2023-06-01,205904,1,0,1,1,0,1
2023-06-01,205943,3,1,4,12,1,12
2023-06-01,205945,3,0,3,3,0,3
2023-06-01,205366,3,0,3,2,0,2
2023-06-01,207739,1,0,1,2,0,2
2023-06-01,205935,4,0,4,2,0,2
2023-06-01,50560,3,1,4,1,1,1
2023-06-01,205940,2,1,3,2,2,2
2023-06-01,205803,1,0,1,2,0,2
2023-06-01,42373,2,0,2,3,0,3
2023-06-01,202345,2,0,2,1,0,1
2023-06-01,44241,1,1,2,2,2,2
2023-06-01,211084,1,1,2,4,3,5
2023-06-01,42871,1,0,1,1,0,1
2023-06-01,205921,1,0,1,1,0,1
2023-06-01,205916,2,2,4,5,4,5
2023-06-01,205842,4,0,4,1,0,1
2023-06-01,205913,3,0,3,3,0,3
2023-06-01,210333,3,0,3,7,0,7
2023-06-01,212551,2,0,2,3,0,3
2023-06-01,51658,1,1,2,3,1,3
2023-06-01,208650,2,2,4,3,3,3
2023-06-01,42411,13,2,15,4,2,4
2023-06-01,42383,1,1,2,1,1,1
2023-06-01,57129,1,1,2,3,1,3
2023-06-01,205875,2,0,2,2,0,2
2023-06-01,42333,1,0,1,3,0,3
2023-06-01,208354,5,0,5,3,0,3
2023-06-01,205689,1,1,2,5,4,7
2023-06-01,21459,6,0,6,3,0,3
2023-06-01,15663,20,1,21,3,1,3
2023-06-01,212549,1,0,1,1,0,1
2023-06-01,39910,1,2,3,2,2,2
2023-06-01,205412,3,1,4,2,2,2
2023-06-01,211894,1,3,4,1,1,1
2023-06-01,207020,2,1,3,1,1,1
2023-06-01,34727,1,0,1,1,0,1
2023-06-01,205863,2,0,2,1,0,1
2023-06-01,205837,3,0,3,3,0,3
2023-06-01,205877,4,0,4,2,0,2
2023-06-01,62976,3,0,3,1,0,1
2023-06-01,209379,1,1,2,1,3,3
2023-06-01,57335,2,0,2,1,0,1
2023-06-01,62299,2,0,2,2,0,2
2023-06-01,205856,1,1,2,4,3,5
2023-06-01,48904,4,1,5,3,1,3
2023-06-01,61961,1,2,3,1,1,2
2023-06-01,205864,4,0,4,4,0,4
2023-06-01,42259,2,0,2,2,0,2
2023-06-01,205832,1,0,1,1,0,1
2023-06-01,205862,4,4,8,3,2,3
2023-06-01,60012,1,0,1,1,0,1
2023-06-01,205852,2,0,2,1,0,1
2023-06-01,205850,1,0,1,3,0,3
2023-06-01,210759,3,1,4,1,1,1
2023-06-01,39019,2,0,2,1,0,1
2023-06-01,42218,2,1,3,1,1,1
2023-06-01,205844,1,0,1,1,0,1
2023-06-01,213128,3,0,3,1,0,1
2023-06-01,209163,1,1,2,2,2,2
2023-06-01,201901,1,1,2,1,1,1
2023-06-01,28979,4,2,6,8,4,9
2023-06-01,204998,1,0,1,1,0,1
2023-06-01,211204,4,0,4,1,0,1
2023-06-01,204734,1,0,1,1,0,1
2023-06-01,59771,6,2,8,2,1,2
2023-06-01,205823,11,0,11,1,0,1
2023-06-01,205821,1,0,1,1,0,1
2023-06-01,205822,4,0,4,2,0,2
2023-06-01,210909,1,1,2,2,2,2
2023-06-01,212140,3,0,3,3,0,3
2023-06-01,201990,3,0,3,7,0,7
2023-06-01,205797,5,0,5,3,0,3
2023-06-01,139704,1,0,1,1,0,1
2023-06-01,205706,1,0,1,3,0,3
2023-06-01,206881,3,0,3,1,0,1
2023-06-01,207047,4,0,4,2,0,2
2023-06-01,212297,1,1,2,2,2,2
2023-06-01,212484,1,0,1,2,0,2
2023-06-01,205236,4,1,5,2,2,2
2023-06-01,29097,3,1,4,5,4,5
2023-06-01,212686,4,1,5,3,3,3
2023-06-01,205693,3,0,3,2,0,2
2023-06-01,205559,3,0,3,3,0,3
2023-06-01,42217,3,1,4,2,2,2
2023-06-01,39124,1,0,1,2,0,2
2023-06-01,60089,1,0,1,1,0,1
2023-06-01,205796,1,0,1,1,0,1
2023-06-01,212499,1,1,2,2,2,2
2023-06-01,6665,6,0,6,2,0,2
2023-06-01,205780,6,0,6,2,0,2
2023-06-01,205800,4,0,4,3,0,3
2023-06-01,61351,1,1,2,1,1,1
2023-06-01,205793,1,0,1,3,0,3
2023-06-01,205787,4,1,5,1,1,1
2023-06-01,42207,3,3,6,4,2,4
2023-06-01,42202,1,1,2,1,1,1
2023-06-01,64475,4,5,9,11,9,13
2023-06-01,201703,2,0,2,2,0,2
2023-06-01,211075,1,1,2,3,3,3
2023-06-01,57419,1,0,1,1,0,1
2023-06-01,199889,1,0,1,1,0,1
2023-06-01,199445,1,0,1,1,0,1
2023-06-01,209197,1,0,1,1,0,1
2023-06-01,205768,1,0,1,2,0,2
2023-06-01,205643,5,0,5,2,0,2
2023-06-01,205737,2,0,2,2,0,2
2023-06-01,12630,2,1,3,3,3,3
2023-06-01,58255,5,1,6,2,1,2
2023-06-01,205763,4,1,5,2,1,2
2023-06-01,42140,5,0,5,1,0,1
2023-06-01,41232,1,0,1,1,0,1
2023-06-01,205755,4,1,5,1,1,1
2023-06-01,41366,1,2,3,1,1,1
2023-06-01,205743,1,0,1,1,0,1
2023-06-01,205746,4,0,4,3,0,3
2023-06-01,205726,3,5,8,2,2,2
2023-06-01,205721,1,0,1,2,0,2
2023-06-01,205739,4,1,5,2,2,2
2023-06-01,48001,1,0,1,1,0,1
2023-06-01,42083,3,0,3,2,0,2
2023-06-01,205732,1,0,1,2,0,2
2023-06-01,205730,1,0,1,1,0,1
2023-06-01,205728,1,1,2,3,3,4
2023-06-01,210771,6,0,6,3,0,3
2023-06-01,49273,52,1,53,2,1,2
2023-06-01,205484,1,0,1,2,0,2
2023-06-01,205710,4,0,4,1,0,1
2023-06-01,209804,1,0,1,1,0,1
2023-06-01,212323,1,1,2,2,2,2
2023-06-01,210460,1,1,2,1,1,1
2023-06-01,57999,5,0,5,5,0,5
2023-06-01,212407,1,0,1,1,0,1
2023-06-01,207193,5,0,5,1,0,1
2023-06-01,205702,1,0,1,1,0,1
2023-06-01,205580,1,0,1,2,0,2
2023-06-01,42011,1,1,2,1,1,1
2023-06-01,205688,1,1,2,1,1,1
2023-06-01,205680,3,0,3,3,0,3
2023-06-01,41839,2,0,2,2,0,2
2023-06-01,205687,1,0,1,1,0,1
2023-06-01,205698,0,0,0,2,0,2
2023-06-01,41876,4,0,4,2,0,2
2023-06-01,205665,1,0,1,1,0,1
2023-06-01,212401,1,1,2,2,1,2
2023-06-01,212399,1,1,2,1,1,1
2023-06-01,210265,1,0,1,2,0,2
2023-06-01,205674,1,0,1,4,0,4
2023-06-01,12762,4,2,6,3,2,3
2023-06-01,210742,3,0,3,2,0,2
2023-06-01,41821,1,1,2,1,1,1
2023-06-01,205673,3,0,3,1,0,1
2023-06-01,205666,4,0,4,1,0,1
2023-06-01,204945,3,3,6,2,2,2
2023-06-01,210924,2,0,2,1,0,1
2023-06-01,13274,2,0,2,1,0,1
2023-06-01,212394,1,0,1,1,0,1
2023-06-01,39307,2,0,2,2,0,2
2023-06-01,205653,2,0,2,1,0,1
2023-06-01,51377,1,0,1,1,0,1
2023-06-01,205831,2,1,3,1,1,1
2023-06-01,49432,1,1,2,1,1,1
2023-06-01,41306,3,1,4,1,2,2
2023-06-01,205654,8,0,8,4,0,4
2023-06-01,35398,2,0,2,1,0,1
2023-06-01,207520,2,0,2,3,0,3
2023-06-01,56883,1,1,2,1,1,1
2023-06-01,205620,12,0,12,7,0,7
2023-06-01,210938,1,0,1,1,0,1
2023-06-01,59794,9,0,9,3,0,3
2023-06-01,15415,5,2,7,2,1,2
2023-06-01,41779,1,1,2,4,3,4
2023-06-01,205562,1,0,1,3,0,3
2023-06-01,205636,1,0,1,1,0,1
2023-06-01,205767,1,0,1,2,0,2
2023-06-01,205637,3,0,3,2,0,2
2023-06-01,49573,1,1,2,1,1,1
2023-06-01,205619,1,0,1,1,0,1
2023-06-01,44203,1,0,1,1,0,1
2023-06-01,205571,1,0,1,1,0,1
2023-06-01,210710,4,0,4,1,0,1
2023-06-01,398456,1,0,1,2,0,2
2023-06-01,62071,1,0,1,3,0,3
2023-06-01,50138,1,0,1,3,0,3
2023-06-01,204421,1,0,1,1,0,1
2023-06-01,57212,4,0,4,3,0,3
2023-06-01,29200,1,1,2,1,1,1
2023-06-01,208819,1,1,2,1,1,1
2023-06-01,205604,4,0,4,6,0,6
2023-06-01,210191,1,0,1,1,0,1
2023-06-01,394485,2,1,3,1,1,1
2023-06-01,205612,3,0,3,3,0,3
2023-06-01,209934,1,0,1,3,0,3
2023-06-01,35153,1,0,1,1,0,1
2023-06-01,205606,2,0,2,2,0,2
2023-06-01,139242,1,1,2,1,1,2
2023-06-01,200314,3,0,3,4,0,4
2023-06-01,204462,1,0,1,1,0,1
2023-06-01,43791,4,0,4,2,0,2
2023-06-01,39230,2,0,2,4,0,4
2023-06-01,42088,1,0,1,2,0,2
2023-06-01,204685,1,0,1,3,0,3
2023-06-01,205588,2,1,3,2,1,2
2023-06-01,43229,3,0,3,1,0,1
2023-06-01,34191,5,1,6,3,3,3
2023-06-01,203215,5,2,7,6,5,6
2023-06-01,41645,1,2,3,1,1,1
2023-06-01,205583,4,2,6,2,2,2
2023-06-01,205572,1,1,2,6,4,7
2023-06-01,204546,1,0,1,4,0,4
2023-06-01,41525,2,0,2,1,0,1
2023-06-01,205556,5,0,5,1,0,1
2023-06-01,211682,1,0,1,2,0,2
2023-06-01,211067,1,0,1,1,0,1
2023-06-01,205568,4,0,4,2,0,2
2023-06-01,208056,2,0,2,4,0,4
2023-06-01,395901,2,0,2,2,0,2
2023-06-01,205565,1,1,2,1,1,1
2023-06-01,205564,4,0,4,2,0,2
2023-06-01,41531,1,0,1,1,0,1
2023-06-01,205558,1,1,2,1,1,1
2023-06-01,212638,1,0,1,3,0,3
2023-06-01,205525,1,0,1,1,0,1
2023-06-01,205555,3,1,4,3,3,4
2023-06-01,212851,1,0,1,2,0,2
2023-06-01,56894,1,1,2,2,3,3
2023-06-01,41488,3,0,3,3,0,3
2023-06-01,205538,2,0,2,1,0,1
2023-06-01,44330,2,1,3,2,1,2
2023-06-01,48351,1,0,1,1,0,1
2023-06-01,60240,1,2,3,1,1,1
2023-06-01,207974,2,4,6,2,2,2
2023-06-01,205545,1,0,1,1,0,1
2023-06-01,205164,1,0,1,1,0,1
2023-06-01,205496,5,1,6,2,1,2
2023-06-01,205543,1,1,2,3,1,3
2023-06-01,61263,1,0,1,1,0,1
2023-06-01,211454,1,2,3,3,2,3
2023-06-01,41391,0,1,1,3,1,3
2023-06-01,205536,1,0,1,1,0,1
2023-06-01,205519,4,0,4,3,0,3
2023-06-01,205461,2,0,2,2,0,2
2023-06-01,60080,1,0,1,1,0,1
2023-06-01,209959,1,0,1,1,0,1
2023-06-01,205518,1,0,1,1,0,1
2023-06-01,212368,1,0,1,2,0,2
2023-06-01,51381,1,0,1,1,0,1
2023-06-01,56395,1,0,1,1,0,1
2023-06-01,205521,3,0,3,2,0,2
2023-06-01,41415,5,0,5,3,0,3
2023-06-01,205490,4,0,4,1,0,1
2023-06-01,210770,1,1,2,1,1,1
2023-06-01,205493,1,1,2,4,2,4
2023-06-01,24861,3,2,5,1,1,1
2023-06-01,208006,3,0,3,1,0,1
2023-06-01,205510,1,0,1,2,0,2
2023-06-01,56438,1,0,1,1,0,1
2023-06-01,213150,1,1,2,2,2,2
2023-06-01,61099,1,0,1,1,0,1
2023-06-01,211470,1,0,1,1,0,1
2023-06-01,209464,5,0,5,1,0,1
2023-06-01,8892,2,1,3,4,1,4
2023-06-01,205504,2,1,3,4,2,4
2023-06-01,213004,5,0,5,3,0,3
2023-06-01,205319,3,0,3,3,0,3
2023-06-01,209254,4,0,4,1,0,1
2023-06-01,205457,1,0,1,1,0,1
2023-06-01,207540,2,0,2,4,0,4
2023-06-01,205338,5,0,5,1,0,1
2023-06-01,205428,1,0,1,1,0,1
2023-06-01,39744,3,0,3,1,0,1
2023-06-01,39503,1,0,1,1,0,1
2023-06-01,47929,1,0,1,3,0,3
2023-06-01,209989,1,0,1,1,0,1
2023-06-01,213251,1,1,2,1,1,1
2023-06-01,51586,2,2,4,1,1,1
2023-06-01,210803,1,0,1,3,0,3
2023-06-01,41338,1,0,1,2,0,2
2023-06-01,205437,2,0,2,1,0,1
2023-06-01,211482,3,0,3,2,0,2
2023-06-01,210569,1,0,1,2,0,2
2023-06-01,212346,2,0,2,2,0,2
2023-06-01,200476,1,0,1,2,0,2
2023-06-01,205477,1,1,2,2,2,2
2023-06-01,212223,1,0,1,2,0,2
2023-06-01,41303,1,0,1,2,0,2
2023-06-01,205470,2,0,2,1,0,1
2023-06-01,57407,2,2,4,3,4,4
2023-06-01,204429,4,0,4,1,0,1
2023-06-01,205281,1,0,1,1,0,1
2023-06-01,212324,1,1,2,1,1,1
2023-06-01,212321,1,3,4,3,3,3
2023-06-01,56509,1,0,1,1,0,1
2023-06-01,44874,1,1,2,1,1,2
2023-06-01,8720,27,0,27,3,0,3
2023-06-01,57852,3,0,3,2,0,2
2023-06-01,205462,3,0,3,2,0,2
2023-06-01,205174,2,0,2,1,0,1
2023-06-01,201931,1,1,2,1,1,2
2023-06-01,205321,2,2,4,1,1,1
2023-06-01,56636,3,0,3,3,0,3
2023-06-01,203092,1,0,1,1,0,1
2023-06-01,205452,3,1,4,1,1,1
2023-06-01,204824,2,0,2,3,0,3
2023-06-01,211577,1,0,1,1,0,1
2023-06-01,49764,1,0,1,2,0,2
2023-06-01,204586,3,1,4,1,3,3
2023-06-01,34735,2,0,2,1,0,1
2023-06-01,210963,1,0,1,2,0,2
2023-06-01,211457,1,0,1,1,0,1
2023-06-01,205439,1,1,2,1,1,1
2023-06-01,58261,1,0,1,1,0,1
2023-06-01,205440,1,0,1,1,0,1
2023-06-01,205419,4,0,4,4,0,4
2023-06-01,209909,1,0,1,1,0,1
2023-06-01,210698,2,0,2,1,0,1
2023-06-01,207003,2,3,5,4,3,4
2023-06-01,42357,3,1,4,2,1,2
2023-06-01,212038,1,1,2,2,1,2
2023-06-01,209233,1,0,1,3,0,3
2023-06-01,45017,1,0,1,2,0,2
2023-06-01,205215,2,0,2,1,0,1
2023-06-01,12483,13,0,13,3,0,3
2023-06-01,202514,5,0,5,2,0,2
2023-06-01,211830,1,0,1,1,0,1
2023-06-01,205253,1,0,1,1,0,1
2023-06-01,35479,7,0,7,3,0,3
2023-06-01,205372,1,0,1,1,0,1
2023-06-01,205409,4,0,4,1,0,1
2023-06-01,205311,3,2,5,1,1,1
2023-06-01,204499,4,0,4,1,0,1
2023-06-01,204949,1,0,1,5,0,5
2023-06-01,203586,1,0,1,1,0,1
2023-06-01,205033,1,1,2,2,1,2
2023-06-01,205390,5,1,6,3,3,3
2023-06-01,212547,3,3,6,3,3,3
2023-06-01,205386,2,0,2,1,0,1
2023-06-01,205385,5,1,6,5,3,5
2023-06-01,202509,1,1,2,2,2,2
2023-06-01,49114,1,0,1,1,0,1
2023-06-01,212282,1,0,1,1,0,1
2023-06-01,205375,4,0,4,1,0,1
2023-06-01,60206,0,0,0,2,0,2
2023-06-01,205100,1,6,7,1,4,4
2023-06-01,205371,4,0,4,4,0,4
2023-06-01,212911,1,1,2,4,1,4
2023-06-01,205348,1,0,1,1,0,1
2023-06-01,205354,4,0,4,2,0,2
2023-06-01,206360,1,0,1,1,0,1
2023-06-01,58119,1,0,1,3,0,3
2023-06-01,205376,7,2,9,3,3,3
2023-06-01,205335,5,0,5,1,0,1
2023-06-01,205377,1,1,2,2,3,3
2023-06-01,205373,5,5,10,3,3,3
2023-06-01,205367,5,0,5,1,0,1
2023-06-01,24956,4,2,6,3,3,3
2023-06-01,41359,1,0,1,1,0,1
2023-06-01,213329,1,0,1,1,0,1
2023-06-01,205310,5,1,6,3,2,3
2023-06-01,205752,1,0,1,1,0,1
2023-06-01,205360,1,1,2,1,1,1
2023-06-01,205274,1,0,1,1,0,1
2023-06-01,206087,4,4,8,3,5,5
2023-06-01,205238,1,0,1,1,0,1
2023-06-01,205929,1,2,3,2,3,3
2023-06-01,58051,1,0,1,1,0,1
2023-06-01,206998,2,0,2,2,0,2
2023-06-01,200534,1,0,1,3,0,3
2023-06-01,205345,1,1,2,1,1,1
2023-06-01,205337,5,0,5,1,0,1
2023-06-01,199546,1,0,1,1,0,1
2023-06-01,210080,1,0,1,1,0,1
2023-06-01,62306,1,0,1,1,0,1
2023-06-01,60502,1,0,1,1,0,1
2023-06-01,205263,2,0,2,3,0,3
2023-06-01,48784,1,0,1,2,0,2
2023-06-01,49041,2,0,2,1,0,1
2023-06-01,213054,1,1,2,4,2,5
2023-06-01,211633,1,1,2,8,3,9
2023-06-01,209442,4,0,4,3,0,3
2023-06-01,204971,1,0,1,1,0,1
2023-06-01,20612,2,2,4,4,3,4
2023-06-01,206976,3,2,5,1,1,1
2023-06-01,205265,2,2,4,1,1,1
2023-06-01,212253,1,0,1,1,0,1
2023-06-01,41068,3,0,3,1,0,1
2023-06-01,204981,4,0,4,3,0,3
2023-06-01,205313,6,0,6,7,0,7
2023-06-01,205126,4,0,4,1,0,1
2023-06-01,205316,1,1,2,1,1,1
2023-06-01,205315,1,1,2,1,1,1
2023-06-01,208286,1,0,1,1,0,1
2023-06-01,205304,1,0,1,1,0,1
2023-06-01,205270,5,0,5,2,0,2
2023-06-01,205309,5,0,5,1,0,1
2023-06-01,34950,9,0,9,1,0,1
2023-06-01,41061,7,1,8,4,1,4
2023-06-01,205306,1,0,1,2,0,2
2023-06-01,202034,1,0,1,3,0,3
2023-06-01,212782,1,1,2,1,1,1
2023-06-01,204689,3,0,3,2,0,2
2023-06-01,205173,4,0,4,3,0,3
2023-06-01,207653,1,0,1,1,0,1
2023-06-01,40987,3,0,3,6,0,6
2023-06-01,42152,2,0,2,1,0,1
2023-06-01,206436,2,1,3,1,1,1
2023-06-01,212198,1,0,1,3,0,3
2023-06-01,50198,4,0,4,2,0,2
2023-06-01,205283,4,0,4,3,0,3
2023-06-01,34422,2,1,3,3,3,3
2023-06-01,198730,1,1,2,1,1,1
2023-06-01,205197,1,0,1,1,0,1
2023-06-01,206416,1,0,1,1,0,1
2023-06-01,205279,1,0,1,1,0,1
2023-06-01,205277,5,0,5,2,0,2
2023-06-01,202411,1,0,1,1,0,1
2023-06-01,212040,1,0,1,1,0,1
2023-06-01,212098,1,1,2,1,1,1
2023-06-01,56491,5,0,5,3,0,3
2023-06-01,202397,1,0,1,1,0,1
2023-06-01,204596,1,1,2,1,1,1
2023-06-01,205114,5,0,5,3,0,3
2023-06-01,205260,1,1,2,4,3,5
2023-06-01,212195,1,0,1,2,0,2
2023-06-01,211550,1,0,1,3,0,3
2023-06-01,212160,1,0,1,1,0,1
2023-06-01,205223,1,0,1,1,0,1
2023-06-01,204959,5,0,5,2,0,2
2023-06-01,35070,5,1,6,2,1,2
2023-06-01,39934,4,0,4,1,0,1
2023-06-01,20896,4,0,4,3,0,3
2023-06-01,205250,11,2,13,1,1,1
2023-06-01,213399,2,0,2,1,0,1
2023-06-01,205244,1,0,1,1,0,1
2023-06-01,205247,1,0,1,1,0,1
2023-06-01,207803,1,5,6,5,5,6
2023-06-01,205229,1,0,1,1,0,1
2023-06-01,43442,1,1,2,3,1,3
2023-06-01,21130,5,1,6,2,2,2
2023-06-01,39050,1,1,2,1,1,1
2023-06-01,203436,1,0,1,1,0,1
2023-06-01,205552,3,0,3,2,0,2
2023-06-01,61280,6,0,6,2,0,2
2023-06-01,39895,1,0,1,2,0,2
2023-06-01,211569,1,1,2,2,1,2
2023-06-01,205119,5,1,6,2,1,2
2023-06-01,205198,1,0,1,3,0,3
2023-06-01,205149,6,0,6,4,0,4
2023-06-01,205218,1,0,1,3,0,3
2023-06-01,205202,3,5,8,4,2,5
2023-06-01,204615,2,0,2,2,0,2
2023-06-01,205205,2,0,2,2,0,2
2023-06-01,60363,3,1,4,2,1,2
2023-06-01,202067,2,0,2,1,0,1
2023-06-01,204951,1,0,1,1,0,1
2023-06-01,204912,3,0,3,1,0,1
2023-06-01,211714,1,0,1,3,0,3
2023-06-01,205213,4,0,4,1,0,1
2023-06-01,212133,1,0,1,1,0,1
2023-06-01,211814,1,0,1,1,0,1
2023-06-01,49368,4,0,4,6,0,6
2023-06-01,44024,1,17,18,1,1,1
2023-06-01,202323,1,0,1,1,0,1
2023-06-01,207627,1,1,2,2,1,2
2023-06-01,207595,1,1,2,1,1,1
2023-06-01,200450,1,0,1,1,0,1
2023-06-01,205010,1,1,2,3,1,3
2023-06-01,205053,4,1,5,1,1,1
2023-06-01,205188,1,0,1,2,0,2
2023-06-01,205110,5,0,5,4,0,4
2023-06-01,207876,5,0,5,1,0,1
2023-06-01,208106,7,3,10,2,2,2
2023-06-01,205171,3,0,3,2,0,2
2023-06-01,62092,1,0,1,1,0,1
2023-06-01,211441,2,1,3,3,1,3
2023-06-01,205190,1,1,2,1,1,1
2023-06-01,205189,2,0,2,1,0,1
2023-06-01,213177,1,0,1,1,0,1
2023-06-01,205179,1,0,1,2,0,2
2023-06-01,211664,1,0,1,2,0,2
2023-06-01,205187,1,0,1,1,0,1
2023-06-01,205181,3,0,3,3,0,3
2023-06-01,205180,1,0,1,2,0,2
2023-06-01,210159,3,0,3,1,0,1
2023-06-01,204338,1,0,1,2,0,2
2023-06-01,205153,2,0,2,3,0,3
2023-06-01,205155,1,0,1,2,0,2
2023-06-01,205176,1,0,1,1,0,1
2023-06-01,209846,5,1,6,2,2,3
2023-06-01,205168,1,0,1,2,0,2
2023-06-01,39615,4,0,4,1,0,1
2023-06-01,205146,2,0,2,3,0,3
2023-06-01,208145,1,0,1,4,0,4
2023-06-01,207789,2,0,2,1,0,1
2023-06-01,397804,1,0,1,2,0,2
2023-06-01,205169,4,0,4,4,0,4
2023-06-01,205166,1,0,1,2,0,2
2023-06-01,207495,5,0,5,3,0,3
2023-06-01,31061,2,0,2,7,0,7
2023-06-01,211177,1,0,1,1,0,1
2023-06-01,50666,1,1,2,2,1,2
2023-06-01,39736,1,1,2,1,1,1
2023-06-01,204934,2,0,2,1,0,1
2023-06-01,204319,1,1,2,1,1,1
2023-06-01,25117,12,2,14,3,2,3
2023-06-01,204781,3,0,3,2,0,2
2023-06-01,205118,1,0,1,1,0,1
2023-06-01,39659,3,0,3,2,0,2
2023-06-01,202341,1,0,1,1,0,1
2023-06-01,201670,1,1,2,1,1,1
2023-06-01,39671,5,0,5,4,0,4
2023-06-01,205120,3,0,3,2,0,2
2023-06-01,205144,1,1,2,2,1,2
2023-06-01,207715,5,1,6,5,1,5
2023-06-01,204988,1,1,2,2,2,2
2023-06-01,57263,2,0,2,5,0,5
2023-06-01,205049,4,2,6,1,1,2
2023-06-01,205692,3,0,3,2,0,2
2023-06-01,271537,1,7,8,3,4,4
2023-06-01,5581,4,0,4,1,0,1
2023-06-01,58182,7,0,7,3,0,3
2023-06-01,204515,1,1,2,2,2,2
2023-06-01,212090,1,0,1,1,0,1
2023-06-01,212078,1,0,1,1,0,1
2023-06-01,205106,4,0,4,2,0,2
2023-06-01,205098,6,0,6,2,0,2
2023-06-01,205107,1,1,2,1,1,1
2023-06-01,210065,1,0,1,2,0,2
2023-06-01,213131,1,0,1,2,0,2
2023-06-01,20541,4,0,4,1,0,1
2023-06-01,205105,5,0,5,2,0,2
2023-06-01,197412,1,0,1,1,0,1
2023-06-01,60937,1,0,1,2,0,2
2023-06-01,205067,4,0,4,2,0,2
2023-06-01,201578,1,0,1,1,0,1
2023-06-01,208741,1,1,2,1,2,2
2023-06-01,211929,1,0,1,1,0,1
2023-06-01,211937,1,0,1,3,0,3
2023-06-01,205093,3,0,3,2,0,2
2023-06-01,210350,1,0,1,5,0,5
2023-06-01,205073,4,0,4,1,0,1
2023-06-01,35657,1,0,1,5,0,5
2023-06-01,42989,2,0,2,4,0,4
2023-06-01,51201,1,0,1,1,0,1
2023-06-01,205074,3,0,3,1,0,1
2023-06-01,41659,1,0,1,1,0,1
2023-06-01,38965,2,2,4,5,4,7
2023-06-01,212076,1,0,1,1,0,1
2023-06-01,212082,1,0,1,2,0,2
2023-06-01,205075,1,0,1,1,0,1
2023-06-01,204905,1,0,1,1,0,1
2023-06-01,205057,5,0,5,1,0,1
2023-06-01,205071,3,1,4,2,1,2
2023-06-01,204970,4,2,6,2,1,2
2023-06-01,200406,5,0,5,1,0,1
2023-06-01,205055,5,1,6,1,1,1
2023-06-01,204821,6,0,6,1,0,1
2023-06-01,205041,1,0,1,2,0,2
2023-06-01,204965,3,0,3,1,0,1
2023-06-01,42106,3,0,3,1,0,1
2023-06-01,212075,1,0,1,2,0,2
2023-06-01,211982,1,0,1,1,0,1
2023-06-01,205044,1,1,2,1,3,3
2023-06-01,39556,1,0,1,1,0,1
2023-06-01,209209,1,12,13,1,5,5
2023-06-01,42397,3,0,3,1,0,1
2023-06-01,205024,1,0,1,3,0,3
2023-06-01,212020,1,0,1,1,0,1
2023-06-01,209952,1,0,1,1,0,1
2023-06-01,209385,5,5,10,4,4,4
2023-06-01,48264,4,0,4,1,0,1
2023-06-01,212428,1,0,1,1,0,1
2023-06-01,204990,1,0,1,3,0,3
2023-06-01,205894,5,0,5,4,0,4
2023-06-01,205011,1,0,1,1,0,1
2023-06-01,396886,1,0,1,3,0,3
2023-06-01,204924,1,0,1,2,0,2
2023-06-01,202283,2,2,4,2,2,2
2023-06-01,205009,3,0,3,1,0,1
2023-06-01,211989,1,1,2,1,1,1
2023-06-01,57375,1,0,1,1,0,1
2023-06-01,211999,1,0,1,3,0,3
2023-06-01,211246,1,0,1,1,0,1
2023-06-01,212836,1,0,1,1,0,1
2023-06-01,150706,1,0,1,1,0,1
2023-06-01,205002,1,1,2,1,1,1
2023-06-01,211997,1,5,6,2,1,2
2023-06-01,211807,1,0,1,1,0,1
2023-06-01,211993,1,1,2,1,1,1
2023-06-01,204920,1,2,3,2,2,2
2023-06-01,204978,1,0,1,1,0,1
2023-06-01,208756,1,0,1,1,0,1
2023-06-01,210982,1,0,1,2,0,2
2023-06-01,211054,1,1,2,1,3,4
2023-06-01,211055,1,0,1,1,0,1
2023-06-01,204964,3,0,3,2,0,2
2023-06-01,204962,1,0,1,2,0,2
2023-06-01,204974,1,0,1,1,0,1
2023-06-01,204983,1,1,2,1,1,1
2023-06-01,204986,1,0,1,1,0,1
2023-06-01,202578,2,0,2,1,0,1
2023-06-01,204975,2,2,4,1,1,1
2023-06-01,59951,2,2,4,1,1,1
2023-06-01,211987,1,1,2,1,1,1
2023-06-01,211986,1,0,1,1,0,1
2023-06-01,61355,1,0,1,1,0,1
2023-06-01,211971,1,0,1,1,0,1
2023-06-01,210114,5,0,5,2,0,2
2023-06-01,204955,2,0,2,2,0,2
2023-06-01,204400,4,0,4,1,0,1
2023-06-01,44421,1,6,7,4,4,6
2023-06-01,205651,1,2,3,1,1,1
2023-06-01,39691,3,0,3,5,0,5
2023-06-01,204940,1,0,1,2,0,2
2023-06-01,204948,3,0,3,1,0,1
2023-06-01,211288,1,1,2,1,1,1
2023-06-01,204939,1,1,2,1,1,1
2023-06-01,211957,1,0,1,1,0,1
2023-06-01,204135,2,1,3,3,2,3
2023-06-01,202124,1,0,1,1,0,1
2023-06-01,204943,1,1,2,1,1,1
2023-06-01,56442,1,0,1,1,0,1
2023-06-01,211925,1,0,1,4,0,4
2023-06-01,204925,2,0,2,4,0,4
2023-06-01,211919,1,0,1,1,0,1
2023-06-01,44794,1,1,2,4,4,6
2023-06-01,62303,3,3,6,1,1,1
2023-06-01,208321,1,1,2,1,1,1
2023-06-01,204891,3,0,3,2,0,2
2023-06-01,212413,3,0,3,2,0,2
2023-06-01,211918,1,1,2,5,2,5
2023-06-01,211494,1,1,2,1,1,1
2023-06-01,42369,3,1,4,2,4,5
2023-06-01,204411,4,0,4,2,0,2
2023-06-01,41033,3,7,10,11,28,30
2023-06-01,198636,1,1,2,1,1,1
2023-06-01,210865,1,0,1,1,0,1
2023-06-01,204922,1,0,1,3,0,3
2023-06-01,39416,2,0,2,2,0,2
2023-06-01,44475,2,0,2,2,0,2
2023-06-01,202327,1,0,1,1,0,1
2023-06-01,208902,1,0,1,1,0,1
2023-06-01,209587,1,0,1,2,0,2
2023-06-01,205600,1,1,2,3,3,3
2023-06-01,48209,15,0,15,5,0,5
2023-06-01,211773,1,0,1,3,0,3
2023-06-01,204904,4,0,4,1,0,1
2023-06-01,204903,4,2,6,5,1,5
2023-06-01,200392,1,0,1,2,0,2
2023-06-01,204899,1,0,1,2,0,2
2023-06-01,211815,1,0,1,1,0,1
2023-06-01,211064,1,0,1,2,0,2
2023-06-01,204897,1,0,1,1,0,1
2023-06-01,51834,4,1,5,2,3,3
2023-06-01,204886,1,1,2,1,1,1
2023-06-01,272713,1,1,2,6,1,6
2023-06-01,39436,4,0,4,2,0,2
2023-06-01,39430,1,0,1,2,0,2
2023-06-01,204880,1,2,3,6,5,8
2023-06-01,205487,1,0,1,1,0,1
2023-06-01,38916,2,0,2,1,0,1
2023-06-01,39419,2,1,3,2,3,4
2023-06-01,204854,4,0,4,1,0,1
2023-06-01,204865,1,0,1,2,0,2
2023-06-01,203973,1,1,2,1,1,2
2023-06-01,210939,1,1,2,1,1,1
2023-06-01,206474,3,0,3,4,0,4
2023-06-01,213068,2,4,6,1,2,2
2023-06-01,211601,1,0,1,1,0,1
2023-06-01,211598,1,1,2,1,1,1
2023-06-01,205160,1,1,2,5,2,5
2023-06-01,44409,4,0,4,1,0,1
2023-06-01,49178,2,0,2,1,0,1
2023-06-01,212310,1,0,1,2,0,2
2023-06-01,204851,5,0,5,2,0,2
2023-06-01,271521,4,1,5,1,1,1
2023-06-01,400002,1,0,1,2,0,2
2023-06-01,201027,1,0,1,3,0,3
2023-06-01,211803,1,0,1,1,0,1
2023-06-01,210751,1,0,1,1,0,1
2023-06-01,206055,2,2,4,2,2,2
2023-06-01,204809,2,1,3,4,3,4
2023-06-01,48171,5,1,6,2,1,2
2023-06-01,3287,1,0,1,1,0,1
2023-06-01,210070,3,0,3,1,0,1
2023-06-01,210896,1,2,3,1,3,3
2023-06-01,200573,3,0,3,6,0,6
2023-06-01,204811,1,0,1,1,0,1
2023-06-01,204806,3,0,3,2,0,2
2023-06-01,209550,3,0,3,2,0,2
2023-06-01,204802,1,1,2,2,1,2
2023-06-01,209080,1,0,1,2,0,2
2023-06-01,211553,1,0,1,2,0,2
2023-06-01,211368,4,0,4,1,0,1
2023-06-01,204798,2,0,2,1,0,1
2023-06-01,202354,1,0,1,1,0,1
2023-06-01,204541,1,0,1,2,0,2
2023-06-01,61282,1,1,2,2,2,2
2023-06-01,204799,1,0,1,1,0,1
2023-06-01,35349,1,0,1,2,0,2
2023-06-01,204796,3,2,5,1,1,1
2023-06-01,204795,2,0,2,1,0,1
2023-06-01,204588,4,0,4,2,0,2
2023-06-01,209034,2,0,2,1,0,1
2023-06-01,13058,8,9,17,8,6,9
2023-06-01,204317,4,0,4,3,0,3
2023-06-01,204780,4,0,4,1,0,1
2023-06-01,203188,1,0,1,4,0,4
2023-06-01,204775,1,0,1,2,0,2
2023-06-01,34871,4,0,4,4,0,4
2023-06-01,59562,1,1,2,2,1,2
2023-06-01,204772,1,1,2,4,1,4
2023-06-01,204758,4,0,4,1,0,1
2023-06-01,42296,1,0,1,1,0,1
2023-06-01,51637,1,0,1,1,0,1
2023-06-01,211160,1,0,1,1,0,1
2023-06-01,211785,1,1,2,4,3,4
2023-06-01,202308,1,0,1,3,0,3
2023-06-01,204763,1,0,1,1,0,1
2023-06-01,135489,1,0,1,1,0,1
2023-06-01,33309,5,4,9,4,3,4
2023-06-01,204476,2,0,2,1,0,1
2023-06-01,48286,1,0,1,1,0,1
2023-06-01,212023,2,1,3,2,1,2
2023-06-01,210844,1,0,1,3,0,3
2023-06-01,204760,3,1,4,1,2,2
2023-06-01,39390,2,0,2,2,0,2
2023-06-01,60901,2,0,2,2,0,2
2023-06-01,204736,4,1,5,2,2,2
2023-06-01,204700,5,0,5,6,0,6
2023-06-01,211778,1,0,1,2,0,2
2023-06-01,200748,1,1,2,5,4,5
2023-06-01,204754,4,1,5,1,1,1
2023-06-01,204751,1,1,2,3,2,3
2023-06-01,61295,1,1,2,1,1,1
2023-06-01,204731,3,5,8,3,3,3
2023-06-01,204351,1,0,1,2,0,2
2023-06-01,35404,1,0,1,1,0,1
2023-06-01,204733,1,0,1,1,0,1
2023-06-01,204565,2,0,2,2,0,2
2023-06-01,204739,1,0,1,1,0,1
2023-06-01,34611,1,0,1,1,0,1
2023-06-01,204683,3,0,3,1,0,1
2023-06-01,204737,1,0,1,1,0,1
2023-06-01,204695,5,0,5,1,0,1
2023-06-01,41331,1,0,1,1,0,1
2023-06-01,206359,1,0,1,1,0,1
2023-06-01,204517,1,0,1,1,0,1
2023-06-01,209936,3,1,4,2,2,2
2023-06-01,211735,1,0,1,1,0,1
2023-06-01,211756,1,0,1,1,0,1
2023-06-01,204690,1,3,4,1,1,1
2023-06-01,204691,1,0,1,1,0,1
2023-06-01,204716,1,0,1,1,0,1
2023-06-01,208887,3,0,3,2,0,2
2023-06-01,204591,3,1,4,2,1,2
2023-06-01,207346,1,0,1,2,0,2
2023-06-01,210776,4,1,5,1,1,1
2023-06-01,202418,1,1,2,4,3,6
2023-06-01,16167,2,0,2,1,0,1
2023-06-01,200490,1,2,3,1,3,3
2023-06-01,203038,2,2,4,2,1,2
2023-06-01,204692,1,0,1,2,0,2
2023-06-01,204698,2,0,2,1,0,1
2023-06-01,34680,1,0,1,1,0,1
2023-06-01,198926,1,0,1,1,0,1
2023-06-01,204694,3,0,3,1,0,1
2023-06-01,60283,4,0,4,2,0,2
2023-06-01,213075,2,1,3,7,2,8
2023-06-01,211727,1,1,2,3,3,4
2023-06-01,210184,2,0,2,1,0,1
2023-06-01,204664,1,1,2,1,1,1
2023-06-01,208820,5,0,5,2,0,2
2023-06-01,204651,6,0,6,4,0,4
2023-06-01,204566,5,0,5,2,0,2
2023-06-01,208042,1,0,1,1,0,1
2023-06-01,201531,1,0,1,3,0,3
2023-06-01,209920,2,0,2,4,0,4
2023-06-01,202585,1,1,2,5,3,6
2023-06-01,212000,1,0,1,1,0,1
2023-06-01,204605,1,0,1,2,0,2
2023-06-01,57309,1,0,1,1,0,1
2023-06-01,204630,2,1,3,2,2,2
2023-06-01,60552,9,0,9,7,0,7
2023-06-01,208764,3,0,3,3,0,3
2023-06-01,204642,7,0,7,1,0,1
2023-06-01,213052,1,1,2,6,3,7
2023-06-01,211145,1,0,1,1,0,1
2023-06-01,211676,1,0,1,2,0,2
2023-06-01,211541,1,5,6,2,2,2
2023-06-01,211719,1,0,1,1,0,1
2023-06-01,200887,1,1,2,2,2,2
2023-06-01,207452,1,0,1,1,0,1
2023-06-01,208175,4,5,9,4,4,4
2023-06-01,204623,1,1,2,2,2,2
2023-06-01,204616,1,0,1,1,0,1
2023-06-01,204184,1,0,1,2,0,2
2023-06-01,208976,3,2,5,3,3,4
2023-06-01,204614,1,0,1,3,0,3
2023-06-01,204599,5,0,5,1,0,1
2023-06-01,204516,2,0,2,1,0,1
2023-06-01,201117,1,0,1,1,0,1
2023-06-01,204593,3,0,3,2,0,2
2023-06-01,207316,1,0,1,1,0,1
2023-06-01,204538,1,0,1,1,0,1
2023-06-01,204542,3,0,3,3,0,3
2023-06-01,204425,1,1,2,2,2,2
2023-06-01,204562,4,1,5,1,1,1
2023-06-01,2541,2,0,2,3,0,3
2023-06-01,35577,4,0,4,3,0,3
2023-06-01,204578,1,0,1,1,0,1
2023-06-01,203128,1,0,1,1,0,1
2023-06-01,204556,4,1,5,1,1,1
2023-06-01,204579,1,0,1,1,0,1
2023-06-01,204576,6,1,7,3,3,4
2023-06-01,204560,3,1,4,1,1,1
2023-06-01,204570,1,1,2,1,1,1
2023-06-01,49475,1,1,2,1,1,1
2023-06-01,203886,2,0,2,1,0,1
2023-06-01,204932,1,0,1,2,0,2
2023-06-01,204697,1,0,1,1,0,1
2023-06-01,204564,2,0,2,1,0,1
2023-06-01,204522,4,0,4,3,0,3
2023-06-01,205805,1,0,1,3,0,3
2023-06-01,207081,2,0,2,1,0,1
2023-06-01,210131,1,0,1,1,0,1
2023-06-01,6858,2,0,2,1,0,1
2023-06-01,204498,2,0,2,1,0,1
2023-06-01,42392,3,0,3,2,0,2
2023-06-01,52144,2,1,3,1,2,2
2023-06-01,202506,1,0,1,1,0,1
2023-06-01,204473,3,0,3,1,0,1
2023-06-01,61062,1,1,2,1,1,1
2023-06-01,59493,1,1,2,1,1,1
2023-06-01,205269,1,0,1,3,0,3
2023-06-01,58277,1,0,1,1,0,1
2023-06-01,206211,2,1,3,2,1,2
2023-06-01,57933,1,1,2,1,1,1
2023-06-01,200369,1,0,1,2,0,2
2023-06-01,204426,4,1,5,1,1,1
2023-06-01,208931,2,0,2,1,0,1
2023-06-01,200308,2,1,3,3,4,4
2023-06-01,211135,1,0,1,1,0,1
2023-06-01,204468,2,0,2,2,0,2
2023-06-01,202374,1,0,1,2,0,2
2023-06-01,206524,1,0,1,1,0,1
2023-06-01,43479,4,0,4,1,0,1
2023-06-01,204464,4,0,4,1,0,1
2023-06-01,204460,1,2,3,1,1,1
2023-06-01,209214,1,0,1,1,0,1
2023-06-01,31531,5,0,5,1,0,1
2023-06-01,204634,3,0,3,2,0,2
2023-06-01,47574,1,0,1,2,0,2
2023-06-01,43704,1,0,1,1,0,1
2023-06-01,208869,1,1,2,1,2,2
2023-06-01,57722,4,1,5,1,1,1
2023-06-01,42061,4,2,6,2,1,2
2023-06-01,49436,5,4,9,3,1,3
2023-06-01,205113,1,0,1,2,0,2
2023-06-01,204439,1,0,1,2,0,2
2023-06-01,204431,3,1,4,1,1,1
2023-06-01,204352,2,0,2,2,0,2
2023-06-01,60398,8,0,8,3,0,3
2023-06-01,204409,1,0,1,4,0,4
2023-06-01,51169,1,0,1,3,0,3
2023-06-01,204419,1,1,2,4,2,4
2023-06-01,204414,1,0,1,1,0,1
2023-06-01,50476,2,2,4,2,2,2
2023-06-01,202393,1,0,1,2,0,2
2023-06-01,211599,1,0,1,1,0,1
2023-06-01,200355,3,0,3,2,0,2
2023-06-01,204403,1,1,2,3,3,3
2023-06-01,200601,2,1,3,1,1,1
2023-06-01,204366,5,0,5,1,0,1
2023-06-01,57799,4,0,4,2,0,2
2023-06-01,204368,4,0,4,1,0,1
2023-06-01,205944,3,0,3,1,0,1
2023-06-01,204394,1,1,2,4,4,5
2023-06-01,210182,2,0,2,2,0,2
2023-06-01,204391,4,0,4,2,0,2
2023-06-01,210248,1,0,1,1,0,1
2023-06-01,39278,1,0,1,1,0,1
2023-06-01,204379,1,0,1,1,0,1
2023-06-01,204386,6,0,6,2,0,2
2023-06-01,204382,1,1,2,1,1,1
2023-06-01,48611,2,4,6,1,1,1
2023-06-01,209478,4,0,4,1,0,1
2023-06-01,209397,2,0,2,1,0,1
2023-06-01,210346,5,0,5,2,0,2
2023-06-01,212800,1,0,1,3,0,3
2023-06-01,211669,1,0,1,1,0,1
2023-06-01,13068,2,0,2,4,0,4
2023-06-01,210782,1,0,1,1,0,1
2023-06-01,207440,1,0,1,1,0,1
2023-06-01,211528,1,0,1,2,0,2
2023-06-01,28883,3,0,3,1,0,1
2023-06-01,204358,5,0,5,3,0,3
2023-06-01,44028,4,0,4,2,0,2
2023-06-01,211649,1,0,1,1,0,1
2023-06-01,204376,2,0,2,3,0,3
2023-06-01,211357,1,0,1,1,0,1
2023-06-01,49233,4,0,4,2,0,2
2023-06-01,204342,2,0,2,2,0,2
2023-06-01,48992,1,1,2,2,2,2
2023-06-01,209669,1,5,6,1,4,4
2023-06-01,204354,1,0,1,1,0,1
2023-06-01,203082,4,1,5,2,2,2
2023-06-01,29661,8,0,8,3,0,3
2023-06-01,39183,1,0,1,3,0,3
2023-06-01,35176,1,0,1,1,0,1
2023-06-01,204324,2,0,2,2,0,2
2023-06-01,204344,1,1,2,2,1,2
2023-06-01,204347,1,0,1,1,0,1
2023-06-01,210304,1,0,1,1,0,1
2023-06-01,44399,1,1,2,1,1,1
2023-06-01,203582,1,0,1,7,0,7
2023-06-01,207585,2,0,2,1,0,1
2023-06-01,204356,6,1,7,2,1,2
2023-06-01,204348,3,16,19,2,1,2
2023-06-01,201750,4,1,5,4,1,4
2023-06-01,200249,1,1,2,2,1,2
2023-06-01,42922,4,0,4,3,0,3
2023-06-01,208738,4,0,4,2,0,2
2023-06-01,211644,1,0,1,1,0,1
2023-06-01,211629,1,1,2,3,3,3
2023-06-01,210780,1,0,1,1,0,1
2023-06-01,204350,4,0,4,4,0,4
2023-06-01,50902,2,2,4,4,3,4
2023-06-01,59852,1,1,2,1,1,1
2023-06-01,211534,1,0,1,1,0,1
2023-06-01,48989,1,0,1,3,0,3
2023-06-01,207041,1,0,1,1,0,1
2023-06-01,211624,1,1,2,1,1,1
2023-06-01,57310,1,0,1,2,0,2
2023-06-01,211623,1,3,4,3,4,6
2023-06-01,203358,1,1,2,1,1,1
2023-06-01,204331,1,0,1,1,0,1
2023-06-01,204290,2,0,2,2,0,2
2023-06-01,208636,3,0,3,6,0,6
2023-06-01,201216,2,0,2,1,0,1
2023-06-01,59474,1,2,3,1,1,1
2023-06-01,211003,1,0,1,2,0,2
2023-06-01,204327,3,0,3,1,0,1
2023-06-01,209363,2,0,2,1,0,1
2023-06-01,207977,1,0,1,1,0,1
2023-06-01,212240,2,0,2,2,0,2
2023-06-01,204315,3,1,4,3,1,3
2023-06-01,42293,1,0,1,2,0,2
2023-06-01,204310,2,1,3,2,2,3
2023-06-01,204297,1,0,1,6,0,6
2023-06-01,62182,6,0,6,1,0,1
2023-06-01,204309,5,0,5,1,0,1
2023-06-01,202688,2,0,2,2,0,2
2023-06-01,209817,1,0,1,6,0,6
2023-06-01,209026,6,1,7,3,1,3
2023-06-01,61203,4,1,5,6,4,6
2023-06-01,211029,1,0,1,5,0,5
2023-06-01,39224,1,1,2,2,1,2
2023-06-01,210256,1,0,1,4,0,4
2023-06-01,204299,5,0,5,2,0,2
2023-06-01,48418,2,0,2,1,0,1
2023-06-01,62215,1,0,1,2,0,2
2023-06-01,204296,3,2,5,4,1,4
2023-06-01,48175,2,0,2,2,0,2
2023-06-01,202449,4,1,5,3,1,3
2023-06-01,204285,1,0,1,1,0,1
2023-06-01,211606,1,0,1,1,0,1
2023-06-01,211328,1,0,1,3,0,3
2023-06-01,211594,1,1,2,1,1,1
2023-06-01,210258,3,43,46,2,2,2
2023-06-01,203835,1,1,2,5,2,5
2023-06-01,212679,0,0,0,2,0,2
2023-06-01,211627,1,0,1,1,0,1
2023-06-01,203463,6,0,6,5,0,5
2023-06-01,203498,1,9,10,2,2,2
2023-06-01,204107,1,0,1,1,0,1
2023-06-01,204081,3,1,4,3,1,3
2023-06-01,204065,1,1,2,2,2,2
2023-06-01,199742,1,0,1,1,0,1
2023-06-01,200910,5,0,5,2,0,2
2023-06-01,48192,3,0,3,2,0,2
2023-06-01,200271,1,1,2,4,3,4
2023-06-01,209604,2,0,2,1,0,1
2023-06-01,204333,1,2,3,2,4,4
2023-06-01,211050,1,0,1,1,0,1
2023-06-01,207499,1,1,2,3,2,3
2023-06-01,211152,1,0,1,1,0,1
2023-06-01,202377,1,0,1,1,0,1
2023-06-01,207987,4,0,4,1,0,1
2023-06-01,137882,1,0,1,2,0,2
2023-06-01,202363,1,0,1,1,0,1
2023-06-01,44319,1,0,1,1,0,1
2023-06-01,31518,2,0,2,1,0,1
2023-06-01,212896,1,0,1,2,0,2
2023-06-01,202655,1,0,1,2,0,2
2023-06-01,200475,3,0,3,1,0,1
2023-06-01,203827,2,0,2,1,0,1
2023-06-01,203824,5,0,5,3,0,3
2023-06-01,39530,1,0,1,1,0,1
2023-06-01,203602,1,1,2,3,2,3
2023-06-01,270520,7,3,10,2,1,2
2023-06-01,270506,3,3,6,1,1,1
2023-06-01,11392,4,0,4,3,0,3
2023-06-01,267770,4,0,4,1,0,1
2023-06-01,52255,25,1,26,3,1,3
2023-06-01,263776,5,1,6,3,2,3
2023-06-01,27837,55,0,55,3,0,3
2023-06-01,52260,37,0,37,4,0,4
2023-06-01,262189,17,0,17,3,0,3
2023-06-01,52408,3,0,3,2,0,2
2023-06-01,266163,2,0,2,2,0,2
2023-06-01,253566,0,0,0,1,0,1
2023-06-01,270975,2,1,3,1,1,1
2023-06-01,28097,2,0,2,2,0,2
2023-06-01,27971,10,1,11,2,1,2
2023-06-01,52384,1,0,1,1,0,1
2023-06-01,27925,19,0,19,2,0,2
2023-06-01,270920,7,0,7,1,0,1
2023-06-01,270923,7,3,10,5,5,6
2023-06-01,270222,1,2,3,1,1,1
2023-06-01,270924,2,2,4,1,2,2
2023-06-01,270925,1,0,1,1,0,1
2023-06-01,270927,7,3,10,4,2,4
2023-06-01,270926,7,1,8,1,1,1
2023-06-01,270938,7,4,11,2,3,3
2023-06-01,270929,3,2,5,1,1,1
2023-06-01,270953,4,5,9,2,2,2
2023-06-01,270939,1,1,2,2,2,2
2023-06-01,270933,5,0,5,1,0,1
2023-06-01,263710,2,0,2,1,0,1
2023-06-01,270022,5,0,5,2,0,2
2023-06-01,27668,123,7,130,1,1,1
2023-06-01,52430,12,0,12,1,0,1
2023-06-01,262207,2,0,2,1,0,1
2023-06-01,52381,24,1,25,4,3,4
2023-06-01,52259,14,0,14,3,0,3
2023-06-01,52383,7,0,7,1,0,1
2023-06-01,28517,23,0,23,4,0,4
2023-06-01,52490,8,0,8,3,0,3
2023-06-01,27924,36,1,37,3,1,3
2023-06-01,15311,53,0,53,2,0,2
2023-06-01,263804,2,0,2,1,0,1
2023-06-01,8163,204,1,205,1,1,1
2023-06-01,61507,1,0,1,1,0,1
2023-06-01,52473,18,0,18,4,0,4
2023-06-01,270023,4,0,4,1,0,1
2023-06-01,52350,1,0,1,2,0,2
2023-06-01,52342,5,1,6,3,1,3
2023-06-01,262164,1,0,1,2,0,2
2023-06-01,27748,3,0,3,1,0,1
2023-06-01,64123,3,0,3,2,0,2
2023-06-01,270665,1,1,2,3,1,3
2023-06-01,27787,26,1,27,5,3,5
2023-06-01,264731,29,1,30,1,1,1
2023-06-01,263181,19,0,19,3,0,3
2023-06-01,52303,9,0,9,2,0,2
2023-06-01,52313,4,0,4,1,0,1
2023-06-01,262727,16,3,19,2,3,4
2023-06-01,263466,52,4,56,4,1,4
2023-06-01,262728,52,7,59,4,1,4
2023-06-01,262516,7,1,8,7,2,7
2023-06-01,53133,22,0,22,4,0,4
2023-06-01,53134,31,0,31,5,0,5
2023-06-01,262708,31,0,31,4,0,4
2023-06-01,270878,4,0,4,5,0,5
2023-06-01,270882,2,3,5,2,2,2
2023-06-01,270879,7,7,14,2,2,2
2023-06-01,270901,5,7,12,5,4,5
2023-06-01,270945,3,1,4,3,1,3
2023-06-01,270957,3,1,4,1,1,1
2023-06-01,28233,48,1,49,4,1,4
2023-06-01,28249,21,0,21,8,0,8
2023-06-01,262359,11,1,12,2,1,2
2023-06-01,53141,11,1,12,3,2,3
2023-06-01,270031,1,0,1,1,0,1
2023-06-01,270765,6,3,9,2,1,2
2023-06-01,53146,11,0,11,4,0,4
2023-06-01,262738,9,6,15,3,3,3
2023-06-01,53208,1,0,1,1,0,1
2023-06-01,270809,5,0,5,1,0,1
2023-06-01,270874,1,1,2,1,1,1
2023-06-01,270080,1,0,1,1,0,1
2023-06-01,270040,5,5,10,1,1,1
2023-06-01,270819,7,1,8,5,2,5
2023-06-01,53149,1,0,1,1,0,1
2023-06-01,53150,5,1,6,1,1,1
2023-06-01,52530,5,0,5,2,0,2
2023-06-01,53151,4,0,4,1,0,1
2023-06-01,263081,3,1,4,2,1,2
2023-06-01,270702,4,1,5,6,4,6
2023-06-01,270703,5,2,7,4,3,4
2023-06-01,262745,3,0,3,3,0,3
2023-06-01,271409,3,1,4,1,1,1
2023-06-01,271430,1,0,1,1,0,1
2023-06-01,271518,7,1,8,1,3,3
2023-06-01,53024,2,1,3,1,1,1
2023-06-01,271778,5,0,5,3,0,3
2023-06-01,271822,4,2,6,2,1,2
2023-06-01,53154,5,0,5,5,0,5
2023-06-01,53155,2,2,4,4,3,4
2023-06-01,262986,3,0,3,1,0,1
2023-06-01,262747,5,0,5,3,0,3
2023-06-01,272618,0,1,1,4,1,4
2023-06-01,271620,2,3,5,1,2,2
2023-06-01,271367,3,2,5,4,1,4
2023-06-01,271383,3,1,4,6,3,7
2023-06-01,28138,13,2,15,9,4,9
2023-06-01,272244,0,3,3,2,3,4
2023-06-01,271694,0,1,1,4,2,4
2023-06-01,272451,0,3,3,3,1,3
2023-06-01,7048,37,7,44,7,3,8
2023-06-01,262955,3,1,4,1,1,1
2023-06-01,262989,21,0,21,7,0,7
2023-06-01,28238,3,0,3,2,0,2
2023-06-01,53166,7,3,10,3,2,4
2023-06-01,270071,4,1,5,2,1,2
2023-06-01,270950,7,7,14,3,1,3
2023-06-01,263451,4,0,4,3,0,3
2023-06-01,28218,29,3,32,4,2,5
2023-06-01,52888,30,6,36,5,6,6
2023-06-01,262754,14,0,14,2,0,2
2023-06-01,53168,1,0,1,1,0,1
2023-06-01,262996,8,32,40,1,1,1
2023-06-01,270598,6,4,10,5,4,5
2023-06-01,270599,5,0,5,1,0,1
2023-06-01,270608,5,1,6,5,3,5
2023-06-01,270609,4,10,14,1,1,1
2023-06-01,262997,1,1,2,3,1,3
2023-06-01,53170,13,1,14,2,2,4
2023-06-01,262998,3,1,4,1,1,1
2023-06-01,262757,30,1,31,5,4,6
2023-06-01,272232,1,1,2,1,1,1
2023-06-01,270622,2,5,7,3,6,6
2023-06-01,262758,8,0,8,1,0,1
2023-06-01,262762,7,0,7,2,0,2
2023-06-01,53174,10,1,11,2,1,2
2023-06-01,263101,5,1,6,3,2,3
2023-06-01,262763,7,0,7,4,0,4
2023-06-01,262954,7,3,10,4,5,8
2023-06-01,263008,15,7,22,1,2,2
2023-06-01,262957,5,7,12,5,4,5
2023-06-01,28333,20,0,20,2,0,2
2023-06-01,263278,5,1,6,5,3,5
2023-06-01,263006,15,0,15,2,0,2
2023-06-01,263136,6,0,6,1,0,1
2023-06-01,262975,1,0,1,1,0,1
2023-06-01,263279,1,1,2,3,1,3
2023-06-01,263287,1,1,2,3,1,3
2023-06-01,263007,2,0,2,2,0,2
2023-06-01,53197,3,0,3,1,0,1
2023-06-01,262779,14,6,20,4,3,4
2023-06-01,53183,8,0,8,2,0,2
2023-06-01,262768,7,2,9,1,1,1
2023-06-01,262614,1,0,1,5,0,5
2023-06-01,53021,2,0,2,3,0,3
2023-06-01,263060,7,0,7,1,0,1
2023-06-01,53188,1,0,1,1,0,1
2023-06-01,263050,1,0,1,1,0,1
2023-06-01,270507,4,1,5,2,1,2
2023-06-01,272441,0,7,7,3,1,3
2023-06-01,263062,7,1,8,3,1,3
2023-06-01,263058,9,0,9,2,0,2
2023-06-01,263059,15,1,16,4,3,4
2023-06-01,53194,17,9,26,3,2,3
2023-06-01,263065,4,3,7,5,3,5
2023-06-01,53198,1,0,1,1,0,1
2023-06-01,270988,1,1,2,1,1,1
2023-06-01,270993,3,1,4,1,1,1
2023-06-01,52879,9,0,9,2,0,2
2023-06-01,53228,1,0,1,2,0,2
2023-06-01,262860,1,0,1,1,0,1
2023-06-01,262897,1,0,1,3,0,3
2023-06-01,53215,1,1,2,2,1,2
2023-06-01,262775,1,30,31,1,1,1
2023-06-01,270755,6,2,8,3,1,3
2023-06-01,262778,4,0,4,2,0,2
2023-06-01,270780,1,1,2,1,1,1
2023-06-01,270790,5,1,6,1,1,1
2023-06-01,262782,3,0,3,1,0,1
2023-06-01,262781,3,0,3,2,0,2
2023-06-01,53204,2,0,2,1,0,1
2023-06-01,262786,15,0,15,1,0,1
2023-06-01,263075,15,4,19,3,1,3
2023-06-01,270572,3,1,4,3,2,3
2023-06-01,262991,1,0,1,2,0,2
2023-06-01,262297,1,0,1,4,0,4
2023-06-01,52891,1,0,1,1,0,1
2023-06-01,263076,1,1,2,1,1,1
2023-06-01,52882,1,0,1,2,0,2
2023-06-01,262958,16,1,17,3,1,3
2023-06-01,262793,2,0,2,1,0,1
2023-06-01,263511,15,3,18,10,5,10
2023-06-01,263096,7,7,14,5,5,6
2023-06-01,28239,11,1,12,6,3,6
2023-06-01,28139,25,0,25,1,0,1
2023-06-01,263103,3,0,3,1,0,1
2023-06-01,262953,7,2,9,2,1,2
2023-06-01,263285,2,3,5,2,2,2
2023-06-01,262965,4,0,4,2,0,2
2023-06-01,262968,2,3,5,5,4,6
2023-06-01,262799,14,3,17,3,3,4
2023-06-01,270624,7,1,8,3,2,3
2023-06-01,270625,3,3,6,2,1,2
2023-06-01,270634,4,0,4,1,0,1
2023-06-01,263018,5,1,6,2,1,2
2023-06-01,61583,22,1,23,4,2,4
2023-06-01,263559,1,1,2,1,1,1
2023-06-01,263022,5,1,6,3,2,3
2023-06-01,28195,11,1,12,6,5,6
2023-06-01,263023,3,0,3,1,0,1
2023-06-01,262822,12,1,13,1,3,4
2023-06-01,28276,16,3,19,6,5,7
2023-06-01,263576,1,1,2,2,1,2
2023-06-01,28285,3,3,6,5,2,5
2023-06-01,61892,1,0,1,2,0,2
2023-06-01,263605,1,0,1,1,0,1
2023-06-01,263662,1,1,2,2,1,2
2023-06-01,263570,8,0,8,1,0,1
2023-06-01,262801,8,1,9,1,1,1
2023-06-01,262803,11,4,15,4,1,4
2023-06-01,270863,3,3,6,5,3,5
2023-06-01,263090,9,1,10,2,2,2
2023-06-01,262967,9,2,11,8,3,8
2023-06-01,262275,1,0,1,1,0,1
2023-06-01,262981,7,0,7,4,0,4
2023-06-01,270521,5,1,6,2,1,2
2023-06-01,262974,5,0,5,1,0,1
2023-06-01,52894,4,0,4,1,0,1
2023-06-01,53216,9,0,9,3,0,3
2023-06-01,28162,5,0,5,1,0,1
2023-06-01,52897,7,0,7,1,0,1
2023-06-01,53221,13,3,16,7,3,7
2023-06-01,263561,7,0,7,2,0,2
2023-06-01,262990,4,1,5,5,2,7
2023-06-01,270752,5,1,6,2,1,2
2023-06-01,52910,1,1,2,2,1,2
2023-06-01,262825,10,4,14,6,1,6
2023-06-01,52621,1,0,1,1,0,1
2023-06-01,52636,1,0,1,2,0,2
2023-06-01,52622,3,1,4,3,4,4
2023-06-01,262826,1,1,2,3,3,4
2023-06-01,262994,4,0,4,2,0,2
2023-06-01,262831,6,1,7,1,2,2
2023-06-01,52899,6,0,6,1,0,1
2023-06-01,262836,3,0,3,2,0,2
2023-06-01,53227,3,1,4,1,1,1
2023-06-01,263568,3,0,3,1,0,1
2023-06-01,263575,2,0,2,1,0,1
2023-06-01,262834,3,5,8,1,1,1
2023-06-01,263580,7,1,8,2,1,2
2023-06-01,263005,2,1,3,1,1,1
2023-06-01,52912,8,6,14,1,1,1
2023-06-01,53229,4,0,4,3,0,3
2023-06-01,262839,8,0,8,1,0,1
2023-06-01,262751,13,0,13,2,0,2
2023-06-01,270604,7,1,8,1,1,1
2023-06-01,270670,3,0,3,2,0,2
2023-06-01,269979,2,0,2,2,0,2
2023-06-01,270589,2,0,2,3,0,3
2023-06-01,263128,2,0,2,2,0,2
2023-06-01,28243,8,0,8,2,0,2
2023-06-01,28246,18,0,18,6,4,6
2023-06-01,28251,12,0,12,1,0,1
2023-06-01,263162,9,0,9,8,0,8
2023-06-01,28256,13,0,13,5,0,5
2023-06-01,28261,7,1,8,2,1,2
2023-06-01,28262,1,1,2,1,1,1
2023-06-01,270611,4,1,5,2,1,2
2023-06-01,270607,3,3,6,2,2,2
2023-06-01,270597,2,0,2,2,0,2
2023-06-01,28267,28,1,29,6,1,6
2023-06-01,28269,10,1,11,3,2,3
2023-06-01,28121,7,0,7,4,0,4
2023-06-01,21911,5,0,5,2,0,2
2023-06-01,53108,7,0,7,3,0,3
2023-06-01,28127,1,0,1,3,0,3
2023-06-01,14571,1,0,1,1,0,1
2023-06-01,53083,9,0,9,4,0,4
2023-06-01,262693,8,0,8,4,0,4
2023-06-01,53084,3,0,3,2,0,2
2023-06-01,263675,9,0,9,7,0,7
2023-06-01,262694,23,0,23,5,0,5
2023-06-01,28136,25,0,25,1,0,1
2023-06-01,28137,10,1,11,3,1,3
2023-06-01,272144,1,0,1,1,0,1
2023-06-01,28143,4,1,5,4,4,5
2023-06-01,28144,8,2,10,4,1,4
2023-06-01,270531,4,0,4,2,0,2
2023-06-01,270532,1,0,1,1,0,1
2023-06-01,270515,5,1,6,1,1,1
2023-06-01,270469,5,1,6,1,1,1
2023-06-01,270509,1,0,1,1,0,1
2023-06-01,270510,7,1,8,1,1,1
2023-06-01,270533,3,0,3,1,0,1
2023-06-01,270527,7,1,8,3,2,3
2023-06-01,270511,2,4,6,3,3,3
2023-06-01,270512,3,0,3,1,0,1
2023-06-01,269973,4,0,4,2,0,2
2023-06-01,53214,5,3,8,4,3,4
2023-06-01,28150,5,0,5,4,0,4
2023-06-01,28156,16,0,16,2,0,2
2023-06-01,28157,1,0,1,2,0,2
2023-06-01,28644,2,0,2,3,0,3
2023-06-01,28161,1,3,4,5,3,5
2023-06-01,28583,14,0,14,2,0,2
2023-06-01,270242,4,1,5,1,1,1
2023-06-01,269723,5,0,5,1,0,1
2023-06-01,269713,7,5,12,1,1,1
2023-06-01,269714,3,3,6,5,4,5
2023-06-01,270243,3,2,5,2,2,2
2023-06-01,269909,9,19,28,4,4,5
2023-06-01,269720,1,1,2,1,1,1
2023-06-01,270591,3,1,4,2,1,2
2023-06-01,269721,7,0,7,2,0,2
2023-06-01,270245,5,0,5,1,0,1
2023-06-01,270238,4,28,32,1,1,1
2023-06-01,28159,9,0,9,3,0,3
2023-06-01,28160,16,1,17,1,2,3
2023-06-01,53063,1,0,1,1,0,1
2023-06-01,262662,3,1,4,7,3,7
2023-06-01,28212,33,0,33,1,0,1
2023-06-01,28164,2,0,2,3,0,3
2023-06-01,262665,7,0,7,1,0,1
2023-06-01,262667,4,0,4,4,0,4
2023-06-01,270774,4,3,7,5,1,5
2023-06-01,272461,0,1,1,2,4,5
2023-06-01,270778,4,1,5,1,1,1
2023-06-01,271417,2,0,2,2,0,2
2023-06-01,271455,7,2,9,2,2,2
2023-06-01,272057,3,0,3,1,0,1
2023-06-01,270883,3,0,3,1,0,1
2023-06-01,28170,6,0,6,4,0,4
2023-06-01,262672,5,2,7,2,2,2
2023-06-01,263621,4,1,5,4,2,4
2023-06-01,28576,11,1,12,4,3,4
2023-06-01,269990,1,0,1,1,0,1
2023-06-01,270516,3,2,5,1,1,1
2023-06-01,270517,5,1,6,7,2,7
2023-06-01,270543,1,0,1,1,0,1
2023-06-01,53054,2,0,2,1,0,1
2023-06-01,53051,1,0,1,2,0,2
2023-06-01,53136,1,0,1,1,0,1
2023-06-01,8055,4,1,5,6,2,6
2023-06-01,270962,3,2,5,3,2,3
2023-06-01,271033,4,0,4,6,0,6
2023-06-01,53071,5,0,5,1,0,1
2023-06-01,53060,16,0,16,2,0,2
2023-06-01,28614,38,1,39,2,2,2
2023-06-01,28205,3,0,3,1,0,1
2023-06-01,53067,15,3,18,1,1,2
2023-06-01,270992,4,1,5,3,2,3
2023-06-01,270986,5,1,6,1,1,2
2023-06-01,270989,4,6,10,3,3,3
2023-06-01,271807,1,0,1,2,0,2
2023-06-01,271138,7,4,11,5,3,5
2023-06-01,263146,15,14,29,6,4,6
2023-06-01,262679,4,0,4,3,0,3
2023-06-01,53073,16,0,16,2,0,2
2023-06-01,262844,2,1,3,1,1,1
2023-06-01,28340,0,0,0,2,0,2
2023-06-01,262520,5,0,5,4,0,4
2023-06-01,262686,23,0,23,5,0,5
2023-06-01,52984,31,2,33,4,3,4
2023-06-01,262690,6,1,7,4,3,5
2023-06-01,270619,5,17,22,1,1,1
2023-06-01,270584,4,16,20,1,1,1
2023-06-01,270577,6,2,8,7,4,7
2023-06-01,262684,3,3,6,2,3,3
2023-06-01,53077,1,0,1,1,0,1
2023-06-01,28322,2,0,2,1,0,1
2023-06-01,53079,10,0,10,1,0,1
2023-06-01,262692,1,0,1,1,0,1
2023-06-01,270544,7,7,14,2,3,3
2023-06-01,270626,5,0,5,2,0,2
2023-06-01,270528,5,0,5,6,0,6
2023-06-01,11751,15,0,15,8,0,8
2023-06-01,53096,3,3,6,2,2,3
2023-06-01,270743,3,1,4,3,2,3
2023-06-01,270045,1,0,1,1,0,1
2023-06-01,270113,2,1,3,1,1,1
2023-06-01,270719,1,1,2,1,1,1
2023-06-01,270004,5,0,5,2,0,2
2023-06-01,270736,3,0,3,1,0,1
2023-06-01,270115,2,0,2,1,0,1
2023-06-01,270728,1,1,2,1,1,1
2023-06-01,270114,1,1,2,1,1,1
2023-06-01,270005,6,0,6,2,0,2
2023-06-01,270722,5,2,7,3,3,3
2023-06-01,270723,5,1,6,1,1,1
2023-06-01,53098,2,0,2,1,0,1
2023-06-01,270991,3,5,8,3,2,3
2023-06-01,270056,5,0,5,3,0,3
2023-06-01,270120,1,1,2,1,1,1
2023-06-01,262702,3,1,4,1,1,1
2023-06-01,53100,3,1,4,4,3,4
2023-06-01,270522,7,1,8,7,3,7
2023-06-01,270523,1,0,1,4,0,4
2023-06-01,270524,3,1,4,1,1,1
2023-06-01,270534,4,3,7,5,3,5
2023-06-01,262674,25,7,32,6,4,6
2023-06-01,28207,24,0,24,4,2,4
2023-06-01,53125,6,2,8,1,1,1
2023-06-01,53113,21,1,22,3,2,3
2023-06-01,262666,1,0,1,1,0,1
2023-06-01,262767,21,1,22,6,4,8
2023-06-01,272435,1,1,2,2,1,2
2023-06-01,262497,31,0,31,1,0,1
2023-06-01,53116,14,0,14,1,0,1
2023-06-01,53127,14,1,15,2,2,2
2023-06-01,270789,1,0,1,1,0,1
2023-06-01,270772,7,4,11,4,2,4
2023-06-01,26606,34,1,35,2,2,2
2023-06-01,262709,25,0,25,1,0,1
2023-06-01,262710,31,0,31,5,0,5
2023-06-01,262712,1,0,1,2,0,2
2023-06-01,11921,35,0,35,6,0,6
2023-06-01,53147,10,2,12,8,4,8
2023-06-01,262714,2,0,2,3,0,3
2023-06-01,28364,1,1,2,1,1,1
2023-06-01,53123,22,5,27,5,1,5
2023-06-01,272619,0,3,3,4,3,5
2023-06-01,262685,3,3,6,1,2,2
2023-06-01,270549,7,3,10,3,2,3
2023-06-01,270545,1,1,2,3,2,3
2023-06-01,270677,4,1,5,3,3,3
2023-06-01,270550,7,1,8,6,2,6
2023-06-01,265628,4,0,4,1,0,1
2023-06-01,262719,14,0,14,1,0,1
2023-06-01,53140,3,0,3,2,0,2
2023-06-01,262722,6,0,6,1,0,1
2023-06-01,53130,14,1,15,3,2,3
2023-06-01,270921,4,1,5,2,1,2
2023-06-01,270918,7,0,7,1,0,1
2023-06-01,262724,8,0,8,3,0,3
2023-06-01,265594,52,255,307,1,2,2
2023-06-01,28513,7,0,7,2,0,2
2023-06-01,28556,9,0,9,1,0,1
2023-06-01,6332,33,0,33,1,0,1
2023-06-01,64713,3,4,7,1,1,2
2023-06-01,57261,9,0,9,3,0,3
2023-06-01,198007,1,0,1,3,0,3
2023-06-01,57201,1,1,2,2,2,2
2023-06-01,205833,1,0,1,1,0,1
2023-06-01,199437,1,0,1,1,0,1
2023-06-01,206053,1,0,1,1,0,1
2023-06-01,57374,24,0,24,1,0,1
2023-06-01,49640,1,1,2,3,2,3
2023-06-01,60561,1,1,2,1,1,1
2023-06-01,34574,3,1,4,3,1,3
2023-06-01,205123,1,0,1,1,0,1
2023-06-01,31626,3,0,3,1,0,1
2023-06-01,212016,1,0,1,1,0,1
2023-06-01,6844,1,0,1,1,0,1
2023-06-01,12906,4,0,4,1,0,1
2023-06-01,15679,5,0,5,3,0,3
2023-06-01,8292,1,0,1,2,0,2
2023-06-01,56500,1,0,1,1,0,1
2023-06-01,201278,2,0,2,1,0,1
2023-06-01,210264,5,0,5,1,0,1
2023-06-01,208604,1,0,1,1,0,1
2023-06-01,210462,6,5,11,3,1,3
2023-06-01,213098,1,0,1,1,0,1
2023-06-01,209565,1,0,1,1,0,1
2023-06-01,201569,1,0,1,3,0,3
2023-06-01,201571,1,0,1,2,0,2
2023-06-01,208356,4,0,4,1,0,1
2023-06-01,208295,2,0,2,3,0,3
2023-06-01,15617,19,0,19,1,0,1
2023-06-01,204320,1,1,2,1,1,1
2023-06-01,205042,1,0,1,1,0,1
2023-06-01,211597,7,5,12,6,7,8
2023-06-01,203558,2,0,2,1,0,1
2023-06-01,207294,7,0,7,4,0,4
2023-06-01,49039,2,0,2,2,0,2
2023-06-01,5528,2,0,2,1,0,1
2023-06-01,49081,1,0,1,2,0,2
2023-06-01,52130,1,1,2,2,1,2
2023-06-01,49574,1,0,1,1,0,1
2023-06-01,8222,2,0,2,3,0,3
2023-06-01,44919,2,1,3,1,1,1
2023-06-01,49254,1,0,1,1,0,1
2023-06-01,8409,1,0,1,4,0,4
2023-06-01,206337,1,0,1,2,0,2
2023-06-01,57011,1,0,1,1,0,1
2023-06-01,210693,1,0,1,1,0,1
2023-06-01,61045,1,0,1,1,0,1
2023-06-01,210745,1,0,1,1,0,1
2023-06-01,35779,8,1,9,1,1,2
2023-06-01,49260,1,0,1,1,0,1
2023-06-01,212452,1,0,1,1,0,1
2023-06-01,212423,1,0,1,1,0,1
2023-06-01,52143,2,0,2,5,0,5
2023-06-01,49388,1,0,1,1,0,1
2023-06-01,25356,7,0,7,3,0,3
2023-06-01,49400,3,0,3,2,0,2
2023-06-01,19305,14,0,14,7,0,7
2023-06-01,196784,5,0,5,3,0,3
2023-06-01,49426,6,0,6,2,0,2
2023-06-01,211583,1,0,1,1,0,1
2023-06-01,211565,1,0,1,1,0,1
2023-06-01,211009,1,0,1,1,0,1
2023-06-01,198210,1,0,1,2,0,2
2023-06-01,49487,3,0,3,1,0,1
2023-06-01,31003,3,0,3,3,0,3
2023-06-01,211572,1,1,2,1,1,1
2023-06-01,210357,1,0,1,3,0,3
2023-06-01,209937,1,0,1,1,0,1
2023-06-01,49412,6,0,6,2,0,2
2023-06-01,49669,4,0,4,3,0,3
2023-06-01,49291,17,0,17,2,0,2
2023-06-01,207555,1,0,1,1,0,1
2023-06-01,207854,1,0,1,2,0,2
2023-06-01,203369,1,1,2,2,1,2
2023-06-01,206118,1,0,1,2,0,2
2023-06-01,205598,1,0,1,2,0,2
2023-06-01,205030,1,0,1,3,0,3
2023-06-01,207838,1,0,1,3,0,3
2023-06-01,201132,1,0,1,2,0,2
2023-06-01,211875,2,0,2,2,0,2
2023-06-01,42513,4,0,4,5,0,5
2023-06-01,210549,1,0,1,1,0,1
2023-06-01,196822,1,1,2,2,1,2
2023-06-01,34736,1,0,1,1,0,1
2023-06-01,64447,1,0,1,1,0,1
2023-06-01,35547,1,0,1,1,0,1
2023-06-01,12379,2,0,2,2,0,2
2023-06-01,208359,4,0,4,1,0,1
2023-06-01,211988,1,0,1,3,0,3
2023-06-01,205201,5,0,5,5,0,5
2023-06-01,213008,1,0,1,1,0,1
2023-06-01,49272,3,1,4,2,1,2
2023-06-01,44506,1,0,1,1,0,1
2023-06-01,58328,6,0,6,1,0,1
2023-06-01,201890,3,1,4,3,1,3
2023-06-01,210020,2,0,2,4,0,4
2023-06-01,200040,1,0,1,1,0,1
2023-06-01,209901,1,0,1,3,0,3
2023-06-01,209269,1,0,1,1,0,1
2023-06-01,49632,9,0,9,2,0,2
2023-06-01,200106,1,0,1,1,0,1
2023-06-01,42049,3,0,3,2,0,2
2023-06-01,201622,1,0,1,1,0,1
2023-06-01,205026,1,0,1,1,0,1
2023-06-01,40977,1,0,1,2,0,2
2023-06-01,203627,1,0,1,2,0,2
2023-06-01,204846,1,0,1,1,0,1
2023-06-01,203513,1,0,1,1,0,1
2023-06-01,203509,1,0,1,2,0,2
2023-06-01,58181,2,0,2,1,0,1
2023-06-01,203922,1,0,1,1,0,1
2023-06-01,200479,1,1,2,2,2,2
2023-06-01,213077,1,0,1,1,0,1
2023-06-01,206538,1,0,1,4,0,4
2023-06-01,202493,1,0,1,1,0,1
2023-06-01,203766,1,0,1,1,0,1
2023-06-01,204792,1,0,1,1,0,1
2023-06-01,207451,1,1,2,1,1,1
2023-06-01,203401,1,0,1,4,0,4
2023-06-01,61416,2,0,2,3,0,3
2023-06-01,209973,1,0,1,3,0,3
2023-06-01,208748,1,0,1,2,0,2
2023-06-01,207501,1,0,1,1,0,1
2023-06-01,49280,1,0,1,1,0,1
2023-06-01,205463,3,0,3,1,0,1
2023-06-01,207474,1,0,1,1,0,1
2023-06-01,203657,1,0,1,1,0,1
2023-06-01,199724,4,0,4,1,0,1
2023-06-01,200075,1,0,1,1,0,1
2023-06-01,206670,1,0,1,1,0,1
2023-06-01,206050,1,0,1,1,0,1
2023-06-01,199100,1,0,1,1,0,1
2023-06-01,203285,1,0,1,1,0,1
2023-06-01,201575,1,0,1,1,0,1
2023-06-01,201233,2,0,2,1,0,1
2023-06-01,200231,1,0,1,1,0,1
2023-06-01,61134,3,0,3,4,0,4
2023-06-01,204574,1,0,1,2,0,2
2023-06-01,204357,3,0,3,4,0,4
2023-06-01,44915,2,0,2,1,0,1
2023-06-01,198145,1,1,2,3,3,3
2023-06-01,9096,2,0,2,4,0,4
2023-06-01,47911,4,1,5,1,1,1
2023-06-01,56370,8,0,8,1,0,1
2023-06-01,209486,2,0,2,1,0,1
2023-06-01,209582,1,1,2,1,1,1
2023-06-01,56407,5,0,5,2,0,2
2023-06-01,207744,1,0,1,1,0,1
2023-06-01,56446,1,0,1,1,0,1
2023-06-01,203706,1,0,1,1,0,1
2023-06-01,57148,6,0,6,2,0,2
2023-06-01,50577,8,0,8,4,0,4
2023-06-01,197620,1,0,1,7,0,7
2023-06-01,203574,2,0,2,2,0,2
2023-06-01,212644,3,3,6,2,2,2
2023-06-01,49918,1,0,1,1,0,1
2023-06-01,50322,1,0,1,2,0,2
2023-06-01,50614,1,0,1,1,0,1
2023-06-01,25097,1,0,1,1,0,1
2023-06-01,50275,1,0,1,3,0,3
2023-06-01,206883,1,1,2,3,3,3
2023-06-01,59995,1,0,1,1,0,1
2023-06-01,50637,1,0,1,1,0,1
2023-06-01,62448,1,0,1,2,0,2
2023-06-01,62074,1,0,1,2,0,2
2023-06-01,58153,1,0,1,1,0,1
2023-06-01,202637,1,0,1,1,0,1
2023-06-01,199444,1,0,1,2,0,2
2023-06-01,60033,1,1,2,2,2,2
2023-06-01,201425,1,0,1,2,0,2
2023-06-01,200621,1,0,1,2,0,2
2023-06-01,211857,1,0,1,1,0,1
2023-06-01,59765,1,0,1,2,0,2
2023-06-01,62032,1,0,1,1,0,1
2023-06-01,62030,1,0,1,2,0,2
2023-06-01,60761,1,0,1,1,0,1
2023-06-01,62042,1,0,1,1,0,1
2023-06-01,57790,1,0,1,1,0,1
2023-06-01,62151,1,0,1,1,0,1
2023-06-01,213240,1,0,1,1,0,1
2023-06-01,50306,1,1,2,3,2,3
2023-06-01,51376,4,0,4,3,0,3
2023-06-01,48308,5,0,5,3,0,3
2023-06-01,58191,1,1,2,3,1,3
2023-06-01,34268,1,0,1,1,0,1
2023-06-01,209656,1,0,1,1,0,1
2023-06-01,199866,1,0,1,2,0,2
2023-06-01,49874,1,1,2,1,1,1
2023-06-01,34359,2,0,2,4,0,4
2023-06-01,29013,1,0,1,2,0,2
2023-06-01,62307,1,0,1,1,0,1
2023-06-01,50944,2,0,2,1,0,1
2023-06-01,212064,1,1,2,1,2,2
2023-06-01,212548,2,1,3,3,3,3
2023-06-01,56397,1,0,1,1,0,1
2023-06-01,52159,1,0,1,1,0,1
2023-06-01,206762,1,0,1,6,0,6
2023-06-01,206594,1,1,2,2,1,2
2023-06-01,16192,8,0,8,2,0,2
2023-06-01,33829,2,0,2,1,0,1
2023-06-01,48556,1,0,1,3,0,3
2023-06-01,50357,4,0,4,4,0,4
2023-06-01,49851,1,0,1,2,0,2
2023-06-01,50069,2,7,9,5,5,6
2023-06-01,56464,1,0,1,2,0,2
2023-06-01,47114,4,1,5,5,4,5
2023-06-01,51331,7,3,10,7,3,9
2023-06-01,29553,3,0,3,1,0,1
2023-06-01,198099,1,0,1,1,0,1
2023-06-01,198173,1,0,1,2,0,2
2023-06-01,212258,1,0,1,1,0,1
2023-06-01,198786,1,0,1,2,0,2
2023-06-01,29604,1,0,1,1,0,1
2023-06-01,196886,1,0,1,1,0,1
2023-06-01,28641,1,0,1,1,0,1
2023-06-01,28664,3,0,3,1,0,1
2023-06-01,28272,16,3,19,3,2,3
2023-06-01,270017,5,0,5,2,0,2
2023-06-01,270732,2,1,3,2,2,2
2023-06-01,270733,5,1,6,3,1,3
2023-06-01,270836,5,3,8,6,4,6
2023-06-01,270829,5,1,6,1,1,1
2023-06-01,270830,3,7,10,3,2,3
2023-06-01,270831,6,1,7,1,1,1
2023-06-01,28328,30,1,31,6,2,7
2023-06-01,28298,1,0,1,2,0,2
2023-06-01,262366,3,1,4,3,2,3
2023-06-01,28291,12,0,12,1,0,1
2023-06-01,270600,3,3,6,6,4,6
2023-06-01,270646,3,1,4,3,1,3
2023-06-01,270647,1,1,2,1,1,1
2023-06-01,270601,5,0,5,2,0,2
2023-06-01,270795,7,3,10,3,1,3
2023-06-01,28301,4,1,5,1,1,1
2023-06-01,28304,11,0,11,6,0,6
2023-06-01,28295,8,0,8,3,0,3
2023-06-01,28313,9,0,9,3,0,3
2023-06-01,268940,3,3,6,7,5,8
2023-06-01,270838,7,3,10,5,5,6
2023-06-01,270792,3,0,3,1,0,1
2023-06-01,28336,5,0,5,3,0,3
2023-06-01,28321,1,0,1,2,0,2
2023-06-01,269978,5,0,5,1,0,1
2023-06-01,270673,3,1,4,5,4,6
2023-06-01,270529,3,0,3,1,0,1
2023-06-01,270674,3,3,6,5,3,5
2023-06-01,28344,3,0,3,1,0,1
2023-06-01,28323,10,1,11,4,1,4
2023-06-01,28324,3,0,3,2,0,2
2023-06-01,270902,5,0,5,1,0,1
2023-06-01,270905,7,4,11,5,2,5
2023-06-01,270907,7,1,8,7,2,7
2023-06-01,270963,3,2,5,1,1,1
2023-06-01,28332,17,0,17,3,0,3
2023-06-01,23105,53,0,53,6,0,6
2023-06-01,269972,1,1,2,1,1,1
2023-06-01,270535,5,1,6,2,1,2
2023-06-01,270552,6,0,6,3,0,3
2023-06-01,270551,5,0,5,5,0,5
2023-06-01,272501,0,5,5,3,2,3
2023-06-01,61603,3,0,3,2,0,2
2023-06-01,270725,4,1,5,2,1,2
2023-06-01,270726,5,3,8,2,2,2
2023-06-01,263349,42,3,45,4,1,4
2023-06-01,270785,5,1,6,4,3,4
2023-06-01,270794,7,3,10,5,3,5
2023-06-01,53037,0,0,0,2,0,2
2023-06-01,28351,3,0,3,1,0,1
2023-06-01,11752,1,1,2,3,3,3
2023-06-01,28357,3,2,5,3,3,3
2023-06-01,28358,5,0,5,4,0,4
2023-06-01,270536,3,1,4,3,1,4
2023-06-01,270538,6,3,9,8,3,8
2023-06-01,270537,7,1,8,3,1,3
2023-06-01,270893,3,1,4,3,1,3
2023-06-01,270904,2,1,3,3,1,3
2023-06-01,270886,2,1,3,1,1,1
2023-06-01,28369,7,4,11,5,2,5
2023-06-01,28172,4,1,5,1,1,1
2023-06-01,28176,19,12,31,6,4,6
2023-06-01,270642,1,1,2,1,1,1
2023-06-01,270139,2,0,2,1,0,1
2023-06-01,272086,5,0,5,3,0,3
2023-06-01,270644,4,6,10,2,2,2
2023-06-01,28175,3,2,5,2,2,2
2023-06-01,28177,28,13,41,3,2,3
2023-06-01,270500,2,2,4,1,1,1
2023-06-01,270110,4,1,5,1,1,1
2023-06-01,270560,5,5,10,5,5,6
2023-06-01,270540,1,1,2,2,2,2
2023-06-01,270562,5,1,6,3,1,3
2023-06-01,270542,5,1,6,1,1,1
2023-06-01,28180,4,0,4,2,0,2
2023-06-01,11844,42,3,45,6,5,7
2023-06-01,262749,27,7,34,2,2,2
2023-06-01,28190,1,0,1,2,0,2
2023-06-01,28193,4,1,5,2,1,2
2023-06-01,28197,1,0,1,3,0,3
2023-06-01,28199,1,0,1,1,0,1
2023-06-01,270718,7,3,10,2,1,2
2023-06-01,270679,1,1,2,1,1,1
2023-06-01,28203,5,0,5,2,0,2
2023-06-01,271406,6,0,6,1,0,1
2023-06-01,271507,5,1,6,4,2,4
2023-06-01,271584,1,1,2,3,1,3
2023-06-01,271300,7,1,8,6,3,6
2023-06-01,10938,4,2,6,2,3,3
2023-06-01,22431,6,1,7,1,1,1
2023-06-01,28211,8,0,8,2,0,2
2023-06-01,28215,13,1,14,4,4,7
2023-06-01,270333,7,3,10,4,3,4
2023-06-01,270334,4,0,4,3,0,3
2023-06-01,270343,5,1,6,2,1,2
2023-06-01,270311,4,1,5,4,2,4
2023-06-01,28647,9,0,9,3,0,3
2023-06-01,262344,5,1,6,4,2,4
2023-06-01,271727,2,2,4,2,1,2
2023-06-01,53161,16,0,16,5,0,5
2023-06-01,14781,1,1,2,3,1,3
2023-06-01,270315,2,2,4,2,1,2
2023-06-01,270344,4,1,5,1,2,2
2023-06-01,269956,2,1,3,1,1,1
2023-06-01,270398,2,1,3,5,2,5
2023-06-01,28223,5,3,8,4,4,7
2023-06-01,270632,1,1,2,2,1,2
2023-06-01,270579,5,1,6,1,1,1
2023-06-01,270576,4,3,7,4,2,4
2023-06-01,270580,1,1,2,1,1,1
2023-06-01,272228,6,0,6,2,0,2
2023-06-01,40356,2,0,2,2,2,3
2023-06-01,28232,10,6,16,6,5,7
2023-06-01,270711,6,5,11,3,3,3
2023-06-01,270701,7,7,14,7,6,10
2023-06-01,270008,3,0,3,1,0,1
2023-06-01,270770,3,0,3,1,0,1
2023-06-01,270714,6,0,6,1,0,1
2023-06-01,270705,5,1,6,3,3,3
2023-06-01,270706,5,1,6,2,1,3
2023-06-01,270707,1,1,2,2,1,2
2023-06-01,270708,4,2,6,1,1,1
2023-06-01,270720,2,1,3,1,1,1
2023-06-01,270712,1,0,1,1,0,1
2023-06-01,270713,5,3,8,7,3,7
2023-06-01,270715,1,1,2,1,1,1
2023-06-01,270721,3,3,6,3,3,3
2023-06-01,28234,31,0,31,6,0,6
2023-06-01,28236,17,0,17,2,0,2
2023-06-01,263253,1,0,1,1,0,1
2023-06-01,28415,2,0,2,1,0,1
2023-06-01,269705,3,3,6,6,5,7
2023-06-01,28466,1,1,2,3,3,3
2023-06-01,3905,8,1,9,1,1,1
2023-06-01,263713,9,3,12,2,1,2
2023-06-01,203335,1,0,1,1,0,1
2023-06-01,13585,56,1,57,3,1,3
2023-06-01,264638,1,0,1,3,0,3
2023-06-01,27711,2,0,2,4,0,4
2023-06-01,270317,5,1,6,5,2,5
2023-06-01,271768,0,0,0,2,0,2
2023-06-01,270335,3,0,3,1,0,1
2023-06-01,28091,1,0,1,1,0,1
2023-06-01,52346,13,0,13,1,0,1
2023-06-01,52415,1,0,1,2,0,2
2023-06-01,263198,2,0,2,3,0,3
2023-06-01,270318,5,1,6,2,1,2
2023-06-01,271603,5,1,6,1,1,1
2023-06-01,263239,3,0,3,2,0,2
2023-06-01,28015,160,0,160,3,0,3
2023-06-01,262195,0,1,1,2,1,2
2023-06-01,28079,1,0,1,1,0,1
2023-06-01,27845,28,1,29,6,2,7
2023-06-01,27691,2,0,2,1,0,1
2023-06-01,270767,6,1,7,2,1,3
2023-06-01,270768,1,1,2,1,1,1
2023-06-01,270769,1,1,2,1,1,1
2023-06-01,270835,5,0,5,1,0,1
2023-06-01,264735,1,0,1,1,0,1
2023-06-01,270618,7,1,8,1,1,1
2023-06-01,262169,5,0,5,1,0,1
2023-06-01,22501,32,0,32,2,0,2
2023-06-01,28436,3,1,4,1,1,1
2023-06-01,28096,8,0,8,1,0,1
2023-06-01,271586,1,1,2,1,1,1
2023-06-01,272982,3,0,3,1,0,1
2023-06-01,271571,5,3,8,3,3,3
2023-06-01,271642,5,0,5,1,0,1
2023-06-01,271591,1,6,7,1,1,1
2023-06-01,271595,5,1,6,1,2,2
2023-06-01,271572,1,1,2,2,2,2
2023-06-01,271607,3,1,4,3,1,3
2023-06-01,270200,1,1,2,1,2,2
2023-06-01,273639,4,0,4,5,0,5
2023-06-01,271590,7,7,14,1,3,3
2023-06-01,271592,4,4,8,3,2,3
2023-06-01,270652,2,1,3,1,1,1
2023-06-01,270653,5,7,12,6,6,7
2023-06-01,270654,5,1,6,3,3,3
2023-06-01,270656,4,3,7,3,3,3
2023-06-01,27740,24,8,32,2,2,2
2023-06-01,271274,4,3,7,1,1,1
2023-06-01,270127,1,0,1,1,0,1
2023-06-01,271795,5,1,6,2,1,2
2023-06-01,271280,4,0,4,2,0,2
2023-06-01,272727,0,7,7,2,2,3
2023-06-01,271276,1,1,2,1,1,1
2023-06-01,52351,8,0,8,3,0,3
2023-06-01,27921,2,0,2,2,0,2
2023-06-01,52344,0,0,0,2,0,2
2023-06-01,61473,1,0,1,1,0,1
2023-06-01,262208,11,0,11,2,0,2
2023-06-01,52300,1,1,2,5,2,5
2023-06-01,52348,2,0,2,1,0,1
2023-06-01,18635,12,0,12,3,0,3
2023-06-01,52281,3,0,3,1,0,1
2023-06-01,28316,1,0,1,1,0,1
2023-06-01,271457,5,0,5,2,0,2
2023-06-01,271545,7,0,7,1,0,1
2023-06-01,271353,2,4,6,4,2,4
2023-06-01,28053,26,2,28,2,2,2
2023-06-01,263201,1,0,1,1,0,1
2023-06-01,272858,1,0,1,3,0,3
2023-06-01,52267,1,0,1,1,0,1
2023-06-01,52270,36,0,36,1,0,1
2023-06-01,27738,248,52,300,2,2,2
2023-06-01,21578,3,1,4,3,1,3
2023-06-01,272829,1,0,1,2,0,2
2023-06-01,64345,0,0,0,2,0,2
2023-06-01,270319,2,2,4,4,4,4
2023-06-01,270320,2,1,3,1,1,1
2023-06-01,269926,4,0,4,2,0,2
2023-06-01,269935,4,0,4,3,0,3
2023-06-01,270323,3,1,4,1,1,1
2023-06-01,270324,1,1,2,1,1,1
2023-06-01,270336,7,1,8,5,2,5
2023-06-01,270348,4,1,5,2,1,2
2023-06-01,270325,5,5,10,3,2,3
2023-06-01,270326,1,9,10,1,1,1
2023-06-01,270345,4,2,6,5,3,5
2023-06-01,270339,3,3,6,1,1,1
2023-06-01,270337,3,2,5,4,4,5
2023-06-01,270349,1,0,1,1,0,1
2023-06-01,270354,1,5,6,1,1,1
2023-06-01,269938,0,0,0,3,0,3
2023-06-01,270351,1,1,2,1,1,1
2023-06-01,269943,1,0,1,2,0,2
2023-06-01,270378,1,0,1,1,0,1
2023-06-01,271823,4,0,4,1,0,1
2023-06-01,269942,2,0,2,1,0,1
2023-06-01,270352,7,0,7,1,0,1
2023-06-01,270341,5,9,14,6,4,6
2023-06-01,269936,4,0,4,2,0,2
2023-06-01,270332,7,0,7,1,0,1
2023-06-01,269930,1,0,1,1,0,1
2023-06-01,270425,7,3,10,5,5,6
2023-06-01,269949,1,0,1,1,0,1
2023-06-01,270347,3,3,6,1,1,1
2023-06-01,270759,1,7,8,1,1,1
2023-06-01,270435,3,1,4,1,1,1
2023-06-01,270350,4,1,5,8,3,9
2023-06-01,270566,1,0,1,1,0,1
2023-06-01,269975,1,0,1,1,0,1
2023-06-01,269951,1,0,1,3,0,3
2023-06-01,270379,1,1,2,2,1,2
2023-06-01,270365,1,4,5,3,1,4
2023-06-01,270402,1,1,2,3,3,3
2023-06-01,269950,4,1,5,3,1,3
2023-06-01,269944,4,0,4,3,0,3
2023-06-01,269955,4,1,5,1,1,1
2023-06-01,270355,3,3,6,4,3,4
2023-06-01,270356,4,0,4,2,0,2
2023-06-01,270380,4,3,7,2,1,2
2023-06-01,270357,3,1,4,2,1,2
2023-06-01,270359,4,0,4,2,0,2
2023-06-01,270363,5,0,5,3,0,3
2023-06-01,270364,4,3,7,4,3,5
2023-06-01,270371,5,1,6,2,1,2
2023-06-01,270372,4,1,5,4,1,4
2023-06-01,272572,0,1,1,4,2,4
2023-06-01,270387,5,1,6,1,1,1
2023-06-01,270366,3,0,3,1,0,1
2023-06-01,270388,1,1,2,2,2,2
2023-06-01,270367,1,1,2,1,1,1
2023-06-01,269953,4,2,6,2,1,2
2023-06-01,270373,1,1,2,2,1,2
2023-06-01,270368,3,3,6,1,1,1
2023-06-01,270381,3,0,3,1,0,1
2023-06-01,272756,0,0,0,2,0,2
2023-06-01,270369,4,0,4,7,3,8
2023-06-01,270370,4,2,6,9,2,9
2023-06-01,270374,7,7,14,4,4,4
2023-06-01,272558,0,5,5,4,3,4
2023-06-01,270376,4,1,5,4,1,4
2023-06-01,270464,4,2,6,6,1,6
2023-06-01,270383,3,3,6,1,1,1
2023-06-01,272039,3,0,3,1,0,1
2023-06-01,270389,1,0,1,1,0,1
2023-06-01,270390,3,2,5,5,2,5
2023-06-01,270408,1,1,2,1,1,1
2023-06-01,270391,7,1,8,1,1,1
2023-06-01,270409,5,6,11,6,1,6
2023-06-01,270394,5,1,6,1,1,1
2023-06-01,270395,2,3,5,1,1,1
2023-06-01,270392,3,0,3,1,0,1
2023-06-01,28579,1,0,1,1,0,1
2023-06-01,270396,5,1,6,1,1,1
2023-06-01,270400,5,0,5,3,0,3
2023-06-01,270411,1,1,2,1,1,1
2023-06-01,267538,5,1,6,3,1,3
2023-06-01,270412,7,2,9,2,1,2
2023-06-01,270397,3,1,4,3,1,3
2023-06-01,269952,2,3,5,1,1,1
2023-06-01,270401,1,1,2,1,1,1
2023-06-01,270422,6,0,6,2,0,2
2023-06-01,270682,5,1,6,5,4,7
2023-06-01,270414,6,6,12,6,6,8
2023-06-01,52414,1,0,1,2,0,2
2023-06-01,270746,5,5,10,7,4,7
2023-06-01,262171,4,0,4,4,0,4
2023-06-01,262183,7,0,7,1,0,1
2023-06-01,270479,1,1,2,1,1,1
2023-06-01,269722,1,1,2,1,1,1
2023-06-01,269932,7,0,7,1,0,1
2023-06-01,269908,4,3,7,3,3,3
2023-06-01,27979,2,0,2,1,0,1
2023-06-01,27844,3,0,3,1,0,1
2023-06-01,265839,5,1,6,1,1,1
2023-06-01,262223,10,3,13,2,1,2
2023-06-01,262212,2,2,4,1,1,1
2023-06-01,26317,14,0,14,2,0,2
2023-06-01,262188,8,0,8,3,0,3
2023-06-01,27956,19,0,19,2,0,2
2023-06-01,267848,4,1,5,2,1,3
2023-06-01,269947,5,0,5,2,0,2
2023-06-01,52235,9,0,9,3,0,3
2023-06-01,52238,8,10,18,2,1,2
2023-06-01,52241,7,0,7,3,0,3
2023-06-01,52366,8,0,8,4,0,4
2023-06-01,52392,5,7,12,2,2,3
2023-06-01,270151,1,4,5,1,1,1
2023-06-01,272547,4,1,5,1,1,1
2023-06-01,271514,2,1,3,2,1,2
2023-06-01,270961,4,0,4,1,0,1
2023-06-01,20462,1,0,1,1,0,1
2023-06-01,13316,29,0,29,3,0,3
2023-06-01,265801,5,1,6,3,1,3
2023-06-01,22313,64,0,64,3,0,3
2023-06-01,52495,10,0,10,1,0,1
2023-06-01,269996,4,0,4,2,0,2
2023-06-01,270060,2,0,2,2,0,2
2023-06-01,270935,5,3,8,3,3,3
2023-06-01,270936,5,1,6,3,1,3
2023-06-01,270937,6,2,8,5,3,5
2023-06-01,272154,1,1,2,3,1,3
2023-06-01,271635,1,1,2,1,1,1
2023-06-01,271853,1,0,1,2,0,2
2023-06-01,61480,1,0,1,1,0,1
2023-06-01,272975,1,0,1,2,0,2
2023-06-01,271865,1,0,1,1,0,1
2023-06-01,270842,4,23,27,4,1,4
2023-06-01,52278,1,0,1,1,0,1
2023-06-01,19447,63,0,63,3,0,3
2023-06-01,262230,1,1,2,2,2,2
2023-06-01,270995,3,3,6,4,4,5
2023-06-01,28026,1,2,3,2,1,2
2023-06-01,262221,8,0,8,3,0,3
2023-06-01,269985,2,0,2,1,0,1
2023-06-01,270616,7,0,7,1,0,1
2023-06-01,270643,3,2,5,1,1,1
2023-06-01,270633,3,3,6,2,1,2
2023-06-01,27902,22,0,22,2,0,2
2023-06-01,263243,4,0,4,1,0,1
2023-06-01,271189,3,1,4,2,1,2
2023-06-01,270415,2,1,3,2,1,2
2023-06-01,270403,4,1,5,4,1,4
2023-06-01,270404,7,1,8,1,1,1
2023-06-01,265748,1,0,1,1,0,1
2023-06-01,61925,6,0,6,2,0,2
2023-06-01,263245,8,1,9,2,1,2
2023-06-01,264688,25,0,25,3,0,3
2023-06-01,263246,4,1,5,1,1,2
2023-06-01,265751,5,1,6,2,1,2
2023-06-01,52395,1,0,1,1,0,1
2023-06-01,262194,31,12,43,8,3,8
2023-06-01,271952,1,0,1,1,0,1
2023-06-01,264226,1,0,1,1,0,1
2023-06-01,264231,1,1,2,1,1,1
2023-06-01,271286,5,1,6,1,1,1
2023-06-01,271222,3,0,3,1,0,1
2023-06-01,271223,7,1,8,1,1,1
2023-06-01,271233,4,1,5,2,1,3
2023-06-01,271232,3,1,4,4,2,4
2023-06-01,271234,5,1,6,1,1,1
2023-06-01,270100,5,0,5,1,0,1
2023-06-01,271968,4,3,7,1,1,1
2023-06-01,263738,1,0,1,2,0,2
2023-06-01,271914,1,1,2,1,1,1
2023-06-01,264797,40,0,40,3,0,3
2023-06-01,272903,1,0,1,2,0,2
2023-06-01,270405,3,1,4,1,1,1
2023-06-01,270406,4,5,9,4,1,4
2023-06-01,270416,5,0,5,2,0,2
2023-06-01,52285,4,0,4,2,0,2
2023-06-01,52291,1,0,1,1,0,1
2023-06-01,270382,6,6,12,9,4,9
2023-06-01,270011,5,0,5,3,0,3
2023-06-01,270554,3,1,4,1,1,1
2023-06-01,270426,4,1,5,2,1,2
2023-06-01,270555,3,1,4,2,1,2
2023-06-01,270429,2,2,4,2,2,2
2023-06-01,270038,1,0,1,1,0,1
2023-06-01,270430,7,1,8,5,3,5
2023-06-01,270427,1,1,2,2,1,2
2023-06-01,270418,3,1,4,1,1,1
2023-06-01,270410,1,14,15,1,1,1
2023-06-01,270492,1,0,1,1,0,1
2023-06-01,269959,1,0,1,4,0,4
2023-06-01,270446,1,1,2,2,1,2
2023-06-01,270547,3,2,5,2,1,2
2023-06-01,270428,3,3,6,5,4,5
2023-06-01,270421,6,0,6,6,0,6
2023-06-01,52273,8,1,9,3,3,3
2023-06-01,264845,4,1,5,1,1,1
2023-06-01,269718,1,1,2,1,1,1
2023-06-01,270338,0,0,0,2,2,2
2023-06-01,269897,1,0,1,1,0,1
2023-06-01,269708,3,1,4,6,2,6
2023-06-01,269709,3,1,4,3,1,3
2023-06-01,269710,4,2,6,1,1,1
2023-06-01,269711,5,0,5,5,0,5
2023-06-01,269712,6,1,7,4,3,4
2023-06-01,270306,7,8,15,6,5,6
2023-06-01,269905,7,1,8,2,1,2
2023-06-01,270241,7,1,8,5,4,5
2023-06-01,61919,4,0,4,4,0,4
2023-06-01,263228,6,0,6,1,0,1
2023-06-01,22860,4,1,5,4,1,4
2023-06-01,271864,3,0,3,3,0,3
2023-06-01,271883,3,0,3,3,0,3
2023-06-01,271806,4,2,6,1,1,1
2023-06-01,271480,6,1,7,2,1,2
2023-06-01,271926,5,0,5,1,0,1
2023-06-01,271881,1,0,1,2,0,2
2023-06-01,271902,1,0,1,1,0,1
2023-06-01,262178,11,4,15,3,2,3
2023-06-01,263698,6,0,6,1,0,1
2023-06-01,52388,4,1,5,1,1,1
2023-06-01,271272,1,1,2,1,1,1
2023-06-01,52359,2,0,2,4,0,4
2023-06-01,27883,4,0,4,4,0,4
2023-06-01,27996,21,0,21,3,0,3
2023-06-01,270103,1,0,1,1,0,1
2023-06-01,270419,7,7,14,1,1,1
2023-06-01,270556,1,1,2,1,1,1
2023-06-01,270454,6,0,6,1,0,1
2023-06-01,270455,1,1,2,1,1,1
2023-06-01,270431,5,1,6,2,1,2
2023-06-01,270447,7,1,8,5,2,5
2023-06-01,270448,5,1,6,3,3,3
2023-06-01,272563,2,0,2,1,0,1
2023-06-01,271526,7,1,8,1,1,1
2023-06-01,271528,3,1,4,1,1,1
2023-06-01,270843,5,1,6,1,1,1
2023-06-01,270824,4,1,5,1,2,3
2023-06-01,270058,1,0,1,1,0,1
2023-06-01,271652,0,1,1,5,3,6
2023-06-01,270844,5,0,5,1,0,1
2023-06-01,270849,3,1,4,2,1,2
2023-06-01,270845,5,3,8,3,2,3
2023-06-01,270828,5,1,6,2,1,2
2023-06-01,270432,1,1,2,2,2,2
2023-06-01,270449,3,3,6,2,1,2
2023-06-01,270433,4,0,4,3,0,3
2023-06-01,28025,28,0,28,3,0,3
2023-06-01,270821,1,0,1,2,0,2
2023-06-01,270822,1,1,2,1,1,1
2023-06-01,270823,3,1,4,2,1,2
2023-06-01,28049,6,0,6,3,0,3
2023-06-01,272834,3,0,3,1,0,1
2023-06-01,266686,4,0,4,1,0,1
2023-06-01,263223,13,0,13,2,0,2
2023-06-01,270121,1,1,2,1,1,1
2023-06-01,271029,1,0,1,1,0,1
2023-06-01,52390,2,0,2,1,0,1
2023-06-01,271344,3,1,4,1,1,1
2023-06-01,271813,3,0,3,2,0,2
2023-06-01,271323,3,0,3,1,0,1
2023-06-01,271326,3,0,3,1,0,1
2023-06-01,271808,4,0,4,3,0,3
2023-06-01,27877,5,0,5,4,0,4
2023-06-01,52321,4,0,4,2,0,2
2023-06-01,28086,7,1,8,2,1,2
2023-06-01,266204,3,0,3,1,0,1
2023-06-01,27928,49,8,57,2,1,2
2023-06-01,52486,24,0,24,2,0,2
2023-06-01,28051,17,0,17,2,0,2
2023-06-01,52304,1,1,2,6,3,6
2023-06-01,40528,5,3,8,9,8,9
2023-06-01,22894,8,19,27,7,7,9
2023-06-01,271005,1,0,1,1,0,1
2023-06-01,265776,9,0,9,3,0,3
2023-06-01,28109,2,1,3,2,2,2
2023-06-01,270860,7,1,8,5,4,5
2023-06-01,270456,5,1,6,2,1,2
2023-06-01,52269,1,0,1,3,0,3
2023-06-01,13682,26,0,26,2,0,2
2023-06-01,15754,1,0,1,5,0,5
2023-06-01,264718,3,1,4,2,1,2
2023-06-01,264714,2,0,2,3,0,3
2023-06-01,27864,1,0,1,1,0,1
2023-06-01,263199,5,0,5,4,0,4
2023-06-01,270146,1,0,1,1,0,1
2023-06-01,272846,1,0,1,1,0,1
2023-06-01,272107,1,0,1,3,0,3
2023-06-01,271536,1,0,1,1,0,1
2023-06-01,11934,1,0,1,2,0,2
2023-06-01,52326,4,0,4,1,0,1
2023-06-01,19192,1,1,2,1,1,2
2023-06-01,27771,1,0,1,1,0,1
2023-06-01,271788,5,0,5,1,0,1
2023-06-01,271238,4,1,5,1,1,1
2023-06-01,271792,3,1,4,2,1,2
2023-06-01,271260,3,0,3,1,0,1
2023-06-01,270098,4,0,4,2,0,2
2023-06-01,271279,3,1,4,6,2,6
2023-06-01,25620,67,1,68,2,1,2
2023-06-01,11750,3,0,3,1,0,1
2023-06-01,263255,3,2,5,3,2,3
2023-06-01,52504,5,0,5,1,0,1
2023-06-01,265719,3,0,3,1,0,1
2023-06-01,27761,18,0,18,1,0,1
2023-06-01,270959,3,4,7,2,2,2
2023-06-01,262181,35,0,35,4,0,4
2023-06-01,271375,1,0,1,3,0,3
2023-06-01,271691,2,3,5,3,2,3
2023-06-01,262222,3,0,3,1,0,1
2023-06-01,272843,15,0,15,3,0,3
2023-06-01,28044,1,0,1,1,0,1
2023-06-01,266153,3,3,6,1,1,1
2023-06-01,266176,4,1,5,4,1,4
2023-06-01,52484,2,0,2,1,0,1
2023-06-01,28012,3,0,3,3,0,3
2023-06-01,28035,1,0,1,4,0,4
2023-06-01,262264,1,0,1,2,0,2
2023-06-01,399051,1,0,1,1,0,1
2023-06-01,52292,9,0,9,3,0,3
2023-06-01,52280,7,1,8,1,2,2
2023-06-01,267853,1,1,2,1,1,1
2023-06-01,52295,5,0,5,3,0,3
2023-06-01,271836,2,0,2,1,0,1
2023-06-01,52479,1,0,1,1,0,1
2023-06-01,27998,1,0,1,2,0,2
2023-06-01,263771,12,0,12,3,0,3
2023-06-01,52319,1,0,1,1,0,1
2023-06-01,14339,2,0,2,1,0,1
2023-06-01,266708,1,0,1,1,0,1
2023-06-01,52299,1,0,1,3,0,3
2023-06-01,52277,1,0,1,1,0,1
2023-06-01,52434,1,0,1,1,0,1
2023-06-01,52256,1,0,1,2,0,2
2023-06-01,19611,48,0,48,3,0,3
2023-06-01,263532,7,3,10,6,4,6
2023-06-01,263533,1,0,1,4,0,4
2023-06-01,263547,3,0,3,2,0,2
2023-06-01,263537,12,5,17,5,4,5
2023-06-01,263538,3,1,4,1,1,1
2023-06-01,263539,11,4,15,6,4,6
2023-06-01,266051,1,0,1,1,0,1
2023-06-01,263550,3,0,3,2,0,2
2023-06-01,271239,2,0,2,2,0,2
2023-06-01,61903,1,1,2,1,2,2
2023-06-01,263312,1,0,1,1,0,1
2023-06-01,269104,0,1,1,2,2,3
2023-06-01,263549,10,0,10,3,0,3
2023-06-01,263548,1,1,2,1,1,1
2023-06-01,263305,4,0,4,1,0,1
2023-06-01,61915,3,1,4,3,2,3
2023-06-01,263299,7,0,7,2,0,2
2023-06-01,263302,11,1,12,4,1,5
2023-06-01,272481,0,1,1,3,2,3
2023-06-01,263304,8,0,8,3,0,3
2023-06-01,263307,4,0,4,2,0,2
2023-06-01,272479,0,1,1,3,1,3
2023-06-01,263308,5,0,5,4,0,4
2023-06-01,263309,6,1,7,7,2,8
2023-06-01,263310,4,0,4,4,0,4
2023-06-01,271014,7,58,65,1,1,1
2023-06-01,270079,1,0,1,1,0,1
2023-06-01,263316,2,1,3,1,1,1
2023-06-01,263317,4,0,4,3,0,3
2023-06-01,263320,17,3,20,5,2,5
2023-06-01,263326,5,1,6,1,2,2
2023-06-01,263325,1,1,2,1,1,1
2023-06-01,263335,7,1,8,3,1,3
2023-06-01,263333,6,0,6,2,0,2
2023-06-01,263337,5,0,5,5,0,5
2023-06-01,263340,3,1,4,1,1,1
2023-06-01,263342,3,1,4,3,1,3
2023-06-01,263343,3,1,4,3,1,3
2023-06-01,263344,3,0,3,2,0,2
2023-06-01,263358,1,0,1,3,0,3
2023-06-01,263364,1,0,1,1,0,1
2023-06-01,263381,1,0,1,2,0,2
2023-06-01,263348,3,1,4,1,1,1
2023-06-01,263350,5,1,6,2,1,2
2023-06-01,263351,6,0,6,1,0,1
2023-06-01,263352,5,1,6,1,1,1
2023-06-01,263353,5,3,8,4,2,4
2023-06-01,263356,15,7,22,3,2,3
2023-06-01,270972,4,1,5,7,2,7
2023-06-01,270973,7,0,7,1,0,1
2023-06-01,263357,8,0,8,3,0,3
2023-06-01,263359,8,1,9,2,2,3
2023-06-01,263360,3,3,6,2,2,2
2023-06-01,263369,9,0,9,2,0,2
2023-06-01,263370,5,0,5,1,0,1
2023-06-01,263404,4,0,4,2,0,2
2023-06-01,263371,5,1,6,1,1,1
2023-06-01,263372,1,0,1,1,0,1
2023-06-01,263375,11,0,11,1,0,1
2023-06-01,270050,1,0,1,1,0,1
2023-06-01,263417,1,0,1,2,0,2
2023-06-01,263273,1,0,1,3,0,3
2023-06-01,263257,1,1,2,2,1,2
2023-06-01,263410,3,3,6,1,1,1
2023-06-01,263282,55,7,62,3,3,3
2023-06-01,270037,4,1,5,4,2,4
2023-06-01,27805,1,0,1,1,0,1
2023-06-01,210977,1,1,2,1,1,1
2023-06-01,271838,1,0,1,1,0,1
2023-06-01,52498,1,1,2,1,1,1
2023-06-01,263229,0,0,0,4,0,4
2023-06-01,263209,3,0,3,1,0,1
2023-06-01,264663,7,1,8,1,1,1
2023-06-01,263212,1,0,1,1,0,1
2023-06-01,26621,14,0,14,3,0,3
2023-06-01,264733,9,5,14,3,3,3
2023-06-01,263215,1,0,1,1,0,1
2023-06-01,263216,2,1,3,2,1,2
2023-06-01,263219,6,6,12,4,2,4
2023-06-01,263177,1,0,1,1,0,1
2023-06-01,262929,2,0,2,1,0,1
2023-06-01,262928,23,11,34,5,4,5
2023-06-01,262931,1,1,2,2,2,2
2023-06-01,27836,1,0,1,1,0,1
2023-06-01,62663,1,1,2,10,9,14
2023-06-01,263663,7,7,14,4,3,4
2023-06-01,263664,7,3,10,2,2,2
2023-06-01,263666,2,5,7,4,4,5
2023-06-01,263667,1,3,4,1,3,3
2023-06-01,271158,1,1,2,1,1,1
2023-06-01,270106,3,0,3,2,0,2
2023-06-01,263676,5,0,5,1,0,1
2023-06-01,263677,14,0,14,1,0,1
2023-06-01,263469,22,1,23,7,2,7
2023-06-01,272659,0,7,7,5,2,5
2023-06-01,263473,7,1,8,3,3,3
2023-06-01,263475,5,1,6,5,3,5
2023-06-01,263477,5,1,6,2,2,3
2023-06-01,263476,12,0,12,3,0,3
2023-06-01,263143,5,1,6,7,4,7
2023-06-01,263480,1,1,2,2,2,2
2023-06-01,263485,4,0,4,1,0,1
2023-06-01,263492,1,1,2,1,1,1
2023-06-01,263493,6,1,7,1,1,1
2023-06-01,263494,4,0,4,2,0,2
2023-06-01,263497,1,1,2,1,1,1
2023-06-01,263499,6,3,9,1,1,1
2023-06-01,263501,4,0,4,1,0,1
2023-06-01,271026,4,0,4,3,0,3
2023-06-01,263156,3,1,4,2,1,2
2023-06-01,263507,7,3,10,4,4,5
2023-06-01,263510,1,0,1,1,0,1
2023-06-01,263512,4,2,6,2,3,3
2023-06-01,263513,6,1,7,1,1,1
2023-06-01,263515,3,0,3,1,0,1
2023-06-01,263519,5,1,6,4,1,4
2023-06-01,272718,0,1,1,2,2,3
2023-06-01,263524,5,3,8,2,2,2
2023-06-01,263525,15,3,18,6,4,6
2023-06-01,272539,14,7,21,1,1,1
2023-06-01,14660,1,0,1,3,0,3
2023-06-01,11282,12,3,15,2,1,2
2023-06-01,26711,1,1,2,1,1,1
2023-06-01,20144,8,9,17,23,15,24
2023-06-01,16876,5,3,8,5,3,5
2023-06-01,26710,7,6,13,3,3,3
2023-06-01,62659,18,0,18,4,0,4
2023-06-01,1855,2,0,2,1,0,1
2023-06-01,54735,5,0,5,2,0,2
2023-06-01,40632,2,0,2,1,0,1
2023-06-01,3557,2,2,4,5,4,5
2023-06-01,30130,0,0,0,2,2,2
2023-06-01,396739,1,0,1,2,0,2
2023-06-01,397204,5,5,10,2,2,2
2023-06-01,396547,5,0,5,2,0,2
2023-06-01,63029,1,0,1,2,0,2
2023-06-01,12081,1,0,1,2,0,2
2023-06-01,775,4,0,4,1,0,1
2023-06-01,10925,1,0,1,2,0,2
2023-06-01,23192,1,0,1,1,0,1
2023-06-01,11978,4,0,4,2,0,2
2023-06-01,393412,1,0,1,2,0,2
2023-06-01,36551,3,0,3,2,0,2
2023-06-01,3431,4,0,4,1,0,1
2023-06-01,63056,2,1,3,3,1,3
2023-06-01,10961,3,0,3,4,0,4
2023-06-01,78,1,0,1,1,0,1
2023-06-01,62905,1,0,1,2,0,2
2023-06-01,393281,1,0,1,2,0,2
2023-06-01,29797,1,0,1,1,0,1
2023-06-01,62973,1,0,1,1,0,1
2023-06-01,395266,19,4,23,8,4,10
2023-06-01,24084,82,0,82,5,0,5
2023-06-01,29861,2,0,2,1,0,1
2023-06-01,393379,1,0,1,2,0,2
2023-06-01,397870,1,0,1,3,0,3
2023-06-01,11948,2,0,2,3,0,3
2023-06-01,21556,2,1,3,3,2,3
2023-06-01,55088,4,1,5,2,1,2
2023-06-01,6305,2,0,2,3,0,3
2023-06-01,1852,1,0,1,1,0,1
2023-06-01,54663,1,0,1,1,0,1
2023-06-01,22945,5,0,5,3,0,3
2023-06-01,26007,1,0,1,1,0,1
2023-06-01,328283,1,1,2,3,1,3
2023-06-01,328268,1,1,2,1,1,1
2023-06-01,398725,1,0,1,1,0,1
2023-06-01,393382,1,0,1,2,0,2
2023-06-01,22788,3,0,3,5,0,5
2023-06-01,33726,1,0,1,1,0,1
2023-06-01,394924,1,0,1,1,0,1
2023-06-01,63331,3,6,9,1,2,2
2023-06-01,393295,1,0,1,1,0,1
2023-06-01,26069,1,0,1,3,0,3
2023-06-01,62606,2,0,2,1,0,1
2023-06-01,13697,1,0,1,2,0,2
2023-06-01,55173,3,0,3,2,0,2
2023-06-01,19348,1,0,1,1,0,1
2023-06-01,395164,1,0,1,1,0,1
2023-06-01,55244,7,2,9,7,5,8
2023-06-01,397886,4,0,4,1,0,1
2023-06-01,40454,1,0,1,1,0,1
2023-06-01,8973,2,0,2,1,0,1
2023-06-01,2845,1,0,1,1,0,1
2023-06-01,32655,1,1,2,2,2,2
2023-06-01,4697,7,1,8,2,1,2
2023-06-01,1888,4,0,4,1,0,1
2023-06-01,21345,1,0,1,1,0,1
2023-06-01,2567,1,0,1,2,0,2
2023-06-01,396885,1,0,1,2,0,2
2023-06-01,30080,1,0,1,2,0,2
2023-06-01,14496,3,0,3,3,0,3
2023-06-01,32680,1,0,1,3,0,3
2023-06-01,400632,1,0,1,1,0,1
2023-06-01,1315,1,0,1,1,0,1
2023-06-01,33466,1,0,1,1,0,1
2023-06-01,7667,2,2,4,4,1,4
2023-06-01,32684,1,0,1,3,0,3
2023-06-01,211722,1,10,11,1,4,4
2023-06-01,53410,2,0,2,1,0,1
2023-06-01,33681,1,0,1,1,0,1
2023-06-01,64247,2,1,3,2,2,2
2023-06-01,48984,2,0,2,2,0,2
2023-06-01,397241,1,0,1,1,0,1
2023-06-01,397235,1,0,1,1,0,1
2023-06-01,63081,2,0,2,1,0,1
2023-06-01,27261,2,0,2,1,0,1
2023-06-01,53701,1,0,1,1,0,1
2023-06-01,31964,1,0,1,3,0,3
2023-06-01,30685,3,1,4,3,2,3
2023-06-01,23413,9,0,9,4,0,4
2023-06-01,1627,1,0,1,3,0,3
2023-06-01,10896,4,0,4,3,0,3
2023-06-01,393405,1,0,1,2,0,2
2023-06-01,29872,1,0,1,1,0,1
2023-06-01,54520,3,0,3,2,0,2
2023-06-01,63454,2,0,2,4,0,4
2023-06-01,393516,2,0,2,2,0,2
2023-06-01,33534,1,0,1,1,0,1
2023-06-01,6492,6,5,11,1,1,1
2023-06-01,393410,1,0,1,1,0,1
2023-06-01,46821,1,0,1,4,0,4
2023-06-01,56473,4,0,4,3,0,3
2023-06-01,18668,1,0,1,2,0,2
2023-06-01,14681,1,0,1,1,0,1
2023-06-01,39952,1,1,2,3,1,3
2023-06-01,32599,1,0,1,2,0,2
2023-06-01,36281,1,0,1,1,0,1
2023-06-01,54840,2,0,2,3,0,3
2023-06-01,23275,4,0,4,3,0,3
2023-06-01,32304,2,0,2,2,0,2
2023-06-01,19770,1,1,2,2,1,2
2023-06-01,54481,3,0,3,2,0,2
2023-06-01,46640,2,0,2,1,0,1
2023-06-01,3555,12,0,12,1,0,1
2023-06-01,40971,1,0,1,1,0,1
2023-06-01,36729,1,0,1,2,0,2
2023-06-01,26988,1,2,3,3,2,3
2023-06-01,46789,3,0,3,2,0,2
2023-06-01,54190,1,0,1,1,0,1
2023-06-01,393512,3,0,3,4,0,4
2023-06-01,393404,1,0,1,1,0,1
2023-06-01,393407,1,0,1,1,0,1
2023-06-01,16757,1,0,1,1,0,1
2023-06-01,14428,2,0,2,2,0,2
2023-06-01,2738,1,0,1,1,0,1
2023-06-01,21759,3,0,3,3,0,3
2023-06-01,30704,1,0,1,3,0,3
2023-06-01,23165,2,0,2,1,0,1
2023-06-01,10943,1,0,1,2,0,2
2023-06-01,393479,1,0,1,2,0,2
2023-06-01,40478,1,0,1,1,0,1
2023-06-01,393506,1,0,1,2,0,2
2023-06-01,394971,2,0,2,1,0,1
2023-06-01,54017,2,0,2,3,0,3
2023-06-01,22233,1,0,1,1,0,1
2023-06-01,26708,1,0,1,2,0,2
2023-06-01,112,2,2,4,16,11,20
2023-06-01,40566,1,0,1,2,0,2
2023-06-01,393419,1,0,1,1,0,1
2023-06-01,54167,2,0,2,1,0,1
2023-06-01,2149,1,1,2,1,1,1
2023-06-01,36637,2,0,2,3,0,3
2023-06-01,396688,2,2,4,2,2,2
2023-06-01,396756,2,0,2,2,0,2
2023-06-01,396654,2,1,3,2,2,2
2023-06-01,396686,2,0,2,2,0,2
2023-06-01,396712,2,2,4,2,2,2
2023-06-01,396758,2,2,4,2,2,2
2023-06-01,396729,2,2,4,2,2,2
2023-06-01,36362,1,0,1,1,0,1
2023-06-01,16411,4,1,5,1,1,1
2023-06-01,22802,1,0,1,3,0,3
2023-06-01,40674,1,0,1,2,0,2
2023-06-01,36253,2,0,2,6,0,6
2023-06-01,2445,2,0,2,1,0,1
2023-06-01,393990,3,1,4,4,2,4
2023-06-01,46634,4,0,4,1,0,1
2023-06-01,6141,1,0,1,2,0,2
2023-06-01,54297,1,1,2,1,1,1
2023-06-01,12276,1,1,2,3,2,3
2023-06-01,14458,2,0,2,3,0,3
2023-06-01,18904,1,0,1,1,0,1
2023-06-01,26796,2,0,2,1,0,1
2023-06-01,393409,1,0,1,1,0,1
2023-06-01,14442,5,1,6,2,3,3
2023-06-01,17140,7,0,7,4,0,4
2023-06-01,393651,1,0,1,2,0,2
2023-06-01,63098,1,0,1,1,0,1
2023-06-01,971,1,1,2,1,1,1
2023-06-01,18864,3,0,3,3,0,3
2023-06-01,26822,1,0,1,3,0,3
2023-06-01,30151,1,0,1,1,0,1
2023-06-01,63116,3,0,3,1,0,1
2023-06-01,397659,2,0,2,2,0,2
2023-06-01,396056,1,1,2,3,3,3
2023-06-01,54712,1,0,1,1,0,1
2023-06-01,47033,1,0,1,1,0,1
2023-06-01,22455,1,0,1,4,0,4
2023-06-01,393420,1,1,2,2,1,2
2023-06-01,46498,4,0,4,2,0,2
2023-06-01,22546,1,0,1,2,0,2
2023-06-01,16486,1,0,1,1,0,1
2023-06-01,31790,3,0,3,3,0,3
2023-06-01,18853,10,1,11,3,1,3
2023-06-01,393482,1,0,1,1,0,1
2023-06-01,198573,4,1,5,1,2,3
2023-06-01,3921,2,0,2,3,0,3
2023-06-01,14531,1,0,1,1,0,1
2023-06-01,397773,2,0,2,2,0,2
2023-06-01,47082,1,0,1,1,0,1
2023-06-01,40858,1,0,1,2,0,2
2023-06-01,22262,2,0,2,3,0,3
2023-06-01,11791,2,0,2,2,0,2
2023-06-01,397495,1,0,1,3,0,3
2023-06-01,46363,1,0,1,2,0,2
2023-06-01,35038,4,0,4,1,0,1
2023-06-01,14198,1,0,1,2,0,2
2023-06-01,9201,23,11,34,4,6,6
2023-06-01,48764,1,0,1,1,0,1
2023-06-01,47699,1,1,2,2,1,2
2023-06-01,200606,9,0,9,1,0,1
2023-06-01,12782,9,1,10,1,1,1
2023-06-01,1882,1,0,1,1,0,1
2023-06-01,5411,25,3,28,3,3,3
2023-06-01,2865,5,0,5,1,0,1
2023-06-01,198476,5,1,6,3,3,3
2023-06-01,199902,5,1,6,1,1,1
2023-06-01,2838,1,0,1,1,0,1
2023-06-01,39871,1,1,2,3,3,3
2023-06-01,39870,1,1,2,5,3,5
2023-06-01,39840,1,1,2,3,3,3
2023-06-01,1883,2,0,2,2,0,2
2023-06-01,29216,2,2,4,1,1,1
2023-06-01,60238,3,0,3,3,0,3
2023-06-01,211434,7,3,10,3,1,3
2023-06-01,61413,1,1,2,3,1,3
2023-06-01,5601,3,0,3,2,0,2
2023-06-01,393473,1,0,1,3,0,3
2023-06-01,18951,1,0,1,2,0,2
2023-06-01,22757,1,0,1,3,0,3
2023-06-01,25770,2,0,2,2,0,2
2023-06-01,400598,1,0,1,1,0,1
2023-06-01,393438,1,0,1,1,0,1
2023-06-01,63151,2,0,2,2,0,2
2023-06-01,393470,1,0,1,1,0,1
2023-06-01,54250,1,0,1,3,0,3
2023-06-01,20395,1,0,1,2,0,2
2023-06-01,13889,1,0,1,2,0,2
2023-06-01,26811,2,0,2,1,0,1
2023-06-01,32930,1,0,1,2,0,2
2023-06-01,51485,2,0,2,1,0,1
2023-06-01,5420,6,2,8,5,3,5
2023-06-01,27367,2,1,3,5,1,5
2023-06-01,30539,9,2,11,7,5,7
2023-06-01,26538,1,0,1,1,0,1
2023-06-01,63115,1,0,1,1,0,1
2023-06-01,11364,2,0,2,1,0,1
2023-06-01,46445,1,0,1,3,0,3
2023-06-01,3785,4,0,4,4,0,4
2023-06-01,30304,3,0,3,4,0,4
2023-06-01,396371,1,0,1,4,0,4
2023-06-01,14472,6,0,6,1,0,1
2023-06-01,63224,2,0,2,3,0,3
2023-06-01,40482,1,0,1,1,0,1
2023-06-01,31830,1,0,1,3,0,3
2023-06-01,393425,2,0,2,1,0,1
2023-06-01,63161,2,2,4,3,3,3
2023-06-01,18870,2,0,2,1,0,1
2023-06-01,63458,1,0,1,3,0,3
2023-06-01,29714,1,0,1,1,0,1
2023-06-01,395317,1,0,1,1,0,1
2023-06-01,63108,1,0,1,1,0,1
2023-06-01,32428,2,0,2,2,0,2
2023-06-01,17341,3,0,3,1,0,1
2023-06-01,16569,2,0,2,3,0,3
2023-06-01,397195,4,0,4,1,0,1
2023-06-01,396558,4,0,4,1,0,1
2023-06-01,396571,5,4,9,2,2,2
2023-06-01,396613,4,0,4,1,0,1
2023-06-01,4767,4,1,5,2,2,2
2023-06-01,393550,1,0,1,2,0,2
2023-06-01,33610,1,0,1,1,0,1
2023-06-01,198423,1,1,2,1,1,1
2023-06-01,229,2,1,3,3,2,3
2023-06-01,46319,1,0,1,2,0,2
2023-06-01,20348,1,0,1,2,0,2
2023-06-01,63126,2,1,3,1,1,1
2023-06-01,393690,1,0,1,3,0,3
2023-06-01,63067,1,0,1,1,0,1
2023-06-01,1102,3,1,4,2,1,2
2023-06-01,393592,1,0,1,4,0,4
2023-06-01,54556,1,0,1,1,0,1
2023-06-01,393566,1,0,1,3,0,3
2023-06-01,10690,11,1,12,8,1,8
2023-06-01,60251,1,1,2,1,1,1
2023-06-01,31940,1,0,1,2,0,2
2023-06-01,55115,1,0,1,2,0,2
2023-06-01,36228,1,0,1,2,0,2
2023-06-01,397956,2,0,2,5,0,5
2023-06-01,25621,1,0,1,1,0,1
2023-06-01,7194,12,1,13,4,1,4
2023-06-01,32487,1,0,1,1,0,1
2023-06-01,135520,1,0,1,1,0,1
2023-06-01,53677,1,0,1,2,0,2
2023-06-01,393563,1,0,1,1,0,1
2023-06-01,399840,1,2,3,1,1,1
2023-06-01,397734,1,0,1,1,0,1
2023-06-01,393554,1,0,1,1,0,1
2023-06-01,63194,1,0,1,1,0,1
2023-06-01,20099,1,1,2,3,3,3
2023-06-01,50897,4,0,4,1,0,1
2023-06-01,2263,2,1,3,1,1,1
2023-06-01,50764,1,0,1,1,0,1
2023-06-01,17020,1,0,1,1,0,1
2023-06-01,132596,3,0,3,3,0,3
2023-06-01,7674,3,1,4,1,2,3
2023-06-01,54875,1,0,1,1,0,1
2023-06-01,15052,1,0,1,1,0,1
2023-06-01,2030,4,0,4,1,0,1
2023-06-01,63087,1,0,1,2,0,2
2023-06-01,393531,1,0,1,1,0,1
2023-06-01,393613,4,0,4,4,0,4
2023-06-01,26365,1,1,2,2,2,2
2023-06-01,397920,2,0,2,1,0,1
2023-06-01,399043,1,0,1,1,0,1
2023-06-01,29716,3,0,3,4,0,4
2023-06-01,157,2,0,2,1,0,1
2023-06-01,19838,1,0,1,2,0,2
2023-06-01,396981,1,0,1,1,0,1
2023-06-01,29764,1,0,1,2,0,2
2023-06-01,19682,1,0,1,1,0,1
2023-06-01,393548,1,0,1,1,0,1
2023-06-01,764,30,0,30,1,0,1
2023-06-01,49422,1,0,1,2,0,2
2023-06-01,7500,3,1,4,12,8,14
2023-06-01,23634,1,1,2,3,4,6
2023-06-01,55396,2,1,3,2,2,3
2023-06-01,59128,1,1,2,4,2,4
2023-06-01,15356,1,0,1,1,0,1
2023-06-01,40608,2,0,2,1,0,1
2023-06-01,36359,1,1,2,3,1,3
2023-06-01,393520,1,0,1,2,0,2
2023-06-01,31952,1,0,1,3,0,3
2023-06-01,3756,7,1,8,4,3,4
2023-06-01,398243,1,0,1,1,0,1
2023-06-01,63244,1,0,1,2,0,2
2023-06-01,399919,1,0,1,1,0,1
2023-06-01,8937,9,0,9,1,0,1
2023-06-01,8687,4,0,4,2,0,2
2023-06-01,13039,8,1,9,6,7,8
2023-06-01,205736,3,0,3,3,0,3
2023-06-01,393567,3,0,3,4,0,4
2023-06-01,17294,2,0,2,1,0,1
2023-06-01,23433,2,0,2,2,0,2
2023-06-01,15228,3,0,3,3,0,3
2023-06-01,27243,1,0,1,1,0,1
2023-06-01,393765,1,0,1,3,0,3
2023-06-01,198773,1,0,1,1,0,1
2023-06-01,64239,1,0,1,3,0,3
2023-06-01,31782,10,0,10,1,0,1
2023-06-01,397552,1,0,1,1,0,1
2023-06-01,55958,6,0,6,3,0,3
2023-06-01,4505,1,0,1,2,0,2
2023-06-01,40739,1,0,1,3,0,3
2023-06-01,14255,6,0,6,1,0,1
2023-06-01,393395,1,0,1,1,0,1
2023-06-01,63180,1,0,1,3,0,3
2023-06-01,3380,4,0,4,1,0,1
2023-06-01,393557,1,0,1,2,0,2
2023-06-01,393553,1,0,1,1,0,1
2023-06-01,16761,40,0,40,5,0,5
2023-06-01,62928,2,0,2,2,0,2
2023-06-01,16927,2,0,2,1,0,1
2023-06-01,399848,1,0,1,1,0,1
2023-06-01,393576,1,0,1,1,0,1
2023-06-01,63097,1,0,1,1,0,1
2023-06-01,26723,1,0,1,3,0,3
2023-06-01,393616,2,0,2,2,0,2
2023-06-01,393622,1,0,1,1,0,1
2023-06-01,400316,1,1,2,2,2,2
2023-06-01,11736,9,0,9,2,0,2
2023-06-01,26823,1,0,1,2,0,2
2023-06-01,63171,1,0,1,2,0,2
2023-06-01,393639,1,0,1,3,0,3
2023-06-01,26443,1,0,1,3,0,3
2023-06-01,63221,2,0,2,1,0,1
2023-06-01,1293,5,0,5,2,0,2
2023-06-01,393593,1,0,1,1,0,1
2023-06-01,8837,1,0,1,1,0,1
2023-06-01,32155,2,0,2,3,0,3
2023-06-01,22782,1,0,1,1,0,1
2023-06-01,13862,1,0,1,1,0,1
2023-06-01,6199,2,0,2,4,0,4
2023-06-01,396620,1,2,3,2,2,2
2023-06-01,396702,1,2,3,2,2,2
2023-06-01,63234,1,0,1,3,0,3
2023-06-01,36525,2,0,2,2,0,2
2023-06-01,393522,1,0,1,1,0,1
2023-06-01,53336,1,0,1,1,0,1
2023-06-01,46122,1,0,1,1,0,1
2023-06-01,25746,1,0,1,1,0,1
2023-06-01,6072,7,0,7,3,0,3
2023-06-01,2021,2,0,2,3,0,3
2023-06-01,397701,2,0,2,3,0,3
2023-06-01,396359,1,0,1,1,0,1
2023-06-01,63278,2,0,2,3,0,3
2023-06-01,62782,1,0,1,4,0,4
2023-06-01,398306,1,0,1,1,0,1
2023-06-01,15097,1,0,1,3,0,3
2023-06-01,393683,1,0,1,1,0,1
2023-06-01,393716,1,0,1,1,0,1
2023-06-01,19867,6,0,6,1,0,1
2023-06-01,26679,2,2,4,2,1,2
2023-06-01,398669,3,0,3,3,0,3
2023-06-01,30617,1,1,2,1,2,2
2023-06-01,398949,2,0,2,3,0,3
2023-06-01,53481,1,0,1,1,0,1
2023-06-01,393668,1,16,17,2,1,2
2023-06-01,10406,12,0,12,4,0,4
2023-06-01,54582,1,0,1,1,0,1
2023-06-01,393766,1,0,1,1,0,1
2023-06-01,17109,2,0,2,1,0,1
2023-06-01,54224,3,0,3,2,0,2
2023-06-01,46764,3,1,4,1,1,1
2023-06-01,55033,4,0,4,1,0,1
2023-06-01,19758,2,0,2,2,0,2
2023-06-01,19121,1,0,1,1,0,1
2023-06-01,9792,4,0,4,3,0,3
2023-06-01,40421,1,0,1,3,0,3
2023-06-01,51063,3,0,3,1,0,1
2023-06-01,397644,7,0,7,2,0,2
2023-06-01,63245,1,0,1,2,0,2
2023-06-01,32092,1,0,1,1,0,1
2023-06-01,210149,11,0,11,1,0,1
2023-06-01,34506,4,0,4,2,0,2
2023-06-01,395619,1,0,1,3,0,3
2023-06-01,393663,2,0,2,3,0,3
2023-06-01,63301,1,0,1,1,0,1
2023-06-01,36010,1,0,1,1,0,1
2023-06-01,393681,2,1,3,4,1,4
2023-06-01,23104,1,0,1,2,0,2
2023-06-01,22579,1,0,1,3,0,3
2023-06-01,11360,5,0,5,4,0,4
2023-06-01,32642,1,0,1,3,0,3
2023-06-01,393811,1,0,1,4,0,4
2023-06-01,63291,1,0,1,1,0,1
2023-06-01,393633,1,0,1,1,0,1
2023-06-01,393669,3,0,3,4,0,4
2023-06-01,393949,1,2,3,1,2,2
2023-06-01,30171,2,0,2,2,0,2
2023-06-01,20488,23,0,23,3,0,3
2023-06-01,204911,1,1,2,4,4,5
2023-06-01,202893,3,0,3,5,0,5
2023-06-01,198743,1,1,2,1,1,1
2023-06-01,399190,1,0,1,1,0,1
2023-06-01,26698,1,0,1,2,0,2
2023-06-01,36623,1,0,1,2,0,2
2023-06-01,63193,1,0,1,3,0,3
2023-06-01,397402,1,0,1,1,0,1
2023-06-01,46641,1,0,1,2,0,2
2023-06-01,266869,1,1,2,1,1,1
2023-06-01,393546,1,0,1,2,0,2
2023-06-01,26835,3,0,3,2,0,2
2023-06-01,53964,1,0,1,2,0,2
2023-06-01,21729,2,0,2,1,0,1
2023-06-01,14746,9,2,11,6,3,8
2023-06-01,47073,1,0,1,1,0,1
2023-06-01,11142,2,1,3,1,3,3
2023-06-01,393717,1,1,2,1,1,1
2023-06-01,63247,1,0,1,1,0,1
2023-06-01,40491,2,0,2,2,0,2
2023-06-01,394248,1,0,1,2,0,2
2023-06-01,54617,3,0,3,3,0,3
2023-06-01,33168,21,0,21,3,0,3
2023-06-01,53800,1,1,2,2,2,2
2023-06-01,9408,4,0,4,5,0,5
2023-06-01,63289,1,0,1,1,0,1
2023-06-01,63280,2,0,2,3,0,3
2023-06-01,395361,1,1,2,1,1,1
2023-06-01,396952,4,1,5,1,1,1
2023-06-01,393685,1,0,1,3,0,3
2023-06-01,396254,2,0,2,3,0,3
2023-06-01,393745,1,0,1,2,0,2
2023-06-01,395333,3,0,3,3,0,3
2023-06-01,397110,1,2,3,1,1,1
2023-06-01,63300,1,0,1,3,0,3
2023-06-01,53568,4,0,4,3,0,3
2023-06-01,17207,12,0,12,1,0,1
2023-06-01,25072,2,0,2,1,0,1
2023-06-01,24605,1,1,2,1,1,1
2023-06-01,200559,2,1,3,1,1,1
2023-06-01,205841,3,0,3,2,0,2
2023-06-01,28680,3,2,5,2,2,2
2023-06-01,210802,1,0,1,2,0,2
2023-06-01,3166,10,2,12,3,3,3
2023-06-01,198054,7,0,7,2,0,2
2023-06-01,206320,3,1,4,2,1,2
2023-06-01,209797,2,0,2,1,0,1
2023-06-01,207396,2,0,2,1,0,1
2023-06-01,13827,1,0,1,3,0,3
2023-06-01,397944,1,0,1,3,0,3
2023-06-01,21933,6,0,6,2,0,2
2023-06-01,54803,3,0,3,3,0,3
2023-06-01,140099,2,0,2,5,0,5
2023-06-01,11743,3,0,3,3,0,3
2023-06-01,393700,1,0,1,2,0,2
2023-06-01,14599,1,0,1,1,0,1
2023-06-01,394735,1,0,1,2,0,2
2023-06-01,21997,1,0,1,1,0,1
2023-06-01,3425,2,0,2,1,0,1
2023-06-01,16545,1,0,1,2,0,2
2023-06-01,32643,1,0,1,1,0,1
2023-06-01,32638,9,1,10,3,1,3
2023-06-01,399031,1,1,2,2,1,2
2023-06-01,29939,1,0,1,1,0,1
2023-06-01,393606,1,0,1,1,0,1
2023-06-01,14426,3,0,3,2,0,2
2023-06-01,1958,1,0,1,1,0,1
2023-06-01,30045,18,8,26,3,1,3
2023-06-01,63308,1,0,1,1,0,1
2023-06-01,396515,1,0,1,2,0,2
2023-06-01,26871,6,0,6,2,0,2
2023-06-01,14843,13,0,13,2,0,2
2023-06-01,393549,1,0,1,2,0,2
2023-06-01,15368,5,5,10,4,3,4
2023-06-01,1064,1,0,1,1,0,1
2023-06-01,21749,1,0,1,2,0,2
2023-06-01,393732,1,4,5,2,3,3
2023-06-01,3715,3,0,3,2,0,2
2023-06-01,35052,2,2,4,10,7,10
2023-06-01,27625,1,1,2,1,1,1
2023-06-01,29700,2,0,2,3,0,3
2023-06-01,394467,2,0,2,3,0,3
2023-06-01,32193,1,0,1,3,0,3
2023-06-01,11032,19,0,19,1,0,1
2023-06-01,17369,4,0,4,2,0,2
2023-06-01,36855,1,0,1,2,0,2
2023-06-01,30677,2,0,2,1,0,1
2023-06-01,394008,1,0,1,3,0,3
2023-06-01,26432,1,0,1,1,0,1
2023-06-01,6950,7,0,7,1,0,1
2023-06-01,63273,1,0,1,1,0,1
2023-06-01,398927,3,0,3,3,0,3
2023-06-01,63455,1,0,1,1,0,1
2023-06-01,56941,3,0,3,2,0,2
2023-06-01,12156,3,0,3,1,0,1
2023-06-01,5783,5,0,5,3,0,3
2023-06-01,394483,1,0,1,1,0,1
2023-06-01,26547,1,0,1,2,0,2
2023-06-01,400319,1,0,1,1,0,1
2023-06-01,394324,1,0,1,1,0,1
2023-06-01,55187,1,0,1,2,0,2
2023-06-01,11782,2,0,2,3,0,3
2023-06-01,63364,1,0,1,3,0,3
2023-06-01,63326,2,1,3,3,2,3
2023-06-01,54945,3,1,4,3,2,3
2023-06-01,63310,1,0,1,1,0,1
2023-06-01,46966,1,1,2,2,1,2
2023-06-01,393730,1,0,1,1,0,1
2023-06-01,40854,1,0,1,3,0,3
2023-06-01,7936,6,0,6,3,0,3
2023-06-01,30048,11,0,11,6,0,6
2023-06-01,36526,4,0,4,2,0,2
2023-06-01,53288,2,0,2,3,0,3
2023-06-01,61990,2,0,2,1,0,1
2023-06-01,393794,1,0,1,2,0,2
2023-06-01,63445,3,0,3,3,0,3
2023-06-01,63332,3,0,3,2,0,2
2023-06-01,53479,2,0,2,1,0,1
2023-06-01,33519,2,0,2,3,0,3
2023-06-01,54102,1,0,1,1,0,1
2023-06-01,26718,9,0,9,3,0,3
2023-06-01,53750,1,0,1,3,0,3
2023-06-01,17351,1,0,1,1,0,1
2023-06-01,395856,2,0,2,4,0,4
2023-06-01,33460,4,0,4,3,0,3
2023-06-01,40232,22,0,22,1,0,1
2023-06-01,397043,1,0,1,2,0,2
2023-06-01,397413,1,0,1,1,0,1
2023-06-01,55408,1,0,1,1,0,1
2023-06-01,394916,1,0,1,2,0,2
2023-06-01,25946,22,0,22,3,0,3
2023-06-01,396372,1,0,1,2,0,2
2023-06-01,63365,1,0,1,3,0,3
2023-06-01,63369,2,0,2,2,0,2
2023-06-01,23457,1,0,1,3,0,3
2023-06-01,7380,1,0,1,1,0,1
2023-06-01,1112,1,0,1,1,0,1
2023-06-01,393863,1,0,1,2,0,2
2023-06-01,393712,1,0,1,1,0,1
2023-06-01,393767,1,0,1,3,0,3
2023-06-01,32603,1,0,1,2,0,2
2023-06-01,199888,1,0,1,5,0,5
2023-06-01,268639,1,0,1,1,0,1
2023-06-01,328163,2,0,2,2,0,2
2023-06-01,46089,2,0,2,2,0,2
2023-06-01,10544,1,0,1,1,0,1
2023-06-01,394629,1,0,1,3,0,3
2023-06-01,6596,2,1,3,3,3,3
2023-06-01,62508,3,0,3,3,0,3
2023-06-01,54796,2,0,2,1,0,1
2023-06-01,12158,3,0,3,2,0,2
2023-06-01,16996,2,0,2,2,0,2
2023-06-01,399664,1,0,1,3,0,3
2023-06-01,36442,1,0,1,1,0,1
2023-06-01,393703,1,0,1,1,0,1
2023-06-01,393501,1,1,2,2,1,2
2023-06-01,394193,1,0,1,1,0,1
2023-06-01,398360,1,0,1,2,0,2
2023-06-01,23495,2,0,2,2,0,2
2023-06-01,2173,6,1,7,3,3,3
2023-06-01,46679,1,0,1,1,0,1
2023-06-01,33282,4,0,4,1,0,1
2023-06-01,55114,1,0,1,3,0,3
2023-06-01,190,5,0,5,1,0,1
2023-06-01,22494,2,0,2,1,0,1
2023-06-01,19099,3,0,3,4,0,4
2023-06-01,6905,3,1,4,2,1,2
2023-06-01,27253,3,0,3,4,0,4
2023-06-01,136025,1,1,2,1,1,1
2023-06-01,53704,1,0,1,1,0,1
2023-06-01,63358,2,0,2,2,0,2
2023-06-01,9179,1,1,2,4,4,5
2023-06-01,393743,1,0,1,2,0,2
2023-06-01,14857,19,0,19,1,0,1
2023-06-01,63348,1,0,1,1,0,1
2023-06-01,26643,1,0,1,1,0,1
2023-06-01,393812,1,0,1,2,0,2
2023-06-01,21630,1,1,2,2,2,2
2023-06-01,396954,2,0,2,1,0,1
2023-06-01,21764,1,0,1,2,0,2
2023-06-01,12801,3,0,3,3,0,3
2023-06-01,29057,1,0,1,4,0,4
2023-06-01,161,13,0,13,4,0,4
2023-06-01,133462,2,0,2,2,0,2
2023-06-01,62830,2,0,2,2,0,2
2023-06-01,3424,2,2,4,2,2,2
2023-06-01,2578,1,0,1,2,0,2
2023-06-01,56739,1,0,1,1,0,1
2023-06-01,393862,1,0,1,4,0,4
2023-06-01,17298,1,0,1,3,0,3
2023-06-01,7985,1,0,1,1,0,1
2023-06-01,268433,1,1,2,3,1,3
2023-06-01,63424,1,0,1,1,0,1
2023-06-01,394175,1,0,1,1,0,1
2023-06-01,3730,1,0,1,2,0,2
2023-06-01,46374,1,0,1,2,0,2
2023-06-01,393931,2,0,2,2,0,2
2023-06-01,393569,1,0,1,2,0,2
2023-06-01,16573,2,0,2,2,0,2
2023-06-01,395587,1,0,1,1,0,1
2023-06-01,396531,1,0,1,2,0,2
2023-06-01,2143,3,0,3,1,0,1
2023-06-01,54159,4,0,4,2,0,2
2023-06-01,62540,2,0,2,1,0,1
2023-06-01,63314,1,1,2,3,1,3
2023-06-01,14092,1,0,1,1,0,1
2023-06-01,14345,1,0,1,1,0,1
2023-06-01,2486,3,5,8,8,4,8
2023-06-01,2089,2,0,2,1,0,1
2023-06-01,23288,2,0,2,1,0,1
2023-06-01,48688,4,0,4,1,0,1
2023-06-01,2462,1,0,1,1,0,1
2023-06-01,212720,1,0,1,2,0,2
2023-06-01,211835,1,0,1,1,0,1
2023-06-01,1222,1,0,1,1,0,1
2023-06-01,48406,1,0,1,3,0,3
2023-06-01,26450,1,18,19,1,19,19
2023-06-01,395134,2,0,2,1,0,1
2023-06-01,393992,1,0,1,3,0,3
2023-06-01,5726,11,1,12,7,1,7
2023-06-01,1252,9,0,9,2,0,2
2023-06-01,63253,1,0,1,3,0,3
2023-06-01,393793,1,0,1,1,0,1
2023-06-01,137217,1,1,2,1,1,1
2023-06-01,7577,21,0,21,7,0,7
2023-06-01,1258,1,0,1,4,0,4
2023-06-01,64198,1,0,1,1,0,1
2023-06-01,11570,9,0,9,1,0,1
2023-06-01,58027,1,1,2,1,1,1
2023-06-01,6083,11,1,12,5,1,5
2023-06-01,31924,1,0,1,1,0,1
2023-06-01,63372,1,0,1,2,0,2
2023-06-01,54826,2,2,4,3,3,3
2023-06-01,393815,1,0,1,2,0,2
2023-06-01,13995,1,0,1,1,0,1
2023-06-01,22718,1,0,1,2,0,2
2023-06-01,22564,1,0,1,3,0,3
2023-06-01,18949,1,0,1,1,0,1
2023-06-01,63380,1,0,1,2,0,2
2023-06-01,11678,1,1,2,1,1,1
2023-06-01,20306,4,2,6,3,2,3
2023-06-01,20349,1,0,1,1,0,1
2023-06-01,7013,1,0,1,1,0,1
2023-06-01,51946,1,0,1,1,0,1
2023-06-01,263226,1,0,1,1,0,1
2023-06-01,28390,4,0,4,1,0,1
2023-06-01,270328,1,1,2,2,1,2
2023-06-01,28454,1,0,1,1,0,1
2023-06-01,263234,1,0,1,2,0,2
2023-06-01,7173,2,1,3,1,1,1
2023-06-01,3968,6,0,6,1,0,1
2023-06-01,16762,1,0,1,1,0,1
2023-06-01,263261,1,1,2,3,3,3
2023-06-01,7974,3,0,3,1,0,1
2023-06-01,61479,1,0,1,2,0,2
2023-06-01,269999,1,0,1,1,0,1
2023-06-01,28382,13,0,13,4,0,4
2023-06-01,271821,1,1,2,1,1,1
2023-06-01,13679,3,1,4,5,2,5
2023-06-01,21603,8,0,8,1,0,1
2023-06-01,7408,5,0,5,1,0,1
2023-06-01,61866,1,0,1,2,0,2
2023-06-01,6927,1,0,1,1,0,1
2023-06-01,28377,0,0,0,3,0,3
2023-06-01,28499,1,1,2,4,3,4
2023-06-01,28510,0,0,0,2,2,2
2023-06-01,14427,1,2,3,4,4,4
2023-06-01,28497,1,1,2,3,3,3
2023-06-01,61867,2,0,2,3,0,3
2023-06-01,11519,7,0,7,5,0,5
2023-06-01,61749,1,1,2,2,1,2
2023-06-01,61881,1,0,1,4,0,4
2023-06-01,61841,1,1,2,4,2,4
2023-06-01,264476,1,0,1,2,0,2
2023-06-01,263241,1,1,2,1,1,1
2023-06-01,63431,2,0,2,1,0,1
2023-06-01,53934,2,0,2,4,0,4
2023-06-01,393846,2,0,2,2,0,2
2023-06-01,26487,1,0,1,1,0,1
2023-06-01,393974,1,0,1,1,0,1
2023-06-01,400274,2,2,4,3,1,3
2023-06-01,396396,1,0,1,1,0,1
2023-06-01,394631,1,0,1,2,0,2
2023-06-01,44880,1,0,1,1,0,1
2023-06-01,14362,2,0,2,1,0,1
2023-06-01,21675,1,0,1,2,0,2
2023-06-01,1897,1,0,1,1,0,1
2023-06-01,395635,1,0,1,2,0,2
2023-06-01,11328,2,0,2,2,0,2
2023-06-01,395277,1,0,1,2,0,2
2023-06-01,30390,2,0,2,2,0,2
2023-06-01,1746,24,0,24,4,0,4
2023-06-01,1603,3,0,3,1,0,1
2023-06-01,54390,1,0,1,1,0,1
2023-06-01,62867,1,0,1,2,0,2
2023-06-01,57682,1,0,1,1,0,1
2023-06-01,63006,1,0,1,2,0,2
2023-06-01,63449,1,0,1,1,0,1
2023-06-01,211655,1,1,2,6,3,6
2023-06-01,1225,3,1,4,1,1,1
2023-06-01,22825,1,0,1,2,0,2
2023-06-01,395152,1,2,3,1,1,2
2023-06-01,395766,1,1,2,2,1,2
2023-06-01,393790,1,0,1,2,0,2
2023-06-01,198737,3,0,3,1,0,1
2023-06-01,7775,6,1,7,3,2,3
2023-06-01,399987,2,0,2,1,0,1
2023-06-01,399310,27,0,27,3,0,3
2023-06-01,396072,2,0,2,2,0,2
2023-06-01,62612,1,0,1,2,0,2
2023-06-01,400003,1,0,1,1,0,1
2023-06-01,393726,1,0,1,1,0,1
2023-06-01,20237,1,0,1,2,0,2
2023-06-01,29955,2,0,2,1,0,1
2023-06-01,62996,1,0,1,1,0,1
2023-06-01,395375,1,0,1,2,0,2
2023-06-01,63418,1,0,1,1,0,1
2023-06-01,53465,1,0,1,1,0,1
2023-06-01,43064,1,0,1,3,0,3
2023-06-01,395906,1,0,1,1,0,1
2023-06-01,14074,12,1,13,3,1,3
2023-06-01,36477,1,0,1,1,0,1
2023-06-01,26734,2,0,2,1,0,1
2023-06-01,54938,9,0,9,2,0,2
2023-06-01,11126,5,0,5,4,0,4
2023-06-01,393868,1,0,1,3,0,3
2023-06-01,27177,1,0,1,3,0,3
2023-06-01,32230,1,0,1,2,0,2
2023-06-01,10959,2,0,2,1,0,1
2023-06-01,26699,2,0,2,2,0,2
2023-06-01,10668,6,0,6,3,0,3
2023-06-01,395287,1,1,2,2,2,2
2023-06-01,398084,1,0,1,1,0,1
2023-06-01,17215,4,0,4,3,0,3
2023-06-01,18789,4,0,4,3,0,3
2023-06-01,5502,1,0,1,1,0,1
2023-06-01,14507,1,0,1,1,0,1
2023-06-01,53613,1,0,1,2,0,2
2023-06-01,40149,2,0,2,3,0,3
2023-06-01,21669,24,0,24,4,0,4
2023-06-01,32450,1,0,1,3,0,3
2023-06-01,22721,1,0,1,2,0,2
2023-06-01,393937,1,0,1,1,0,1
2023-06-01,62503,1,0,1,3,0,3
2023-06-01,54933,4,0,4,5,0,5
2023-06-01,36115,1,0,1,1,0,1
2023-06-01,396081,1,0,1,2,0,2
2023-06-01,394784,2,0,2,1,0,1
2023-06-01,27270,2,0,2,3,0,3
2023-06-01,393940,1,0,1,2,0,2
2023-06-01,19631,9,0,9,2,0,2
2023-06-01,393831,1,0,1,1,0,1
2023-06-01,41969,2,0,2,2,0,2
2023-06-01,9083,2,1,3,4,5,6
2023-06-01,30014,1,0,1,2,0,2
2023-06-01,34521,2,0,2,3,0,3
2023-06-01,1755,1,0,1,1,0,1
2023-06-01,1878,5,2,7,1,1,1
2023-06-01,1879,1,0,1,1,0,1
2023-06-01,393820,1,0,1,1,0,1
2023-06-01,394596,1,0,1,2,0,2
2023-06-01,46976,5,0,5,1,0,1
2023-06-01,34615,3,1,4,4,3,4
2023-06-01,61320,1,0,1,1,0,1
2023-06-01,63401,1,0,1,2,0,2
2023-06-01,393817,1,0,1,1,0,1
2023-06-01,63346,1,0,1,3,0,3
2023-06-01,52012,1,0,1,1,0,1
2023-06-01,213370,1,0,1,1,0,1
2023-06-01,206448,2,0,2,1,0,1
2023-06-01,42691,1,0,1,1,0,1
2023-06-01,40227,2,0,2,2,0,2
2023-06-01,32588,3,0,3,2,0,2
2023-06-01,393835,1,0,1,2,0,2
2023-06-01,13746,1,2,3,3,1,3
2023-06-01,11385,2,0,2,1,0,1
2023-06-01,396877,1,0,1,1,0,1
2023-06-01,25791,2,0,2,3,0,3
2023-06-01,397462,1,0,1,1,0,1
2023-06-01,14718,1,0,1,2,0,2
2023-06-01,33111,6,0,6,4,0,4
2023-06-01,397650,5,0,5,4,0,4
2023-06-01,200693,1,1,2,1,1,1
2023-06-01,398555,2,0,2,2,0,2
2023-06-01,13460,2,1,3,5,2,5
2023-06-01,3247,1,0,1,1,0,1
2023-06-01,22422,1,0,1,4,0,4
2023-06-01,11369,3,0,3,5,0,5
2023-06-01,393830,1,0,1,1,0,1
2023-06-01,393999,1,0,1,2,0,2
2023-06-01,27412,1,0,1,2,0,2
2023-06-01,61721,1,1,2,3,1,3
2023-06-01,17124,3,0,3,1,0,1
2023-06-01,63327,1,0,1,1,0,1
2023-06-01,5927,15,7,22,3,3,3
2023-06-01,11327,3,0,3,1,0,1
2023-06-01,19395,2,0,2,2,0,2
2023-06-01,62812,1,0,1,3,0,3
2023-06-01,393714,1,0,1,2,0,2
2023-06-01,393843,1,0,1,1,0,1
2023-06-01,1055,1,0,1,2,0,2
2023-06-01,16410,31,0,31,2,0,2
2023-06-01,33360,3,1,4,2,1,2
2023-06-01,8738,5,0,5,3,0,3
2023-06-01,8894,3,0,3,2,0,2
2023-06-01,21363,1,0,1,1,0,1
2023-06-01,31391,6,3,9,4,2,4
2023-06-01,8203,3,0,3,1,0,1
2023-06-01,12619,5,0,5,2,0,2
2023-06-01,3288,11,0,11,1,0,1
2023-06-01,35016,1,0,1,1,0,1
2023-06-01,12736,4,0,4,2,0,2
2023-06-01,15823,2,1,3,3,1,3
2023-06-01,30744,4,0,4,3,0,3
2023-06-01,35553,1,0,1,1,0,1
2023-06-01,12753,3,0,3,3,0,3
2023-06-01,12802,4,0,4,3,0,3
2023-06-01,29410,4,0,4,2,0,2
2023-06-01,16061,1,0,1,2,0,2
2023-06-01,8958,1,0,1,2,0,2
2023-06-01,9071,4,0,4,3,0,3
2023-06-01,21486,5,0,5,2,0,2
2023-06-01,12988,2,0,2,2,0,2
2023-06-01,13073,3,0,3,1,0,1
2023-06-01,13074,7,0,7,1,0,1
2023-06-01,13093,2,0,2,3,0,3
2023-06-01,28783,2,0,2,1,0,1
2023-06-01,15976,4,0,4,2,0,2
2023-06-01,13240,1,0,1,2,0,2
2023-06-01,25565,1,0,1,1,0,1
2023-06-01,29149,1,0,1,2,0,2
2023-06-01,15526,4,0,4,2,0,2
2023-06-01,209876,1,0,1,1,0,1
2023-06-01,16521,1,0,1,1,0,1
2023-06-01,197942,19,8,27,2,2,2
2023-06-01,60269,9,0,9,3,0,3
2023-06-01,208514,2,0,2,2,0,2
2023-06-01,207448,2,1,3,3,2,3
2023-06-01,202064,1,0,1,1,0,1
2023-06-01,12381,7,4,11,4,2,4
2023-06-01,2836,1,0,1,1,0,1
2023-06-01,199950,1,6,7,2,4,4
2023-06-01,2859,2,0,2,1,0,1
2023-06-01,62463,4,1,5,3,1,3
2023-06-01,50273,3,1,4,1,1,1
2023-06-01,41884,2,1,3,2,3,3
2023-06-01,393825,1,0,1,2,0,2
2023-06-01,63456,1,0,1,1,0,1
2023-06-01,393849,1,0,1,2,0,2
2023-06-01,38079,1,0,1,2,0,2
2023-06-01,27001,1,0,1,1,0,1
2023-06-01,12168,1,0,1,1,0,1
2023-06-01,36191,1,0,1,2,0,2
2023-06-01,21718,5,0,5,3,0,3
2023-06-01,208097,1,0,1,1,0,1
2023-06-01,23319,1,0,1,1,0,1
2023-06-01,393805,1,0,1,3,0,3
2023-06-01,1734,3,1,4,1,1,2
2023-06-01,11916,1,0,1,1,0,1
2023-06-01,398365,1,0,1,1,0,1
2023-06-01,31766,2,0,2,3,0,3
2023-06-01,3944,3,0,3,1,0,1
2023-06-01,27644,1,3,4,2,1,2
2023-06-01,63464,1,0,1,3,0,3
2023-06-01,27636,1,0,1,1,0,1
2023-06-01,20246,1,0,1,1,0,1
2023-06-01,212959,1,0,1,3,0,3
2023-06-01,3312,2,0,2,3,0,3
2023-06-01,35991,1,0,1,3,0,3
2023-06-01,210544,3,1,4,2,1,2
2023-06-01,393799,1,0,1,2,0,2
2023-06-01,23526,1,0,1,1,0,1
2023-06-01,54952,2,0,2,1,0,1
2023-06-01,12001,12,0,12,2,0,2
2023-06-01,31834,7,0,7,6,0,6
2023-06-01,46988,1,0,1,1,0,1
2023-06-01,40239,1,0,1,3,0,3
2023-06-01,211769,3,1,4,1,1,1
2023-06-01,40330,1,0,1,1,0,1
2023-06-01,14536,4,2,6,2,1,2
2023-06-01,11528,10,0,10,11,0,11
2023-06-01,395641,1,0,1,1,0,1
2023-06-01,53832,5,0,5,2,0,2
2023-06-01,63412,3,0,3,2,0,2
2023-06-01,6318,2,0,2,3,0,3
2023-06-01,399317,1,0,1,2,0,2
2023-06-01,395146,1,0,1,4,0,4
2023-06-01,396475,1,0,1,3,0,3
2023-06-01,21538,1,1,2,1,1,1
2023-06-01,32521,2,1,3,3,1,3
2023-06-01,394731,2,1,3,2,2,2
2023-06-01,31971,1,0,1,1,0,1
2023-06-01,32765,1,1,2,3,1,3
2023-06-01,396433,1,0,1,1,0,1
2023-06-01,19845,2,0,2,3,0,3
2023-06-01,23262,3,0,3,2,0,2
2023-06-01,63396,1,0,1,1,0,1
2023-06-01,394060,1,0,1,1,0,1
2023-06-01,2901,29,0,29,4,0,4
2023-06-01,32468,1,0,1,1,0,1
2023-06-01,21912,1,0,1,1,0,1
2023-06-01,394858,2,1,3,3,2,3
2023-06-01,1492,1,0,1,1,0,1
2023-06-01,46755,3,0,3,3,0,3
2023-06-01,3858,1,0,1,1,0,1
2023-06-01,63476,2,0,2,1,0,1
2023-06-01,26385,19,0,19,1,0,1
2023-06-01,393943,1,0,1,3,0,3
2023-06-01,30405,7,4,11,2,2,2
2023-06-01,399879,1,3,4,3,2,3
2023-06-01,138348,1,0,1,1,0,1
2023-06-01,393877,1,0,1,3,0,3
2023-06-01,63465,1,0,1,2,0,2
2023-06-01,394705,1,0,1,1,0,1
2023-06-01,53495,1,0,1,1,0,1
2023-06-01,2703,3,0,3,1,0,1
2023-06-01,397737,1,0,1,2,0,2
2023-06-01,33060,2,0,2,3,0,3
2023-06-01,12401,2,1,3,4,2,4
2023-06-01,27282,3,1,4,3,1,4
2023-06-01,11017,3,1,4,1,1,1
2023-06-01,54533,4,0,4,1,0,1
2023-06-01,2485,6,3,9,3,4,4
2023-06-01,40063,1,0,1,2,0,2
2023-06-01,394124,1,0,1,1,0,1
2023-06-01,394259,1,0,1,1,0,1
2023-06-01,25800,3,0,3,1,0,1
2023-06-01,268620,1,0,1,3,0,3
2023-06-01,26633,14,0,14,4,0,4
2023-06-01,1982,11,0,11,4,0,4
2023-06-01,30232,1,1,2,3,3,3
2023-06-01,394004,1,0,1,2,0,2
2023-06-01,17105,2,0,2,2,0,2
2023-06-01,394139,1,0,1,3,0,3
2023-06-01,32253,1,0,1,1,0,1
2023-06-01,36519,4,0,4,1,0,1
2023-06-01,394017,1,0,1,2,0,2
2023-06-01,32389,1,0,1,3,0,3
2023-06-01,46554,1,0,1,1,0,1
2023-06-01,393935,1,0,1,3,0,3
2023-06-01,22704,1,0,1,3,0,3
2023-06-01,397535,3,0,3,3,0,3
2023-06-01,63463,1,0,1,4,0,4
2023-06-01,397061,1,0,1,2,0,2
2023-06-01,27339,1,0,1,1,0,1
2023-06-01,393983,1,1,2,2,1,2
2023-06-01,10745,2,2,4,4,4,4
2023-06-01,1700,1,1,2,2,2,2
2023-06-01,394090,1,0,1,3,0,3
2023-06-01,33728,2,0,2,2,0,2
2023-06-01,29888,12,0,12,5,0,5
2023-06-01,33573,3,0,3,1,0,1
2023-06-01,897,1,1,2,2,2,2
2023-06-01,33019,5,0,5,2,0,2
2023-06-01,393873,1,0,1,1,0,1
2023-06-01,394212,1,0,1,3,0,3
2023-06-01,63413,1,0,1,2,0,2
2023-06-01,40043,3,0,3,2,0,2
2023-06-01,20143,2,0,2,2,0,2
2023-06-01,22994,2,0,2,2,0,2
2023-06-01,8971,7,0,7,3,0,3
2023-06-01,38590,1,1,2,2,3,3
2023-06-01,393933,1,0,1,1,0,1
2023-06-01,12137,1,0,1,3,0,3
2023-06-01,393888,1,0,1,3,0,3
2023-06-01,394382,1,0,1,2,0,2
2023-06-01,19350,9,0,9,1,0,1
2023-06-01,394121,1,0,1,2,0,2
2023-06-01,19456,1,0,1,3,0,3
2023-06-01,19423,4,0,4,3,0,3
2023-06-01,11507,3,0,3,3,0,3
2023-06-01,26037,2,0,2,3,0,3
2023-06-01,395087,1,0,1,1,0,1
2023-06-01,26227,2,1,3,2,2,2
2023-06-01,26221,2,0,2,2,0,2
2023-06-01,25706,3,0,3,1,0,1
2023-06-01,54738,2,0,2,2,0,2
2023-06-01,54743,2,0,2,2,0,2
2023-06-01,13582,1,0,1,2,0,2
2023-06-01,25728,4,0,4,3,0,3
2023-06-01,32443,2,0,2,2,0,2
2023-06-01,25911,1,0,1,1,0,1
2023-06-01,395704,2,0,2,2,0,2
2023-06-01,398163,5,0,5,1,0,1
2023-06-01,267392,1,0,1,3,0,3
2023-06-01,271376,2,1,3,1,1,1
2023-06-01,266222,5,1,6,3,1,3
2023-06-01,266223,3,1,4,3,1,3
2023-06-01,266202,5,1,6,2,2,4
2023-06-01,266208,3,0,3,3,0,3
2023-06-01,266203,3,1,4,3,2,3
2023-06-01,265707,5,0,5,1,0,1
2023-06-01,266550,4,5,9,2,2,2
2023-06-01,266251,7,3,10,1,2,3
2023-06-01,266239,5,1,6,1,1,1
2023-06-01,271111,7,3,10,3,1,3
2023-06-01,266260,7,2,9,5,4,5
2023-06-01,265711,4,1,5,1,1,1
2023-06-01,266261,2,0,2,2,0,2
2023-06-01,266256,5,1,6,5,3,6
2023-06-01,266262,4,0,4,1,0,1
2023-06-01,266243,1,3,4,2,1,2
2023-06-01,266252,3,1,4,2,1,2
2023-06-01,270030,1,1,2,1,1,1
2023-06-01,265731,1,1,2,1,1,2
2023-06-01,265895,1,0,1,1,0,1
2023-06-01,133972,3,0,3,2,0,2
2023-06-01,267440,3,3,6,3,2,3
2023-06-01,266664,3,2,5,3,1,3
2023-06-01,267451,7,20,27,4,3,4
2023-06-01,267441,6,0,6,3,0,3
2023-06-01,272150,3,1,4,3,1,3
2023-06-01,267461,5,0,5,2,0,2
2023-06-01,265787,3,1,4,2,1,2
2023-06-01,265794,4,0,4,1,0,1
2023-06-01,265533,2,0,2,2,0,2
2023-06-01,267443,7,23,30,1,1,1
2023-06-01,267447,7,1,8,1,1,1
2023-06-01,267448,7,6,13,1,1,1
2023-06-01,267471,1,1,2,1,1,1
2023-06-01,267477,7,5,12,1,1,1
2023-06-01,267462,3,4,7,3,3,4
2023-06-01,267459,5,2,7,1,1,1
2023-06-01,267527,1,0,1,1,0,1
2023-06-01,267485,1,1,2,1,1,1
2023-06-01,267522,3,2,5,7,4,7
2023-06-01,267535,4,4,8,4,2,4
2023-06-01,272701,1,1,2,5,2,5
2023-06-01,267467,7,1,8,5,2,6
2023-06-01,267466,6,2,8,4,3,4
2023-06-01,267486,6,0,6,2,0,2
2023-06-01,267487,5,0,5,2,0,2
2023-06-01,267468,4,3,7,3,2,3
2023-06-01,267537,1,1,2,1,1,1
2023-06-01,265786,5,0,5,3,0,3
2023-06-01,267472,7,1,8,1,2,2
2023-06-01,267489,1,1,2,1,1,1
2023-06-01,265788,5,1,6,2,1,2
2023-06-01,267490,7,3,10,1,1,1
2023-06-01,265791,4,0,4,2,0,2
2023-06-01,265792,5,0,5,3,0,3
2023-06-01,267473,4,1,5,6,6,8
2023-06-01,272218,0,7,7,4,9,11
2023-06-01,267474,3,7,10,1,1,1
2023-06-01,267479,5,1,6,2,1,2
2023-06-01,267476,1,0,1,1,0,1
2023-06-01,265795,1,0,1,1,0,1
2023-06-01,271980,4,0,4,1,0,1
2023-06-01,267491,1,0,1,1,0,1
2023-06-01,267480,1,1,2,1,1,1
2023-06-01,267481,5,1,6,1,1,1
2023-06-01,265813,5,1,6,2,2,2
2023-06-01,267495,3,0,3,2,0,2
2023-06-01,267483,1,0,1,1,0,1
2023-06-01,267542,5,1,6,2,1,2
2023-06-01,267498,7,3,10,4,3,5
2023-06-01,18710,3,0,3,3,0,3
2023-06-01,35713,1,0,1,3,0,3
2023-06-01,56516,1,0,1,1,0,1
2023-06-01,42268,1,0,1,1,0,1
2023-06-01,209996,1,0,1,3,0,3
2023-06-01,59615,2,2,4,2,2,2
2023-06-01,209174,2,0,2,2,0,2
2023-06-01,266156,4,3,7,3,1,3
2023-06-01,267322,3,1,4,1,1,2
2023-06-01,266229,2,1,3,3,2,3
2023-06-01,266244,3,0,3,1,0,1
2023-06-01,266230,1,0,1,1,0,1
2023-06-01,266533,5,3,8,3,1,3
2023-06-01,266217,2,0,2,1,0,1
2023-06-01,272483,6,1,7,2,1,2
2023-06-01,209766,1,0,1,2,0,2
2023-06-01,209760,3,0,3,1,0,1
2023-06-01,207271,1,1,2,3,1,3
2023-06-01,41318,2,0,2,1,0,1
2023-06-01,40976,5,1,6,2,2,2
2023-06-01,56603,1,1,2,2,3,3
2023-06-01,51628,1,1,2,1,1,2
2023-06-01,212138,2,0,2,2,0,2
2023-06-01,328596,3,1,4,4,1,4
2023-06-01,328600,4,0,4,2,0,2
2023-06-01,328609,1,0,1,2,0,2
2023-06-01,328601,4,1,5,1,1,1
2023-06-01,266218,1,0,1,1,0,1
2023-06-01,266219,5,1,6,1,1,1
2023-06-01,266241,7,0,7,1,0,1
2023-06-01,266235,5,1,6,1,1,1
2023-06-01,271296,1,1,2,1,1,1
2023-06-01,395625,1,0,1,3,0,3
2023-06-01,19239,13,0,13,11,0,11
2023-06-01,1751,1,0,1,1,0,1
2023-06-01,13869,1,0,1,3,0,3
2023-06-01,29827,2,0,2,1,0,1
2023-06-01,57672,1,1,2,1,1,1
2023-06-01,57671,3,0,3,4,0,4
2023-06-01,400730,1,0,1,3,0,3
2023-06-01,53736,2,3,5,3,5,5
2023-06-01,394942,1,0,1,3,0,3
2023-06-01,394252,1,0,1,1,0,1
2023-06-01,396892,4,0,4,1,0,1
2023-06-01,393904,1,0,1,2,0,2
2023-06-01,61814,1,0,1,2,0,2
2023-06-01,12196,1,1,2,1,1,1
2023-06-01,15327,3,0,3,2,0,2
2023-06-01,400355,1,0,1,2,0,2
2023-06-01,395745,1,0,1,2,0,2
2023-06-01,36345,1,1,2,2,2,2
2023-06-01,63481,2,0,2,2,0,2
2023-06-01,14278,5,0,5,2,0,2
2023-06-01,27477,3,0,3,3,0,3
2023-06-01,397913,9,3,12,2,2,2
2023-06-01,53578,2,0,2,2,0,2
2023-06-01,93,2,0,2,1,0,1
2023-06-01,61840,1,0,1,2,0,2
2023-06-01,61742,1,1,2,1,1,1
2023-06-01,12236,4,0,4,2,0,2
2023-06-01,46846,9,7,16,4,1,4
2023-06-01,23513,2,0,2,1,0,1
2023-06-01,20074,1,1,2,2,1,2
2023-06-01,203619,1,0,1,1,0,1
2023-06-01,46084,2,0,2,3,0,3
2023-06-01,40331,1,0,1,2,0,2
2023-06-01,393908,1,0,1,2,0,2
2023-06-01,137188,4,0,4,1,0,1
2023-06-01,398643,5,2,7,1,2,2
2023-06-01,13501,7,0,7,2,0,2
2023-06-01,399985,1,0,1,2,0,2
2023-06-01,3635,1,12,13,1,1,1
2023-06-01,16404,1,0,1,1,0,1
2023-06-01,393618,2,0,2,2,0,2
2023-06-01,393965,1,1,2,3,3,3
2023-06-01,13714,1,0,1,1,0,1
2023-06-01,393928,1,0,1,1,0,1
2023-06-01,393797,1,0,1,1,0,1
2023-06-01,31816,2,0,2,1,0,1
2023-06-01,1084,1,0,1,3,0,3
2023-06-01,394057,1,0,1,1,0,1
2023-06-01,20280,2,0,2,2,0,2
2023-06-01,19138,2,0,2,1,0,1
2023-06-01,393680,1,0,1,2,0,2
2023-06-01,394160,1,0,1,2,0,2
2023-06-01,394025,2,0,2,2,0,2
2023-06-01,39461,1,0,1,3,0,3
2023-06-01,198032,1,0,1,1,0,1
2023-06-01,46252,2,0,2,2,0,2
2023-06-01,16833,8,0,8,3,0,3
2023-06-01,395580,3,0,3,3,0,3
2023-06-01,1848,25,1,26,2,1,2
2023-06-01,393798,1,0,1,2,0,2
2023-06-01,393688,1,0,1,1,0,1
2023-06-01,62578,1,0,1,1,0,1
2023-06-01,393997,1,0,1,2,0,2
2023-06-01,394242,1,0,1,3,0,3
2023-06-01,393822,1,0,1,1,0,1
2023-06-01,398240,1,0,1,1,0,1
2023-06-01,394101,1,1,2,3,3,3
2023-06-01,11362,2,0,2,3,0,3
2023-06-01,400417,1,0,1,2,0,2
2023-06-01,915,1,1,2,1,1,1
2023-06-01,395274,1,0,1,2,0,2
2023-06-01,37998,4,0,4,1,0,1
2023-06-01,63529,0,0,0,2,0,2
2023-06-01,3836,2,1,3,6,3,7
2023-06-01,46875,4,1,5,2,1,2
2023-06-01,16868,5,0,5,4,0,4
2023-06-01,35788,1,1,2,1,1,1
2023-06-01,1904,16,0,16,2,0,2
2023-06-01,27304,2,0,2,1,0,1
2023-06-01,25845,3,0,3,1,0,1
2023-06-01,30570,3,0,3,3,0,3
2023-06-01,397869,1,1,2,2,3,3
2023-06-01,36050,36,0,36,2,0,2
2023-06-01,40194,1,0,1,1,0,1
2023-06-01,394783,1,0,1,1,0,1
2023-06-01,23474,4,0,4,1,0,1
2023-06-01,17308,1,0,1,2,0,2
2023-06-01,22991,1,0,1,2,0,2
2023-06-01,26889,2,1,3,1,1,1
2023-06-01,15062,2,0,2,1,0,1
2023-06-01,53367,1,0,1,2,0,2
2023-06-01,394103,1,0,1,1,0,1
2023-06-01,393953,1,0,1,3,0,3
2023-06-01,268293,1,0,1,1,0,1
2023-06-01,400293,1,0,1,1,0,1
2023-06-01,36831,14,0,14,1,0,1
2023-06-01,30116,2,0,2,3,0,3
2023-06-01,28609,17,1,18,1,1,1
2023-06-01,37889,3,0,3,2,0,2
2023-06-01,394792,4,0,4,3,0,3
2023-06-01,264396,1,1,2,2,1,2
2023-06-01,8256,6,1,7,2,2,2
2023-06-01,16283,6,1,7,4,4,4
2023-06-01,17318,2,0,2,5,0,5
2023-06-01,24959,1,0,1,1,0,1
2023-06-01,2562,3,0,3,2,0,2
2023-06-01,40003,1,0,1,2,0,2
2023-06-01,54172,1,0,1,1,0,1
2023-06-01,393882,2,0,2,1,0,1
2023-06-01,14448,2,0,2,1,0,1
2023-06-01,396391,2,0,2,2,0,2
2023-06-01,399407,1,0,1,1,0,1
2023-06-01,4889,3,0,3,2,0,2
2023-06-01,393782,1,0,1,1,0,1
2023-06-01,14150,1,0,1,1,0,1
2023-06-01,395480,1,0,1,1,0,1
2023-06-01,394410,1,0,1,3,0,3
2023-06-01,13511,10,0,10,5,0,5
2023-06-01,11302,9,0,9,3,0,3
2023-06-01,197671,1,0,1,1,0,1
2023-06-01,395431,2,0,2,1,0,1
2023-06-01,394110,1,0,1,2,0,2
2023-06-01,22507,1,0,1,3,0,3
2023-06-01,26775,1,0,1,1,0,1
2023-06-01,394086,1,0,1,2,0,2
2023-06-01,394988,1,0,1,1,0,1
2023-06-01,46393,0,0,0,2,0,2
2023-06-01,394210,1,0,1,2,0,2
2023-06-01,21654,2,0,2,1,0,1
2023-06-01,138380,4,0,4,2,0,2
2023-06-01,18786,3,0,3,2,0,2
2023-06-01,26364,1,0,1,3,0,3
2023-06-01,15129,13,1,14,6,2,6
2023-06-01,26213,1,0,1,1,0,1
2023-06-01,21944,2,0,2,2,0,2
2023-06-01,394919,1,0,1,1,0,1
2023-06-01,393733,1,0,1,1,0,1
2023-06-01,19827,1,0,1,1,0,1
2023-06-01,12163,2,0,2,5,0,5
2023-06-01,62096,1,1,2,1,1,2
2023-06-01,46400,1,0,1,1,0,1
2023-06-01,23060,1,0,1,1,0,1
2023-06-01,33299,2,0,2,2,0,2
2023-06-01,264481,1,0,1,3,0,3
2023-06-01,395923,1,0,1,1,0,1
2023-06-01,62901,1,0,1,3,0,3
2023-06-01,3366,1,0,1,1,0,1
2023-06-01,264363,1,0,1,4,0,4
2023-06-01,264370,1,0,1,2,0,2
2023-06-01,26513,1,0,1,2,0,2
2023-06-01,270123,1,0,1,1,0,1
2023-06-01,30379,1,0,1,1,0,1
2023-06-01,395386,1,0,1,2,0,2
2023-06-01,264482,1,0,1,3,0,3
2023-06-01,23090,1,0,1,1,0,1
2023-06-01,58100,1,0,1,3,0,3
2023-06-01,23182,1,0,1,2,0,2
2023-06-01,11181,2,0,2,3,0,3
2023-06-01,54925,2,0,2,1,0,1
2023-06-01,35678,2,1,3,1,1,1
2023-06-01,35165,3,3,6,1,1,1
2023-06-01,44233,5,2,7,2,1,2
2023-06-01,50676,6,0,6,3,0,3
2023-06-01,197682,3,0,3,4,0,4
2023-06-01,56569,5,0,5,3,0,3
2023-06-01,205162,1,0,1,2,0,2
2023-06-01,204837,2,0,2,2,0,2
2023-06-01,201414,0,0,0,2,0,2
2023-06-01,62091,1,0,1,1,0,1
2023-06-01,205194,1,0,1,1,0,1
2023-06-01,15505,8,0,8,1,0,1
2023-06-01,29203,1,1,2,2,2,2
2023-06-01,29436,4,1,5,3,2,3
2023-06-01,15370,1,1,2,2,1,2
2023-06-01,8538,2,0,2,3,0,3
2023-06-01,56581,4,0,4,3,0,3
2023-06-01,12662,1,0,1,2,0,2
2023-06-01,197709,2,0,2,6,0,6
2023-06-01,197721,1,0,1,3,0,3
2023-06-01,15867,1,0,1,1,0,1
2023-06-01,56618,1,0,1,1,0,1
2023-06-01,56664,4,0,4,1,0,1
2023-06-01,56638,3,2,5,4,1,4
2023-06-01,197818,1,0,1,1,0,1
2023-06-01,197821,1,0,1,3,0,3
2023-06-01,56562,5,0,5,2,0,2
2023-06-01,394438,1,0,1,1,0,1
2023-06-01,136806,1,0,1,3,0,3
2023-06-01,137220,3,0,3,2,0,2
2023-06-01,399017,1,0,1,1,0,1
2023-06-01,11805,3,1,4,1,1,1
2023-06-01,44753,1,1,2,1,1,1
2023-06-01,16381,1,0,1,1,0,1
2023-06-01,47477,7,8,15,3,2,3
2023-06-01,208760,1,0,1,3,0,3
2023-06-01,211564,1,1,2,1,1,1
2023-06-01,197557,4,0,4,2,0,2
2023-06-01,209960,3,0,3,1,0,1
2023-06-01,33980,1,0,1,1,0,1
2023-06-01,8995,1,1,2,5,1,5
2023-06-01,8642,1,0,1,1,0,1
2023-06-01,203788,6,0,6,3,0,3
2023-06-01,48445,1,1,2,1,1,1
2023-06-01,204302,3,1,4,2,2,2
2023-06-01,201154,1,0,1,2,0,2
2023-06-01,199977,2,0,2,1,0,1
2023-06-01,41446,1,1,2,2,2,2
2023-06-01,1271,1,1,2,1,1,1
2023-06-01,60554,5,0,5,3,0,3
2023-06-01,57275,1,0,1,1,0,1
2023-06-01,198039,1,0,1,1,0,1
2023-06-01,57244,7,0,7,1,0,1
2023-06-01,56526,4,0,4,3,0,3
2023-06-01,5529,2,0,2,1,0,1
2023-06-01,9007,2,1,3,1,1,1
2023-06-01,198146,1,0,1,1,0,1
2023-06-01,200788,2,0,2,2,0,2
2023-06-01,201240,1,1,2,2,2,2
2023-06-01,197701,1,0,1,3,0,3
2023-06-01,400445,2,0,2,1,0,1
2023-06-01,394043,1,0,1,3,0,3
2023-06-01,46338,1,0,1,2,0,2
2023-06-01,25950,1,0,1,3,0,3
2023-06-01,393821,2,0,2,1,0,1
2023-06-01,10221,2,0,2,1,0,1
2023-06-01,396335,1,0,1,2,0,2
2023-06-01,32286,6,0,6,5,0,5
2023-06-01,394220,2,0,2,3,0,3
2023-06-01,40813,2,0,2,2,0,2
2023-06-01,1907,1,0,1,1,0,1
2023-06-01,394653,2,0,2,2,0,2
2023-06-01,1909,1,0,1,1,0,1
2023-06-01,394157,1,0,1,1,0,1
2023-06-01,64273,1,1,2,1,1,1
2023-06-01,3584,13,1,14,2,2,2
2023-06-01,394370,1,0,1,2,0,2
2023-06-01,54853,1,1,2,1,1,1
2023-06-01,40851,3,0,3,3,0,3
2023-06-01,55028,6,1,7,1,1,1
2023-06-01,17309,6,0,6,2,0,2
2023-06-01,48920,3,0,3,2,0,2
2023-06-01,32701,55,0,55,8,0,8
2023-06-01,202967,3,1,4,3,1,3
2023-06-01,199973,3,1,4,1,1,1
2023-06-01,39369,5,0,5,1,0,1
2023-06-01,23263,2,0,2,1,0,1
2023-06-01,22669,1,0,1,1,0,1
2023-06-01,398188,1,0,1,1,0,1
2023-06-01,395960,1,0,1,2,0,2
2023-06-01,11420,1,0,1,2,0,2
2023-06-01,393833,1,0,1,1,0,1
2023-06-01,53164,4,3,7,2,2,3
2023-06-01,54072,5,0,5,3,0,3
2023-06-01,62625,1,0,1,1,0,1
2023-06-01,3443,1,0,1,1,0,1
2023-06-01,52343,1,1,2,1,1,1
2023-06-01,28027,14,1,15,1,1,1
2023-06-01,394426,1,0,1,1,0,1
2023-06-01,13691,2,0,2,1,0,1
2023-06-01,38076,1,0,1,1,0,1
2023-06-01,394460,1,0,1,3,0,3
2023-06-01,27201,2,0,2,1,0,1
2023-06-01,54689,1,0,1,3,0,3
2023-06-01,136971,1,0,1,1,0,1
2023-06-01,400837,1,0,1,2,0,2
2023-06-01,10908,4,4,8,1,1,1
2023-06-01,30065,1,0,1,2,0,2
2023-06-01,54294,9,0,9,2,0,2
2023-06-01,25778,1,0,1,2,0,2
2023-06-01,22137,1,0,1,1,0,1
2023-06-01,395843,1,0,1,2,0,2
2023-06-01,394290,1,0,1,1,0,1
2023-06-01,393638,1,1,2,2,2,2
2023-06-01,21794,3,0,3,2,0,2
2023-06-01,16401,2,1,3,1,1,1
2023-06-01,40238,2,0,2,2,0,2
2023-06-01,398070,1,0,1,1,0,1
2023-06-01,23727,6,0,6,1,0,1
2023-06-01,394377,2,0,2,3,0,3
2023-06-01,400225,1,0,1,1,0,1
2023-06-01,40769,1,0,1,1,0,1
2023-06-01,394415,1,0,1,1,0,1
2023-06-01,393276,6,0,6,1,0,1
2023-06-01,46943,6,0,6,1,0,1
2023-06-01,394173,1,0,1,1,0,1
2023-06-01,18512,1,0,1,2,0,2
2023-06-01,54833,8,0,8,3,0,3
2023-06-01,53305,1,0,1,1,0,1
2023-06-01,33318,2,0,2,1,0,1
2023-06-01,36101,4,0,4,3,0,3
2023-06-01,23037,1,0,1,1,0,1
2023-06-01,394473,8,0,8,3,0,3
2023-06-01,396291,2,0,2,4,0,4
2023-06-01,7637,6,0,6,1,0,1
2023-06-01,397717,1,0,1,2,0,2
2023-06-01,59326,4,0,4,3,0,3
2023-06-01,46597,8,0,8,2,0,2
2023-06-01,399712,1,0,1,3,0,3
2023-06-01,32143,4,0,4,1,0,1
2023-06-01,27167,1,0,1,2,0,2
2023-06-01,22569,1,0,1,1,0,1
2023-06-01,10129,8,0,8,3,0,3
2023-06-01,25883,14,0,14,2,0,2
2023-06-01,32287,20,0,20,2,0,2
2023-06-01,4996,17,0,17,3,0,3
2023-06-01,32111,6,0,6,2,0,2
2023-06-01,3081,18,0,18,3,0,3
2023-06-01,2912,12,0,12,3,0,3
2023-06-01,24568,9,0,9,2,0,2
2023-06-01,23564,4,0,4,2,0,2
2023-06-01,3073,5,0,5,2,0,2
2023-06-01,1696,21,0,21,3,0,3
2023-06-01,2909,1,0,1,1,0,1
2023-06-01,30284,5,0,5,2,0,2
2023-06-01,33463,2,0,2,2,0,2
2023-06-01,394402,1,0,1,1,0,1
2023-06-01,270327,1,0,1,3,0,3
2023-06-01,36863,1,0,1,1,0,1
2023-06-01,15606,1,1,2,7,4,8
2023-06-01,400420,1,0,1,1,0,1
2023-06-01,17496,9,0,9,1,0,1
2023-06-01,198597,1,0,1,1,0,1
2023-06-01,64449,2,1,3,2,1,2
2023-06-01,397348,6,0,6,3,0,3
2023-06-01,264474,1,0,1,1,0,1
2023-06-01,397789,1,0,1,2,0,2
2023-06-01,54097,1,1,2,1,1,1
2023-06-01,396833,1,0,1,2,0,2
2023-06-01,396511,2,0,2,1,0,1
2023-06-01,398492,3,0,3,1,0,1
2023-06-01,16598,4,0,4,2,0,2
2023-06-01,32157,6,0,6,1,0,1
2023-06-01,32250,2,0,2,1,0,1
2023-06-01,32817,2,0,2,2,0,2
2023-06-01,32762,1,0,1,1,0,1
2023-06-01,19167,5,0,5,1,0,1
2023-06-01,19062,1,0,1,1,0,1
2023-06-01,40119,2,1,3,3,2,3
2023-06-01,53443,12,0,12,3,0,3
2023-06-01,26391,1,0,1,2,0,2
2023-06-01,32820,3,0,3,1,0,1
2023-06-01,820,5,0,5,1,0,1
2023-06-01,13733,1,0,1,3,0,3
2023-06-01,399844,57,0,57,3,0,3
2023-06-01,397452,1,0,1,3,0,3
2023-06-01,394263,1,0,1,2,0,2
2023-06-01,263197,1,1,2,1,1,1
2023-06-01,395751,1,0,1,3,0,3
2023-06-01,396314,1,0,1,1,0,1
2023-06-01,394116,1,0,1,1,0,1
2023-06-01,63468,2,0,2,5,0,5
2023-06-01,13804,12,2,14,2,1,2
2023-06-01,53405,3,0,3,3,0,3
2023-06-01,18438,21,0,21,10,0,10
2023-06-01,394374,1,0,1,1,0,1
2023-06-01,11068,2,0,2,3,0,3
2023-06-01,20050,4,0,4,3,0,3
2023-06-01,14283,10,0,10,1,0,1
2023-06-01,16575,1,0,1,1,0,1
2023-06-01,13926,7,1,8,4,3,4
2023-06-01,29721,2,0,2,3,0,3
2023-06-01,11470,3,0,3,3,0,3
2023-06-01,398756,3,0,3,2,0,2
2023-06-01,17196,1,0,1,2,0,2
2023-06-01,2924,4,0,4,3,0,3
2023-06-01,11073,1,0,1,3,0,3
2023-06-01,22328,1,0,1,3,0,3
2023-06-01,393961,1,0,1,1,0,1
2023-06-01,396470,2,0,2,2,0,2
2023-06-01,29996,2,0,2,2,0,2
2023-06-01,46874,4,0,4,1,0,1
2023-06-01,46149,6,1,7,1,1,1
2023-06-01,62681,2,1,3,3,2,3
2023-06-01,393853,1,0,1,4,0,4
2023-06-01,399798,1,1,2,1,1,2
2023-06-01,3791,3,0,3,3,0,3
2023-06-01,22551,1,0,1,1,0,1
2023-06-01,33580,1,0,1,2,0,2
2023-06-01,26159,6,0,6,3,0,3
2023-06-01,10400,1,0,1,2,0,2
2023-06-01,397480,1,0,1,3,0,3
2023-06-01,399088,2,0,2,1,0,1
2023-06-01,26394,7,0,7,3,0,3
2023-06-01,53853,1,0,1,3,0,3
2023-06-01,31770,9,0,9,4,0,4
2023-06-01,47058,1,0,1,1,0,1
2023-06-01,26511,2,0,2,3,0,3
2023-06-01,46171,5,0,5,3,0,3
2023-06-01,62884,2,0,2,4,0,4
2023-06-01,394236,1,0,1,3,0,3
2023-06-01,6971,2,1,3,2,2,2
2023-06-01,32082,35,0,35,3,0,3
2023-06-01,394425,1,0,1,3,0,3
2023-06-01,38302,3,0,3,1,0,1
2023-06-01,30312,3,1,4,1,1,1
2023-06-01,3347,3,1,4,5,3,5
2023-06-01,32533,1,0,1,2,0,2
2023-06-01,399909,3,0,3,1,0,1
2023-06-01,11097,4,6,10,1,3,3
2023-06-01,264506,1,0,1,2,0,2
2023-06-01,61773,14,0,14,3,0,3
2023-06-01,264507,1,0,1,1,0,1
2023-06-01,395073,6,0,6,1,0,1
2023-06-01,1098,1,0,1,1,0,1
2023-06-01,36337,1,0,1,3,0,3
2023-06-01,63269,2,0,2,1,0,1
2023-06-01,54035,4,0,4,1,0,1
2023-06-01,62505,1,0,1,2,0,2
2023-06-01,57327,1,1,2,1,1,1
2023-06-01,394514,3,0,3,1,0,1
2023-06-01,40129,1,0,1,2,0,2
2023-06-01,131158,1,0,1,3,0,3
2023-06-01,397681,3,0,3,10,0,10
2023-06-01,55578,1,0,1,3,0,3
2023-06-01,393666,1,0,1,1,0,1
2023-06-01,54954,1,0,1,1,0,1
2023-06-01,55112,10,0,10,3,0,3
2023-06-01,393920,1,0,1,1,0,1
2023-06-01,200961,7,0,7,5,0,5
2023-06-01,46372,1,0,1,1,0,1
2023-06-01,21987,1,0,1,1,0,1
2023-06-01,846,1,0,1,1,0,1
2023-06-01,63462,1,0,1,3,0,3
2023-06-01,32506,2,0,2,2,0,2
2023-06-01,4577,1,0,1,1,0,1
2023-06-01,394240,1,0,1,2,0,2
2023-06-01,26665,2,0,2,1,0,1
2023-06-01,32245,1,0,1,1,0,1
2023-06-01,396306,2,0,2,1,0,1
2023-06-01,62525,2,0,2,2,0,2
2023-06-01,36600,4,0,4,3,0,3
2023-06-01,399632,4,0,4,2,0,2
2023-06-01,30128,1,1,2,3,1,3
2023-06-01,17194,2,0,2,2,0,2
2023-06-01,399444,1,0,1,1,0,1
2023-06-01,36218,6,3,9,3,3,3
2023-06-01,137235,1,0,1,1,0,1
2023-06-01,55178,11,0,11,3,0,3
2023-06-01,396141,2,1,3,4,1,4
2023-06-01,26165,2,0,2,1,0,1
2023-06-01,54854,2,0,2,2,0,2
2023-06-01,843,1,0,1,3,0,3
2023-06-01,397144,1,0,1,1,0,1
2023-06-01,47615,1,0,1,1,0,1
2023-06-01,397087,3,0,3,1,0,1
2023-06-01,394246,1,0,1,1,0,1
2023-06-01,395288,1,0,1,1,0,1
2023-06-01,11394,3,0,3,1,0,1
2023-06-01,400723,1,0,1,2,0,2
2023-06-01,132868,4,0,4,3,0,3
2023-06-01,395740,2,0,2,3,0,3
2023-06-01,14518,1,0,1,1,0,1
2023-06-01,16874,21,0,21,4,0,4
2023-06-01,264372,1,1,2,2,1,2
2023-06-01,271775,1,1,2,1,1,1
2023-06-01,271407,1,1,2,4,2,4
2023-06-01,271246,1,1,2,1,1,1
2023-06-01,263718,1,0,1,3,0,3
2023-06-01,23191,4,0,4,3,0,3
2023-06-01,397410,4,0,4,1,0,1
2023-06-01,15336,1,0,1,4,0,4
2023-06-01,33575,2,0,2,3,0,3
2023-06-01,264534,1,1,2,2,1,2
2023-06-01,394761,2,0,2,2,0,2
2023-06-01,397980,1,0,1,1,0,1
2023-06-01,328607,1,0,1,1,0,1
2023-06-01,40890,2,0,2,2,0,2
2023-06-01,394664,1,0,1,1,0,1
2023-06-01,19556,8,0,8,4,0,4
2023-06-01,23922,10,0,10,2,0,2
2023-06-01,394533,4,0,4,2,0,2
2023-06-01,399046,2,0,2,3,0,3
2023-06-01,19882,2,0,2,2,0,2
2023-06-01,23067,1,0,1,2,0,2
2023-06-01,23538,1,0,1,1,0,1
2023-06-01,6290,1,0,1,1,0,1
2023-06-01,2031,2,0,2,1,0,1
2023-06-01,40716,4,0,4,3,0,3
2023-06-01,11871,2,0,2,2,0,2
2023-06-01,398850,2,1,3,2,1,2
2023-06-01,63370,6,0,6,6,0,6
2023-06-01,398062,1,0,1,1,0,1
2023-06-01,22172,3,0,3,1,0,1
2023-06-01,30494,1,0,1,4,0,4
2023-06-01,398743,5,0,5,3,0,3
2023-06-01,5117,1,0,1,2,0,2
2023-06-01,23323,4,0,4,1,0,1
2023-06-01,54985,1,0,1,1,0,1
2023-06-01,30413,2,0,2,1,0,1
2023-06-01,53939,1,1,2,4,4,5
2023-06-01,394915,1,3,4,1,1,1
2023-06-01,394185,1,0,1,3,0,3
2023-06-01,25958,10,0,10,2,0,2
2023-06-01,47049,1,0,1,3,0,3
2023-06-01,10264,16,0,16,5,0,5
2023-06-01,399103,1,0,1,1,0,1
2023-06-01,394744,1,0,1,3,0,3
2023-06-01,53398,2,0,2,2,0,2
2023-06-01,396330,1,0,1,3,0,3
2023-06-01,31951,1,0,1,1,0,1
2023-06-01,397307,1,0,1,3,0,3
2023-06-01,46761,2,0,2,1,0,1
2023-06-01,394592,1,1,2,1,1,1
2023-06-01,399120,1,1,2,1,1,1
2023-06-01,62575,2,0,2,4,0,4
2023-06-01,18545,1,0,1,1,0,1
2023-06-01,30545,1,0,1,2,0,2
2023-06-01,400397,5,0,5,3,0,3
2023-06-01,271157,1,1,2,1,1,2
2023-06-01,14598,1,0,1,2,0,2
2023-06-01,393216,1,0,1,1,0,1
2023-06-01,400697,2,0,2,1,0,1
2023-06-01,29903,10,0,10,1,0,1
2023-06-01,63050,2,0,2,3,0,3
2023-06-01,63480,3,0,3,4,0,4
2023-06-01,136814,1,0,1,2,0,2
2023-06-01,8135,2,0,2,1,0,1
2023-06-01,32366,1,0,1,2,0,2
2023-06-01,26047,1,0,1,1,0,1
2023-06-01,7868,2,0,2,1,0,1
2023-06-01,64204,7,0,7,6,0,6
2023-06-01,21763,4,0,4,3,0,3
2023-06-01,14628,24,0,24,2,0,2
2023-06-01,33370,1,0,1,1,0,1
2023-06-01,4631,4,0,4,1,0,1
2023-06-01,55025,3,0,3,2,0,2
2023-06-01,31618,2,0,2,1,0,1
2023-06-01,135514,2,0,2,1,0,1
2023-06-01,394049,2,0,2,4,0,4
2023-06-01,23034,11,0,11,3,0,3
2023-06-01,3738,60,0,60,10,0,10
2023-06-01,40687,4,0,4,1,0,1
2023-06-01,20179,1,0,1,1,0,1
2023-06-01,397145,1,0,1,1,0,1
2023-06-01,393251,2,0,2,1,0,1
2023-06-01,64223,2,0,2,4,0,4
2023-06-01,21710,2,0,2,3,0,3
2023-06-01,14049,3,0,3,2,0,2
2023-06-01,399727,3,0,3,1,0,1
2023-06-01,17272,1,0,1,1,0,1
2023-06-01,20390,1,0,1,2,0,2
2023-06-01,36719,1,1,2,2,2,2
2023-06-01,17244,3,2,5,1,1,1
2023-06-01,11199,3,0,3,3,0,3
2023-06-01,394411,2,0,2,1,0,1
2023-06-01,36174,1,0,1,4,0,4
2023-06-01,55113,5,0,5,3,0,3
2023-06-01,138206,1,0,1,1,0,1
2023-06-01,14192,4,0,4,1,0,1
2023-06-01,400078,3,0,3,2,0,2
2023-06-01,395346,1,0,1,2,0,2
2023-06-01,394602,1,0,1,3,0,3
2023-06-01,17040,6,0,6,2,0,2
2023-06-01,49745,1,3,4,1,3,3
2023-06-01,21521,1,0,1,3,0,3
2023-06-01,393661,1,0,1,1,0,1
2023-06-01,3465,4,0,4,7,0,7
2023-06-01,1824,4,0,4,3,0,3
2023-06-01,19230,1,1,2,1,1,1
2023-06-01,54454,10,0,10,1,0,1
2023-06-01,32974,5,0,5,2,0,2
2023-06-01,6989,15,0,15,4,0,4
2023-06-01,10524,1,0,1,2,0,2
2023-06-01,3333,6,1,7,11,5,12
2023-06-01,197000,1,1,2,7,3,8
2023-06-01,25152,2,2,4,16,7,18
2023-06-01,2121,1,1,2,1,1,1
2023-06-01,25111,5,1,6,7,1,7
2023-06-01,8890,2,1,3,2,1,3
2023-06-01,198752,1,0,1,2,0,2
2023-06-01,43741,1,0,1,1,0,1
2023-06-01,198754,1,0,1,1,0,1
2023-06-01,3191,1,0,1,2,0,2
2023-06-01,198758,5,0,5,3,0,3
2023-06-01,58169,1,0,1,1,0,1
2023-06-01,198787,2,0,2,2,0,2
2023-06-01,59596,1,0,1,3,0,3
2023-06-01,58116,1,1,2,2,1,2
2023-06-01,198784,1,0,1,1,0,1
2023-06-01,35003,2,2,4,2,2,2
2023-06-01,58097,2,0,2,2,0,2
2023-06-01,24839,5,0,5,2,0,2
2023-06-01,34489,2,0,2,1,0,1
2023-06-01,25150,6,0,6,5,0,5
2023-06-01,49549,1,3,4,1,1,1
2023-06-01,15380,1,1,2,2,2,2
2023-06-01,42453,2,0,2,2,0,2
2023-06-01,25544,1,0,1,1,0,1
2023-06-01,24756,1,0,1,3,0,3
2023-06-01,34027,1,0,1,1,0,1
2023-06-01,25303,1,1,2,2,2,2
2023-06-01,41980,3,1,4,2,2,2
2023-06-01,210790,1,0,1,2,0,2
2023-06-01,31131,10,0,10,2,0,2
2023-06-01,210753,1,0,1,1,0,1
2023-06-01,48741,1,12,13,1,2,2
2023-06-01,210684,1,0,1,1,0,1
2023-06-01,211307,2,1,3,6,2,6
2023-06-01,211861,1,0,1,1,0,1
2023-06-01,212476,1,0,1,2,0,2
2023-06-01,211384,1,0,1,1,0,1
2023-06-01,211566,1,0,1,1,0,1
2023-06-01,212661,12,3,15,3,2,3
2023-06-01,211709,4,0,4,2,0,2
2023-06-01,211558,1,0,1,1,0,1
2023-06-01,211607,2,3,5,1,1,1
2023-06-01,211547,1,11,12,1,4,4
2023-06-01,210553,1,0,1,1,0,1
2023-06-01,212670,3,0,3,3,0,3
2023-06-01,209903,1,1,2,1,1,1
2023-06-01,212753,2,0,2,4,0,4
2023-06-01,57729,2,0,2,1,0,1
2023-06-01,29166,10,0,10,2,0,2
2023-06-01,8300,3,4,7,1,1,1
2023-06-01,57987,3,0,3,2,0,2
2023-06-01,51820,1,0,1,1,0,1
2023-06-01,196621,1,1,2,3,1,3
2023-06-01,52183,4,0,4,3,0,3
2023-06-01,206994,1,1,2,1,1,1
2023-06-01,211452,1,1,2,2,2,2
2023-06-01,196722,7,0,7,5,0,5
2023-06-01,30853,8,0,8,2,0,2
2023-06-01,30791,1,1,2,2,2,2
2023-06-01,207950,1,0,1,1,0,1
2023-06-01,207988,1,1,2,1,1,1
2023-06-01,21222,5,0,5,3,0,3
2023-06-01,208065,2,0,2,2,0,2
2023-06-01,58199,1,0,1,2,0,2
2023-06-01,39750,2,0,2,3,0,3
2023-06-01,57170,1,0,1,2,0,2
2023-06-01,197707,1,0,1,1,0,1
2023-06-01,197698,1,0,1,1,0,1
2023-06-01,210500,4,0,4,3,0,3
2023-06-01,29641,2,0,2,3,0,3
2023-06-01,31182,1,1,2,1,1,2
2023-06-01,25289,8,0,8,3,0,3
2023-06-01,199802,2,0,2,1,0,1
2023-06-01,199819,1,1,2,1,1,1
2023-06-01,50405,3,0,3,4,0,4
2023-06-01,198505,1,0,1,3,0,3
2023-06-01,24843,11,0,11,1,0,1
2023-06-01,25090,1,0,1,1,0,1
2023-06-01,209498,1,0,1,1,0,1
2023-06-01,48776,2,0,2,3,0,3
2023-06-01,41099,5,0,5,4,0,4
2023-06-01,210416,1,0,1,2,0,2
2023-06-01,200395,1,0,1,1,0,1
2023-06-01,15392,1,0,1,1,0,1
2023-06-01,34845,2,0,2,2,0,2
2023-06-01,211047,1,0,1,1,0,1
2023-06-01,208092,2,0,2,3,0,3
2023-06-01,25113,8,0,8,1,0,1
2023-06-01,51510,3,0,3,1,0,1
2023-06-01,49311,8,0,8,2,0,2
2023-06-01,44602,1,0,1,2,0,2
2023-06-01,211801,1,0,1,2,0,2
2023-06-01,43665,3,0,3,1,0,1
2023-06-01,8748,2,0,2,1,0,1
2023-06-01,204612,1,0,1,3,0,3
2023-06-01,200768,2,1,3,1,1,1
2023-06-01,211499,1,1,2,1,1,1
2023-06-01,31534,1,0,1,3,0,3
2023-06-01,31497,1,0,1,2,0,2
2023-06-01,39453,1,0,1,1,0,1
2023-06-01,31528,1,0,1,2,0,2
2023-06-01,48210,4,0,4,1,0,1
2023-06-01,31545,1,0,1,1,0,1
2023-06-01,31557,1,0,1,3,0,3
2023-06-01,31393,1,0,1,2,0,2
2023-06-01,31417,1,0,1,1,0,1
2023-06-01,44823,1,0,1,1,0,1
2023-06-01,31428,1,0,1,2,0,2
2023-06-01,31468,1,0,1,1,0,1
2023-06-01,42312,18,0,18,7,0,7
2023-06-01,16108,2,1,3,3,3,3
2023-06-01,60209,5,0,5,3,0,3
2023-06-01,30831,3,0,3,2,0,2
2023-06-01,200291,1,0,1,4,0,4
2023-06-01,20971,5,0,5,3,0,3
2023-06-01,41241,1,0,1,3,0,3
2023-06-01,31446,1,0,1,1,0,1
2023-06-01,31599,1,0,1,2,0,2
2023-06-01,206031,1,0,1,1,0,1
2023-06-01,31627,2,0,2,3,0,3
2023-06-01,31457,1,0,1,1,0,1
2023-06-01,29343,1,0,1,1,0,1
2023-06-01,42195,2,0,2,1,0,1
2023-06-01,29673,1,0,1,1,0,1
2023-06-01,57517,1,1,2,2,2,2
2023-06-01,207572,4,1,5,1,1,1
2023-06-01,12613,1,0,1,1,0,1
2023-06-01,39142,4,1,5,2,2,2
2023-06-01,35242,4,0,4,2,0,2
2023-06-01,213100,1,3,4,1,4,4
2023-06-01,31080,2,1,3,7,5,7
2023-06-01,31092,1,0,1,1,0,1
2023-06-01,198488,1,0,1,1,0,1
2023-06-01,31086,1,0,1,2,0,2
2023-06-01,31091,2,0,2,3,0,3
2023-06-01,30869,1,0,1,1,0,1
2023-06-01,208336,2,0,2,2,0,2
2023-06-01,58012,4,1,5,2,2,2
2023-06-01,31578,1,0,1,2,0,2
2023-06-01,31589,1,0,1,3,0,3
2023-06-01,209418,1,1,2,2,1,2
2023-06-01,31045,1,0,1,2,0,2
2023-06-01,210752,1,1,2,2,1,2
2023-06-01,60698,1,0,1,1,0,1
2023-06-01,200520,2,0,2,1,0,1
2023-06-01,31026,1,0,1,2,0,2
2023-06-01,34022,1,0,1,2,0,2
2023-06-01,199003,1,0,1,2,0,2
2023-06-01,198451,1,0,1,1,0,1
2023-06-01,34045,1,0,1,2,0,2
2023-06-01,34460,3,0,3,4,0,4
2023-06-01,34065,11,0,11,2,0,2
2023-06-01,34228,1,0,1,2,0,2
2023-06-01,34069,1,0,1,1,0,1
2023-06-01,211247,1,0,1,2,0,2
2023-06-01,34278,1,0,1,1,0,1
2023-06-01,34094,1,0,1,3,0,3
2023-06-01,24708,5,1,6,2,2,3
2023-06-01,34745,2,0,2,1,0,1
2023-06-01,41716,1,0,1,3,0,3
2023-06-01,12815,1,0,1,2,0,2
2023-06-01,30859,1,0,1,3,0,3
2023-06-01,30771,1,0,1,1,0,1
2023-06-01,30769,1,0,1,1,0,1
2023-06-01,30871,1,0,1,1,0,1
2023-06-01,31285,1,0,1,2,0,2
2023-06-01,44665,2,0,2,2,0,2
2023-06-01,34798,2,1,3,1,1,1
2023-06-01,30911,2,0,2,2,0,2
2023-06-01,202833,1,0,1,1,0,1
2023-06-01,29335,6,0,6,3,0,3
2023-06-01,57319,4,0,4,5,0,5
2023-06-01,44805,1,0,1,1,0,1
2023-06-01,44770,1,1,2,1,1,1
2023-06-01,44378,1,0,1,2,0,2
2023-06-01,21346,5,0,5,1,0,1
2023-06-01,210860,1,0,1,1,0,1
2023-06-01,29682,1,1,2,2,1,2
2023-06-01,211491,1,0,1,1,0,1
2023-06-01,51598,1,0,1,1,0,1
2023-06-01,197285,1,0,1,1,0,1
2023-06-01,30841,1,0,1,1,0,1
2023-06-01,57249,1,0,1,3,0,3
2023-06-01,28981,2,0,2,1,0,1
2023-06-01,15939,1,0,1,1,0,1
2023-06-01,56537,1,0,1,3,0,3
2023-06-01,35114,1,0,1,2,0,2
2023-06-01,31606,1,0,1,1,0,1
2023-06-01,57132,1,0,1,1,0,1
2023-06-01,56469,1,0,1,1,0,1
2023-06-01,207697,2,0,2,5,0,5
2023-06-01,31009,1,0,1,2,0,2
2023-06-01,30973,1,0,1,2,0,2
2023-06-01,31332,1,0,1,1,0,1
2023-06-01,207864,2,0,2,1,0,1
2023-06-01,39682,1,0,1,3,0,3
2023-06-01,31310,1,0,1,3,0,3
2023-06-01,210255,1,0,1,2,0,2
2023-06-01,210326,2,0,2,2,0,2
2023-06-01,50645,1,0,1,1,0,1
2023-06-01,20163,2,0,2,2,0,2
2023-06-01,31140,1,0,1,4,0,4
2023-06-01,41594,3,0,3,1,0,1
2023-06-01,31096,1,0,1,1,0,1
2023-06-01,31184,2,0,2,1,0,1
2023-06-01,200346,1,0,1,3,0,3
2023-06-01,51799,1,0,1,2,0,2
2023-06-01,210252,2,2,4,1,1,1
2023-06-01,62242,1,1,2,1,1,1
2023-06-01,35616,1,1,2,2,1,2
2023-06-01,31060,1,0,1,1,0,1
2023-06-01,31072,2,0,2,1,0,1
2023-06-01,31113,1,0,1,1,0,1
2023-06-01,31114,1,0,1,1,0,1
2023-06-01,31434,1,0,1,1,0,1
2023-06-01,31134,1,0,1,1,0,1
2023-06-01,31632,1,0,1,2,0,2
2023-06-01,34180,3,0,3,1,0,1
2023-06-01,48993,1,0,1,1,0,1
2023-06-01,8741,3,2,5,2,1,2
2023-06-01,48890,1,0,1,2,0,2
2023-06-01,51695,13,1,14,3,1,3
2023-06-01,30849,1,0,1,3,0,3
2023-06-01,60030,1,0,1,3,0,3
2023-06-01,30905,1,0,1,1,0,1
2023-06-01,31062,1,0,1,2,0,2
2023-06-01,43701,1,0,1,2,0,2
2023-06-01,25115,3,2,5,2,2,2
2023-06-01,50355,1,0,1,4,0,4
2023-06-01,30787,1,0,1,2,0,2
2023-06-01,42118,1,0,1,2,0,2
2023-06-01,15096,4,1,5,1,1,1
2023-06-01,31187,1,0,1,3,0,3
2023-06-01,43978,5,0,5,2,0,2
2023-06-01,57437,2,0,2,3,0,3
2023-06-01,31049,1,0,1,2,0,2
2023-06-01,50803,5,0,5,2,0,2
2023-06-01,202998,4,0,4,1,0,1
2023-06-01,198036,1,0,1,5,0,5
2023-06-01,31095,1,0,1,3,0,3
2023-06-01,34059,1,0,1,1,0,1
2023-06-01,209463,1,0,1,1,0,1
2023-06-01,202542,1,0,1,2,0,2
2023-06-01,208019,6,0,6,2,0,2
2023-06-01,21169,2,0,2,1,0,1
2023-06-01,31369,3,0,3,3,0,3
2023-06-01,31413,2,0,2,1,0,1
2023-06-01,31173,3,0,3,6,0,6
2023-06-01,31181,1,0,1,2,0,2
2023-06-01,39323,1,0,1,2,0,2
2023-06-01,48853,1,0,1,2,0,2
2023-06-01,31164,1,0,1,2,0,2
2023-06-01,31235,2,0,2,4,0,4
2023-06-01,51679,3,0,3,1,0,1
2023-06-01,212526,1,1,2,1,1,1
2023-06-01,51429,1,0,1,1,0,1
2023-06-01,15550,1,1,2,3,3,3
2023-06-01,58274,1,0,1,1,0,1
2023-06-01,29500,8,0,8,3,0,3
2023-06-01,33946,1,0,1,1,0,1
2023-06-01,15543,2,0,2,3,0,3
2023-06-01,49336,1,0,1,2,0,2
2023-06-01,33907,5,1,6,1,1,1
2023-06-01,61306,1,0,1,1,0,1
2023-06-01,209977,1,0,1,3,0,3
2023-06-01,33996,1,0,1,3,0,3
2023-06-01,12986,2,1,3,3,2,3
2023-06-01,8294,1,0,1,1,0,1
2023-06-01,16084,2,0,2,1,0,1
2023-06-01,39218,1,1,2,2,2,2
2023-06-01,213106,0,2,2,5,4,5
2023-06-01,47145,1,0,1,1,0,1
2023-06-01,31278,2,0,2,3,0,3
2023-06-01,31193,1,0,1,1,0,1
2023-06-01,31192,1,0,1,3,0,3
2023-06-01,12325,2,0,2,1,0,1
2023-06-01,207674,2,0,2,2,0,2
2023-06-01,49337,1,0,1,1,0,1
2023-06-01,33853,1,0,1,2,0,2
2023-06-01,60862,1,0,1,2,0,2
2023-06-01,56651,1,0,1,3,0,3
2023-06-01,34614,1,0,1,1,0,1
2023-06-01,44097,2,1,3,4,4,6
2023-06-01,35262,1,0,1,1,0,1
2023-06-01,30816,1,0,1,3,0,3
2023-06-01,57900,4,0,4,2,0,2
2023-06-01,31401,1,0,1,1,0,1
2023-06-01,207699,1,0,1,1,0,1
2023-06-01,210849,1,0,1,1,0,1
2023-06-01,49161,2,0,2,2,0,2
2023-06-01,197334,1,0,1,3,0,3
2023-06-01,50778,3,0,3,3,0,3
2023-06-01,31038,1,0,1,1,0,1
2023-06-01,31676,2,0,2,4,0,4
2023-06-01,31162,2,0,2,3,0,3
2023-06-01,60997,2,1,3,2,2,2
2023-06-01,57493,3,0,3,3,0,3
2023-06-01,206852,2,0,2,3,0,3
2023-06-01,13160,2,0,2,1,0,1
2023-06-01,21123,2,0,2,3,0,3
2023-06-01,30928,1,0,1,1,0,1
2023-06-01,41718,1,0,1,2,0,2
2023-06-01,198769,1,0,1,1,0,1
2023-06-01,61175,1,0,1,1,0,1
2023-06-01,31439,1,0,1,2,0,2
2023-06-01,197509,1,0,1,1,0,1
2023-06-01,6764,6,1,7,8,2,8
2023-06-01,207486,8,4,12,2,2,2
2023-06-01,31174,3,0,3,3,0,3
2023-06-01,31048,1,0,1,1,0,1
2023-06-01,58020,1,0,1,1,0,1
2023-06-01,3304,1,0,1,1,0,1
2023-06-01,202946,1,0,1,3,0,3
2023-06-01,31347,1,0,1,1,0,1
2023-06-01,44138,3,0,3,1,0,1
2023-06-01,62434,12,1,13,4,2,4
2023-06-01,31711,1,0,1,1,0,1
2023-06-01,41746,1,0,1,2,0,2
2023-06-01,31722,1,0,1,2,0,2
2023-06-01,41086,7,0,7,2,0,2
2023-06-01,31735,1,0,1,1,0,1
2023-06-01,16018,1,0,1,1,0,1
2023-06-01,33826,1,0,1,2,0,2
2023-06-01,49989,1,0,1,1,0,1
2023-06-01,31206,1,0,1,1,0,1
2023-06-01,35646,1,0,1,2,0,2
2023-06-01,48290,1,0,1,2,0,2
2023-06-01,42194,2,0,2,2,0,2
2023-06-01,31375,1,0,1,1,0,1
2023-06-01,30825,1,0,1,1,0,1
2023-06-01,208964,1,0,1,3,0,3
2023-06-01,31014,1,0,1,2,0,2
2023-06-01,31081,1,0,1,1,0,1
2023-06-01,34125,3,0,3,2,0,2
2023-06-01,207858,1,0,1,1,0,1
2023-06-01,44952,2,0,2,1,0,1
2023-06-01,59656,1,0,1,2,0,2
2023-06-01,201228,1,0,1,1,0,1
2023-06-01,50246,1,0,1,1,0,1
2023-06-01,30775,1,0,1,1,0,1
2023-06-01,202133,2,0,2,2,0,2
2023-06-01,12594,3,1,4,1,1,1
2023-06-01,31315,1,0,1,1,0,1
2023-06-01,28820,2,0,2,1,0,1
2023-06-01,12625,18,5,23,9,7,10
2023-06-01,198552,1,0,1,1,0,1
2023-06-01,208080,6,0,6,2,0,2
2023-06-01,197203,1,0,1,2,0,2
2023-06-01,31249,1,0,1,1,0,1
2023-06-01,207488,1,1,2,3,3,4
2023-06-01,21096,2,0,2,2,0,2
2023-06-01,60112,1,0,1,2,0,2
2023-06-01,44499,2,0,2,2,0,2
2023-06-01,199294,1,0,1,3,0,3
2023-06-01,34591,4,1,5,1,1,1
2023-06-01,204636,1,0,1,2,0,2
2023-06-01,21188,4,0,4,2,0,2
2023-06-01,42198,3,4,7,2,1,2
2023-06-01,30920,2,1,3,3,1,4
2023-06-01,31396,1,1,2,3,3,4
2023-06-01,213238,1,0,1,1,0,1
2023-06-01,201107,4,0,4,1,0,1
2023-06-01,39641,2,0,2,2,0,2
2023-06-01,210917,1,0,1,1,0,1
2023-06-01,212533,1,0,1,3,0,3
2023-06-01,21458,1,0,1,1,0,1
2023-06-01,30907,1,0,1,1,0,1
2023-06-01,31280,1,0,1,2,0,2
2023-06-01,62098,1,1,2,1,1,1
2023-06-01,8431,7,0,7,6,0,6
2023-06-01,31011,1,0,1,1,0,1
2023-06-01,43815,1,1,2,1,1,1
2023-06-01,39222,2,0,2,3,0,3
2023-06-01,31069,2,0,2,1,0,1
2023-06-01,59646,1,0,1,1,0,1
2023-06-01,16313,1,0,1,1,0,1
2023-06-01,41787,3,0,3,1,0,1
2023-06-01,34142,1,0,1,1,0,1
2023-06-01,43079,1,0,1,2,0,2
2023-06-01,199555,2,0,2,1,0,1
2023-06-01,208020,1,0,1,1,0,1
2023-06-01,59487,1,0,1,1,0,1
2023-06-01,59490,1,0,1,1,0,1
2023-06-01,59489,1,0,1,1,0,1
2023-06-01,211268,2,0,2,1,0,1
2023-06-01,8484,4,0,4,3,0,3
2023-06-01,199041,1,0,1,1,0,1
2023-06-01,205127,3,1,4,2,1,2
2023-06-01,211493,1,0,1,3,0,3
2023-06-01,34681,1,4,5,4,2,5
2023-06-01,211462,1,0,1,1,0,1
2023-06-01,200889,1,0,1,4,0,4
2023-06-01,208856,1,0,1,1,0,1
2023-06-01,211643,1,0,1,2,0,2
2023-06-01,209803,1,0,1,3,0,3
2023-06-01,209357,1,0,1,2,0,2
2023-06-01,41952,5,0,5,4,0,4
2023-06-01,208187,3,2,5,2,2,2
2023-06-01,210245,3,0,3,2,0,2
2023-06-01,41705,4,0,4,1,0,1
2023-06-01,41367,3,0,3,1,0,1
2023-06-01,42211,1,0,1,1,0,1
2023-06-01,42243,1,0,1,1,0,1
2023-06-01,42665,3,0,3,1,0,1
2023-06-01,49580,2,0,2,3,0,3
2023-06-01,42264,1,0,1,1,0,1
2023-06-01,204288,1,0,1,4,0,4
2023-06-01,42327,2,0,2,4,0,4
2023-06-01,42379,3,0,3,3,0,3
2023-06-01,62266,1,0,1,1,0,1
2023-06-01,51245,1,0,1,2,0,2
2023-06-01,42393,2,0,2,2,0,2
2023-06-01,65121,0,0,0,1,0,1
2023-06-01,42404,1,0,1,1,0,1
2023-06-01,42424,3,0,3,5,0,5
2023-06-01,211201,1,0,1,2,0,2
2023-06-01,57163,1,0,1,1,0,1
2023-06-01,208705,1,2,3,3,2,3
2023-06-01,197353,3,0,3,2,0,2
2023-06-01,49945,4,0,4,4,0,4
2023-06-01,50972,1,0,1,1,0,1
2023-06-01,42729,1,0,1,2,0,2
2023-06-01,42712,1,0,1,1,0,1
2023-06-01,201633,2,1,3,1,1,1
2023-06-01,57171,1,0,1,1,0,1
2023-06-01,48343,1,0,1,2,0,2
2023-06-01,42799,2,0,2,1,0,1
2023-06-01,42802,1,0,1,1,0,1
2023-06-01,56321,1,0,1,1,0,1
2023-06-01,16060,2,0,2,3,0,3
2023-06-01,42920,1,0,1,2,0,2
2023-06-01,34852,1,0,1,1,0,1
2023-06-01,42939,1,0,1,1,0,1
2023-06-01,41855,5,0,5,3,0,3
2023-06-01,51871,5,1,6,3,1,3
2023-06-01,24809,1,0,1,1,0,1
2023-06-01,48626,1,0,1,2,0,2
2023-06-01,41923,4,0,4,3,0,3
2023-06-01,205212,1,4,5,1,2,2
2023-06-01,44246,1,0,1,1,0,1
2023-06-01,41987,4,0,4,6,0,6
2023-06-01,41926,4,0,4,4,0,4
2023-06-01,47129,1,0,1,1,0,1
2023-06-01,41914,1,0,1,1,0,1
2023-06-01,34755,3,1,4,3,1,3
2023-06-01,199510,2,0,2,3,0,3
2023-06-01,8270,2,0,2,3,0,3
2023-06-01,41992,1,0,1,1,0,1
2023-06-01,41781,1,0,1,1,0,1
2023-06-01,41796,2,0,2,3,0,3
2023-06-01,41826,1,0,1,1,0,1
2023-06-01,3167,1,0,1,1,0,1
2023-06-01,39041,1,0,1,2,0,2
2023-06-01,50856,5,0,5,6,0,6
2023-06-01,211226,1,0,1,1,0,1
2023-06-01,209728,4,0,4,3,0,3
2023-06-01,201116,2,0,2,1,0,1
2023-06-01,28846,14,0,14,4,0,4
2023-06-01,44213,20,0,20,5,0,5
2023-06-01,59404,5,0,5,1,0,1
2023-06-01,198937,1,0,1,2,0,2
2023-06-01,59423,1,0,1,4,0,4
2023-06-01,59418,2,0,2,2,0,2
2023-06-01,198941,1,1,2,1,1,1
2023-06-01,33807,1,0,1,1,0,1
2023-06-01,198979,1,0,1,4,0,4
2023-06-01,205873,1,0,1,3,0,3
2023-06-01,58333,2,0,2,2,0,2
2023-06-01,211010,1,0,1,1,0,1
2023-06-01,198029,2,0,2,1,0,1
2023-06-01,198062,1,0,1,3,0,3
2023-06-01,197694,2,0,2,1,0,1
2023-06-01,12592,2,0,2,2,0,2
2023-06-01,57299,1,0,1,1,0,1
2023-06-01,201066,3,0,3,2,0,2
2023-06-01,8405,5,0,5,1,0,1
2023-06-01,208796,1,1,2,1,1,1
2023-06-01,44403,6,0,6,3,0,3
2023-06-01,25421,9,0,9,3,0,3
2023-06-01,41686,1,0,1,1,0,1
2023-06-01,60538,1,0,1,2,0,2
2023-06-01,5482,1,1,2,6,5,7
2023-06-01,48933,1,0,1,1,0,1
2023-06-01,49015,1,0,1,2,0,2
2023-06-01,49003,1,0,1,3,0,3
2023-06-01,210107,4,55,59,1,1,1
2023-06-01,211345,1,0,1,1,0,1
2023-06-01,211450,1,1,2,3,1,3
2023-06-01,211400,1,2,3,3,2,3
2023-06-01,210044,1,1,2,2,2,2
2023-06-01,210036,3,3,6,8,7,12
2023-06-01,56984,3,0,3,2,0,2
2023-06-01,41924,1,0,1,1,0,1
2023-06-01,212829,1,0,1,1,0,1
2023-06-01,34398,1,0,1,1,0,1
2023-06-01,57190,1,0,1,1,0,1
2023-06-01,61201,1,1,2,1,1,1
2023-06-01,41708,1,0,1,1,0,1
2023-06-01,205138,1,8,9,5,4,6
2023-06-01,210847,5,0,5,4,0,4
2023-06-01,41217,2,0,2,3,0,3
2023-06-01,39306,1,0,1,1,0,1
2023-06-01,42182,1,0,1,1,0,1
2023-06-01,41766,1,0,1,2,0,2
2023-06-01,41345,1,0,1,1,0,1
2023-06-01,41755,1,0,1,1,0,1
2023-06-01,42024,1,0,1,1,0,1
2023-06-01,199697,1,0,1,3,0,3
2023-06-01,41768,1,0,1,3,0,3
2023-06-01,210037,1,0,1,1,0,1
2023-06-01,213152,2,1,3,3,1,3
2023-06-01,42479,1,0,1,1,0,1
2023-06-01,200587,4,0,4,2,0,2
2023-06-01,208697,5,0,5,2,0,2
2023-06-01,210183,1,0,1,3,0,3
2023-06-01,198199,1,0,1,2,0,2
2023-06-01,48397,2,0,2,1,0,1
2023-06-01,211227,1,2,3,3,3,4
2023-06-01,213360,1,0,1,2,0,2
2023-06-01,62364,3,0,3,1,0,1
2023-06-01,48705,1,0,1,2,0,2
2023-06-01,41791,1,0,1,1,0,1
2023-06-01,41875,1,0,1,1,0,1
2023-06-01,41834,4,0,4,3,0,3
2023-06-01,202110,1,0,1,1,0,1
2023-06-01,41814,1,0,1,1,0,1
2023-06-01,41832,1,0,1,1,0,1
2023-06-01,211426,1,0,1,1,0,1
2023-06-01,41845,1,0,1,1,0,1
2023-06-01,43410,1,0,1,2,0,2
2023-06-01,3332,2,0,2,3,0,3
2023-06-01,15821,1,0,1,1,0,1
2023-06-01,15923,1,0,1,1,0,1
2023-06-01,15946,1,0,1,1,0,1
2023-06-01,29273,1,0,1,1,0,1
2023-06-01,15908,1,0,1,2,0,2
2023-06-01,15608,1,0,1,3,0,3
2023-06-01,59579,1,0,1,1,0,1
2023-06-01,15827,1,0,1,1,0,1
2023-06-01,210788,2,2,4,3,2,3
2023-06-01,209999,1,0,1,1,0,1
2023-06-01,207573,1,0,1,1,0,1
2023-06-01,15911,1,0,1,1,0,1
2023-06-01,20675,2,0,2,1,0,1
2023-06-01,15981,1,0,1,3,0,3
2023-06-01,16052,1,0,1,2,0,2
2023-06-01,16104,1,1,2,3,1,3
2023-06-01,58217,2,0,2,1,0,1
2023-06-01,16049,2,0,2,1,0,1
2023-06-01,44940,1,0,1,1,0,1
2023-06-01,15840,1,0,1,1,0,1
2023-06-01,21443,1,0,1,1,0,1
2023-06-01,25497,1,0,1,1,0,1
2023-06-01,6686,1,0,1,1,0,1
2023-06-01,6688,1,0,1,1,0,1
2023-06-01,5623,1,0,1,1,0,1
2023-06-01,6742,1,0,1,1,0,1
2023-06-01,9176,2,0,2,1,0,1
2023-06-01,213379,1,0,1,2,0,2
2023-06-01,25193,2,0,2,1,0,1
2023-06-01,16107,5,1,6,3,1,3
2023-06-01,57260,1,1,2,2,1,2
2023-06-01,42060,1,1,2,1,1,2
2023-06-01,16013,2,0,2,2,0,2
2023-06-01,197146,1,0,1,4,0,4
2023-06-01,16077,2,0,2,1,0,1
2023-06-01,16193,1,0,1,1,0,1
2023-06-01,16101,1,1,2,2,2,2
2023-06-01,16062,2,0,2,4,0,4
2023-06-01,25411,2,1,3,2,1,2
2023-06-01,8314,1,0,1,1,0,1
2023-06-01,212946,1,0,1,1,0,1
2023-06-01,16181,1,3,4,2,3,3
2023-06-01,15768,7,0,7,3,0,3
2023-06-01,13137,1,0,1,3,0,3
2023-06-01,208441,1,1,2,2,2,2
2023-06-01,16194,1,0,1,1,0,1
2023-06-01,16289,1,0,1,1,0,1
2023-06-01,16148,1,0,1,1,0,1
2023-06-01,57236,1,0,1,1,0,1
2023-06-01,211170,1,1,2,2,2,2
2023-06-01,210002,2,0,2,2,0,2
2023-06-01,210949,2,0,2,2,0,2
2023-06-01,211211,2,1,3,3,1,4
2023-06-01,39901,1,0,1,3,0,3
2023-06-01,60366,1,0,1,2,0,2
2023-06-01,51488,1,0,1,3,0,3
2023-06-01,203652,4,0,4,1,0,1
2023-06-01,57510,1,0,1,1,0,1
2023-06-01,47940,1,0,1,1,0,1
2023-06-01,48026,1,0,1,1,0,1
2023-06-01,48182,1,0,1,1,0,1
2023-06-01,48021,1,0,1,2,0,2
2023-06-01,47946,1,0,1,3,0,3
2023-06-01,13254,3,0,3,1,0,1
2023-06-01,50827,2,1,3,2,1,2
2023-06-01,16266,2,0,2,1,0,1
2023-06-01,15668,1,0,1,4,0,4
2023-06-01,43307,2,0,2,1,0,1
2023-06-01,202344,3,3,6,3,3,4
2023-06-01,34340,2,0,2,2,0,2
2023-06-01,208060,3,1,4,5,4,5
2023-06-01,212235,5,0,5,1,0,1
2023-06-01,34330,1,0,1,2,0,2
2023-06-01,61160,1,1,2,1,1,1
2023-06-01,34389,3,0,3,3,0,3
2023-06-01,8978,2,1,3,8,6,8
2023-06-01,2595,1,0,1,3,0,3
2023-06-01,208794,1,1,2,1,1,1
2023-06-01,49978,1,0,1,1,0,1
2023-06-01,51600,1,0,1,2,0,2
2023-06-01,13165,2,0,2,2,0,2
2023-06-01,207378,1,0,1,1,0,1
2023-06-01,34958,2,1,3,1,1,1
2023-06-01,35675,2,1,3,2,1,2
2023-06-01,35585,2,0,2,3,0,3
2023-06-01,200901,5,0,5,2,0,2
2023-06-01,200620,1,0,1,1,0,1
2023-06-01,9023,2,1,3,3,1,3
2023-06-01,44344,1,0,1,1,0,1
2023-06-01,44663,1,0,1,1,0,1
2023-06-01,199893,1,0,1,3,0,3
2023-06-01,212774,2,2,4,1,1,1
2023-06-01,43423,1,0,1,4,0,4
2023-06-01,43416,1,0,1,1,0,1
2023-06-01,43461,1,0,1,1,0,1
2023-06-01,43430,1,0,1,1,0,1
2023-06-01,43462,1,0,1,3,0,3
2023-06-01,43605,1,0,1,1,0,1
2023-06-01,213266,1,0,1,1,0,1
2023-06-01,43455,1,1,2,2,1,2
2023-06-01,51107,1,0,1,1,0,1
2023-06-01,43472,1,0,1,1,0,1
2023-06-01,43631,1,0,1,2,0,2
2023-06-01,5397,2,0,2,4,0,4
2023-06-01,43498,1,0,1,1,0,1
2023-06-01,200692,1,0,1,1,0,1
2023-06-01,43506,1,0,1,1,0,1
2023-06-01,200974,1,0,1,3,0,3
2023-06-01,207930,1,0,1,1,0,1
2023-06-01,206017,0,0,0,2,0,2
2023-06-01,64470,1,0,1,1,0,1
2023-06-01,29301,2,1,3,5,2,5
2023-06-01,43730,1,0,1,3,0,3
2023-06-01,47106,1,0,1,2,0,2
2023-06-01,198829,1,0,1,1,0,1
2023-06-01,44594,5,0,5,1,0,1
2023-06-01,42196,1,0,1,1,0,1
2023-06-01,43512,1,0,1,1,0,1
2023-06-01,43520,1,0,1,3,0,3
2023-06-01,43536,1,0,1,1,0,1
2023-06-01,56383,1,0,1,1,0,1
2023-06-01,202507,4,0,4,1,0,1
2023-06-01,58111,1,0,1,3,0,3
2023-06-01,35293,1,0,1,1,0,1
2023-06-01,35167,1,0,1,2,0,2
2023-06-01,35309,1,0,1,2,0,2
2023-06-01,35316,2,0,2,1,0,1
2023-06-01,35321,1,0,1,1,0,1
2023-06-01,60295,2,0,2,1,0,1
2023-06-01,35340,1,0,1,2,0,2
2023-06-01,44888,2,0,2,1,0,1
2023-06-01,8930,4,0,4,2,0,2
2023-06-01,35338,1,0,1,1,0,1
2023-06-01,35343,1,0,1,3,0,3
2023-06-01,35552,1,0,1,1,0,1
2023-06-01,9171,1,0,1,1,0,1
2023-06-01,35500,1,0,1,2,0,2
2023-06-01,25412,2,0,2,2,0,2
2023-06-01,197553,1,0,1,1,0,1
2023-06-01,35354,1,0,1,2,0,2
2023-06-01,212181,1,1,2,2,2,2
2023-06-01,35209,1,0,1,1,0,1
2023-06-01,35504,1,0,1,2,0,2
2023-06-01,25318,2,1,3,1,1,1
2023-06-01,199601,1,0,1,3,0,3
2023-06-01,41269,3,0,3,1,0,1
2023-06-01,44879,3,0,3,2,0,2
2023-06-01,35822,1,0,1,1,0,1
2023-06-01,3297,2,0,2,3,0,3
2023-06-01,35416,1,0,1,3,0,3
2023-06-01,35438,1,0,1,1,0,1
2023-06-01,35436,1,0,1,2,0,2
2023-06-01,2472,9,1,10,1,1,1
2023-06-01,2470,21,1,22,1,1,1
2023-06-01,2088,3,1,4,1,1,1
2023-06-01,2198,4,0,4,1,0,1
2023-06-01,60650,1,0,1,1,0,1
2023-06-01,203017,1,1,2,2,2,2
2023-06-01,59876,2,1,3,1,1,1
2023-06-01,21373,6,0,6,3,0,3
2023-06-01,205420,1,0,1,1,0,1
2023-06-01,12823,1,0,1,2,0,2
2023-06-01,39804,9,0,9,1,0,1
2023-06-01,44209,4,0,4,2,0,2
2023-06-01,34719,2,0,2,1,0,1
2023-06-01,2199,12,1,13,1,1,1
2023-06-01,211425,1,0,1,1,0,1
2023-06-01,211394,1,0,1,3,0,3
2023-06-01,211274,1,1,2,1,1,1
2023-06-01,210228,2,0,2,1,0,1
2023-06-01,210227,1,0,1,1,0,1
2023-06-01,203360,5,0,5,2,0,2
2023-06-01,210297,3,0,3,2,0,2
2023-06-01,62269,1,1,2,4,6,6
2023-06-01,211416,1,1,2,1,1,1
2023-06-01,211413,1,1,2,1,1,1
2023-06-01,15846,8,0,8,1,0,1
2023-06-01,211410,1,0,1,1,0,1
2023-06-01,202639,1,0,1,2,0,2
2023-06-01,208960,1,0,1,2,0,2
2023-06-01,202407,1,0,1,1,0,1
2023-06-01,199024,1,0,1,2,0,2
2023-06-01,198060,3,1,4,2,1,2
2023-06-01,202328,5,0,5,4,0,4
2023-06-01,210890,1,4,5,4,5,5
2023-06-01,207861,4,0,4,2,0,2
2023-06-01,1015,1,0,1,1,0,1
2023-06-01,24954,16,1,17,2,2,2
2023-06-01,202574,2,0,2,3,0,3
2023-06-01,204227,1,0,1,2,0,2
2023-06-01,202515,2,0,2,3,0,3
2023-06-01,202112,1,2,3,3,1,3
2023-06-01,210068,2,0,2,2,0,2
2023-06-01,60812,1,0,1,2,0,2
2023-06-01,202475,2,0,2,1,0,1
2023-06-01,207761,4,0,4,1,0,1
2023-06-01,202460,5,0,5,4,0,4
2023-06-01,202517,1,0,1,3,0,3
2023-06-01,60226,1,0,1,1,0,1
2023-06-01,21093,4,0,4,1,0,1
2023-06-01,25682,1,1,2,1,1,1
2023-06-01,201072,8,0,8,2,0,2
2023-06-01,198340,10,0,10,2,0,2
2023-06-01,211449,1,0,1,1,0,1
2023-06-01,212646,2,0,2,3,0,3
2023-06-01,28988,4,0,4,1,0,1
2023-06-01,21241,3,0,3,2,0,2
2023-06-01,212710,2,2,4,1,1,1
2023-06-01,39070,1,1,2,1,1,1
2023-06-01,208031,3,0,3,2,0,2
2023-06-01,202516,1,1,2,2,2,2
2023-06-01,200930,3,0,3,2,0,2
2023-06-01,34386,2,0,2,3,0,3
2023-06-01,34780,1,0,1,3,0,3
2023-06-01,34813,1,0,1,3,0,3
2023-06-01,60802,1,0,1,2,0,2
2023-06-01,61218,0,10,10,2,5,6
2023-06-01,207856,4,0,4,1,0,1
2023-06-01,34834,1,0,1,1,0,1
2023-06-01,51289,1,0,1,2,0,2
2023-06-01,34519,1,0,1,1,0,1
2023-06-01,206354,1,0,1,1,0,1
2023-06-01,207684,3,0,3,3,0,3
2023-06-01,204569,1,0,1,3,0,3
2023-06-01,204679,5,2,7,4,5,6
2023-06-01,210271,1,0,1,3,0,3
2023-06-01,60877,4,0,4,2,0,2
2023-06-01,212422,2,0,2,2,0,2
2023-06-01,201143,1,0,1,1,0,1
2023-06-01,59832,2,0,2,2,0,2
2023-06-01,209316,1,0,1,1,0,1
2023-06-01,199815,1,1,2,1,2,2
2023-06-01,211155,1,0,1,2,0,2
2023-06-01,199845,1,0,1,2,0,2
2023-06-01,203384,3,0,3,2,0,2
2023-06-01,51066,6,1,7,3,2,3
2023-06-01,39331,1,0,1,2,0,2
2023-06-01,31579,1,0,1,1,0,1
2023-06-01,34204,4,0,4,2,0,2
2023-06-01,39348,1,0,1,1,0,1
2023-06-01,41035,2,0,2,3,0,3
2023-06-01,39457,1,0,1,1,0,1
2023-06-01,41442,1,0,1,1,0,1
2023-06-01,39379,1,0,1,1,0,1
2023-06-01,50633,9,0,9,3,0,3
2023-06-01,47435,1,0,1,1,0,1
2023-06-01,39468,2,0,2,2,0,2
2023-06-01,39851,1,0,1,1,0,1
2023-06-01,44478,2,0,2,4,0,4
2023-06-01,35524,2,0,2,1,0,1
2023-06-01,39357,1,0,1,2,0,2
2023-06-01,211360,1,6,7,4,4,5
2023-06-01,211304,1,0,1,1,0,1
2023-06-01,34763,1,0,1,1,0,1
2023-06-01,201447,2,0,2,1,0,1
2023-06-01,198296,3,1,4,2,2,2
2023-06-01,35036,1,0,1,1,0,1
2023-06-01,39403,1,0,1,1,0,1
2023-06-01,39481,1,0,1,2,0,2
2023-06-01,199806,1,1,2,1,1,1
2023-06-01,39429,1,0,1,2,0,2
2023-06-01,209111,1,0,1,2,0,2
2023-06-01,39648,3,1,4,2,2,2
2023-06-01,202510,1,1,2,1,1,2
2023-06-01,39414,1,0,1,1,0,1
2023-06-01,8577,1,0,1,1,0,1
2023-06-01,39445,1,0,1,1,0,1
2023-06-01,211821,1,0,1,2,0,2
2023-06-01,33958,1,1,2,4,1,4
2023-06-01,42520,1,0,1,2,0,2
2023-06-01,39513,1,0,1,2,0,2
2023-06-01,20897,6,1,7,5,1,5
2023-06-01,202500,1,0,1,3,0,3
2023-06-01,203238,1,0,1,1,0,1
2023-06-01,8458,1,0,1,2,0,2
2023-06-01,29229,1,1,2,1,1,1
2023-06-01,39748,1,0,1,1,0,1
2023-06-01,39760,1,0,1,1,0,1
2023-06-01,39764,1,0,1,3,0,3
2023-06-01,202508,1,0,1,1,0,1
2023-06-01,39860,2,0,2,1,0,1
2023-06-01,37551,3,0,3,1,0,1
2023-06-01,21192,6,0,6,1,0,1
2023-06-01,49009,1,1,2,9,5,12
2023-06-01,28940,1,1,2,2,2,2
2023-06-01,15779,4,0,4,2,0,2
2023-06-01,24926,19,0,19,6,0,6
2023-06-01,57911,1,0,1,1,0,1
2023-06-01,21063,1,0,1,1,0,1
2023-06-01,200916,1,0,1,1,0,1
2023-06-01,15363,2,0,2,1,0,1
2023-06-01,20740,3,1,4,1,1,1
2023-06-01,58092,9,0,9,7,0,7
2023-06-01,211784,1,1,2,1,1,1
2023-06-01,41072,1,0,1,3,0,3
2023-06-01,49708,1,0,1,1,0,1
2023-06-01,207886,4,2,6,3,2,3
2023-06-01,49871,5,0,5,1,0,1
2023-06-01,49927,1,0,1,2,0,2
2023-06-01,49875,1,0,1,1,0,1
2023-06-01,35088,1,0,1,1,0,1
2023-06-01,49955,1,0,1,2,0,2
2023-06-01,205237,1,0,1,3,0,3
2023-06-01,49939,1,0,1,2,0,2
2023-06-01,20703,1,0,1,1,0,1
2023-06-01,199994,1,0,1,2,0,2
2023-06-01,9149,1,0,1,2,0,2
2023-06-01,50185,1,0,1,3,0,3
2023-06-01,49946,1,0,1,2,0,2
2023-06-01,196806,1,0,1,2,0,2
2023-06-01,49938,1,0,1,1,0,1
2023-06-01,49923,1,0,1,2,0,2
2023-06-01,49881,1,1,2,3,1,3
2023-06-01,49982,1,0,1,1,0,1
2023-06-01,50197,1,0,1,3,0,3
2023-06-01,49960,1,0,1,1,0,1
2023-06-01,50117,1,0,1,2,0,2
2023-06-01,206166,2,0,2,2,0,2
2023-06-01,49994,3,0,3,4,0,4
2023-06-01,41551,2,0,2,2,0,2
2023-06-01,50014,1,0,1,3,0,3
2023-06-01,50036,1,0,1,1,0,1
2023-06-01,49990,1,0,1,1,0,1
2023-06-01,58091,1,0,1,1,0,1
2023-06-01,49996,1,0,1,1,0,1
2023-06-01,34599,4,0,4,6,0,6
2023-06-01,50006,1,0,1,1,0,1
2023-06-01,196839,1,0,1,3,0,3
2023-06-01,50426,1,0,1,1,0,1
2023-06-01,16351,1,0,1,1,0,1
2023-06-01,50034,1,1,2,2,1,2
2023-06-01,50051,1,0,1,1,0,1
2023-06-01,207470,3,0,3,2,0,2
2023-06-01,201230,1,0,1,1,0,1
2023-06-01,8706,1,0,1,3,0,3
2023-06-01,48598,1,1,2,1,1,1
2023-06-01,196674,4,1,5,6,2,6
2023-06-01,41077,2,0,2,1,0,1
2023-06-01,51368,1,0,1,2,0,2
2023-06-01,50865,1,0,1,1,0,1
2023-06-01,62438,1,0,1,1,0,1
2023-06-01,50081,1,0,1,1,0,1
2023-06-01,196783,2,0,2,2,0,2
2023-06-01,50080,1,0,1,1,0,1
2023-06-01,199505,1,0,1,1,0,1
2023-06-01,50143,1,0,1,3,0,3
2023-06-01,50110,1,0,1,2,0,2
2023-06-01,50093,1,0,1,2,0,2
2023-06-01,41973,1,0,1,1,0,1
2023-06-01,50112,3,0,3,2,0,2
2023-06-01,50111,1,0,1,2,0,2
2023-06-01,199063,1,0,1,1,0,1
2023-06-01,201967,1,0,1,1,0,1
2023-06-01,50140,1,0,1,3,0,3
2023-06-01,198523,1,0,1,3,0,3
2023-06-01,50137,1,0,1,1,0,1
2023-06-01,62385,1,0,1,3,0,3
2023-06-01,25546,2,0,2,1,0,1
2023-06-01,50145,1,0,1,1,0,1
2023-06-01,6873,1,0,1,5,0,5
2023-06-01,50268,1,0,1,1,0,1
2023-06-01,211317,1,0,1,1,0,1
2023-06-01,196855,1,0,1,1,0,1
2023-06-01,50172,3,0,3,2,0,2
2023-06-01,50194,1,0,1,1,0,1
2023-06-01,34986,1,0,1,2,0,2
2023-06-01,50209,1,0,1,3,0,3
2023-06-01,8619,2,0,2,1,0,1
2023-06-01,50221,1,0,1,1,0,1
2023-06-01,212444,1,0,1,1,0,1
2023-06-01,47795,1,0,1,4,0,4
2023-06-01,212415,2,1,3,1,1,1
2023-06-01,42824,1,0,1,2,0,2
2023-06-01,50279,1,0,1,3,0,3
2023-06-01,50248,1,0,1,2,0,2
2023-06-01,196869,1,0,1,1,0,1
2023-06-01,50346,1,0,1,2,0,2
2023-06-01,50288,1,0,1,1,0,1
2023-06-01,50320,1,0,1,1,0,1
2023-06-01,42974,1,0,1,2,0,2
2023-06-01,50305,1,0,1,1,0,1
2023-06-01,50298,1,0,1,2,0,2
2023-06-01,196877,1,0,1,3,0,3
2023-06-01,50303,1,0,1,3,0,3
2023-06-01,50420,2,0,2,1,0,1
2023-06-01,16075,1,1,2,5,4,5
2023-06-01,50353,1,0,1,3,0,3
2023-06-01,15422,5,0,5,5,0,5
2023-06-01,196913,1,0,1,2,0,2
2023-06-01,196882,1,0,1,1,0,1
2023-06-01,50344,1,1,2,1,1,1
2023-06-01,196884,1,0,1,2,0,2
2023-06-01,50350,1,0,1,2,0,2
2023-06-01,197220,1,0,1,2,0,2
2023-06-01,50356,1,0,1,3,0,3
2023-06-01,50361,1,0,1,3,0,3
2023-06-01,59434,1,0,1,1,0,1
2023-06-01,196887,1,0,1,1,0,1
2023-06-01,50687,1,0,1,3,0,3
2023-06-01,50375,1,0,1,2,0,2
2023-06-01,34596,2,1,3,1,1,1
2023-06-01,42915,1,0,1,2,0,2
2023-06-01,12553,1,1,2,2,3,4
2023-06-01,198655,1,0,1,4,0,4
2023-06-01,50407,2,1,3,2,1,2
2023-06-01,50441,1,0,1,2,0,2
2023-06-01,50423,1,0,1,1,0,1
2023-06-01,196895,1,0,1,3,0,3
2023-06-01,50410,1,0,1,1,0,1
2023-06-01,50982,1,0,1,1,0,1
2023-06-01,50425,1,0,1,3,0,3
2023-06-01,50455,1,1,2,3,1,3
2023-06-01,34291,2,0,2,4,0,4
2023-06-01,12774,2,0,2,2,0,2
2023-06-01,24898,1,0,1,1,0,1
2023-06-01,196902,1,0,1,1,0,1
2023-06-01,50462,1,0,1,2,0,2
2023-06-01,201788,1,0,1,1,0,1
2023-06-01,41764,1,0,1,1,0,1
2023-06-01,50493,1,0,1,1,0,1
2023-06-01,8976,1,0,1,2,0,2
2023-06-01,50483,1,0,1,1,0,1
2023-06-01,24728,1,0,1,1,0,1
2023-06-01,213000,1,0,1,3,0,3
2023-06-01,209140,1,0,1,2,0,2
2023-06-01,50501,1,0,1,1,0,1
2023-06-01,50508,2,0,2,2,0,2
2023-06-01,50587,1,0,1,3,0,3
2023-06-01,207425,4,0,4,1,0,1
2023-06-01,51462,1,0,1,1,0,1
2023-06-01,50674,1,0,1,3,0,3
2023-06-01,50737,1,1,2,4,2,5
2023-06-01,50582,1,2,3,1,1,1
2023-06-01,50592,1,0,1,2,0,2
2023-06-01,196935,1,0,1,1,0,1
2023-06-01,196939,1,1,2,2,1,2
2023-06-01,39121,2,0,2,1,0,1
2023-06-01,50609,1,1,2,2,2,2
2023-06-01,8351,8,1,9,4,3,4
2023-06-01,211899,1,0,1,2,0,2
2023-06-01,60207,1,0,1,1,0,1
2023-06-01,196944,1,1,2,1,1,1
2023-06-01,50638,1,0,1,2,0,2
2023-06-01,56778,1,0,1,3,0,3
2023-06-01,196876,1,0,1,1,0,1
2023-06-01,196947,1,0,1,3,0,3
2023-06-01,196948,1,1,2,1,1,1
2023-06-01,13154,1,0,1,3,0,3
2023-06-01,43384,2,1,3,1,2,3
2023-06-01,212912,1,1,2,1,1,1
2023-06-01,50731,1,0,1,1,0,1
2023-06-01,196951,1,0,1,1,0,1
2023-06-01,50654,1,0,1,1,0,1
2023-06-01,50680,1,0,1,1,0,1
2023-06-01,50708,1,0,1,1,0,1
2023-06-01,196982,1,0,1,2,0,2
2023-06-01,196972,1,0,1,1,0,1
2023-06-01,29647,1,0,1,1,0,1
2023-06-01,50700,1,0,1,1,0,1
2023-06-01,50725,1,0,1,3,0,3
2023-06-01,50744,1,0,1,1,0,1
2023-06-01,50730,3,0,3,3,0,3
2023-06-01,197003,1,0,1,2,0,2
2023-06-01,50720,1,0,1,1,0,1
2023-06-01,50721,1,0,1,1,0,1
2023-06-01,207851,4,0,4,1,0,1
2023-06-01,196990,1,0,1,1,0,1
2023-06-01,196971,1,0,1,3,0,3
2023-06-01,50748,1,0,1,4,0,4
2023-06-01,196975,2,0,2,5,0,5
2023-06-01,50762,1,0,1,2,0,2
2023-06-01,210739,1,0,1,2,0,2
2023-06-01,51215,1,0,1,2,0,2
2023-06-01,196992,1,0,1,2,0,2
2023-06-01,50786,1,0,1,4,0,4
2023-06-01,50777,1,0,1,1,0,1
2023-06-01,212412,1,0,1,1,0,1
2023-06-01,200364,1,0,1,1,0,1
2023-06-01,50787,1,0,1,2,0,2
2023-06-01,197229,2,0,2,1,0,1
2023-06-01,50381,1,1,2,1,1,1
2023-06-01,50965,1,0,1,3,0,3
2023-06-01,196999,1,0,1,3,0,3
2023-06-01,50847,1,0,1,3,0,3
2023-06-01,196652,1,0,1,3,0,3
2023-06-01,50813,1,0,1,1,0,1
2023-06-01,50808,1,0,1,1,0,1
2023-06-01,197007,1,0,1,1,0,1
2023-06-01,50251,5,1,6,1,1,1
2023-06-01,50237,5,0,5,2,0,2
2023-06-01,50281,1,0,1,2,0,2
2023-06-01,50283,2,0,2,2,0,2
2023-06-01,196879,1,0,1,6,0,6
2023-06-01,50433,1,0,1,2,0,2
2023-06-01,209008,1,0,1,2,0,2
2023-06-01,50465,4,0,4,1,0,1
2023-06-01,196901,1,0,1,2,0,2
2023-06-01,50454,5,0,5,2,0,2
2023-06-01,29637,1,0,1,1,0,1
2023-06-01,50505,1,0,1,1,0,1
2023-06-01,211187,1,0,1,2,0,2
2023-06-01,28969,2,0,2,3,0,3
2023-06-01,50488,1,0,1,1,0,1
2023-06-01,196980,2,0,2,1,0,1
2023-06-01,211385,1,1,2,1,2,2
2023-06-01,34190,4,0,4,7,0,7
2023-06-01,200252,1,0,1,1,0,1
2023-06-01,60076,1,0,1,1,0,1
2023-06-01,50027,2,0,2,1,0,1
2023-06-01,203198,1,0,1,1,0,1
2023-06-01,198958,1,0,1,3,0,3
2023-06-01,50657,2,0,2,1,0,1
2023-06-01,50750,4,0,4,1,0,1
2023-06-01,50727,1,0,1,1,0,1
2023-06-01,196978,1,1,2,1,1,1
2023-06-01,20980,1,0,1,1,0,1
2023-06-01,207850,1,0,1,1,0,1
2023-06-01,16328,2,0,2,1,0,1
2023-06-01,42900,1,0,1,2,0,2
2023-06-01,206599,3,0,3,3,0,3
2023-06-01,6748,1,0,1,1,0,1
2023-06-01,8238,1,0,1,1,0,1
2023-06-01,20782,1,0,1,1,0,1
2023-06-01,16081,2,0,2,1,0,1
2023-06-01,20708,2,1,3,2,2,2
2023-06-01,208128,1,0,1,2,0,2
2023-06-01,20979,1,0,1,3,0,3
2023-06-01,34252,2,0,2,3,0,3
2023-06-01,51958,2,0,2,2,0,2
2023-06-01,28801,2,0,2,7,0,7
2023-06-01,50774,2,0,2,2,0,2
2023-06-01,17905,1,0,1,1,0,1
2023-06-01,22399,3,0,3,2,0,2
2023-06-01,15375,1,0,1,1,0,1
2023-06-01,20813,2,0,2,1,0,1
2023-06-01,212801,1,1,2,1,1,1
2023-06-01,21436,1,1,2,1,1,1
2023-06-01,1898,1,0,1,1,0,1
2023-06-01,20906,1,0,1,1,0,1
2023-06-01,4200000181,2,0,2,1,0,1
2023-06-01,6733,2,0,2,2,0,2
2023-06-01,20572,1,1,2,2,1,2
2023-06-01,12498,2,0,2,1,0,1
2023-06-01,10108,1,0,1,2,0,2
2023-06-01,20808,1,0,1,1,0,1
2023-06-01,20841,1,0,1,2,0,2
2023-06-01,43948,1,1,2,1,1,1
2023-06-01,211786,1,1,2,1,4,4
2023-06-01,20898,1,0,1,2,0,2
2023-06-01,21014,1,0,1,1,0,1
2023-06-01,21006,1,0,1,2,0,2
2023-06-01,60719,1,0,1,3,0,3
2023-06-01,25126,1,1,2,3,2,3
2023-06-01,20967,1,0,1,1,0,1
2023-06-01,20949,1,0,1,1,0,1
2023-06-01,209487,1,0,1,1,0,1
2023-06-01,24743,2,0,2,2,0,2
2023-06-01,198838,1,0,1,2,0,2
2023-06-01,59582,2,0,2,1,0,1
2023-06-01,25073,11,0,11,3,0,3
2023-06-01,21075,1,0,1,1,0,1
2023-06-01,21227,1,1,2,3,1,3
2023-06-01,44329,2,1,3,2,1,2
2023-06-01,49642,3,0,3,2,0,2
2023-06-01,20795,1,0,1,3,0,3
2023-06-01,21134,2,0,2,1,0,1
2023-06-01,25167,1,0,1,1,0,1
2023-06-01,21252,1,0,1,3,0,3
2023-06-01,16184,1,0,1,2,0,2
2023-06-01,21179,1,0,1,2,0,2
2023-06-01,21158,1,1,2,4,3,4
2023-06-01,21247,3,0,3,2,0,2
2023-06-01,21256,2,0,2,1,0,1
2023-06-01,200986,2,2,4,3,3,3
2023-06-01,43115,1,1,2,1,1,1
2023-06-01,204803,1,0,1,2,0,2
2023-06-01,21328,2,0,2,3,0,3
2023-06-01,50831,1,0,1,3,0,3
2023-06-01,207828,4,0,4,1,0,1
2023-06-01,21441,1,0,1,2,0,2
2023-06-01,21467,2,0,2,3,0,3
2023-06-01,21362,2,0,2,1,0,1
2023-06-01,21420,1,0,1,1,0,1
2023-06-01,21257,2,0,2,3,0,3
2023-06-01,20983,3,0,3,5,0,5
2023-06-01,204343,2,0,2,1,0,1
2023-06-01,211017,2,0,2,1,0,1
2023-06-01,21061,1,0,1,1,0,1
2023-06-01,21401,1,0,1,3,0,3
2023-06-01,24652,5,0,5,5,0,5
2023-06-01,21490,5,0,5,1,0,1
2023-06-01,21456,1,0,1,1,0,1
2023-06-01,21434,2,0,2,1,0,1
2023-06-01,35459,1,0,1,1,0,1
2023-06-01,24584,1,0,1,1,0,1
2023-06-01,199692,1,0,1,2,0,2
2023-06-01,24918,1,0,1,1,0,1
2023-06-01,24610,5,0,5,3,0,3
2023-06-01,9052,1,1,2,2,1,2
2023-06-01,34272,1,0,1,3,0,3
2023-06-01,24606,1,0,1,1,0,1
2023-06-01,24597,1,1,2,2,1,2
2023-06-01,24619,1,0,1,2,0,2
2023-06-01,41737,1,0,1,1,0,1
2023-06-01,24629,3,1,4,3,3,3
2023-06-01,24650,1,0,1,2,0,2
2023-06-01,24770,1,0,1,2,0,2
2023-06-01,24593,1,0,1,10,0,10
2023-06-01,51061,1,0,1,2,0,2
2023-06-01,24656,1,0,1,1,0,1
2023-06-01,24681,1,1,2,2,1,2
2023-06-01,61398,1,0,1,1,0,1
2023-06-01,31517,1,0,1,1,0,1
2023-06-01,12891,7,0,7,2,0,2
2023-06-01,50072,2,0,2,7,0,7
2023-06-01,44899,1,0,1,1,0,1
2023-06-01,21422,1,0,1,1,0,1
2023-06-01,47774,3,0,3,2,0,2
2023-06-01,24717,1,0,1,4,0,4
2023-06-01,15728,1,0,1,3,0,3
2023-06-01,210568,1,0,1,1,0,1
2023-06-01,39526,3,5,8,7,6,7
2023-06-01,24738,1,0,1,3,0,3
2023-06-01,25005,1,0,1,1,0,1
2023-06-01,202527,1,0,1,1,0,1
2023-06-01,202503,2,18,20,1,1,1
2023-06-01,201099,1,0,1,2,0,2
2023-06-01,38998,1,0,1,1,0,1
2023-06-01,24780,2,0,2,2,0,2
2023-06-01,207629,1,0,1,1,0,1
2023-06-01,30894,1,0,1,5,0,5
2023-06-01,24784,1,0,1,3,0,3
2023-06-01,199282,1,0,1,1,0,1
2023-06-01,24791,1,0,1,1,0,1
2023-06-01,24632,4,0,4,3,0,3
2023-06-01,24920,1,0,1,1,0,1
2023-06-01,25118,1,0,1,1,0,1
2023-06-01,16263,1,0,1,1,0,1
2023-06-01,24836,1,1,2,1,1,1
2023-06-01,24879,1,0,1,1,0,1
2023-06-01,24909,2,1,3,4,4,4
2023-06-01,24882,1,0,1,1,0,1
2023-06-01,24924,1,0,1,2,0,2
2023-06-01,43355,3,1,4,3,2,3
2023-06-01,8880,4,0,4,3,0,3
2023-06-01,25199,1,0,1,1,0,1
2023-06-01,12598,1,0,1,3,0,3
2023-06-01,24939,1,0,1,4,0,4
2023-06-01,24894,1,0,1,1,0,1
2023-06-01,25101,1,0,1,3,0,3
2023-06-01,25102,1,0,1,2,0,2
2023-06-01,24999,1,0,1,3,0,3
2023-06-01,12761,6,0,6,2,0,2
2023-06-01,210221,2,0,2,3,0,3
2023-06-01,24622,1,0,1,1,0,1
2023-06-01,213046,1,0,1,1,0,1
2023-06-01,211520,1,0,1,2,0,2
2023-06-01,25006,2,0,2,1,0,1
2023-06-01,30756,2,0,2,1,0,1
2023-06-01,21464,1,0,1,1,0,1
2023-06-01,21229,0,0,0,2,0,2
2023-06-01,3244,3,0,3,4,0,4
2023-06-01,5586,2,0,2,1,0,1
2023-06-01,34099,2,0,2,2,0,2
2023-06-01,198175,1,1,2,1,2,2
2023-06-01,48857,2,0,2,1,0,1
2023-06-01,41294,2,1,3,1,1,2
2023-06-01,27363,2,0,2,2,0,2
2023-06-01,201223,1,0,1,3,0,3
2023-06-01,28916,2,0,2,3,0,3
2023-06-01,43189,1,0,1,1,0,1
2023-06-01,59812,1,0,1,2,0,2
2023-06-01,207282,1,0,1,3,0,3
2023-06-01,207298,1,0,1,1,0,1
2023-06-01,207297,1,1,2,2,1,2
2023-06-01,49837,1,0,1,2,0,2
2023-06-01,31051,1,0,1,2,0,2
2023-06-01,29296,3,0,3,2,0,2
2023-06-01,209830,3,1,4,2,2,2
2023-06-01,45023,3,0,3,2,0,2
2023-06-01,34885,1,0,1,1,0,1
2023-06-01,34729,1,0,1,3,0,3
2023-06-01,208378,1,0,1,2,0,2
2023-06-01,198962,1,0,1,1,0,1
2023-06-01,31522,1,0,1,1,0,1
2023-06-01,204825,1,0,1,2,0,2
2023-06-01,28749,1,0,1,1,0,1
2023-06-01,47429,1,0,1,1,0,1
2023-06-01,208814,1,8,9,4,5,5
2023-06-01,28830,1,0,1,1,0,1
2023-06-01,28867,1,0,1,1,0,1
2023-06-01,15912,5,0,5,2,0,2
2023-06-01,28853,1,0,1,2,0,2
2023-06-01,204113,1,0,1,2,0,2
2023-06-01,20763,1,0,1,3,0,3
2023-06-01,41941,2,0,2,2,0,2
2023-06-01,29507,1,0,1,1,0,1
2023-06-01,28960,2,0,2,1,0,1
2023-06-01,13116,2,0,2,2,0,2
2023-06-01,34216,5,0,5,2,0,2
2023-06-01,34320,1,0,1,1,0,1
2023-06-01,200337,1,0,1,3,0,3
2023-06-01,31689,18,0,18,3,0,3
2023-06-01,34478,2,0,2,2,0,2
2023-06-01,207263,4,0,4,3,0,3
2023-06-01,5474,4,1,5,3,1,3
2023-06-01,60881,1,0,1,1,0,1
2023-06-01,213309,3,0,3,1,0,1
2023-06-01,24922,3,0,3,1,0,1
2023-06-01,24614,6,0,6,1,0,1
2023-06-01,205798,2,0,2,4,0,4
2023-06-01,200297,3,1,4,2,2,3
2023-06-01,61346,1,0,1,2,0,2
2023-06-01,197805,1,0,1,1,0,1
2023-06-01,57200,1,0,1,1,0,1
2023-06-01,210100,3,0,3,1,0,1
2023-06-01,47780,4,0,4,2,0,2
2023-06-01,42558,2,0,2,5,0,5
2023-06-01,42559,1,0,1,4,0,4
2023-06-01,200217,3,0,3,2,0,2
2023-06-01,200144,1,1,2,2,2,2
2023-06-01,207670,2,1,3,2,2,2
2023-06-01,47908,1,0,1,1,0,1
2023-06-01,42594,1,0,1,1,0,1
2023-06-01,42963,1,0,1,3,0,3
2023-06-01,42681,1,0,1,1,0,1
2023-06-01,62656,2,0,2,2,0,2
2023-06-01,51364,1,0,1,1,0,1
2023-06-01,5594,1,0,1,1,0,1
2023-06-01,42948,1,0,1,2,0,2
2023-06-01,42647,1,0,1,2,0,2
2023-06-01,197688,1,0,1,2,0,2
2023-06-01,44939,1,0,1,1,0,1
2023-06-01,42643,2,0,2,4,0,4
2023-06-01,42722,1,0,1,2,0,2
2023-06-01,57647,1,0,1,1,0,1
2023-06-01,42582,1,0,1,2,0,2
2023-06-01,12685,1,1,2,2,1,2
2023-06-01,12830,4,0,4,1,0,1
2023-06-01,209877,1,1,2,1,1,1
2023-06-01,202498,4,0,4,6,0,6
2023-06-01,49093,1,0,1,1,0,1
2023-06-01,43396,1,0,1,2,0,2
2023-06-01,210180,3,0,3,1,0,1
2023-06-01,29093,2,0,2,3,0,3
2023-06-01,207925,1,2,3,1,1,1
2023-06-01,202495,1,0,1,1,0,1
2023-06-01,210196,1,0,1,1,0,1
2023-06-01,35013,1,0,1,3,0,3
2023-06-01,3324,7,0,7,1,0,1
2023-06-01,202494,1,0,1,1,0,1
2023-06-01,34851,1,0,1,1,0,1
2023-06-01,34791,1,0,1,1,0,1
2023-06-01,49576,18,0,18,4,0,4
2023-06-01,204282,1,0,1,1,0,1
2023-06-01,42147,14,0,14,1,0,1
2023-06-01,16373,1,0,1,1,0,1
2023-06-01,5436,2,0,2,2,0,2
2023-06-01,132077,2,0,2,3,0,3
2023-06-01,393400,1,0,1,1,0,1
2023-06-01,12967,1,0,1,1,0,1
2023-06-01,20492,1,0,1,1,0,1
2023-06-01,9935,1,0,1,1,0,1
2023-06-01,198140,1,0,1,1,0,1
2023-06-01,196653,2,1,3,1,1,1
2023-06-01,42340,1,0,1,1,0,1
2023-06-01,57381,1,2,3,3,1,3
2023-06-01,198143,3,1,4,2,2,2
2023-06-01,198142,2,0,2,3,0,3
2023-06-01,41259,1,0,1,1,0,1
2023-06-01,57472,2,1,3,1,1,1
2023-06-01,197608,1,0,1,1,0,1
2023-06-01,57398,1,0,1,1,0,1
2023-06-01,61325,1,0,1,2,0,2
2023-06-01,12397,5,0,5,3,0,3
2023-06-01,198127,1,1,2,1,3,3
2023-06-01,198522,1,0,1,2,0,2
2023-06-01,57716,4,0,4,2,0,2
2023-06-01,57404,1,0,1,2,0,2
2023-06-01,197945,1,0,1,3,0,3
2023-06-01,198152,2,0,2,3,0,3
2023-06-01,57418,5,0,5,2,0,2
2023-06-01,198155,1,0,1,1,0,1
2023-06-01,57421,1,0,1,1,0,1
2023-06-01,198162,1,0,1,3,0,3
2023-06-01,196699,2,0,2,3,0,3
2023-06-01,57438,1,0,1,1,0,1
2023-06-01,57449,1,0,1,4,0,4
2023-06-01,57423,1,1,2,1,1,1
2023-06-01,198168,1,0,1,3,0,3
2023-06-01,198242,1,0,1,1,0,1
2023-06-01,198181,1,0,1,3,0,3
2023-06-01,57434,1,0,1,3,0,3
2023-06-01,57435,1,0,1,1,0,1
2023-06-01,51412,4,0,4,3,0,3
2023-06-01,13153,3,0,3,3,0,3
2023-06-01,31379,1,0,1,1,0,1
2023-06-01,31305,1,0,1,1,0,1
2023-06-01,31308,2,2,4,1,1,1
2023-06-01,31348,1,1,2,1,1,1
2023-06-01,204534,1,0,1,2,0,2
2023-06-01,31345,1,0,1,1,0,1
2023-06-01,204110,2,0,2,2,0,2
2023-06-01,31350,1,0,1,1,0,1
2023-06-01,31381,1,0,1,5,0,5
2023-06-01,60077,7,0,7,1,0,1
2023-06-01,209732,1,0,1,1,0,1
2023-06-01,209742,1,0,1,2,0,2
2023-06-01,35308,1,0,1,1,0,1
2023-06-01,35829,5,3,8,3,3,4
2023-06-01,209995,4,0,4,1,0,1
2023-06-01,59559,7,0,7,2,0,2
2023-06-01,39510,1,0,1,2,0,2
2023-06-01,43628,2,0,2,1,0,1
2023-06-01,39036,1,1,2,3,1,3
2023-06-01,34706,1,0,1,2,0,2
2023-06-01,57036,1,0,1,3,0,3
2023-06-01,203617,1,0,1,1,0,1
2023-06-01,44457,2,0,2,1,0,1
2023-06-01,57821,1,1,2,2,2,3
2023-06-01,202057,1,0,1,3,0,3
2023-06-01,51283,1,0,1,3,0,3
2023-06-01,200644,1,0,1,3,0,3
2023-06-01,197120,1,0,1,2,0,2
2023-06-01,197193,1,0,1,3,0,3
2023-06-01,51284,1,0,1,3,0,3
2023-06-01,197125,1,0,1,1,0,1
2023-06-01,208040,2,0,2,1,0,1
2023-06-01,207035,1,0,1,2,0,2
2023-06-01,208469,1,0,1,1,0,1
2023-06-01,41785,1,1,2,1,1,1
2023-06-01,48295,2,0,2,2,0,2
2023-06-01,198940,1,0,1,3,0,3
2023-06-01,198134,1,0,1,1,0,1
2023-06-01,212420,1,0,1,1,0,1
2023-06-01,212575,1,0,1,1,0,1
2023-06-01,212445,1,0,1,1,0,1
2023-06-01,12834,2,0,2,3,0,3
2023-06-01,211371,1,0,1,4,0,4
2023-06-01,43517,1,0,1,1,0,1
2023-06-01,47773,1,0,1,1,0,1
2023-06-01,210210,3,0,3,3,0,3
2023-06-01,202049,1,0,1,1,0,1
2023-06-01,62270,1,1,2,2,2,2
2023-06-01,209291,3,0,3,1,0,1
2023-06-01,213066,1,0,1,3,0,3
2023-06-01,211681,1,0,1,1,0,1
2023-06-01,56814,3,1,4,4,1,4
2023-06-01,212485,1,0,1,2,0,2
2023-06-01,212707,1,1,2,1,1,1
2023-06-01,212493,1,0,1,1,0,1
2023-06-01,212608,1,0,1,4,0,4
2023-06-01,212640,1,1,2,3,3,3
2023-06-01,212456,1,0,1,2,0,2
2023-06-01,211839,1,0,1,1,0,1
2023-06-01,212202,1,0,1,2,0,2
2023-06-01,212435,1,0,1,1,0,1
2023-06-01,212466,1,2,3,2,2,2
2023-06-01,210748,1,0,1,2,0,2
2023-06-01,43167,1,0,1,1,0,1
2023-06-01,212380,1,0,1,5,0,5
2023-06-01,212404,1,0,1,2,0,2
2023-06-01,212766,1,0,1,1,0,1
2023-06-01,212885,2,0,2,3,0,3
2023-06-01,211702,1,0,1,1,0,1
2023-06-01,212031,1,0,1,2,0,2
2023-06-01,41949,1,0,1,1,0,1
2023-06-01,212130,1,0,1,2,0,2
2023-06-01,212373,1,0,1,1,0,1
2023-06-01,210437,1,1,2,3,1,3
2023-06-01,210722,1,1,2,1,1,1
2023-06-01,211356,1,0,1,1,0,1
2023-06-01,212739,1,0,1,1,0,1
2023-06-01,5491,1,0,1,2,0,2
2023-06-01,44328,4,0,4,3,0,3
2023-06-01,13057,1,0,1,1,0,1
2023-06-01,29139,19,0,19,3,0,3
2023-06-01,34873,1,0,1,1,0,1
2023-06-01,47995,1,1,2,2,1,3
2023-06-01,31124,2,0,2,1,0,1
2023-06-01,210216,1,0,1,1,0,1
2023-06-01,41584,1,0,1,1,0,1
2023-06-01,49408,3,0,3,2,0,2
2023-06-01,200090,3,0,3,2,0,2
2023-06-01,61986,1,0,1,1,0,1
2023-06-01,5552,3,1,4,1,1,1
2023-06-01,41434,1,0,1,1,0,1
2023-06-01,41422,1,0,1,1,0,1
2023-06-01,202971,2,1,3,4,4,6
2023-06-01,41432,1,0,1,3,0,3
2023-06-01,206880,1,0,1,1,0,1
2023-06-01,29092,3,0,3,1,0,1
2023-06-01,41473,1,0,1,1,0,1
2023-06-01,41468,1,0,1,3,0,3
2023-06-01,200377,1,0,1,3,0,3
2023-06-01,49698,1,0,1,1,0,1
2023-06-01,49763,1,0,1,4,0,4
2023-06-01,50228,1,0,1,1,0,1
2023-06-01,39240,2,0,2,1,0,1
2023-06-01,200114,3,0,3,1,0,1
2023-06-01,12895,1,0,1,6,0,6
2023-06-01,24647,1,0,1,1,0,1
2023-06-01,13223,5,0,5,2,0,2
2023-06-01,21406,2,2,4,3,3,3
2023-06-01,50595,2,0,2,1,0,1
2023-06-01,201441,3,0,3,1,0,1
2023-06-01,198221,1,0,1,2,0,2
2023-06-01,210145,2,0,2,2,0,2
2023-06-01,44708,3,0,3,2,0,2
2023-06-01,39622,5,0,5,1,0,1
2023-06-01,207562,1,0,1,3,0,3
2023-06-01,209714,4,0,4,3,0,3
2023-06-01,16027,5,0,5,3,0,3
2023-06-01,209750,1,0,1,1,0,1
2023-06-01,208316,4,0,4,3,0,3
2023-06-01,51075,1,1,2,1,1,1
2023-06-01,49261,2,0,2,6,0,6
2023-06-01,49315,1,0,1,2,0,2
2023-06-01,196775,1,0,1,1,0,1
2023-06-01,49346,1,0,1,1,0,1
2023-06-01,49369,1,0,1,2,0,2
2023-06-01,49361,1,0,1,1,0,1
2023-06-01,49404,1,0,1,3,0,3
2023-06-01,49464,1,0,1,3,0,3
2023-06-01,49456,1,0,1,1,0,1
2023-06-01,49494,1,1,2,3,1,3
2023-06-01,49501,2,0,2,1,0,1
2023-06-01,49510,1,0,1,3,0,3
2023-06-01,6852,1,0,1,1,0,1
2023-06-01,41067,2,0,2,2,0,2
2023-06-01,49530,1,0,1,2,0,2
2023-06-01,49568,2,0,2,1,0,1
2023-06-01,25553,3,0,3,3,0,3
2023-06-01,199491,1,1,2,4,1,4
2023-06-01,48682,1,0,1,1,0,1
2023-06-01,205753,1,0,1,1,0,1
2023-06-01,47142,1,0,1,1,0,1
2023-06-01,196830,2,0,2,1,0,1
2023-06-01,49579,3,0,3,1,0,1
2023-06-01,49646,1,0,1,1,0,1
2023-06-01,202511,0,0,0,2,0,2
2023-06-01,9041,1,0,1,1,0,1
2023-06-01,12529,3,0,3,2,0,2
2023-06-01,198738,2,0,2,1,0,1
2023-06-01,20826,1,0,1,3,0,3
2023-06-01,213322,1,0,1,1,0,1
2023-06-01,61206,3,0,3,3,0,3
2023-06-01,29215,1,0,1,2,0,2
2023-06-01,197621,1,0,1,2,0,2
2023-06-01,41927,1,0,1,1,0,1
2023-06-01,49679,2,0,2,2,0,2
2023-06-01,198810,1,0,1,1,0,1
2023-06-01,202478,5,0,5,7,0,7
2023-06-01,213334,2,0,2,2,0,2
2023-06-01,209994,1,1,2,2,1,2
2023-06-01,39048,2,0,2,2,0,2
2023-06-01,212613,4,1,5,1,1,1
2023-06-01,210012,1,0,1,1,0,1
2023-06-01,33904,4,0,4,2,0,2
2023-06-01,9134,1,0,1,1,0,1
2023-06-01,203242,1,0,1,1,0,1
2023-06-01,48240,1,0,1,2,0,2
2023-06-01,208240,1,2,3,1,1,1
2023-06-01,43388,3,0,3,4,0,4
2023-06-01,213173,1,0,1,2,0,2
2023-06-01,62054,2,0,2,1,0,1
2023-06-01,25377,7,0,7,1,0,1
2023-06-01,207063,2,1,3,7,6,9
2023-06-01,8694,3,0,3,3,0,3
2023-06-01,206249,1,0,1,1,0,1
2023-06-01,24675,20,0,20,3,0,3
2023-06-01,197282,3,0,3,2,0,2
2023-06-01,34776,1,1,2,1,1,1
2023-06-01,31337,1,1,2,1,1,1
2023-06-01,34765,1,0,1,1,0,1
2023-06-01,51748,1,0,1,2,0,2
2023-06-01,29536,1,0,1,2,0,2
2023-06-01,12965,1,0,1,1,0,1
2023-06-01,12591,3,0,3,1,0,1
2023-06-01,3296,14,0,14,5,0,5
2023-06-01,20499,1,0,1,1,0,1
2023-06-01,43476,1,0,1,6,0,6
2023-06-01,16288,1,0,1,1,0,1
2023-06-01,25439,1,0,1,2,0,2
2023-06-01,20656,1,0,1,1,0,1
2023-06-01,20624,1,0,1,2,0,2
2023-06-01,25012,1,0,1,1,0,1
2023-06-01,16279,1,0,1,1,0,1
2023-06-01,25445,1,0,1,3,0,3
2023-06-01,59427,1,0,1,1,0,1
2023-06-01,25174,2,0,2,3,0,3
2023-06-01,25149,1,0,1,3,0,3
2023-06-01,25155,1,0,1,2,0,2
2023-06-01,20486,1,0,1,1,0,1
2023-06-01,20501,1,0,1,2,0,2
2023-06-01,20509,1,0,1,1,0,1
2023-06-01,20515,1,0,1,1,0,1
2023-06-01,20491,1,0,1,1,0,1
2023-06-01,206393,3,0,3,2,0,2
2023-06-01,198837,1,1,2,2,2,2
2023-06-01,60582,5,0,5,2,0,2
2023-06-01,201171,2,0,2,1,0,1
2023-06-01,208639,1,0,1,1,0,1
2023-06-01,205078,2,1,3,3,3,3
2023-06-01,212515,1,0,1,3,0,3
2023-06-01,206013,3,1,4,2,1,2
2023-06-01,39658,2,1,3,3,1,3
2023-06-01,204334,2,0,2,1,0,1
2023-06-01,209315,2,0,2,2,0,2
2023-06-01,57602,4,1,5,2,2,2
2023-06-01,199150,2,1,3,4,3,5
2023-06-01,211502,2,0,2,2,0,2
2023-06-01,204850,10,0,10,4,0,4
2023-06-01,209454,2,2,4,1,1,2
2023-06-01,56946,10,0,10,4,0,4
2023-06-01,212725,1,1,2,2,2,2
2023-06-01,208583,1,0,1,1,0,1
2023-06-01,210409,1,1,2,1,1,1
2023-06-01,50791,1,0,1,1,0,1
2023-06-01,212021,1,0,1,1,0,1
2023-06-01,202646,3,0,3,3,0,3
2023-06-01,211353,4,0,4,1,0,1
2023-06-01,207825,1,1,2,1,2,2
2023-06-01,208298,2,0,2,1,0,1
2023-06-01,58320,2,1,3,3,2,3
2023-06-01,34628,1,1,2,1,1,1
2023-06-01,204847,2,2,4,3,3,3
2023-06-01,204074,1,1,2,3,1,3
2023-06-01,201604,2,0,2,2,0,2
2023-06-01,60053,1,1,2,3,2,3
2023-06-01,206258,4,0,4,1,0,1
2023-06-01,62338,1,0,1,1,0,1
2023-06-01,43910,1,0,1,2,0,2
2023-06-01,43891,1,0,1,2,0,2
2023-06-01,43392,1,0,1,1,0,1
2023-06-01,25056,1,0,1,1,0,1
2023-06-01,43899,1,0,1,1,0,1
2023-06-01,43900,1,0,1,1,0,1
2023-06-01,57622,1,0,1,1,0,1
2023-06-01,213080,4,1,5,1,1,1
2023-06-01,210341,4,0,4,3,0,3
2023-06-01,49921,2,0,2,3,0,3
2023-06-01,209608,4,1,5,5,1,5
2023-06-01,43322,1,0,1,1,0,1
2023-06-01,210077,1,0,1,3,0,3
2023-06-01,21039,3,0,3,1,0,1
2023-06-01,44363,1,0,1,1,0,1
2023-06-01,132244,1,0,1,1,0,1
2023-06-01,33872,3,0,3,1,0,1
2023-06-01,199043,1,0,1,3,0,3
2023-06-01,60217,1,1,2,2,2,2
2023-06-01,199066,1,0,1,1,0,1
2023-06-01,59509,1,0,1,2,0,2
2023-06-01,59549,2,0,2,1,0,1
2023-06-01,210003,4,0,4,1,0,1
2023-06-01,12766,4,0,4,3,0,3
2023-06-01,34789,2,0,2,2,0,2
2023-06-01,202451,1,1,2,2,2,2
2023-06-01,29029,15,0,15,3,0,3
2023-06-01,198008,3,1,4,2,2,2
2023-06-01,43080,1,0,1,2,0,2
2023-06-01,8956,1,0,1,3,0,3
2023-06-01,34973,1,0,1,2,0,2
2023-06-01,8735,12,0,12,3,0,3
2023-06-01,34815,4,0,4,1,0,1
2023-06-01,40969,1,0,1,3,0,3
2023-06-01,209151,1,0,1,1,0,1
2023-06-01,34906,3,0,3,2,0,2
2023-06-01,206335,1,1,2,3,1,3
2023-06-01,200543,1,0,1,4,0,4
2023-06-01,35044,1,1,2,2,2,2
2023-06-01,34998,1,0,1,1,0,1
2023-06-01,35285,1,0,1,1,0,1
2023-06-01,39200,1,0,1,1,0,1
2023-06-01,29474,4,0,4,1,0,1
2023-06-01,35001,1,0,1,1,0,1
2023-06-01,35150,1,0,1,2,0,2
2023-06-01,59640,1,0,1,2,0,2
2023-06-01,51566,1,0,1,1,0,1
2023-06-01,34961,1,0,1,1,0,1
2023-06-01,34964,1,1,2,3,3,3
2023-06-01,35282,1,0,1,1,0,1
2023-06-01,21382,2,0,2,1,0,1
2023-06-01,207741,2,0,2,2,0,2
2023-06-01,25060,4,0,4,1,0,1
2023-06-01,35446,1,0,1,2,0,2
2023-06-01,49383,1,0,1,1,0,1
2023-06-01,35480,1,0,1,1,0,1
2023-06-01,200745,1,1,2,2,1,2
2023-06-01,199538,1,0,1,2,0,2
2023-06-01,203613,1,0,1,4,0,4
2023-06-01,198115,2,0,2,4,0,4
2023-06-01,57243,1,1,2,1,1,1
2023-06-01,16274,2,0,2,3,0,3
2023-06-01,9128,1,0,1,4,0,4
2023-06-01,34794,1,0,1,2,0,2
2023-06-01,34795,1,0,1,2,0,2
2023-06-01,30983,4,4,8,3,2,3
2023-06-01,37450,2,0,2,1,0,1
2023-06-01,3208,32,1,33,4,2,4
2023-06-01,56683,5,0,5,4,0,4
2023-06-01,57291,1,0,1,2,0,2
2023-06-01,44962,1,0,1,1,0,1
2023-06-01,47717,1,0,1,1,0,1
2023-06-01,12982,2,0,2,2,0,2
2023-06-01,8476,2,0,2,2,0,2
2023-06-01,41817,1,1,2,1,1,1
2023-06-01,42208,1,0,1,3,0,3
2023-06-01,42257,1,0,1,1,0,1
2023-06-01,42212,1,0,1,1,0,1
2023-06-01,42234,1,0,1,3,0,3
2023-06-01,39803,2,0,2,3,0,3
2023-06-01,42276,1,0,1,2,0,2
2023-06-01,201467,1,0,1,1,0,1
2023-06-01,42251,2,2,4,1,1,1
2023-06-01,210755,1,0,1,3,0,3
2023-06-01,210364,1,0,1,1,0,1
2023-06-01,42809,1,0,1,1,0,1
2023-06-01,42620,2,0,2,4,0,4
2023-06-01,42606,1,0,1,1,0,1
2023-06-01,204341,1,0,1,1,0,1
2023-06-01,197717,1,0,1,2,0,2
2023-06-01,42630,1,0,1,1,0,1
2023-06-01,29496,2,0,2,3,0,3
2023-06-01,42534,1,0,1,1,0,1
2023-06-01,48376,0,0,0,2,0,2
2023-06-01,203080,4,0,4,2,0,2
2023-06-01,42564,1,1,2,1,2,2
2023-06-01,52020,3,0,3,3,0,3
2023-06-01,42849,1,0,1,1,0,1
2023-06-01,42854,1,0,1,1,0,1
2023-06-01,42856,1,0,1,1,0,1
2023-06-01,25598,2,1,3,5,1,5
2023-06-01,49728,1,0,1,1,0,1
2023-06-01,43572,1,0,1,2,0,2
2023-06-01,43102,1,0,1,3,0,3
2023-06-01,49836,1,0,1,3,0,3
2023-06-01,39584,5,0,5,1,0,1
2023-06-01,43014,1,0,1,1,0,1
2023-06-01,42982,1,0,1,1,0,1
2023-06-01,42967,1,0,1,1,0,1
2023-06-01,207241,1,0,1,3,0,3
2023-06-01,43217,1,0,1,1,0,1
2023-06-01,212981,1,1,2,2,2,2
2023-06-01,43015,1,0,1,2,0,2
2023-06-01,42999,1,0,1,1,0,1
2023-06-01,43042,2,0,2,2,0,2
2023-06-01,211447,1,1,2,1,1,1
2023-06-01,43033,1,0,1,3,0,3
2023-06-01,43018,1,1,2,1,2,2
2023-06-01,43804,1,0,1,1,0,1
2023-06-01,44461,1,0,1,3,0,3
2023-06-01,43034,1,0,1,3,0,3
2023-06-01,43021,1,1,2,1,1,1
2023-06-01,43051,1,0,1,1,0,1
2023-06-01,43058,1,0,1,1,0,1
2023-06-01,43062,1,0,1,3,0,3
2023-06-01,43086,1,0,1,3,0,3
2023-06-01,43107,1,0,1,2,0,2
2023-06-01,43104,1,0,1,1,0,1
2023-06-01,43091,4,0,4,2,0,2
2023-06-01,31374,1,0,1,1,0,1
2023-06-01,212933,1,1,2,2,1,2
2023-06-01,43117,1,0,1,2,0,2
2023-06-01,208511,1,0,1,4,0,4
2023-06-01,42301,1,0,1,2,0,2
2023-06-01,60584,1,1,2,1,1,1
2023-06-01,43143,1,0,1,2,0,2
2023-06-01,25456,1,0,1,1,0,1
2023-06-01,9168,1,0,1,2,0,2
2023-06-01,25001,1,0,1,1,0,1
2023-06-01,198009,1,0,1,1,0,1
2023-06-01,15507,1,1,2,1,1,1
2023-06-01,25040,1,0,1,4,0,4
2023-06-01,60766,1,0,1,1,0,1
2023-06-01,25173,1,1,2,3,2,3
2023-06-01,207798,4,0,4,2,0,2
2023-06-01,63268,1,0,1,1,0,1
2023-06-01,24981,1,0,1,3,0,3
2023-06-01,25024,1,0,1,1,0,1
2023-06-01,25321,1,0,1,3,0,3
2023-06-01,210394,1,0,1,1,0,1
2023-06-01,38977,1,0,1,3,0,3
2023-06-01,198429,1,0,1,1,0,1
2023-06-01,47364,1,0,1,1,0,1
2023-06-01,13195,2,2,4,2,2,2
2023-06-01,25066,1,0,1,1,0,1
2023-06-01,57490,1,0,1,1,0,1
2023-06-01,29663,2,2,4,2,1,2
2023-06-01,25030,3,0,3,1,0,1
2023-06-01,49868,1,0,1,2,0,2
2023-06-01,58028,1,0,1,3,0,3
2023-06-01,42598,2,1,3,3,1,3
2023-06-01,25075,1,0,1,3,0,3
2023-06-01,203348,1,1,2,4,2,4
2023-06-01,25055,2,0,2,2,0,2
2023-06-01,25166,1,1,2,3,1,3
2023-06-01,25119,1,0,1,1,0,1
2023-06-01,25109,1,1,2,2,2,2
2023-06-01,43528,7,0,7,2,0,2
2023-06-01,41586,6,0,6,3,0,3
2023-06-01,47572,4,0,4,2,0,2
2023-06-01,25059,1,0,1,1,0,1
2023-06-01,29607,1,1,2,2,1,2
2023-06-01,1771,1,0,1,1,0,1
2023-06-01,41730,2,0,2,3,0,3
2023-06-01,41561,2,1,3,2,2,2
2023-06-01,35056,1,0,1,3,0,3
2023-06-01,48178,1,0,1,1,0,1
2023-06-01,35010,1,0,1,3,0,3
2023-06-01,210302,1,0,1,2,0,2
2023-06-01,25194,4,0,4,3,0,3
2023-06-01,197638,5,0,5,1,0,1
2023-06-01,197568,1,0,1,1,0,1
2023-06-01,50216,1,0,1,2,0,2
2023-06-01,49850,2,0,2,1,0,1
2023-06-01,35124,1,0,1,2,0,2
2023-06-01,50876,1,0,1,1,0,1
2023-06-01,15904,1,0,1,1,0,1
2023-06-01,201142,5,0,5,3,0,3
2023-06-01,394221,4,0,4,1,0,1
2023-06-01,133924,4,0,4,1,0,1
2023-06-01,205468,4,0,4,1,0,1
2023-06-01,21113,6,0,6,2,0,2
2023-06-01,59864,1,0,1,1,0,1
2023-06-01,62420,3,0,3,3,0,3
2023-06-01,41191,1,0,1,4,0,4
2023-06-01,35386,1,0,1,1,0,1
2023-06-01,57635,1,0,1,3,0,3
2023-06-01,196979,2,0,2,1,0,1
2023-06-01,47303,1,0,1,1,0,1
2023-06-01,29258,3,0,3,1,0,1
2023-06-01,49244,1,1,2,2,2,2
2023-06-01,47300,3,0,3,3,0,3
2023-06-01,47338,1,0,1,2,0,2
2023-06-01,16176,2,0,2,1,0,1
2023-06-01,39341,1,0,1,2,0,2
2023-06-01,38967,1,0,1,1,0,1
2023-06-01,51605,2,0,2,2,0,2
2023-06-01,35127,1,0,1,2,0,2
2023-06-01,38931,1,0,1,1,0,1
2023-06-01,210035,1,1,2,1,1,1
2023-06-01,203437,3,0,3,3,0,3
2023-06-01,35472,3,0,3,3,0,3
2023-06-01,8388,12,0,12,4,0,4
2023-06-01,49593,1,0,1,1,0,1
2023-06-01,22150,16,1,17,1,1,2
2023-06-01,12992,1,0,1,3,0,3
2023-06-01,52220,7,0,7,1,0,1
2023-06-01,24777,1,0,1,3,0,3
2023-06-01,198696,5,0,5,4,0,4
2023-06-01,42048,1,0,1,1,0,1
2023-06-01,203231,3,1,4,1,1,1
2023-06-01,43816,1,0,1,1,0,1
2023-06-01,48866,3,0,3,2,0,2
2023-06-01,209872,1,0,1,3,0,3
2023-06-01,207055,1,0,1,2,0,2
2023-06-01,8221,22,0,22,5,0,5
2023-06-01,211180,1,0,1,1,0,1
2023-06-01,198217,1,1,2,2,1,2
2023-06-01,24849,2,0,2,2,0,2
2023-06-01,21031,2,0,2,2,0,2
2023-06-01,35135,2,0,2,4,0,4
2023-06-01,3272,2,0,2,1,0,1
2023-06-01,131222,1,0,1,1,0,1
2023-06-01,41630,1,0,1,1,0,1
2023-06-01,29612,1,0,1,1,0,1
2023-06-01,41667,1,0,1,3,0,3
2023-06-01,41643,1,0,1,2,0,2
2023-06-01,41100,1,0,1,1,0,1
2023-06-01,44481,1,0,1,2,0,2
2023-06-01,41660,1,0,1,2,0,2
2023-06-01,210735,1,0,1,1,0,1
2023-06-01,41662,1,0,1,1,0,1
2023-06-01,8841,2,0,2,2,0,2
2023-06-01,25717,9,0,9,5,0,5
2023-06-01,35023,1,0,1,1,0,1
2023-06-01,35099,1,0,1,2,0,2
2023-06-01,209678,1,0,1,2,0,2
2023-06-01,8272,1,0,1,1,0,1
2023-06-01,35121,1,0,1,1,0,1
2023-06-01,59667,1,0,1,2,0,2
2023-06-01,198205,1,0,1,2,0,2
2023-06-01,57609,1,0,1,2,0,2
2023-06-01,200564,1,2,3,2,2,2
2023-06-01,35468,1,0,1,1,0,1
2023-06-01,35514,1,0,1,1,0,1
2023-06-01,210647,1,0,1,2,0,2
2023-06-01,35281,3,0,3,1,0,1
2023-06-01,206630,1,0,1,1,0,1
2023-06-01,198511,1,0,1,1,0,1
2023-06-01,211102,2,0,2,3,0,3
2023-06-01,206790,3,0,3,1,0,1
2023-06-01,20523,2,0,2,1,0,1
2023-06-01,207129,1,0,1,1,0,1
2023-06-01,50252,3,0,3,3,0,3
2023-06-01,9064,5,0,5,2,0,2
2023-06-01,15553,4,0,4,3,0,3
2023-06-01,41485,1,0,1,1,0,1
2023-06-01,41285,5,0,5,4,0,4
2023-06-01,41478,1,0,1,3,0,3
2023-06-01,200662,3,0,3,5,0,5
2023-06-01,41482,1,0,1,1,0,1
2023-06-01,41506,1,0,1,1,0,1
2023-06-01,41510,1,0,1,3,0,3
2023-06-01,212222,1,1,2,1,1,1
2023-06-01,41583,1,0,1,3,0,3
2023-06-01,39299,3,1,4,3,3,3
2023-06-01,41519,1,0,1,3,0,3
2023-06-01,35101,1,0,1,1,0,1
2023-06-01,35126,1,0,1,1,0,1
2023-06-01,8794,2,1,3,2,2,2
2023-06-01,15845,1,0,1,2,0,2
2023-06-01,13023,3,1,4,2,2,2
2023-06-01,12966,1,0,1,3,0,3
2023-06-01,35764,1,0,1,3,0,3
2023-06-01,207543,4,1,5,3,1,3
2023-06-01,35737,2,0,2,1,0,1
2023-06-01,38959,7,0,7,3,0,3
2023-06-01,200577,3,0,3,4,0,4
2023-06-01,48486,2,0,2,2,0,2
2023-06-01,200629,3,4,7,2,1,2
2023-06-01,29643,1,0,1,3,0,3
2023-06-01,41384,2,0,2,1,0,1
2023-06-01,204441,1,0,1,3,0,3
2023-06-01,30739,3,0,3,2,0,2
2023-06-01,211339,1,0,1,1,0,1
2023-06-01,211322,1,0,1,1,0,1
2023-06-01,211960,1,5,6,3,3,3
2023-06-01,207528,4,0,4,1,0,1
2023-06-01,206858,1,1,2,1,1,1
2023-06-01,43353,1,0,1,1,0,1
2023-06-01,43427,1,0,1,1,0,1
2023-06-01,43365,1,0,1,2,0,2
2023-06-01,43504,1,0,1,3,0,3
2023-06-01,58306,1,0,1,2,0,2
2023-06-01,43374,1,0,1,1,0,1
2023-06-01,39330,3,0,3,4,0,4
2023-06-01,206983,4,1,5,2,1,2
2023-06-01,29161,6,0,6,2,0,2
2023-06-01,211133,4,0,4,3,0,3
2023-06-01,208409,1,0,1,2,0,2
2023-06-01,200417,1,0,1,2,0,2
2023-06-01,210822,1,0,1,2,0,2
2023-06-01,41806,2,0,2,1,0,1
2023-06-01,42089,1,0,1,1,0,1
2023-06-01,31454,2,0,2,2,0,2
2023-06-01,34551,1,0,1,1,0,1
2023-06-01,29437,1,0,1,1,0,1
2023-06-01,13181,1,0,1,1,0,1
2023-06-01,25461,2,0,2,1,0,1
2023-06-01,210343,1,0,1,1,0,1
2023-06-01,49384,1,0,1,2,0,2
2023-06-01,43285,1,0,1,2,0,2
2023-06-01,16026,3,0,3,3,0,3
2023-06-01,34808,1,0,1,3,0,3
2023-06-01,56519,1,0,1,1,0,1
2023-06-01,43703,1,0,1,1,0,1
2023-06-01,205859,1,0,1,1,0,1
2023-06-01,60644,1,0,1,1,0,1
2023-06-01,61348,1,0,1,1,0,1
2023-06-01,8614,6,0,6,2,0,2
2023-06-01,42790,1,0,1,1,0,1
2023-06-01,24712,1,0,1,1,0,1
2023-06-01,212264,3,0,3,1,0,1
2023-06-01,50227,1,0,1,3,0,3
2023-06-01,50282,1,0,1,3,0,3
2023-06-01,204980,2,0,2,3,0,3
2023-06-01,62004,2,0,2,2,0,2
2023-06-01,38928,2,0,2,2,0,2
2023-06-01,50452,1,0,1,2,0,2
2023-06-01,50169,2,1,3,9,2,9
2023-06-01,50276,2,0,2,2,0,2
2023-06-01,49742,1,0,1,1,0,1
2023-06-01,201804,2,0,2,4,0,4
2023-06-01,57529,3,0,3,1,0,1
2023-06-01,5568,3,1,4,3,4,4
2023-06-01,59801,1,1,2,2,1,2
2023-06-01,205022,2,1,3,2,2,2
2023-06-01,50382,1,0,1,1,0,1
2023-06-01,50677,1,0,1,4,0,4
2023-06-01,39589,2,0,2,2,0,2
2023-06-01,50416,1,0,1,2,0,2
2023-06-01,57290,1,0,1,1,0,1
2023-06-01,50640,2,0,2,3,0,3
2023-06-01,50571,1,0,1,1,0,1
2023-06-01,51285,1,0,1,1,0,1
2023-06-01,50703,1,0,1,2,0,2
2023-06-01,50644,1,0,1,3,0,3
2023-06-01,50701,1,0,1,2,0,2
2023-06-01,212883,1,0,1,4,0,4
2023-06-01,42135,1,1,2,2,2,2
2023-06-01,48724,1,1,2,2,2,2
2023-06-01,61411,1,1,2,1,3,3
2023-06-01,61375,1,0,1,1,0,1
2023-06-01,61383,1,0,1,1,0,1
2023-06-01,31649,1,1,2,4,4,4
2023-06-01,44522,1,1,2,5,4,6
2023-06-01,42728,2,2,4,5,4,5
2023-06-01,62135,2,2,4,3,3,3
2023-06-01,41740,6,6,12,5,3,5
2023-06-01,199085,3,0,3,2,0,2
2023-06-01,199583,2,0,2,3,0,3
2023-06-01,59688,1,0,1,1,0,1
2023-06-01,198070,3,0,3,1,0,1
2023-06-01,56903,1,0,1,1,0,1
2023-06-01,47354,2,0,2,3,0,3
2023-06-01,12938,2,1,3,1,1,1
2023-06-01,57211,5,0,5,3,0,3
2023-06-01,39911,1,0,1,2,0,2
2023-06-01,52156,1,0,1,2,0,2
2023-06-01,42097,1,0,1,3,0,3
2023-06-01,42253,2,0,2,4,0,4
2023-06-01,29114,1,0,1,7,0,7
2023-06-01,20821,1,0,1,1,0,1
2023-06-01,43213,1,0,1,2,0,2
2023-06-01,200294,1,0,1,1,0,1
2023-06-01,8790,4,0,4,1,0,1
2023-06-01,204898,2,0,2,3,0,3
2023-06-01,204833,1,0,1,3,0,3
2023-06-01,202999,5,0,5,4,0,4
2023-06-01,2587,1,0,1,2,0,2
2023-06-01,203319,0,0,0,2,2,2
2023-06-01,8325,1,0,1,1,0,1
2023-06-01,207447,1,0,1,1,0,1
2023-06-01,20549,1,0,1,3,0,3
2023-06-01,201842,1,0,1,2,0,2
2023-06-01,39770,1,0,1,1,0,1
2023-06-01,50053,1,1,2,2,1,2
2023-06-01,210171,1,0,1,1,0,1
2023-06-01,205628,1,0,1,2,0,2
2023-06-01,6869,1,0,1,1,0,1
2023-06-01,203344,1,0,1,1,0,1
2023-06-01,49954,3,0,3,2,0,2
2023-06-01,203163,2,0,2,2,0,2
2023-06-01,203337,2,0,2,2,0,2
2023-06-01,206152,1,0,1,3,0,3
2023-06-01,199868,1,0,1,1,0,1
2023-06-01,206167,1,0,1,1,0,1
2023-06-01,35783,1,0,1,2,0,2
2023-06-01,212624,1,0,1,1,0,1
2023-06-01,204863,1,0,1,2,0,2
2023-06-01,12501,5,0,5,1,0,1
2023-06-01,200300,1,1,2,1,1,1
2023-06-01,210629,1,0,1,1,0,1
2023-06-01,212079,1,1,2,1,1,1
2023-06-01,206117,1,0,1,2,0,2
2023-06-01,201456,1,1,2,1,1,1
2023-06-01,199768,3,1,4,2,2,2
2023-06-01,60586,2,0,2,2,0,2
2023-06-01,203426,1,1,2,1,1,1
2023-06-01,201317,1,1,2,1,1,2
2023-06-01,197332,2,0,2,1,0,1
2023-06-01,206941,2,0,2,2,0,2
2023-06-01,53745,2,0,2,2,0,2
2023-06-01,200881,10,1,11,1,1,1
2023-06-01,202671,2,0,2,1,0,1
2023-06-01,210140,1,1,2,1,1,1
2023-06-01,201816,5,1,6,2,1,2
2023-06-01,201087,1,0,1,3,0,3
2023-06-01,199155,3,1,4,1,2,2
2023-06-01,207969,1,1,2,1,1,1
2023-06-01,12833,1,0,1,3,0,3
2023-06-01,34544,4,0,4,2,0,2
2023-06-01,39907,1,0,1,1,0,1
2023-06-01,202614,2,0,2,2,0,2
2023-06-01,212236,2,0,2,3,0,3
2023-06-01,20938,3,0,3,5,0,5
2023-06-01,6831,2,1,3,3,1,4
2023-06-01,212787,1,0,1,2,0,2
2023-06-01,212863,1,0,1,2,0,2
2023-06-01,208631,1,0,1,2,0,2
2023-06-01,48877,3,0,3,1,0,1
2023-06-01,16111,5,0,5,2,0,2
2023-06-01,34805,1,0,1,1,0,1
2023-06-01,211319,1,1,2,1,2,2
2023-06-01,39213,3,0,3,3,0,3
2023-06-01,35198,1,0,1,1,0,1
2023-06-01,34933,3,0,3,2,0,2
2023-06-01,34982,1,0,1,3,0,3
2023-06-01,35096,3,1,4,1,1,1
2023-06-01,40988,4,0,4,4,0,4
2023-06-01,202466,5,0,5,5,0,5
2023-06-01,35609,1,1,2,1,1,1
2023-06-01,15470,2,0,2,1,0,1
2023-06-01,35215,1,0,1,1,0,1
2023-06-01,35243,4,0,4,1,0,1
2023-06-01,35306,1,0,1,4,0,4
2023-06-01,21103,0,0,0,2,0,2
2023-06-01,8440,10,1,11,4,1,4
2023-06-01,8460,1,0,1,1,0,1
2023-06-01,35093,2,0,2,1,0,1
2023-06-01,13085,1,0,1,1,0,1
2023-06-01,21308,2,0,2,1,0,1
2023-06-01,136526,1,0,1,1,0,1
2023-06-01,35151,3,0,3,1,0,1
2023-06-01,43543,3,0,3,4,0,4
2023-06-01,35296,1,1,2,1,1,1
2023-06-01,198971,1,0,1,1,0,1
2023-06-01,12811,2,0,2,1,0,1
2023-06-01,197448,1,0,1,3,0,3
2023-06-01,34516,1,1,2,2,2,3
2023-06-01,35523,1,0,1,1,0,1
2023-06-01,42417,1,0,1,1,0,1
2023-06-01,48751,3,0,3,2,0,2
2023-06-01,35317,1,0,1,2,0,2
2023-06-01,59535,1,0,1,3,0,3
2023-06-01,35345,1,0,1,1,0,1
2023-06-01,14226,2,0,2,3,0,3
2023-06-01,395369,2,0,2,3,0,3
2023-06-01,22056,7,0,7,4,0,4
2023-06-01,21033,9,0,9,2,0,2
2023-06-01,34199,1,0,1,2,0,2
2023-06-01,201418,1,0,1,1,0,1
2023-06-01,57252,1,0,1,2,0,2
2023-06-01,34256,1,0,1,2,0,2
2023-06-01,34280,2,0,2,1,0,1
2023-06-01,60521,1,0,1,1,0,1
2023-06-01,12808,4,0,4,9,0,9
2023-06-01,33813,1,0,1,2,0,2
2023-06-01,208085,1,1,2,1,1,1
2023-06-01,198917,1,0,1,2,0,2
2023-06-01,198932,1,0,1,2,0,2
2023-06-01,200531,1,0,1,1,0,1
2023-06-01,198928,1,0,1,2,0,2
2023-06-01,58311,1,0,1,1,0,1
2023-06-01,198922,1,0,1,2,0,2
2023-06-01,198945,1,0,1,3,0,3
2023-06-01,198929,1,0,1,2,0,2
2023-06-01,59483,1,0,1,2,0,2
2023-06-01,59399,2,0,2,2,0,2
2023-06-01,35420,1,0,1,2,0,2
2023-06-01,58338,1,0,1,1,0,1
2023-06-01,198943,1,0,1,2,0,2
2023-06-01,58335,1,0,1,1,0,1
2023-06-01,11086,17,0,17,8,0,8
2023-06-01,13038,9,0,9,1,0,1
2023-06-01,21298,1,0,1,1,0,1
2023-06-01,28689,1,0,1,3,0,3
2023-06-01,28750,3,0,3,3,0,3
2023-06-01,35208,1,0,1,3,0,3
2023-06-01,212352,1,0,1,1,0,1
2023-06-01,210747,1,0,1,3,0,3
2023-06-01,60436,55,2,57,1,1,1
2023-06-01,205233,7,0,7,2,0,2
2023-06-01,202830,2,0,2,2,0,2
2023-06-01,15953,3,1,4,1,1,1
2023-06-01,15361,3,0,3,4,0,4
2023-06-01,201586,1,0,1,1,0,1
2023-06-01,207830,2,0,2,2,0,2
2023-06-01,35396,1,0,1,1,0,1
2023-06-01,39265,2,1,3,3,3,3
2023-06-01,206225,4,0,4,1,0,1
2023-06-01,213142,1,0,1,1,0,1
2023-06-01,31592,1,0,1,1,0,1
2023-06-01,6732,1,0,1,1,0,1
2023-06-01,203130,2,0,2,1,0,1
2023-06-01,57651,1,1,2,1,1,1
2023-06-01,2286,4,0,4,2,0,2
2023-06-01,24600,5,8,13,1,1,1
2023-06-01,13034,2,0,2,1,0,1
2023-06-01,12726,2,0,2,4,0,4
2023-06-01,213141,5,0,5,2,0,2
2023-06-01,8461,1,0,1,4,0,4
2023-06-01,25323,1,0,1,2,0,2
2023-06-01,25304,1,1,2,1,1,1
2023-06-01,57254,1,0,1,1,0,1
2023-06-01,25349,1,0,1,3,0,3
2023-06-01,12777,2,0,2,1,0,1
2023-06-01,212167,4,0,4,1,0,1
2023-06-01,210690,1,0,1,1,0,1
2023-06-01,48811,2,0,2,1,0,1
2023-06-01,44639,1,0,1,1,0,1
2023-06-01,48053,1,1,2,5,3,5
2023-06-01,210004,1,1,2,2,1,2
2023-06-01,199670,4,4,8,13,10,14
2023-06-01,2484,1,1,2,5,5,7
2023-06-01,49488,1,1,2,4,3,4
2023-06-01,197440,1,1,2,9,7,11
2023-06-01,51833,1,1,2,2,2,3
2023-06-01,51966,1,1,2,1,1,1
2023-06-01,201612,2,2,4,7,7,7
2023-06-01,48283,4,4,8,2,2,2
2023-06-01,25354,3,3,6,6,5,6
2023-06-01,57382,2,2,4,1,1,1
2023-06-01,198147,2,2,4,1,1,1
2023-06-01,61392,1,0,1,2,0,2
2023-06-01,199222,1,0,1,2,0,2
2023-06-01,59669,1,0,1,1,0,1
2023-06-01,60693,5,0,5,2,0,2
2023-06-01,202616,2,1,3,1,1,1
2023-06-01,28862,1,0,1,1,0,1
2023-06-01,42886,4,1,5,1,1,1
2023-06-01,41744,1,0,1,2,0,2
2023-06-01,41800,4,0,4,1,0,1
2023-06-01,8410,25,0,25,3,0,3
2023-06-01,42171,1,0,1,2,0,2
2023-06-01,42452,1,0,1,1,0,1
2023-06-01,34162,1,0,1,1,0,1
2023-06-01,42138,1,0,1,1,0,1
2023-06-01,42134,1,0,1,1,0,1
2023-06-01,42180,1,0,1,3,0,3
2023-06-01,42528,1,1,2,2,1,3
2023-06-01,42190,1,0,1,2,0,2
2023-06-01,42164,1,0,1,3,0,3
2023-06-01,42166,1,0,1,2,0,2
2023-06-01,25099,1,0,1,3,0,3
2023-06-01,42181,1,0,1,3,0,3
2023-06-01,42219,1,0,1,1,0,1
2023-06-01,57548,1,0,1,1,0,1
2023-06-01,42328,1,0,1,2,0,2
2023-06-01,42204,1,1,2,1,1,1
2023-06-01,8921,2,0,2,2,0,2
2023-06-01,42272,1,0,1,2,0,2
2023-06-01,212391,1,1,2,2,2,2
2023-06-01,204055,1,1,2,5,5,5
2023-06-01,42292,1,0,1,1,0,1
2023-06-01,42294,1,0,1,1,0,1
2023-06-01,198061,1,0,1,2,0,2
2023-06-01,21423,1,0,1,3,0,3
2023-06-01,42966,1,0,1,2,0,2
2023-06-01,42321,1,0,1,2,0,2
2023-06-01,42380,1,0,1,1,0,1
2023-06-01,42324,1,0,1,1,0,1
2023-06-01,42359,1,0,1,1,0,1
2023-06-01,199148,1,0,1,2,0,2
2023-06-01,39508,5,1,6,1,1,1
2023-06-01,42488,1,0,1,3,0,3
2023-06-01,206546,1,0,1,1,0,1
2023-06-01,42545,1,0,1,2,0,2
2023-06-01,198042,1,0,1,3,0,3
2023-06-01,197446,1,0,1,2,0,2
2023-06-01,42562,1,0,1,1,0,1
2023-06-01,30898,7,0,7,3,0,3
2023-06-01,42454,1,0,1,1,0,1
2023-06-01,42409,1,1,2,1,1,1
2023-06-01,57528,1,0,1,1,0,1
2023-06-01,16367,3,0,3,1,0,1
2023-06-01,34090,1,0,1,1,0,1
2023-06-01,42426,1,0,1,2,0,2
2023-06-01,43280,1,0,1,2,0,2
2023-06-01,3161,1,0,1,1,0,1
2023-06-01,42458,1,0,1,2,0,2
2023-06-01,44263,1,0,1,2,0,2
2023-06-01,16380,1,0,1,1,0,1
2023-06-01,198544,1,0,1,1,0,1
2023-06-01,42449,1,0,1,2,0,2
2023-06-01,42464,2,0,2,2,0,2
2023-06-01,42472,1,0,1,1,0,1
2023-06-01,200285,1,0,1,1,0,1
2023-06-01,57905,1,0,1,3,0,3
2023-06-01,34604,3,0,3,3,0,3
2023-06-01,57915,1,0,1,3,0,3
2023-06-01,59750,1,1,2,3,1,3
2023-06-01,44260,1,0,1,3,0,3
2023-06-01,47818,2,0,2,1,0,1
2023-06-01,206443,2,0,2,2,0,2
2023-06-01,9180,15,0,15,2,0,2
2023-06-01,200604,5,0,5,2,0,2
2023-06-01,51870,7,0,7,3,0,3
2023-06-01,208353,6,0,6,1,0,1
2023-06-01,51366,17,0,17,4,0,4
2023-06-01,210206,4,2,6,3,2,3
2023-06-01,29639,4,0,4,1,0,1
2023-06-01,200530,1,0,1,1,0,1
2023-06-01,198825,1,2,3,1,1,1
2023-06-01,50559,1,0,1,1,0,1
2023-06-01,199700,1,1,2,1,1,1
2023-06-01,57499,1,0,1,2,0,2
2023-06-01,208101,1,0,1,1,0,1
2023-06-01,202459,1,0,1,1,0,1
2023-06-01,202455,1,0,1,1,0,1
2023-06-01,202452,1,1,2,3,2,3
2023-06-01,211766,1,0,1,1,0,1
2023-06-01,34915,2,3,5,2,3,3
2023-06-01,51466,2,0,2,2,0,2
2023-06-01,210998,2,0,2,2,0,2
2023-06-01,35276,1,0,1,2,0,2
2023-06-01,39227,1,1,2,4,3,4
2023-06-01,51199,1,0,1,1,0,1
2023-06-01,38947,1,0,1,1,0,1
2023-06-01,213264,1,0,1,2,0,2
2023-06-01,57028,1,0,1,1,0,1
2023-06-01,38978,1,0,1,1,0,1
2023-06-01,29627,1,0,1,2,0,2
2023-06-01,33850,1,0,1,2,0,2
2023-06-01,33918,1,0,1,2,0,2
2023-06-01,209256,2,0,2,2,0,2
2023-06-01,203718,1,1,2,2,2,2
2023-06-01,42415,1,0,1,1,0,1
2023-06-01,198283,1,0,1,1,0,1
2023-06-01,9091,1,0,1,1,0,1
2023-06-01,41621,1,0,1,1,0,1
2023-06-01,41623,1,0,1,2,0,2
2023-06-01,58007,1,1,2,6,2,6
2023-06-01,29599,1,0,1,1,0,1
2023-06-01,29603,1,0,1,2,0,2
2023-06-01,29597,1,0,1,1,0,1
2023-06-01,21083,1,1,2,1,1,1
2023-06-01,212367,1,0,1,1,0,1
2023-06-01,44872,1,1,2,1,1,1
2023-06-01,39057,2,1,3,2,2,2
2023-06-01,29595,1,0,1,1,0,1
2023-06-01,58131,1,0,1,1,0,1
2023-06-01,44616,2,0,2,3,0,3
2023-06-01,44415,2,0,2,1,0,1
2023-06-01,44560,1,0,1,1,0,1
2023-06-01,43237,2,0,2,1,0,1
2023-06-01,44576,2,0,2,1,0,1
2023-06-01,44580,1,0,1,1,0,1
2023-06-01,210653,2,0,2,1,0,1
2023-06-01,44669,2,0,2,1,0,1
2023-06-01,44632,3,0,3,3,0,3
2023-06-01,47696,6,0,6,1,0,1
2023-06-01,21026,3,0,3,2,0,2
2023-06-01,50863,2,0,2,2,0,2
2023-06-01,41774,2,0,2,3,0,3
2023-06-01,50850,2,0,2,1,0,1
2023-06-01,197016,1,0,1,1,0,1
2023-06-01,206683,1,0,1,1,0,1
2023-06-01,50899,1,0,1,1,0,1
2023-06-01,50918,1,0,1,1,0,1
2023-06-01,41337,1,2,3,1,1,1
2023-06-01,41406,2,0,2,4,0,4
2023-06-01,205509,1,0,1,1,0,1
2023-06-01,41413,3,0,3,2,0,2
2023-06-01,28965,1,0,1,2,0,2
2023-06-01,56599,2,0,2,2,0,2
2023-06-01,41724,1,0,1,1,0,1
2023-06-01,41522,2,0,2,3,0,3
2023-06-01,197770,1,0,1,1,0,1
2023-06-01,41486,2,0,2,4,0,4
2023-06-01,208197,1,1,2,1,1,1
2023-06-01,37166,3,0,3,3,0,3
2023-06-01,29494,1,0,1,2,0,2
2023-06-01,210444,1,0,1,2,0,2
2023-06-01,34261,1,2,3,2,2,2
2023-06-01,13244,2,0,2,3,0,3
2023-06-01,207557,1,0,1,1,0,1
2023-06-01,207460,1,1,2,1,1,1
2023-06-01,207553,1,0,1,1,0,1
2023-06-01,207986,2,0,2,3,0,3
2023-06-01,12743,1,0,1,1,0,1
2023-06-01,47367,1,0,1,1,0,1
2023-06-01,64690,1,0,1,1,0,1
2023-06-01,39564,1,0,1,1,0,1
2023-06-01,48914,1,0,1,4,0,4
2023-06-01,202440,7,0,7,3,0,3
2023-06-01,200776,1,0,1,1,0,1
2023-06-01,28928,4,0,4,3,0,3
2023-06-01,35458,1,0,1,1,0,1
2023-06-01,42407,1,0,1,1,0,1
2023-06-01,31097,6,0,6,4,0,4
2023-06-01,198647,1,0,1,1,0,1
2023-06-01,210468,1,0,1,2,0,2
2023-06-01,212794,1,1,2,1,1,1
2023-06-01,198028,4,0,4,1,0,1
2023-06-01,57237,4,0,4,2,0,2
2023-06-01,41803,1,0,1,4,0,4
2023-06-01,200481,1,0,1,1,0,1
2023-06-01,29353,2,0,2,1,0,1
2023-06-01,61329,1,0,1,1,0,1
2023-06-01,48997,3,0,3,2,0,2
2023-06-01,205915,3,1,4,3,3,4
2023-06-01,50066,4,0,4,1,0,1
2023-06-01,51040,1,1,2,1,1,1
2023-06-01,206884,1,1,2,3,1,3
2023-06-01,48540,2,0,2,2,0,2
2023-06-01,205332,4,0,4,6,0,6
2023-06-01,199438,1,3,4,1,1,1
2023-06-01,57083,1,0,1,3,0,3
2023-06-01,212807,1,1,2,2,2,2
2023-06-01,211278,1,0,1,1,0,1
2023-06-01,49527,1,0,1,3,0,3
2023-06-01,200063,1,0,1,1,0,1
2023-06-01,207506,1,0,1,3,0,3
2023-06-01,43917,1,0,1,1,0,1
2023-06-01,39284,2,0,2,1,0,1
2023-06-01,60434,1,0,1,2,0,2
2023-06-01,60774,1,1,2,1,3,3
2023-06-01,209799,4,0,4,1,0,1
2023-06-01,3220,1,0,1,1,0,1
2023-06-01,12408,1,0,1,1,0,1
2023-06-01,208517,5,0,5,2,0,2
2023-06-01,205764,1,0,1,2,0,2
2023-06-01,16188,2,1,3,1,1,1
2023-06-01,39538,3,1,4,1,2,3
2023-06-01,30939,1,0,1,3,0,3
2023-06-01,206084,1,0,1,1,0,1
2023-06-01,49865,3,1,4,3,1,3
2023-06-01,207995,4,1,5,8,4,8
2023-06-01,41295,1,0,1,1,0,1
2023-06-01,41316,2,0,2,2,0,2
2023-06-01,41328,1,0,1,1,0,1
2023-06-01,41317,1,0,1,2,0,2
2023-06-01,41308,1,0,1,1,0,1
2023-06-01,31471,2,0,2,3,0,3
2023-06-01,41044,5,1,6,1,1,1
2023-06-01,209434,1,0,1,2,0,2
2023-06-01,31540,1,0,1,4,0,4
2023-06-01,31542,1,0,1,2,0,2
2023-06-01,51602,2,0,2,1,0,1
2023-06-01,48699,1,0,1,1,0,1
2023-06-01,15536,3,0,3,1,0,1
2023-06-01,210962,1,0,1,1,0,1
2023-06-01,209721,1,1,2,1,1,1
2023-06-01,44819,7,1,8,2,2,2
2023-06-01,211816,1,0,1,4,0,4
2023-06-01,210556,1,0,1,1,0,1
2023-06-01,210555,1,1,2,1,1,1
2023-06-01,52177,1,4,5,4,4,5
2023-06-01,62447,1,0,1,2,0,2
2023-06-01,13102,2,0,2,2,0,2
2023-06-01,15843,1,0,1,3,0,3
2023-06-01,205782,1,0,1,1,0,1
2023-06-01,50882,1,0,1,1,0,1
2023-06-01,60399,5,0,5,5,0,5
2023-06-01,13107,1,0,1,1,0,1
2023-06-01,48712,2,0,2,3,0,3
2023-06-01,51699,1,1,2,1,1,1
2023-06-01,208709,1,1,2,1,1,1
2023-06-01,44006,1,0,1,1,0,1
2023-06-01,211218,1,0,1,1,0,1
2023-06-01,50956,1,0,1,1,0,1
2023-06-01,197409,3,0,3,3,0,3
2023-06-01,47434,2,0,2,1,0,1
2023-06-01,21448,2,0,2,1,0,1
2023-06-01,197058,5,1,6,5,2,5
2023-06-01,197073,1,0,1,1,0,1
2023-06-01,51068,5,0,5,5,0,5
2023-06-01,44661,2,0,2,2,0,2
2023-06-01,34639,1,0,1,4,0,4
2023-06-01,201671,2,2,4,3,1,3
2023-06-01,51086,5,0,5,4,0,4
2023-06-01,41795,2,0,2,2,0,2
2023-06-01,208241,1,0,1,1,0,1
2023-06-01,12763,2,0,2,1,0,1
2023-06-01,20958,3,0,3,1,0,1
2023-06-01,50862,2,0,2,2,0,2
2023-06-01,20537,1,0,1,3,0,3
2023-06-01,29224,3,0,3,3,0,3
2023-06-01,12464,3,1,4,5,2,5
2023-06-01,21029,1,0,1,2,0,2
2023-06-01,196984,1,0,1,1,0,1
2023-06-01,34792,2,0,2,1,0,1
2023-06-01,34902,1,0,1,1,0,1
2023-06-01,50978,2,0,2,3,0,3
2023-06-01,34870,1,0,1,1,0,1
2023-06-01,34877,2,0,2,5,0,5
2023-06-01,207991,2,1,3,1,1,1
2023-06-01,42069,1,0,1,1,0,1
2023-06-01,29241,1,0,1,1,0,1
2023-06-01,210580,1,0,1,1,0,1
2023-06-01,49067,1,0,1,1,0,1
2023-06-01,207874,2,0,2,3,0,3
2023-06-01,21355,2,0,2,1,0,1
2023-06-01,212587,1,1,2,2,2,2
2023-06-01,198431,2,0,2,4,0,4
2023-06-01,57713,1,0,1,1,0,1
2023-06-01,198164,1,0,1,1,0,1
2023-06-01,57715,1,0,1,1,0,1
2023-06-01,61328,1,0,1,1,0,1
2023-06-01,57719,1,0,1,1,0,1
2023-06-01,198425,1,0,1,1,0,1
2023-06-01,206827,1,0,1,1,0,1
2023-06-01,204146,1,0,1,1,0,1
2023-06-01,204155,1,0,1,1,0,1
2023-06-01,200232,1,1,2,5,4,6
2023-06-01,209815,1,1,2,2,2,2
2023-06-01,209548,3,0,3,2,0,2
2023-06-01,207646,2,1,3,1,1,1
2023-06-01,31550,1,0,1,3,0,3
2023-06-01,25481,2,0,2,3,0,3
2023-06-01,56942,1,0,1,1,0,1
2023-06-01,60193,4,1,5,3,3,4
2023-06-01,31645,3,0,3,3,0,3
2023-06-01,58036,1,1,2,1,1,1
2023-06-01,200439,1,0,1,1,0,1
2023-06-01,49859,1,1,2,1,1,1
2023-06-01,210740,1,0,1,1,0,1
2023-06-01,60704,1,0,1,1,0,1
2023-06-01,210048,1,0,1,1,0,1
2023-06-01,59609,1,0,1,1,0,1
2023-06-01,207661,1,0,1,1,0,1
2023-06-01,207975,2,0,2,1,0,1
2023-06-01,35707,5,0,5,3,0,3
2023-06-01,44680,1,0,1,2,0,2
2023-06-01,209930,5,0,5,3,0,3
2023-06-01,198298,1,0,1,1,0,1
2023-06-01,41859,1,0,1,1,0,1
2023-06-01,207347,1,0,1,2,0,2
2023-06-01,202446,2,0,2,2,0,2
2023-06-01,400601,1,0,1,1,0,1
2023-06-01,22108,10,0,10,3,0,3
2023-06-01,31493,2,1,3,4,2,4
2023-06-01,62452,2,1,3,2,1,3
2023-06-01,59448,2,1,3,1,1,1
2023-06-01,58237,1,0,1,1,0,1
2023-06-01,57930,1,0,1,3,0,3
2023-06-01,198854,1,0,1,1,0,1
2023-06-01,58230,5,0,5,2,0,2
2023-06-01,58231,3,0,3,6,0,6
2023-06-01,62260,1,0,1,2,0,2
2023-06-01,58257,1,0,1,3,0,3
2023-06-01,198856,1,0,1,1,0,1
2023-06-01,204278,1,0,1,4,0,4
2023-06-01,212119,1,0,1,3,0,3
2023-06-01,58249,1,0,1,1,0,1
2023-06-01,41910,1,0,1,2,0,2
2023-06-01,206629,16,0,16,1,0,1
2023-06-01,41901,2,0,2,3,0,3
2023-06-01,210201,1,0,1,2,0,2
2023-06-01,210124,1,0,1,1,0,1
2023-06-01,202373,6,3,9,3,3,3
2023-06-01,202368,1,0,1,1,0,1
2023-06-01,202443,1,0,1,1,0,1
2023-06-01,41570,4,0,4,3,0,3
2023-06-01,207985,4,0,4,1,0,1
2023-06-01,41907,1,0,1,1,0,1
2023-06-01,204526,1,0,1,1,0,1
2023-06-01,41978,1,0,1,1,0,1
2023-06-01,202442,1,0,1,1,0,1
2023-06-01,39281,1,0,1,1,0,1
2023-06-01,209979,5,0,5,1,0,1
2023-06-01,209122,3,3,6,3,2,3
2023-06-01,207593,4,0,4,2,0,2
2023-06-01,395854,1,0,1,2,0,2
2023-06-01,49007,3,0,3,3,0,3
2023-06-01,202433,3,0,3,2,0,2
2023-06-01,44479,11,0,11,1,0,1
2023-06-01,198656,1,1,2,2,2,2
2023-06-01,204994,1,1,2,6,3,7
2023-06-01,210190,1,1,2,1,2,2
2023-06-01,213389,3,0,3,3,0,3
2023-06-01,47611,2,0,2,4,0,4
2023-06-01,213387,1,0,1,6,0,6
2023-06-01,213108,1,0,1,1,0,1
2023-06-01,47009,0,0,0,2,0,2
2023-06-01,49657,4,0,4,4,0,4
2023-06-01,57297,3,0,3,3,0,3
2023-06-01,41928,1,0,1,2,0,2
2023-06-01,42012,1,0,1,4,0,4
2023-06-01,209962,1,0,1,1,0,1
2023-06-01,15814,14,5,19,3,3,3
2023-06-01,204852,3,0,3,1,0,1
2023-06-01,43913,2,0,2,1,0,1
2023-06-01,41915,1,0,1,1,0,1
2023-06-01,200404,2,0,2,2,0,2
2023-06-01,43485,1,0,1,1,0,1
2023-06-01,41728,6,0,6,3,0,3
2023-06-01,43756,1,0,1,1,0,1
2023-06-01,209789,2,0,2,1,0,1
2023-06-01,207308,3,1,4,3,2,3
2023-06-01,205483,1,0,1,5,0,5
2023-06-01,30941,3,0,3,1,0,1
2023-06-01,207980,3,0,3,2,0,2
2023-06-01,31098,1,0,1,3,0,3
2023-06-01,58106,1,0,1,1,0,1
2023-06-01,199574,2,0,2,1,0,1
2023-06-01,202434,1,0,1,4,0,4
2023-06-01,200342,2,0,2,2,0,2
2023-06-01,202401,1,6,7,1,1,1
2023-06-01,202381,3,0,3,1,0,1
2023-06-01,210194,1,0,1,1,0,1
2023-06-01,210034,1,0,1,2,0,2
2023-06-01,210098,1,0,1,2,0,2
2023-06-01,206891,3,0,3,2,0,2
2023-06-01,198772,2,0,2,3,0,3
2023-06-01,196846,2,0,2,1,0,1
2023-06-01,202419,1,0,1,1,0,1
2023-06-01,57195,1,1,2,2,2,2
2023-06-01,25495,1,0,1,2,0,2
2023-06-01,200324,4,0,4,1,0,1
2023-06-01,200389,1,0,1,1,0,1
2023-06-01,15902,1,0,1,1,0,1
2023-06-01,44906,1,0,1,1,0,1
2023-06-01,213183,3,0,3,2,0,2
2023-06-01,31598,1,0,1,2,0,2
2023-06-01,200001,1,0,1,3,0,3
2023-06-01,42441,1,1,2,1,1,1
2023-06-01,31614,2,0,2,3,0,3
2023-06-01,31646,1,0,1,2,0,2
2023-06-01,211465,1,0,1,3,0,3
2023-06-01,12545,2,0,2,6,0,6
2023-06-01,212955,1,0,1,1,0,1
2023-06-01,50569,1,0,1,1,0,1
2023-06-01,29375,1,0,1,2,0,2
2023-06-01,12706,2,0,2,2,0,2
2023-06-01,204461,2,0,2,2,0,2
2023-06-01,28804,1,0,1,1,0,1
2023-06-01,31145,1,0,1,1,0,1
2023-06-01,212825,1,0,1,1,0,1
2023-06-01,197348,1,0,1,2,0,2
2023-06-01,211820,1,0,1,4,0,4
2023-06-01,211115,1,1,2,1,1,1
2023-06-01,213231,2,0,2,1,0,1
2023-06-01,16032,7,0,7,1,0,1
2023-06-01,12991,3,1,4,3,2,3
2023-06-01,29143,3,0,3,1,0,1
2023-06-01,25053,5,0,5,2,0,2
2023-06-01,201320,1,0,1,1,0,1
2023-06-01,31146,1,0,1,1,0,1
2023-06-01,44396,1,0,1,1,0,1
2023-06-01,44426,1,0,1,3,0,3
2023-06-01,44434,1,0,1,2,0,2
2023-06-01,44523,1,0,1,1,0,1
2023-06-01,202426,1,0,1,1,0,1
2023-06-01,200319,4,2,6,3,3,3
2023-06-01,206356,4,3,7,10,7,11
2023-06-01,208727,1,1,2,3,4,4
2023-06-01,202424,1,1,2,1,1,1
2023-06-01,200387,4,0,4,3,0,3
2023-06-01,208508,1,0,1,2,0,2
2023-06-01,40381,1,0,1,1,0,1
2023-06-01,48566,1,0,1,1,0,1
2023-06-01,48547,1,0,1,1,0,1
2023-06-01,202315,3,2,5,1,1,1
2023-06-01,212984,1,0,1,1,0,1
2023-06-01,210108,3,0,3,3,0,3
2023-06-01,212214,1,0,1,3,0,3
2023-06-01,212211,1,0,1,3,0,3
2023-06-01,56891,1,0,1,3,0,3
2023-06-01,39502,1,0,1,2,0,2
2023-06-01,200382,3,0,3,2,0,2
2023-06-01,198933,1,0,1,1,0,1
2023-06-01,40992,2,0,2,2,0,2
2023-06-01,20560,1,0,1,3,0,3
2023-06-01,28786,6,0,6,1,0,1
2023-06-01,39516,1,0,1,2,0,2
2023-06-01,47469,1,0,1,2,0,2
2023-06-01,39547,1,0,1,3,0,3
2023-06-01,39914,2,0,2,2,0,2
2023-06-01,39579,1,0,1,1,0,1
2023-06-01,39581,1,0,1,1,0,1
2023-06-01,39601,1,0,1,2,0,2
2023-06-01,39606,1,0,1,1,0,1
2023-06-01,48560,1,0,1,3,0,3
2023-06-01,24944,1,0,1,1,0,1
2023-06-01,39711,1,0,1,1,0,1
2023-06-01,39617,1,1,2,2,1,2
2023-06-01,201908,2,0,2,3,0,3
2023-06-01,40967,1,0,1,2,0,2
2023-06-01,39628,1,1,2,2,2,2
2023-06-01,39644,1,0,1,1,0,1
2023-06-01,34800,1,1,2,2,2,3
2023-06-01,39713,1,0,1,1,0,1
2023-06-01,39850,1,0,1,1,0,1
2023-06-01,2877,1,0,1,2,0,2
2023-06-01,39643,1,1,2,1,1,1
2023-06-01,8838,2,0,2,3,0,3
2023-06-01,39661,1,0,1,5,0,5
2023-06-01,41637,1,1,2,1,1,1
2023-06-01,39666,1,0,1,3,0,3
2023-06-01,201459,1,0,1,1,0,1
2023-06-01,39695,1,0,1,3,0,3
2023-06-01,39717,1,0,1,1,0,1
2023-06-01,39698,1,0,1,2,0,2
2023-06-01,42033,1,0,1,2,0,2
2023-06-01,57861,1,0,1,1,0,1
2023-06-01,57856,1,0,1,1,0,1
2023-06-01,198526,1,0,1,1,0,1
2023-06-01,39722,1,0,1,1,0,1
2023-06-01,35724,1,0,1,2,0,2
2023-06-01,42273,1,0,1,1,0,1
2023-06-01,39726,1,0,1,1,0,1
2023-06-01,20929,2,0,2,1,0,1
2023-06-01,39768,1,0,1,3,0,3
2023-06-01,203420,1,1,2,1,1,1
2023-06-01,43393,1,0,1,1,0,1
2023-06-01,43425,1,0,1,1,0,1
2023-06-01,212390,1,1,2,1,1,1
2023-06-01,60010,1,0,1,1,0,1
2023-06-01,8474,9,0,9,1,0,1
2023-06-01,201163,3,1,4,5,4,6
2023-06-01,207796,4,0,4,3,0,3
2023-06-01,25093,2,0,2,1,0,1
2023-06-01,47468,1,0,1,3,0,3
2023-06-01,39794,1,0,1,3,0,3
2023-06-01,200646,1,0,1,1,0,1
2023-06-01,56688,1,0,1,3,0,3
2023-06-01,39800,1,0,1,1,0,1
2023-06-01,39843,2,0,2,1,0,1
2023-06-01,203749,1,0,1,1,0,1
2023-06-01,207659,1,0,1,1,0,1
2023-06-01,200374,2,1,3,2,2,2
2023-06-01,210214,1,1,2,1,1,1
2023-06-01,210181,1,1,2,1,1,1
2023-06-01,59543,2,0,2,3,0,3
2023-06-01,209572,1,0,1,1,0,1
2023-06-01,210186,1,0,1,1,0,1
2023-06-01,35803,4,0,4,4,0,4
2023-06-01,44408,3,0,3,2,0,2
2023-06-01,31620,2,0,2,2,0,2
2023-06-01,8654,8,0,8,1,0,1
2023-06-01,205131,4,0,4,1,0,1
2023-06-01,39343,1,0,1,2,0,2
2023-06-01,28914,2,0,2,2,0,2
2023-06-01,31707,2,0,2,2,0,2
2023-06-01,30790,4,0,4,1,0,1
2023-06-01,20775,5,0,5,3,0,3
2023-06-01,200777,5,0,5,2,0,2
2023-06-01,29236,1,1,2,3,2,3
2023-06-01,34475,4,0,4,1,0,1
2023-06-01,44438,1,0,1,1,0,1
2023-06-01,60393,1,1,2,3,1,3
2023-06-01,202406,1,0,1,1,0,1
2023-06-01,201319,2,1,3,1,1,1
2023-06-01,210185,1,0,1,1,0,1
2023-06-01,51588,6,1,7,2,3,3
2023-06-01,21190,1,0,1,2,0,2
2023-06-01,30862,2,0,2,2,0,2
2023-06-01,12776,2,1,3,2,2,2
2023-06-01,198951,2,1,3,2,2,2
2023-06-01,200336,1,0,1,1,0,1
2023-06-01,35337,1,0,1,2,0,2
2023-06-01,209889,1,0,1,1,0,1
2023-06-01,202035,1,0,1,2,0,2
2023-06-01,209943,2,1,3,1,1,1
2023-06-01,201807,1,0,1,1,0,1
2023-06-01,50805,2,0,2,2,0,2
2023-06-01,9111,2,1,3,2,1,2
2023-06-01,56908,3,1,4,1,1,1
2023-06-01,57021,7,7,14,5,5,5
2023-06-01,20943,1,1,2,3,3,3
2023-06-01,201716,1,0,1,1,0,1
2023-06-01,201677,1,0,1,3,0,3
2023-06-01,34172,3,1,4,1,1,1
2023-06-01,48774,1,0,1,2,0,2
2023-06-01,44126,1,0,1,1,0,1
2023-06-01,28850,3,0,3,2,0,2
2023-06-01,12470,2,0,2,8,0,8
2023-06-01,41886,1,0,1,1,0,1
2023-06-01,29214,6,0,6,2,0,2
2023-06-01,41970,1,0,1,2,0,2
2023-06-01,41940,1,0,1,2,0,2
2023-06-01,41961,3,0,3,3,0,3
2023-06-01,42021,1,0,1,3,0,3
2023-06-01,213072,1,1,2,1,1,1
2023-06-01,41971,1,0,1,2,0,2
2023-06-01,41988,1,0,1,2,0,2
2023-06-01,34930,1,0,1,1,0,1
2023-06-01,208026,2,0,2,1,0,1
2023-06-01,8835,1,0,1,1,0,1
2023-06-01,200311,4,0,4,3,0,3
2023-06-01,57520,1,0,1,1,0,1
2023-06-01,57466,1,0,1,2,0,2
2023-06-01,210166,2,0,2,3,0,3
2023-06-01,200383,1,0,1,1,0,1
2023-06-01,198814,1,1,2,1,1,1
2023-06-01,59551,1,0,1,2,0,2
2023-06-01,58210,1,0,1,1,0,1
2023-06-01,58155,1,0,1,1,0,1
2023-06-01,33985,1,0,1,1,0,1
2023-06-01,60026,1,0,1,1,0,1
2023-06-01,62329,1,0,1,3,0,3
2023-06-01,49171,1,0,1,1,0,1
2023-06-01,207188,1,0,1,2,0,2
2023-06-01,25050,1,0,1,2,0,2
2023-06-01,210127,1,0,1,2,0,2
2023-06-01,210179,4,0,4,2,0,2
2023-06-01,210178,6,0,6,1,0,1
2023-06-01,209991,3,0,3,4,0,4
2023-06-01,49324,3,0,3,1,0,1
2023-06-01,34464,1,0,1,1,0,1
2023-06-01,210657,4,0,4,2,0,2
2023-06-01,51365,1,0,1,3,0,3
2023-06-01,34657,1,0,1,1,0,1
2023-06-01,210177,1,0,1,1,0,1
2023-06-01,202392,2,0,2,2,0,2
2023-06-01,42523,1,0,1,2,0,2
2023-06-01,211006,1,0,1,1,0,1
2023-06-01,31460,1,0,1,1,0,1
2023-06-01,35102,2,0,2,3,0,3
2023-06-01,34698,1,0,1,2,0,2
2023-06-01,212662,3,0,3,2,0,2
2023-06-01,200143,1,1,2,1,1,1
2023-06-01,207166,1,0,1,3,0,3
2023-06-01,208822,1,0,1,1,0,1
2023-06-01,21160,1,0,1,1,0,1
2023-06-01,40481,2,0,2,2,0,2
2023-06-01,48553,3,0,3,2,0,2
2023-06-01,35106,1,1,2,1,1,1
2023-06-01,210501,1,0,1,1,0,1
2023-06-01,22731,1,0,1,3,0,3
2023-06-01,211296,1,0,1,1,0,1
2023-06-01,201645,1,0,1,1,0,1
2023-06-01,16282,2,0,2,1,0,1
2023-06-01,25443,1,1,2,2,1,2
2023-06-01,204398,1,0,1,3,0,3
2023-06-01,15980,1,0,1,1,0,1
2023-06-01,206889,3,0,3,3,0,3
2023-06-01,51634,2,0,2,1,0,1
2023-06-01,199355,1,1,2,3,3,4
2023-06-01,56961,1,0,1,1,0,1
2023-06-01,200591,1,0,1,1,0,1
2023-06-01,35073,2,1,3,1,1,1
2023-06-01,29672,3,1,4,5,2,5
2023-06-01,211551,1,1,2,1,1,1
2023-06-01,203245,3,0,3,2,0,2
2023-06-01,210679,1,0,1,2,0,2
2023-06-01,199564,1,1,2,1,1,1
2023-06-01,3306,1,1,2,2,2,2
2023-06-01,209570,1,0,1,3,0,3
2023-06-01,24668,2,0,2,3,0,3
2023-06-01,21250,3,0,3,1,0,1
2023-06-01,208373,1,0,1,2,0,2
2023-06-01,48942,1,1,2,2,2,2
2023-06-01,200341,1,0,1,3,0,3
2023-06-01,50756,1,0,1,1,0,1
2023-06-01,50122,1,0,1,1,0,1
2023-06-01,207673,1,0,1,1,0,1
2023-06-01,6687,1,0,1,2,0,2
2023-06-01,212797,1,0,1,1,0,1
2023-06-01,57342,1,1,2,1,1,1
2023-06-01,56488,2,2,4,5,4,5
2023-06-01,207489,4,1,5,5,4,8
2023-06-01,39204,1,1,2,2,2,2
2023-06-01,31473,2,1,3,2,1,2
2023-06-01,58043,1,0,1,1,0,1
2023-06-01,58038,1,0,1,3,0,3
2023-06-01,198204,1,1,2,1,1,1
2023-06-01,207797,1,1,2,1,1,1
2023-06-01,5669,43,1,44,1,1,1
2023-06-01,204673,1,0,1,2,0,2
2023-06-01,39795,1,0,1,3,0,3
2023-06-01,48049,6,0,6,1,0,1
2023-06-01,35720,2,0,2,3,0,3
2023-06-01,202438,5,1,6,1,1,1
2023-06-01,35796,1,0,1,1,0,1
2023-06-01,49545,1,0,1,2,0,2
2023-06-01,48876,1,0,1,2,0,2
2023-06-01,204696,1,0,1,3,0,3
2023-06-01,201195,1,0,1,3,0,3
2023-06-01,208811,1,0,1,3,0,3
2023-06-01,31324,1,0,1,1,0,1
2023-06-01,57628,1,0,1,3,0,3
2023-06-01,51138,1,0,1,1,0,1
2023-06-01,197200,1,0,1,1,0,1
2023-06-01,58019,1,0,1,3,0,3
2023-06-01,34862,2,0,2,3,0,3
2023-06-01,203514,2,0,2,4,0,4
2023-06-01,57078,1,1,2,2,1,2
2023-06-01,59446,1,0,1,1,0,1
2023-06-01,204067,1,0,1,2,0,2
2023-06-01,57658,1,0,1,3,0,3
2023-06-01,207634,1,0,1,1,0,1
2023-06-01,56820,2,0,2,5,0,5
2023-06-01,57368,1,0,1,1,0,1
2023-06-01,57579,1,0,1,1,0,1
2023-06-01,57680,1,0,1,3,0,3
2023-06-01,208447,2,1,3,2,1,2
2023-06-01,41688,1,0,1,1,0,1
2023-06-01,49050,1,0,1,1,0,1
2023-06-01,211697,1,0,1,2,0,2
2023-06-01,209701,2,0,2,2,0,2
2023-06-01,210113,1,0,1,2,0,2
2023-06-01,61011,1,0,1,2,0,2
2023-06-01,59957,1,0,1,1,0,1
2023-06-01,57867,8,0,8,4,0,4
2023-06-01,204553,1,0,1,1,0,1
2023-06-01,212254,1,0,1,1,0,1
2023-06-01,3351,1,0,1,1,0,1
2023-06-01,200110,1,0,1,1,0,1
2023-06-01,206256,1,0,1,1,0,1
2023-06-01,213028,2,1,3,2,1,2
2023-06-01,210839,1,0,1,1,0,1
2023-06-01,60177,3,0,3,4,0,4
2023-06-01,42822,1,0,1,2,0,2
2023-06-01,198749,1,1,2,1,1,1
2023-06-01,200113,1,0,1,1,0,1
2023-06-01,34214,1,0,1,1,0,1
2023-06-01,34208,2,0,2,2,0,2
2023-06-01,41680,1,0,1,3,0,3
2023-06-01,51983,1,0,1,1,0,1
2023-06-01,61427,1,0,1,2,0,2
2023-06-01,198598,1,0,1,2,0,2
2023-06-01,202738,1,0,1,1,0,1
2023-06-01,12589,1,0,1,1,0,1
2023-06-01,49180,1,0,1,2,0,2
2023-06-01,398037,4,0,4,4,0,4
2023-06-01,35752,1,0,1,2,0,2
2023-06-01,35792,2,0,2,3,0,3
2023-06-01,35780,1,0,1,1,0,1
2023-06-01,62426,1,0,1,2,0,2
2023-06-01,35774,1,0,1,3,0,3
2023-06-01,35772,1,0,1,1,0,1
2023-06-01,35781,1,0,1,2,0,2
2023-06-01,35800,1,0,1,1,0,1
2023-06-01,41005,1,0,1,1,0,1
2023-06-01,48907,2,0,2,1,0,1
2023-06-01,35522,3,0,3,4,0,4
2023-06-01,35512,1,0,1,1,0,1
2023-06-01,35640,8,0,8,6,0,6
2023-06-01,197439,1,1,2,1,1,1
2023-06-01,34633,2,0,2,3,0,3
2023-06-01,31504,1,0,1,1,0,1
2023-06-01,207077,2,3,5,1,1,1
2023-06-01,41234,1,0,1,2,0,2
2023-06-01,41240,4,0,4,2,0,2
2023-06-01,209795,1,0,1,1,0,1
2023-06-01,209792,1,1,2,2,1,2
2023-06-01,211874,6,0,6,4,0,4
2023-06-01,202703,1,0,1,3,0,3
2023-06-01,57464,1,0,1,2,0,2
2023-06-01,50598,4,1,5,2,2,2
2023-06-01,198043,1,0,1,2,0,2
2023-06-01,29118,1,0,1,1,0,1
2023-06-01,16017,2,0,2,2,0,2
2023-06-01,34213,1,0,1,1,0,1
2023-06-01,200657,1,0,1,3,0,3
2023-06-01,203889,1,0,1,2,0,2
2023-06-01,48565,1,0,1,3,0,3
2023-06-01,204681,1,0,1,2,0,2
2023-06-01,60123,3,0,3,2,0,2
2023-06-01,211008,1,0,1,1,0,1
2023-06-01,211018,1,1,2,1,1,1
2023-06-01,23985,2,0,2,3,0,3
2023-06-01,35474,1,0,1,2,0,2
2023-06-01,201190,1,1,2,1,2,2
2023-06-01,35307,2,0,2,1,0,1
2023-06-01,25278,1,0,1,1,0,1
2023-06-01,15873,1,0,1,1,0,1
2023-06-01,60709,1,0,1,1,0,1
2023-06-01,62285,1,0,1,2,0,2
2023-06-01,57082,1,0,1,1,0,1
2023-06-01,15882,2,0,2,1,0,1
2023-06-01,34517,2,0,2,1,0,1
2023-06-01,20930,2,0,2,1,0,1
2023-06-01,208537,1,0,1,1,0,1
2023-06-01,49862,1,0,1,2,0,2
2023-06-01,203158,2,1,3,2,2,2
2023-06-01,203373,1,0,1,3,0,3
2023-06-01,200018,3,0,3,2,0,2
2023-06-01,203383,1,1,2,1,1,1
2023-06-01,62305,1,0,1,1,0,1
2023-06-01,199470,7,1,8,1,1,1
2023-06-01,200357,1,0,1,1,0,1
2023-06-01,207949,2,0,2,1,0,1
2023-06-01,196618,1,0,1,1,0,1
2023-06-01,210688,1,0,1,1,0,1
2023-06-01,47951,1,1,2,1,2,2
2023-06-01,208935,1,0,1,2,0,2
2023-06-01,47553,4,0,4,1,0,1
2023-06-01,60571,1,1,2,1,1,1
2023-06-01,57196,1,1,2,3,3,3
2023-06-01,200347,1,0,1,1,0,1
2023-06-01,57549,1,0,1,1,0,1
2023-06-01,41818,1,0,1,1,0,1
2023-06-01,12922,1,0,1,3,0,3
2023-06-01,25413,7,0,7,1,0,1
2023-06-01,39203,2,0,2,1,0,1
2023-06-01,34501,1,0,1,1,0,1
2023-06-01,39223,1,0,1,2,0,2
2023-06-01,39269,1,0,1,1,0,1
2023-06-01,9124,1,0,1,2,0,2
2023-06-01,213403,3,0,3,2,0,2
2023-06-01,53973,3,0,3,5,0,5
2023-06-01,47571,2,0,2,1,0,1
2023-06-01,34052,4,0,4,1,0,1
2023-06-01,43300,1,0,1,1,0,1
2023-06-01,43805,1,0,1,2,0,2
2023-06-01,31152,2,1,3,3,3,3
2023-06-01,43224,1,0,1,1,0,1
2023-06-01,44192,1,0,1,3,0,3
2023-06-01,44262,1,0,1,2,0,2
2023-06-01,59561,1,0,1,2,0,2
2023-06-01,43241,1,0,1,1,0,1
2023-06-01,202367,1,0,1,2,0,2
2023-06-01,56672,3,1,4,2,2,2
2023-06-01,25089,2,0,2,2,0,2
2023-06-01,209144,1,0,1,2,0,2
2023-06-01,200354,1,0,1,1,0,1
2023-06-01,43579,1,0,1,2,0,2
2023-06-01,41981,2,2,4,1,1,1
2023-06-01,49014,2,1,3,1,1,1
2023-06-01,39208,9,0,9,9,0,9
2023-06-01,210303,1,1,2,2,1,2
2023-06-01,201112,1,0,1,1,0,1
2023-06-01,57686,1,0,1,1,0,1
2023-06-01,42674,1,0,1,3,0,3
2023-06-01,43363,1,0,1,2,0,2
2023-06-01,198413,1,0,1,2,0,2
2023-06-01,48879,1,0,1,1,0,1
2023-06-01,30850,2,0,2,2,0,2
2023-06-01,43122,1,0,1,3,0,3
2023-06-01,42711,1,0,1,5,0,5
2023-06-01,42659,1,0,1,1,0,1
2023-06-01,57364,1,0,1,3,0,3
2023-06-01,210236,4,1,5,1,1,1
2023-06-01,201516,1,0,1,1,0,1
2023-06-01,42680,1,0,1,3,0,3
2023-06-01,42700,1,1,2,2,2,2
2023-06-01,42693,1,0,1,2,0,2
2023-06-01,42721,1,1,2,1,1,1
2023-06-01,43121,1,0,1,1,0,1
2023-06-01,42736,1,0,1,1,0,1
2023-06-01,29052,1,0,1,2,0,2
2023-06-01,51749,1,0,1,2,0,2
2023-06-01,42757,1,0,1,2,0,2
2023-06-01,42778,1,0,1,4,0,4
2023-06-01,42793,1,0,1,1,0,1
2023-06-01,39536,1,0,1,1,0,1
2023-06-01,43292,6,0,6,1,0,1
2023-06-01,24845,6,1,7,2,1,2
2023-06-01,210955,2,0,2,1,0,1
2023-06-01,200328,2,0,2,1,0,1
2023-06-01,207902,2,12,14,1,1,1
2023-06-01,207794,4,0,4,2,0,2
2023-06-01,38974,2,2,4,1,2,2
2023-06-01,47307,1,0,1,1,0,1
2023-06-01,39797,1,0,1,1,0,1
2023-06-01,28932,14,0,14,3,0,3
2023-06-01,15113,10,0,10,5,0,5
2023-06-01,202462,1,1,2,2,2,2
2023-06-01,211295,1,0,1,1,0,1
2023-06-01,60305,3,0,3,3,0,3
2023-06-01,13130,1,0,1,3,0,3
2023-06-01,29012,1,0,1,1,0,1
2023-06-01,57666,1,0,1,1,0,1
2023-06-01,50524,2,0,2,1,0,1
2023-06-01,25309,1,0,1,2,0,2
2023-06-01,34392,1,0,1,1,0,1
2023-06-01,51098,1,0,1,2,0,2
2023-06-01,34493,2,0,2,3,0,3
2023-06-01,56732,1,0,1,1,0,1
2023-06-01,208379,3,0,3,2,0,2
2023-06-01,44949,3,4,7,4,3,4
2023-06-01,8276,1,0,1,1,0,1
2023-06-01,198063,1,0,1,1,0,1
2023-06-01,57410,1,0,1,2,0,2
2023-06-01,34448,2,0,2,2,0,2
2023-06-01,43549,1,0,1,1,0,1
2023-06-01,42986,2,0,2,3,0,3
2023-06-01,34514,1,0,1,2,0,2
2023-06-01,34523,4,0,4,1,0,1
2023-06-01,213315,1,0,1,1,0,1
2023-06-01,57247,1,1,2,1,1,1
2023-06-01,44865,1,1,2,5,2,5
2023-06-01,34688,2,1,3,1,1,1
2023-06-01,197024,1,0,1,1,0,1
2023-06-01,35160,4,0,4,2,0,2
2023-06-01,6673,5,0,5,3,0,3
2023-06-01,28989,1,0,1,2,0,2
2023-06-01,52221,1,0,1,1,0,1
2023-06-01,35559,1,1,2,1,1,1
2023-06-01,31267,1,0,1,3,0,3
2023-06-01,35601,3,0,3,1,0,1
2023-06-01,35597,1,0,1,1,0,1
2023-06-01,198323,1,0,1,1,0,1
2023-06-01,3299,22,0,22,3,0,3
2023-06-01,64958,2,0,2,1,0,1
2023-06-01,45888,2,0,2,3,0,3
2023-06-01,139061,2,0,2,3,0,3
2023-06-01,3298,10,0,10,4,0,4
2023-06-01,8874,1,0,1,1,0,1
2023-06-01,47340,2,1,3,1,1,2
2023-06-01,210249,1,0,1,1,0,1
2023-06-01,35466,1,0,1,1,0,1
2023-06-01,15492,1,0,1,2,0,2
2023-06-01,208099,1,0,1,3,0,3
2023-06-01,202346,1,1,2,1,1,2
2023-06-01,210018,2,0,2,2,0,2
2023-06-01,51934,2,0,2,2,0,2
2023-06-01,202908,4,2,6,3,3,3
2023-06-01,210308,2,0,2,2,0,2
2023-06-01,59813,1,1,2,3,3,4
2023-06-01,207936,2,6,8,2,1,2
2023-06-01,60735,1,1,2,3,2,4
2023-06-01,208381,1,0,1,2,0,2
2023-06-01,50106,1,0,1,1,0,1
2023-06-01,207293,1,0,1,1,0,1
2023-06-01,20777,1,0,1,1,0,1
2023-06-01,20660,2,0,2,3,0,3
2023-06-01,12771,1,0,1,1,0,1
2023-06-01,34488,1,0,1,3,0,3
2023-06-01,199031,1,0,1,1,0,1
2023-06-01,34548,1,0,1,2,0,2
2023-06-01,35596,1,0,1,1,0,1
2023-06-01,34522,1,0,1,2,0,2
2023-06-01,34532,1,0,1,2,0,2
2023-06-01,34543,1,0,1,2,0,2
2023-06-01,51049,1,0,1,1,0,1
2023-06-01,25256,1,0,1,1,0,1
2023-06-01,29109,1,0,1,1,0,1
2023-06-01,34564,1,1,2,3,3,3
2023-06-01,33910,1,0,1,1,0,1
2023-06-01,39358,4,3,7,3,2,3
2023-06-01,42553,1,0,1,1,0,1
2023-06-01,212026,1,0,1,1,0,1
2023-06-01,201805,1,0,1,2,0,2
2023-06-01,34793,1,0,1,2,0,2
2023-06-01,206104,1,0,1,2,0,2
2023-06-01,34842,1,0,1,1,0,1
2023-06-01,206471,1,0,1,1,0,1
2023-06-01,43916,1,0,1,1,0,1
2023-06-01,207793,4,1,5,3,1,3
2023-06-01,16277,2,0,2,3,0,3
2023-06-01,34646,1,0,1,1,0,1
2023-06-01,41040,5,1,6,1,1,1
2023-06-01,207932,4,0,4,4,0,4
2023-06-01,201339,1,0,1,2,0,2
2023-06-01,207404,1,0,1,1,0,1
2023-06-01,31352,5,0,5,2,0,2
2023-06-01,202321,3,0,3,3,0,3
2023-06-01,202188,1,1,2,1,1,1
2023-06-01,203471,1,0,1,1,0,1
2023-06-01,211213,1,0,1,1,0,1
2023-06-01,207494,1,0,1,1,0,1
2023-06-01,212278,1,0,1,2,0,2
2023-06-01,9805,2,0,2,3,0,3
2023-06-01,8216,9,0,9,1,0,1
2023-06-01,197523,2,0,2,2,0,2
2023-06-01,212486,1,0,1,3,0,3
2023-06-01,41159,1,0,1,1,0,1
2023-06-01,197781,1,0,1,4,0,4
2023-06-01,41136,1,0,1,1,0,1
2023-06-01,41137,1,0,1,1,0,1
2023-06-01,41183,1,0,1,1,0,1
2023-06-01,41198,1,0,1,1,0,1
2023-06-01,41178,1,0,1,3,0,3
2023-06-01,34645,1,0,1,1,0,1
2023-06-01,34662,2,0,2,1,0,1
2023-06-01,42867,3,0,3,2,0,2
2023-06-01,206823,1,0,1,2,0,2
2023-06-01,34701,1,0,1,1,0,1
2023-06-01,8860,1,0,1,1,0,1
2023-06-01,8766,1,0,1,1,0,1
2023-06-01,34184,3,0,3,2,0,2
2023-06-01,9118,1,0,1,2,0,2
2023-06-01,6750,1,0,1,1,0,1
2023-06-01,62080,1,1,2,3,1,3
2023-06-01,12523,1,0,1,1,0,1
2023-06-01,34131,1,0,1,1,0,1
2023-06-01,34176,1,0,1,1,0,1
2023-06-01,41063,1,0,1,1,0,1
2023-06-01,200822,1,0,1,2,0,2
2023-06-01,34212,1,0,1,2,0,2
2023-06-01,57226,1,0,1,1,0,1
2023-06-01,34193,1,0,1,1,0,1
2023-06-01,61172,4,0,4,1,0,1
2023-06-01,202836,1,0,1,1,0,1
2023-06-01,34294,1,0,1,1,0,1
2023-06-01,29561,1,0,1,2,0,2
2023-06-01,29533,1,0,1,2,0,2
2023-06-01,60488,1,1,2,3,3,5
2023-06-01,31074,3,0,3,4,0,4
2023-06-01,29576,1,0,1,1,0,1
2023-06-01,29574,4,0,4,3,0,3
2023-06-01,202347,1,1,2,4,4,5
2023-06-01,16327,5,0,5,4,0,4
2023-06-01,29658,1,0,1,1,0,1
2023-06-01,207655,1,0,1,1,0,1
2023-06-01,39191,1,1,2,1,1,1
2023-06-01,210253,3,0,3,2,0,2
2023-06-01,206779,1,0,1,2,0,2
2023-06-01,61305,1,0,1,1,0,1
2023-06-01,210167,1,1,2,1,1,1
2023-06-01,211924,1,0,1,1,0,1
2023-06-01,52094,1,0,1,1,0,1
2023-06-01,35387,1,0,1,1,0,1
2023-06-01,198547,1,0,1,1,0,1
2023-06-01,39190,4,0,4,1,0,1
2023-06-01,202261,2,3,5,1,1,1
2023-06-01,207465,1,1,2,1,1,1
2023-06-01,200339,2,0,2,1,0,1
2023-06-01,44075,4,0,4,3,0,3
2023-06-01,205393,2,0,2,1,0,1
2023-06-01,202405,5,0,5,2,0,2
2023-06-01,42662,1,0,1,1,0,1
2023-06-01,39381,1,1,2,1,1,1
2023-06-01,209794,1,0,1,3,0,3
2023-06-01,209525,1,0,1,1,0,1
2023-06-01,198667,1,0,1,2,0,2
2023-06-01,51105,2,2,4,1,1,1
2023-06-01,3334,2,0,2,1,0,1
2023-06-01,16280,2,0,2,1,0,1
2023-06-01,25371,2,0,2,3,0,3
2023-06-01,9056,1,0,1,1,0,1
2023-06-01,50067,4,1,5,2,2,2
2023-06-01,197222,1,0,1,1,0,1
2023-06-01,51270,1,0,1,2,0,2
2023-06-01,8662,1,0,1,3,0,3
2023-06-01,15508,3,0,3,2,0,2
2023-06-01,203773,1,0,1,1,0,1
2023-06-01,199194,1,0,1,2,0,2
2023-06-01,15590,15,0,15,2,0,2
2023-06-01,210964,1,0,1,1,0,1
2023-06-01,31450,5,0,5,4,0,4
2023-06-01,213009,1,0,1,1,0,1
2023-06-01,29619,1,0,1,2,0,2
2023-06-01,198035,2,0,2,4,0,4
2023-06-01,33978,1,0,1,1,0,1
2023-06-01,198629,1,0,1,3,0,3
2023-06-01,33981,2,0,2,2,0,2
2023-06-01,201130,2,0,2,1,0,1
2023-06-01,33888,1,0,1,1,0,1
2023-06-01,33914,1,0,1,1,0,1
2023-06-01,31671,1,0,1,1,0,1
2023-06-01,47220,2,0,2,4,0,4
2023-06-01,212649,1,0,1,1,0,1
2023-06-01,47275,1,0,1,4,0,4
2023-06-01,205353,1,0,1,1,0,1
2023-06-01,47488,1,1,2,1,1,1
2023-06-01,208861,1,0,1,1,0,1
2023-06-01,209597,1,0,1,3,0,3
2023-06-01,47281,2,0,2,2,0,2
2023-06-01,47243,1,0,1,2,0,2
2023-06-01,204163,2,0,2,2,0,2
2023-06-01,197823,1,0,1,1,0,1
2023-06-01,15719,4,0,4,2,0,2
2023-06-01,35128,1,0,1,1,0,1
2023-06-01,12666,1,0,1,3,0,3
2023-06-01,207928,3,0,3,4,0,4
2023-06-01,47632,1,0,1,1,0,1
2023-06-01,38982,1,0,1,1,0,1
2023-06-01,34886,1,0,1,1,0,1
2023-06-01,43236,1,0,1,3,0,3
2023-06-01,41184,1,0,1,1,0,1
2023-06-01,15618,1,0,1,3,0,3
2023-06-01,12628,1,1,2,1,1,1
2023-06-01,41990,1,0,1,1,0,1
2023-06-01,25522,2,1,3,2,2,2
2023-06-01,13027,1,0,1,2,0,2
2023-06-01,13031,1,0,1,1,0,1
2023-06-01,13060,1,0,1,2,0,2
2023-06-01,13200,2,0,2,2,0,2
2023-06-01,211721,1,5,6,3,2,3
2023-06-01,9090,2,0,2,4,0,4
2023-06-01,13147,1,0,1,1,0,1
2023-06-01,13202,1,0,1,2,0,2
2023-06-01,16151,1,0,1,2,0,2
2023-06-01,52216,1,0,1,1,0,1
2023-06-01,198567,1,0,1,3,0,3
2023-06-01,48769,1,0,1,2,0,2
2023-06-01,65538,1,0,1,1,0,1
2023-06-01,5425,31,1,32,1,1,1
2023-06-01,212989,2,1,3,3,3,4
2023-06-01,206086,1,0,1,1,0,1
2023-06-01,28879,1,0,1,2,0,2
2023-06-01,209482,1,0,1,2,0,2
2023-06-01,213247,1,0,1,1,0,1
2023-06-01,208598,4,0,4,2,0,2
2023-06-01,200312,5,0,5,2,0,2
2023-06-01,212207,1,0,1,1,0,1
2023-06-01,41514,1,0,1,2,0,2
2023-06-01,48386,1,1,2,1,2,2
2023-06-01,202301,1,1,2,1,1,1
2023-06-01,208011,4,0,4,3,0,3
2023-06-01,47314,1,1,2,3,3,3
2023-06-01,209081,2,0,2,2,0,2
2023-06-01,202333,3,1,4,2,1,2
2023-06-01,200333,1,0,1,1,0,1
2023-06-01,30768,1,0,1,2,0,2
2023-06-01,25269,1,0,1,2,0,2
2023-06-01,43702,2,0,2,3,0,3
2023-06-01,48721,2,1,3,1,1,1
2023-06-01,196641,2,0,2,2,0,2
2023-06-01,35162,1,0,1,3,0,3
2023-06-01,207727,4,6,10,3,3,3
2023-06-01,16122,2,0,2,1,0,1
2023-06-01,39209,1,0,1,2,0,2
2023-06-01,39219,1,0,1,2,0,2
2023-06-01,51529,1,0,1,2,0,2
2023-06-01,48534,1,1,2,2,2,2
2023-06-01,198274,1,0,1,1,0,1
2023-06-01,39243,1,0,1,2,0,2
2023-06-01,49522,1,0,1,1,0,1
2023-06-01,211460,1,0,1,3,0,3
2023-06-01,199772,1,0,1,1,0,1
2023-06-01,39254,1,0,1,1,0,1
2023-06-01,40427,2,0,2,1,0,1
2023-06-01,200318,1,1,2,1,2,2
2023-06-01,62394,1,0,1,1,0,1
2023-06-01,39237,2,0,2,1,0,1
2023-06-01,212186,4,0,4,2,0,2
2023-06-01,16051,1,0,1,1,0,1
2023-06-01,44723,1,0,1,1,0,1
2023-06-01,42051,1,0,1,1,0,1
2023-06-01,42054,1,0,1,1,0,1
2023-06-01,42052,1,0,1,3,0,3
2023-06-01,42026,1,0,1,2,0,2
2023-06-01,49537,1,0,1,2,0,2
2023-06-01,50943,1,0,1,2,0,2
2023-06-01,199330,1,1,2,3,4,4
2023-06-01,42046,1,0,1,3,0,3
2023-06-01,202860,2,0,2,1,0,1
2023-06-01,42070,1,0,1,1,0,1
2023-06-01,42107,1,0,1,2,0,2
2023-06-01,199161,1,0,1,1,0,1
2023-06-01,198311,9,1,10,2,1,2
2023-06-01,24984,2,0,2,1,0,1
2023-06-01,41373,1,0,1,1,0,1
2023-06-01,15822,1,0,1,1,0,1
2023-06-01,20506,1,0,1,1,0,1
2023-06-01,15520,2,0,2,1,0,1
2023-06-01,28743,3,0,3,1,0,1
2023-06-01,48664,3,0,3,2,0,2
2023-06-01,50035,1,0,1,1,0,1
2023-06-01,35560,5,0,5,3,0,3
2023-06-01,48790,1,0,1,2,0,2
2023-06-01,15948,3,0,3,1,0,1
2023-06-01,15690,4,1,5,1,1,1
2023-06-01,25508,2,0,2,1,0,1
2023-06-01,209774,2,0,2,3,0,3
2023-06-01,5382,1,0,1,1,0,1
2023-06-01,3278,5,0,5,3,0,3
2023-06-01,199162,1,0,1,1,0,1
2023-06-01,202326,5,0,5,3,0,3
2023-06-01,60400,1,0,1,2,0,2
2023-06-01,9067,1,1,2,2,2,3
2023-06-01,211896,4,0,4,1,0,1
2023-06-01,49651,3,0,3,3,0,3
2023-06-01,199877,5,0,5,6,0,6
2023-06-01,200331,1,0,1,2,0,2
2023-06-01,206899,2,0,2,1,0,1
2023-06-01,213400,1,1,2,2,1,2
2023-06-01,201448,1,0,1,1,0,1
2023-06-01,203508,1,0,1,2,0,2
2023-06-01,207105,1,1,2,2,2,2
2023-06-01,200633,1,0,1,2,0,2
2023-06-01,202854,1,0,1,3,0,3
2023-06-01,199648,1,0,1,2,0,2
2023-06-01,3240,3,1,4,1,1,1
2023-06-01,210721,1,0,1,1,0,1
2023-06-01,208971,1,0,1,1,0,1
2023-06-01,204715,1,0,1,4,0,4
2023-06-01,201920,1,0,1,2,0,2
2023-06-01,35580,1,0,1,2,0,2
2023-06-01,34098,1,0,1,3,0,3
2023-06-01,199463,1,0,1,2,0,2
2023-06-01,198502,1,0,1,1,0,1
2023-06-01,209568,1,1,2,2,2,2
2023-06-01,60225,1,0,1,1,0,1
2023-06-01,204486,1,0,1,3,0,3
2023-06-01,35355,1,0,1,2,0,2
2023-06-01,35565,1,0,1,1,0,1
2023-06-01,35373,1,0,1,1,0,1
2023-06-01,35385,3,0,3,2,0,2
2023-06-01,35350,5,0,5,2,0,2
2023-06-01,210886,1,0,1,2,0,2
2023-06-01,35519,1,0,1,3,0,3
2023-06-01,58211,2,0,2,1,0,1
2023-06-01,35538,4,0,4,4,0,4
2023-06-01,35533,1,0,1,1,0,1
2023-06-01,47761,5,0,5,2,0,2
2023-06-01,41057,1,0,1,3,0,3
2023-06-01,20950,1,0,1,2,0,2
2023-06-01,35618,4,0,4,1,0,1
2023-06-01,199122,1,0,1,1,0,1
2023-06-01,200142,1,0,1,2,0,2
2023-06-01,35673,4,2,6,3,2,4
2023-06-01,199730,1,0,1,1,0,1
2023-06-01,49358,1,0,1,3,0,3
2023-06-01,56342,2,0,2,4,0,4
2023-06-01,201302,1,0,1,2,0,2
2023-06-01,47213,2,0,2,2,0,2
2023-06-01,52184,1,0,1,2,0,2
2023-06-01,41615,2,0,2,2,0,2
2023-06-01,49668,1,0,1,1,0,1
2023-06-01,50001,1,0,1,3,0,3
2023-06-01,49886,2,0,2,3,0,3
2023-06-01,52016,5,3,8,7,5,7
2023-06-01,50002,1,0,1,4,0,4
2023-06-01,64409,3,0,3,3,0,3
2023-06-01,49925,7,0,7,3,0,3
2023-06-01,50003,2,0,2,2,0,2
2023-06-01,200065,1,0,1,1,0,1
2023-06-01,62439,1,0,1,1,0,1
2023-06-01,50082,1,0,1,4,0,4
2023-06-01,50435,5,0,5,2,0,2
2023-06-01,203794,2,0,2,1,0,1
2023-06-01,59513,2,0,2,1,0,1
2023-06-01,50567,1,0,1,2,0,2
2023-06-01,50804,4,0,4,1,0,1
2023-06-01,50822,1,0,1,3,0,3
2023-06-01,39058,2,2,4,2,2,2
2023-06-01,50776,5,0,5,4,0,4
2023-06-01,202342,1,0,1,3,0,3
2023-06-01,50885,1,0,1,2,0,2
2023-06-01,21020,1,0,1,2,0,2
2023-06-01,197080,1,0,1,2,0,2
2023-06-01,51039,1,0,1,2,0,2
2023-06-01,50946,1,0,1,2,0,2
2023-06-01,50958,1,0,1,2,0,2
2023-06-01,51125,1,0,1,3,0,3
2023-06-01,206465,1,0,1,2,0,2
2023-06-01,51051,1,0,1,1,0,1
2023-06-01,211164,1,0,1,3,0,3
2023-06-01,207561,2,0,2,3,0,3
2023-06-01,204600,1,1,2,5,3,5
2023-06-01,199576,1,0,1,2,0,2
2023-06-01,57107,3,0,3,2,0,2
2023-06-01,208303,1,0,1,2,0,2
2023-06-01,57352,1,0,1,1,0,1
2023-06-01,211258,1,0,1,2,0,2
2023-06-01,49521,1,0,1,2,0,2
2023-06-01,51523,1,0,1,2,0,2
2023-06-01,51771,1,0,1,2,0,2
2023-06-01,52085,1,0,1,1,0,1
2023-06-01,51339,3,0,3,3,0,3
2023-06-01,48723,1,0,1,2,0,2
2023-06-01,209636,1,0,1,2,0,2
2023-06-01,208894,1,0,1,2,0,2
2023-06-01,207259,1,0,1,2,0,2
2023-06-01,39131,4,0,4,3,0,3
2023-06-01,203767,2,0,2,1,0,1
2023-06-01,24677,2,0,2,1,0,1
2023-06-01,29058,1,0,1,1,0,1
2023-06-01,204510,2,0,2,2,0,2
2023-06-01,208813,1,1,2,1,1,1
2023-06-01,48590,1,0,1,2,0,2
2023-06-01,41503,2,0,2,1,0,1
2023-06-01,41521,2,0,2,2,0,2
2023-06-01,50734,1,0,1,2,0,2
2023-06-01,205492,1,0,1,2,0,2
2023-06-01,205815,1,0,1,1,0,1
2023-06-01,203104,1,0,1,3,0,3
2023-06-01,212823,3,0,3,2,0,2
2023-06-01,16114,1,0,1,2,0,2
2023-06-01,35187,1,0,1,2,0,2
2023-06-01,29466,1,0,1,2,0,2
2023-06-01,35304,1,0,1,3,0,3
2023-06-01,49508,1,0,1,1,0,1
2023-06-01,51555,1,0,1,1,0,1
2023-06-01,20619,1,0,1,3,0,3
2023-06-01,35265,1,0,1,1,0,1
2023-06-01,41812,2,0,2,2,0,2
2023-06-01,197185,1,1,2,1,1,1
2023-06-01,51314,1,0,1,5,0,5
2023-06-01,51316,1,1,2,2,1,2
2023-06-01,51307,1,1,2,1,2,2
2023-06-01,51315,2,0,2,1,0,1
2023-06-01,38958,1,0,1,1,0,1
2023-06-01,213218,1,0,1,2,0,2
2023-06-01,204993,2,0,2,1,0,1
2023-06-01,35264,2,0,2,1,0,1
2023-06-01,211359,3,0,3,2,0,2
2023-06-01,43965,12,0,12,2,0,2
2023-06-01,57745,8,0,8,2,0,2
2023-06-01,47981,1,0,1,1,0,1
2023-06-01,41620,5,0,5,2,0,2
2023-06-01,62422,1,0,1,1,0,1
2023-06-01,210726,1,0,1,2,0,2
2023-06-01,211532,1,0,1,1,0,1
2023-06-01,48035,2,0,2,2,0,2
2023-06-01,41127,2,0,2,1,0,1
2023-06-01,39321,1,0,1,3,0,3
2023-06-01,201312,1,0,1,1,0,1
2023-06-01,201037,1,0,1,3,0,3
2023-06-01,59850,1,0,1,2,0,2
2023-06-01,56384,9,0,9,2,0,2
2023-06-01,205735,1,0,1,1,0,1
2023-06-01,205442,2,0,2,3,0,3
2023-06-01,42121,1,0,1,1,0,1
2023-06-01,51334,1,0,1,3,0,3
2023-06-01,51994,1,0,1,3,0,3
2023-06-01,212220,2,0,2,1,0,1
2023-06-01,212308,1,0,1,2,0,2
2023-06-01,60837,1,0,1,3,0,3
2023-06-01,62029,1,0,1,1,0,1
2023-06-01,60040,1,0,1,2,0,2
2023-06-01,202156,1,0,1,3,0,3
2023-06-01,201994,1,0,1,2,0,2
2023-06-01,61378,2,0,2,6,0,6
2023-06-01,201778,1,0,1,2,0,2
2023-06-01,201820,1,1,2,2,1,3
2023-06-01,59928,1,0,1,1,0,1
2023-06-01,212273,1,0,1,1,0,1
2023-06-01,42168,1,1,2,1,1,1
2023-06-01,57138,1,1,2,2,2,2
2023-06-01,49723,1,0,1,1,0,1
2023-06-01,49841,1,0,1,3,0,3
2023-06-01,197160,1,0,1,1,0,1
2023-06-01,49756,1,0,1,1,0,1
2023-06-01,196764,1,0,1,1,0,1
2023-06-01,20526,1,0,1,2,0,2
2023-06-01,12968,0,0,0,2,0,2
2023-06-01,39487,1,0,1,3,0,3
2023-06-01,20684,1,0,1,3,0,3
2023-06-01,206932,1,0,1,1,0,1
2023-06-01,20585,1,0,1,3,0,3
2023-06-01,34253,5,0,5,1,0,1
2023-06-01,20790,1,0,1,1,0,1
2023-06-01,39616,1,0,1,1,0,1
2023-06-01,31574,5,0,5,3,0,3
2023-06-01,59453,3,0,3,1,0,1
2023-06-01,202271,2,0,2,2,0,2
2023-06-01,47826,2,0,2,2,0,2
2023-06-01,198215,1,0,1,1,0,1
2023-06-01,50134,1,0,1,3,0,3
2023-06-01,57545,1,0,1,2,0,2
2023-06-01,198222,1,0,1,1,0,1
2023-06-01,207873,1,0,1,1,0,1
2023-06-01,40061,5,1,6,3,2,3
2023-06-01,31035,1,0,1,1,0,1
2023-06-01,12795,2,0,2,4,0,4
2023-06-01,197874,2,1,3,2,1,2
2023-06-01,50829,1,0,1,5,0,5
2023-06-01,201886,1,0,1,1,0,1
2023-06-01,50846,1,0,1,2,0,2
2023-06-01,50848,3,0,3,3,0,3
2023-06-01,50852,1,0,1,2,0,2
2023-06-01,50854,1,0,1,1,0,1
2023-06-01,60971,1,0,1,1,0,1
2023-06-01,52071,1,0,1,1,0,1
2023-06-01,52066,1,0,1,1,0,1
2023-06-01,52069,1,0,1,3,0,3
2023-06-01,52203,1,0,1,4,0,4
2023-06-01,197586,1,0,1,3,0,3
2023-06-01,52160,1,0,1,3,0,3
2023-06-01,52097,1,0,1,1,0,1
2023-06-01,52108,1,0,1,2,0,2
2023-06-01,52109,1,0,1,1,0,1
2023-06-01,57216,1,0,1,1,0,1
2023-06-01,52186,1,0,1,2,0,2
2023-06-01,12396,4,0,4,1,0,1
2023-06-01,196831,2,0,2,3,0,3
2023-06-01,50127,1,0,1,2,0,2
2023-06-01,50123,1,0,1,1,0,1
2023-06-01,50158,2,0,2,2,0,2
2023-06-01,25181,1,1,2,1,1,1
2023-06-01,29219,7,0,7,1,0,1
2023-06-01,48530,3,0,3,3,0,3
2023-06-01,48561,3,0,3,2,0,2
2023-06-01,44196,6,0,6,1,0,1
2023-06-01,13029,1,0,1,2,0,2
2023-06-01,197031,1,0,1,1,0,1
2023-06-01,44052,2,0,2,1,0,1
2023-06-01,50378,1,0,1,2,0,2
2023-06-01,43999,1,0,1,1,0,1
2023-06-01,15824,1,0,1,1,0,1
2023-06-01,41377,3,0,3,2,0,2
2023-06-01,41433,1,0,1,1,0,1
2023-06-01,50806,1,0,1,1,0,1
2023-06-01,39562,1,0,1,3,0,3
2023-06-01,42506,3,0,3,1,0,1
2023-06-01,51895,5,1,6,2,1,2
2023-06-01,41504,1,1,2,3,2,3
2023-06-01,56390,1,0,1,2,0,2
2023-06-01,41513,1,0,1,1,0,1
2023-06-01,41681,1,1,2,1,2,2
2023-06-01,41599,1,1,2,2,2,4
2023-06-01,8239,3,1,4,2,2,2
2023-06-01,39675,1,0,1,1,0,1
2023-06-01,39680,1,0,1,1,0,1
2023-06-01,35476,1,0,1,1,0,1
2023-06-01,199982,1,0,1,1,0,1
2023-06-01,211030,1,1,2,1,1,1
2023-06-01,39130,5,0,5,5,0,5
2023-06-01,56482,1,0,1,3,0,3
2023-06-01,44968,1,1,2,3,1,3
2023-06-01,50277,1,1,2,2,2,2
2023-06-01,45026,1,0,1,1,0,1
2023-06-01,45016,1,0,1,3,0,3
2023-06-01,45022,1,0,1,2,0,2
2023-06-01,60654,1,0,1,1,0,1
2023-06-01,210073,1,0,1,3,0,3
2023-06-01,206107,1,0,1,1,0,1
2023-06-01,48257,3,0,3,7,0,7
2023-06-01,48650,3,0,3,2,0,2
2023-06-01,48649,1,0,1,3,0,3
2023-06-01,48651,3,3,6,2,1,2
2023-06-01,197457,1,0,1,2,0,2
2023-06-01,34424,1,0,1,2,0,2
2023-06-01,34431,1,0,1,3,0,3
2023-06-01,205278,1,0,1,1,0,1
2023-06-01,35331,1,0,1,1,0,1
2023-06-01,34433,1,0,1,1,0,1
2023-06-01,34438,1,0,1,1,0,1
2023-06-01,34451,1,0,1,1,0,1
2023-06-01,44018,2,0,2,2,0,2
2023-06-01,211752,1,1,2,4,3,5
2023-06-01,50099,1,0,1,1,0,1
2023-06-01,15443,1,0,1,1,0,1
2023-06-01,42016,1,0,1,3,0,3
2023-06-01,41777,1,0,1,2,0,2
2023-06-01,41790,1,0,1,5,0,5
2023-06-01,6891,1,0,1,3,0,3
2023-06-01,6981,0,0,0,1,0,1
2023-06-01,35756,1,0,1,1,0,1
2023-06-01,57280,1,1,2,1,1,1
2023-06-01,35802,1,0,1,3,0,3
2023-06-01,35734,1,0,1,1,0,1
2023-06-01,59558,1,0,1,1,0,1
2023-06-01,9014,1,0,1,1,0,1
2023-06-01,35785,1,0,1,3,0,3
2023-06-01,207592,1,0,1,1,0,1
2023-06-01,59929,2,0,2,2,0,2
2023-06-01,15549,5,0,5,4,0,4
2023-06-01,39456,1,0,1,1,0,1
2023-06-01,47205,1,0,1,1,0,1
2023-06-01,8547,1,0,1,3,0,3
2023-06-01,12318,1,0,1,2,0,2
2023-06-01,38914,1,1,2,2,2,2
2023-06-01,58319,1,1,2,2,2,3
2023-06-01,38991,1,0,1,2,0,2
2023-06-01,39008,1,0,1,2,0,2
2023-06-01,41536,1,0,1,3,0,3
2023-06-01,39014,1,0,1,1,0,1
2023-06-01,39026,1,0,1,1,0,1
2023-06-01,61063,4,0,4,1,0,1
2023-06-01,39037,1,0,1,1,0,1
2023-06-01,49326,1,0,1,3,0,3
2023-06-01,12456,1,0,1,3,0,3
2023-06-01,49976,1,0,1,2,0,2
2023-06-01,207024,1,0,1,2,0,2
2023-06-01,51360,3,0,3,3,0,3
2023-06-01,51860,1,0,1,2,0,2
2023-06-01,51372,1,0,1,1,0,1
2023-06-01,212506,1,0,1,1,0,1
2023-06-01,48352,1,1,2,1,1,1
2023-06-01,31064,1,0,1,2,0,2
2023-06-01,47905,1,0,1,2,0,2
2023-06-01,44131,1,0,1,2,0,2
2023-06-01,42529,1,0,1,2,0,2
2023-06-01,200384,1,0,1,2,0,2
2023-06-01,8557,5,0,5,1,0,1
2023-06-01,50586,1,0,1,1,0,1
2023-06-01,62295,1,0,1,3,0,3
2023-06-01,62115,1,0,1,2,0,2
2023-06-01,207025,1,0,1,2,0,2
2023-06-01,206871,1,0,1,1,0,1
2023-06-01,6868,1,0,1,3,0,3
2023-06-01,56686,1,0,1,2,0,2
2023-06-01,199572,2,0,2,2,0,2
2023-06-01,56777,2,0,2,2,0,2
2023-06-01,44310,6,0,6,3,0,3
2023-06-01,199032,1,0,1,1,0,1
2023-06-01,56854,1,0,1,1,0,1
2023-06-01,47503,2,0,2,1,0,1
2023-06-01,44093,1,0,1,2,0,2
2023-06-01,51642,1,0,1,3,0,3
2023-06-01,51593,3,0,3,2,0,2
2023-06-01,51721,3,0,3,3,0,3
2023-06-01,209821,1,0,1,1,0,1
2023-06-01,5553,1,0,1,2,0,2
2023-06-01,6699,1,0,1,2,0,2
2023-06-01,61041,1,0,1,1,0,1
2023-06-01,34561,1,0,1,3,0,3
2023-06-01,200175,1,0,1,2,0,2
2023-06-01,206334,1,0,1,2,0,2
2023-06-01,200847,1,0,1,1,0,1
2023-06-01,199602,1,0,1,1,0,1
2023-06-01,61291,1,0,1,1,0,1
2023-06-01,61197,1,0,1,1,0,1
2023-06-01,61285,3,0,3,3,0,3
2023-06-01,41322,1,0,1,1,0,1
2023-06-01,31624,3,0,3,1,0,1
2023-06-01,211698,1,0,1,1,0,1
2023-06-01,31079,1,1,2,2,4,4
2023-06-01,25391,1,0,1,2,0,2
2023-06-01,25437,1,0,1,3,0,3
2023-06-01,5401,1,3,4,2,2,2
2023-06-01,197396,1,0,1,2,0,2
2023-06-01,25403,1,0,1,1,0,1
2023-06-01,25444,1,0,1,1,0,1
2023-06-01,52111,1,0,1,1,0,1
2023-06-01,197512,1,0,1,1,0,1
2023-06-01,197513,1,0,1,2,0,2
2023-06-01,52123,1,0,1,3,0,3
2023-06-01,52118,1,0,1,2,0,2
2023-06-01,52196,1,0,1,1,0,1
2023-06-01,205288,1,0,1,2,0,2
2023-06-01,56424,1,0,1,3,0,3
2023-06-01,52141,1,0,1,2,0,2
2023-06-01,197511,1,0,1,1,0,1
2023-06-01,197525,1,0,1,1,0,1
2023-06-01,52151,1,0,1,3,0,3
2023-06-01,196926,1,0,1,2,0,2
2023-06-01,197517,1,0,1,3,0,3
2023-06-01,197521,1,1,2,3,1,3
2023-06-01,197320,1,0,1,1,0,1
2023-06-01,52149,1,0,1,1,0,1
2023-06-01,8264,2,1,3,3,1,3
2023-06-01,15847,2,0,2,1,0,1
2023-06-01,42063,1,1,2,2,2,2
2023-06-01,42249,1,0,1,3,0,3
2023-06-01,56489,4,0,4,2,0,2
2023-06-01,204797,1,0,1,1,0,1
2023-06-01,52169,1,0,1,3,0,3
2023-06-01,197763,1,1,2,1,1,1
2023-06-01,56640,1,0,1,2,0,2
2023-06-01,197808,1,0,1,2,0,2
2023-06-01,25503,1,0,1,1,0,1
2023-06-01,60746,1,0,1,3,0,3
2023-06-01,21275,1,0,1,3,0,3
2023-06-01,29652,1,0,1,2,0,2
2023-06-01,20833,3,0,3,5,0,5
2023-06-01,209823,1,1,2,1,1,1
2023-06-01,208778,2,0,2,1,0,1
2023-06-01,25448,1,0,1,1,0,1
2023-06-01,212617,1,0,1,1,0,1
2023-06-01,12939,1,0,1,1,0,1
2023-06-01,28736,1,0,1,2,0,2
2023-06-01,41266,1,0,1,1,0,1
2023-06-01,41288,1,0,1,1,0,1
2023-06-01,8507,29,0,29,2,0,2
2023-06-01,198460,2,0,2,2,0,2
2023-06-01,30890,1,0,1,1,0,1
2023-06-01,44738,1,0,1,1,0,1
2023-06-01,44758,1,0,1,1,0,1
2023-06-01,44761,2,0,2,2,0,2
2023-06-01,8620,1,1,2,3,3,3
2023-06-01,33821,2,0,2,2,0,2
2023-06-01,56801,3,0,3,2,0,2
2023-06-01,208986,1,0,1,2,0,2
2023-06-01,21323,1,0,1,2,0,2
2023-06-01,20972,2,0,2,1,0,1
2023-06-01,20992,1,0,1,1,0,1
2023-06-01,49027,1,0,1,1,0,1
2023-06-01,52117,1,0,1,1,0,1
2023-06-01,41562,1,0,1,1,0,1
2023-06-01,44960,1,0,1,1,0,1
2023-06-01,41590,1,0,1,3,0,3
2023-06-01,51383,1,0,1,3,0,3
2023-06-01,21337,2,0,2,1,0,1
2023-06-01,43883,2,0,2,1,0,1
2023-06-01,47650,1,0,1,1,0,1
2023-06-01,15698,1,1,2,2,1,2
2023-06-01,15993,1,0,1,1,0,1
2023-06-01,196807,1,0,1,2,0,2
2023-06-01,49688,4,1,5,1,1,1
2023-06-01,41399,1,0,1,1,0,1
2023-06-01,15677,1,0,1,2,0,2
2023-06-01,15853,1,0,1,1,0,1
2023-06-01,9099,2,0,2,2,0,2
2023-06-01,5392,1,1,2,5,2,5
2023-06-01,198041,1,0,1,3,0,3
2023-06-01,8886,2,0,2,2,0,2
2023-06-01,15458,2,0,2,2,0,2
2023-06-01,33878,1,0,1,2,0,2
2023-06-01,33903,1,0,1,1,0,1
2023-06-01,28912,2,0,2,3,0,3
2023-06-01,29010,1,0,1,2,0,2
2023-06-01,28967,2,0,2,1,0,1
2023-06-01,28991,3,0,3,2,0,2
2023-06-01,28953,2,0,2,2,0,2
2023-06-01,206613,1,1,2,1,1,1
2023-06-01,207921,3,5,8,3,5,5
2023-06-01,44732,1,0,1,2,0,2
2023-06-01,44719,1,0,1,3,0,3
2023-06-01,44726,1,0,1,2,0,2
2023-06-01,44693,1,0,1,2,0,2
2023-06-01,44688,1,0,1,2,0,2
2023-06-01,8515,1,0,1,2,0,2
2023-06-01,49966,3,0,3,4,0,4
2023-06-01,25464,2,0,2,5,0,5
2023-06-01,197114,3,0,3,2,0,2
2023-06-01,51197,3,0,3,2,0,2
2023-06-01,25282,2,0,2,3,0,3
2023-06-01,51354,1,1,2,2,1,2
2023-06-01,51349,1,1,2,2,4,4
2023-06-01,51136,3,0,3,4,0,4
2023-06-01,47360,1,0,1,1,0,1
2023-06-01,48222,1,0,1,3,0,3
2023-06-01,35769,1,0,1,3,0,3
2023-06-01,59979,1,0,1,1,0,1
2023-06-01,47415,1,0,1,2,0,2
2023-06-01,47411,1,0,1,1,0,1
2023-06-01,47426,1,1,2,1,2,2
2023-06-01,207788,4,1,5,1,1,1
2023-06-01,57926,1,1,2,3,3,4
2023-06-01,28815,1,0,1,1,0,1
2023-06-01,29163,1,0,1,2,0,2
2023-06-01,28790,1,0,1,2,0,2
2023-06-01,34117,1,0,1,3,0,3
2023-06-01,16069,1,0,1,1,0,1
2023-06-01,29366,1,0,1,2,0,2
2023-06-01,196624,1,0,1,2,0,2
2023-06-01,28933,2,1,3,1,1,1
2023-06-01,28934,1,0,1,1,0,1
2023-06-01,28998,1,0,1,3,0,3
2023-06-01,28950,1,0,1,3,0,3
2023-06-01,28975,1,0,1,3,0,3
2023-06-01,28793,1,0,1,1,0,1
2023-06-01,197010,1,0,1,2,0,2
2023-06-01,28935,1,0,1,2,0,2
2023-06-01,29162,1,0,1,1,0,1
2023-06-01,28951,1,0,1,2,0,2
2023-06-01,50402,1,0,1,1,0,1
2023-06-01,206297,3,0,3,1,0,1
2023-06-01,28984,1,0,1,3,0,3
2023-06-01,29051,1,0,1,3,0,3
2023-06-01,29019,1,0,1,2,0,2
2023-06-01,29130,1,0,1,1,0,1
2023-06-01,25529,1,0,1,1,0,1
2023-06-01,200292,2,0,2,2,0,2
2023-06-01,40984,1,0,1,2,0,2
2023-06-01,5498,4,0,4,2,0,2
2023-06-01,201976,6,0,6,3,0,3
2023-06-01,204705,1,0,1,1,0,1
2023-06-01,25261,2,0,2,2,0,2
2023-06-01,30846,4,0,4,3,0,3
2023-06-01,210995,3,0,3,3,0,3
2023-06-01,51222,2,0,2,1,0,1
2023-06-01,61147,1,0,1,1,0,1
2023-06-01,51203,1,0,1,1,0,1
2023-06-01,51233,1,0,1,1,0,1
2023-06-01,51171,1,0,1,1,0,1
2023-06-01,51147,1,1,2,1,1,1
2023-06-01,197118,1,1,2,2,1,2
2023-06-01,196969,2,0,2,4,0,4
2023-06-01,1696969,0,0,0,1,0,1
2023-06-01,52152,1,0,1,2,0,2
2023-06-01,209195,1,0,1,2,0,2
2023-06-01,204748,3,0,3,4,0,4
2023-06-01,25539,1,0,1,1,0,1
2023-06-01,30917,1,0,1,1,0,1
2023-06-01,65201,1,2,3,3,1,4
2023-06-01,211795,1,0,1,2,0,2
2023-06-01,39731,1,0,1,3,0,3
2023-06-01,39732,1,1,2,1,1,1
2023-06-01,39734,1,0,1,3,0,3
2023-06-01,39745,1,0,1,2,0,2
2023-06-01,12371,2,1,3,3,2,3
2023-06-01,198033,1,0,1,3,0,3
2023-06-01,198395,1,0,1,1,0,1
2023-06-01,39082,1,0,1,1,0,1
2023-06-01,39127,1,0,1,1,0,1
2023-06-01,39100,1,0,1,3,0,3
2023-06-01,39096,3,0,3,4,0,4
2023-06-01,46235,4,0,4,2,0,2
2023-06-01,41299,1,0,1,2,0,2
2023-06-01,57268,1,0,1,3,0,3
2023-06-01,39528,2,0,2,2,0,2
2023-06-01,209069,1,0,1,2,0,2
2023-06-01,31738,5,0,5,3,0,3
2023-06-01,47001,2,0,2,2,0,2
2023-06-01,198584,1,0,1,1,0,1
2023-06-01,58183,1,0,1,1,0,1
2023-06-01,44856,2,0,2,1,0,1
2023-06-01,44830,1,0,1,1,0,1
2023-06-01,44849,1,0,1,1,0,1
2023-06-01,199664,1,1,2,2,2,2
2023-06-01,62444,1,1,2,2,2,2
2023-06-01,34739,2,0,2,1,0,1
2023-06-01,47257,1,0,1,1,0,1
2023-06-01,47953,1,0,1,1,0,1
2023-06-01,47259,1,0,1,1,0,1
2023-06-01,47274,2,0,2,3,0,3
2023-06-01,47291,1,0,1,2,0,2
2023-06-01,42059,1,0,1,2,0,2
2023-06-01,42095,1,0,1,1,0,1
2023-06-01,42085,1,0,1,3,0,3
2023-06-01,48892,1,0,1,1,0,1
2023-06-01,41115,1,0,1,2,0,2
2023-06-01,44958,1,0,1,3,0,3
2023-06-01,41125,1,0,1,1,0,1
2023-06-01,34711,1,0,1,2,0,2
2023-06-01,197144,2,0,2,1,0,1
2023-06-01,49570,1,0,1,1,0,1
2023-06-01,41169,1,0,1,2,0,2
2023-06-01,41150,2,0,2,1,0,1
2023-06-01,207093,1,0,1,1,0,1
2023-06-01,39267,2,0,2,3,0,3
2023-06-01,8258,3,1,4,7,2,7
2023-06-01,211250,2,0,2,1,0,1
2023-06-01,205459,1,0,1,2,0,2
2023-06-01,211947,1,1,2,2,1,2
2023-06-01,199313,1,0,1,1,0,1
2023-06-01,213198,1,0,1,3,0,3
2023-06-01,41229,1,0,1,2,0,2
2023-06-01,201870,2,0,2,2,0,2
2023-06-01,47299,1,0,1,2,0,2
2023-06-01,209494,1,0,1,2,0,2
2023-06-01,206794,1,0,1,1,0,1
2023-06-01,212920,1,0,1,2,0,2
2023-06-01,30934,2,0,2,1,0,1
2023-06-01,24869,4,0,4,2,0,2
2023-06-01,39071,1,0,1,2,0,2
2023-06-01,199126,1,0,1,2,0,2
2023-06-01,39085,1,0,1,2,0,2
2023-06-01,43351,1,1,2,2,1,2
2023-06-01,39073,1,0,1,1,0,1
2023-06-01,39157,1,0,1,2,0,2
2023-06-01,39092,1,0,1,3,0,3
2023-06-01,39084,1,0,1,1,0,1
2023-06-01,39086,1,1,2,1,1,1
2023-06-01,39119,1,0,1,2,0,2
2023-06-01,39109,1,0,1,1,0,1
2023-06-01,42836,1,1,2,3,3,3
2023-06-01,39460,1,0,1,3,0,3
2023-06-01,39137,1,0,1,3,0,3
2023-06-01,210991,1,1,2,1,1,1
2023-06-01,44855,1,0,1,1,0,1
2023-06-01,44852,1,0,1,1,0,1
2023-06-01,44839,1,0,1,1,0,1
2023-06-01,49913,1,0,1,1,0,1
2023-06-01,198085,1,0,1,1,0,1
2023-06-01,44867,1,0,1,3,0,3
2023-06-01,44860,1,0,1,2,0,2
2023-06-01,15559,1,0,1,1,0,1
2023-06-01,44909,1,0,1,1,0,1
2023-06-01,44886,1,0,1,1,0,1
2023-06-01,47310,1,0,1,1,0,1
2023-06-01,39022,1,1,2,5,5,7
2023-06-01,39062,3,0,3,1,0,1
2023-06-01,29023,2,0,2,2,0,2
2023-06-01,56774,1,0,1,1,0,1
2023-06-01,29044,3,0,3,1,0,1
2023-06-01,29042,2,0,2,3,0,3
2023-06-01,29080,3,0,3,1,0,1
2023-06-01,29095,2,0,2,1,0,1
2023-06-01,29395,1,0,1,3,0,3
2023-06-01,29187,1,0,1,1,0,1
2023-06-01,29146,1,0,1,1,0,1
2023-06-01,29178,1,0,1,1,0,1
2023-06-01,57233,1,0,1,1,0,1
2023-06-01,48051,1,0,1,1,0,1
2023-06-01,29082,5,0,5,3,0,3
2023-06-01,29116,1,0,1,1,0,1
2023-06-01,204362,1,0,1,1,0,1
2023-06-01,29121,1,0,1,1,0,1
2023-06-01,29210,5,0,5,1,0,1
2023-06-01,29227,1,0,1,1,0,1
2023-06-01,211002,1,0,1,1,0,1
2023-06-01,8775,4,0,4,2,0,2
2023-06-01,31656,1,0,1,2,0,2
2023-06-01,210243,1,0,1,2,0,2
2023-06-01,213084,3,0,3,1,0,1
2023-06-01,25011,1,0,1,1,0,1
2023-06-01,34668,1,0,1,2,0,2
2023-06-01,198384,1,0,1,2,0,2
2023-06-01,28996,2,0,2,1,0,1
2023-06-01,212979,1,0,1,2,0,2
2023-06-01,202316,4,1,5,3,2,4
2023-06-01,50204,2,0,2,1,0,1
2023-06-01,210007,3,0,3,1,0,1
2023-06-01,8457,4,1,5,3,1,3
2023-06-01,15534,1,0,1,1,0,1
2023-06-01,204501,1,0,1,2,0,2
2023-06-01,204500,1,0,1,2,0,2
2023-06-01,39247,1,0,1,1,0,1
2023-06-01,42197,4,0,4,1,0,1
2023-06-01,42177,4,1,5,6,2,7
2023-06-01,48527,1,0,1,2,0,2
2023-06-01,209637,1,0,1,2,0,2
2023-06-01,41243,2,0,2,1,0,1
2023-06-01,41283,1,0,1,1,0,1
2023-06-01,44080,1,0,1,1,0,1
2023-06-01,41892,1,0,1,1,0,1
2023-06-01,42492,1,0,1,1,0,1
2023-06-01,41358,1,0,1,1,0,1
2023-06-01,41389,1,0,1,4,0,4
2023-06-01,8519,1,1,2,1,1,1
2023-06-01,202233,2,0,2,1,0,1
2023-06-01,208726,1,0,1,1,0,1
2023-06-01,25277,3,0,3,1,0,1
2023-06-01,43540,2,0,2,1,0,1
2023-06-01,59485,1,0,1,1,0,1
2023-06-01,41492,2,0,2,2,0,2
2023-06-01,41502,2,0,2,2,0,2
2023-06-01,41512,1,0,1,1,0,1
2023-06-01,41538,2,0,2,3,0,3
2023-06-01,208243,1,0,1,1,0,1
2023-06-01,6674,3,0,3,3,0,3
2023-06-01,41534,1,0,1,1,0,1
2023-06-01,41544,1,0,1,1,0,1
2023-06-01,25299,7,0,7,1,0,1
2023-06-01,50772,1,0,1,1,0,1
2023-06-01,50015,2,0,2,1,0,1
2023-06-01,50413,2,0,2,1,0,1
2023-06-01,49819,2,0,2,1,0,1
2023-06-01,196789,1,0,1,3,0,3
2023-06-01,31088,1,0,1,1,0,1
2023-06-01,39066,5,0,5,3,0,3
2023-06-01,209175,1,0,1,1,0,1
2023-06-01,209085,1,0,1,3,0,3
2023-06-01,39410,1,0,1,4,0,4
2023-06-01,39424,1,0,1,1,0,1
2023-06-01,39315,2,1,3,3,2,3
2023-06-01,50947,1,0,1,3,0,3
2023-06-01,41636,1,0,1,2,0,2
2023-06-01,35186,1,0,1,1,0,1
2023-06-01,35195,1,0,1,3,0,3
2023-06-01,44846,2,0,2,1,0,1
2023-06-01,44861,1,0,1,1,0,1
2023-06-01,44857,2,0,2,3,0,3
2023-06-01,62358,1,0,1,1,0,1
2023-06-01,9006,1,0,1,2,0,2
2023-06-01,44892,1,0,1,1,0,1
2023-06-01,399399,2,0,2,2,0,2
2023-06-01,44268,1,0,1,2,0,2
2023-06-01,29103,1,0,1,2,0,2
2023-06-01,198491,1,0,1,2,0,2
2023-06-01,29267,1,0,1,2,0,2
2023-06-01,212945,1,0,1,1,0,1
2023-06-01,206764,1,0,1,3,0,3
2023-06-01,207786,4,0,4,1,0,1
2023-06-01,48859,1,0,1,2,0,2
2023-06-01,29324,1,0,1,1,0,1
2023-06-01,29221,1,0,1,1,0,1
2023-06-01,29223,1,0,1,2,0,2
2023-06-01,29199,1,0,1,1,0,1
2023-06-01,207324,4,1,5,1,2,2
2023-06-01,47404,1,0,1,2,0,2
2023-06-01,58203,2,0,2,2,0,2
2023-06-01,43331,4,0,4,3,0,3
2023-06-01,199812,1,0,1,2,0,2
2023-06-01,34299,3,0,3,2,0,2
2023-06-01,41143,1,0,1,1,0,1
2023-06-01,49203,2,0,2,1,0,1
2023-06-01,196657,1,0,1,4,0,4
2023-06-01,48567,1,0,1,1,0,1
2023-06-01,48387,3,2,5,1,1,1
2023-06-01,196686,1,0,1,1,0,1
2023-06-01,48897,1,0,1,2,0,2
2023-06-01,48911,1,0,1,1,0,1
2023-06-01,48928,1,0,1,1,0,1
2023-06-01,48930,1,0,1,2,0,2
2023-06-01,48938,1,0,1,2,0,2
2023-06-01,49216,2,0,2,4,0,4
2023-06-01,48969,1,0,1,2,0,2
2023-06-01,199969,2,0,2,3,0,3
2023-06-01,48962,1,0,1,1,0,1
2023-06-01,48986,1,0,1,1,0,1
2023-06-01,49008,1,0,1,1,0,1
2023-06-01,49842,1,0,1,1,0,1
2023-06-01,206664,1,0,1,1,0,1
2023-06-01,207696,1,1,2,1,1,1
2023-06-01,52046,1,0,1,2,0,2
2023-06-01,49098,1,0,1,1,0,1
2023-06-01,49078,2,1,3,1,1,1
2023-06-01,49153,1,0,1,2,0,2
2023-06-01,204305,1,0,1,1,0,1
2023-06-01,203167,1,0,1,1,0,1
2023-06-01,49156,1,0,1,1,0,1
2023-06-01,49155,1,0,1,1,0,1
2023-06-01,201484,3,0,3,1,0,1
2023-06-01,49146,1,0,1,1,0,1
2023-06-01,49205,2,0,2,1,0,1
2023-06-01,49179,2,0,2,3,0,3
2023-06-01,198711,1,0,1,1,0,1
2023-06-01,49231,1,0,1,1,0,1
2023-06-01,196754,1,0,1,2,0,2
2023-06-01,57500,1,0,1,1,0,1
2023-06-01,198223,1,0,1,1,0,1
2023-06-01,49238,2,0,2,1,0,1
2023-06-01,202431,1,0,1,3,0,3
2023-06-01,207909,2,0,2,1,0,1
2023-06-01,39327,3,0,3,1,0,1
2023-06-01,44211,1,0,1,1,0,1
2023-06-01,51623,1,0,1,2,0,2
2023-06-01,44254,3,0,3,1,0,1
2023-06-01,44255,3,0,3,1,0,1
2023-06-01,44280,1,0,1,1,0,1
2023-06-01,44338,1,0,1,1,0,1
2023-06-01,44353,1,0,1,2,0,2
2023-06-01,41493,1,0,1,2,0,2
2023-06-01,44336,1,0,1,1,0,1
2023-06-01,44380,2,0,2,1,0,1
2023-06-01,44127,3,0,3,3,0,3
2023-06-01,44392,1,0,1,1,0,1
2023-06-01,44420,2,0,2,2,0,2
2023-06-01,44435,3,0,3,3,0,3
2023-06-01,44470,3,0,3,3,0,3
2023-06-01,44485,1,0,1,1,0,1
2023-06-01,12486,20,1,21,6,1,6
2023-06-01,12330,2,0,2,1,0,1
2023-06-01,39935,1,0,1,2,0,2
2023-06-01,39926,1,0,1,1,0,1
2023-06-01,39930,1,0,1,1,0,1
2023-06-01,39297,2,0,2,1,0,1
2023-06-01,210169,1,0,1,2,0,2
2023-06-01,40978,1,0,1,2,0,2
2023-06-01,41543,1,0,1,1,0,1
2023-06-01,48759,1,0,1,3,0,3
2023-06-01,49590,1,0,1,1,0,1
2023-06-01,40998,1,0,1,2,0,2
2023-06-01,41016,1,0,1,1,0,1
2023-06-01,41104,1,0,1,1,0,1
2023-06-01,41037,1,0,1,1,0,1
2023-06-01,199166,1,0,1,2,0,2
2023-06-01,200132,1,1,2,6,5,7
2023-06-01,43210,1,0,1,1,0,1
2023-06-01,41116,1,0,1,1,0,1
2023-06-01,5629,1,0,1,1,0,1
2023-06-01,51576,1,0,1,1,0,1
2023-06-01,34167,1,0,1,1,0,1
2023-06-01,34166,1,0,1,1,0,1
2023-06-01,34239,1,0,1,2,0,2
2023-06-01,8354,1,0,1,1,0,1
2023-06-01,8745,2,2,4,2,2,2
2023-06-01,6862,8,0,8,1,0,1
2023-06-01,208524,1,0,1,1,0,1
2023-06-01,42142,1,0,1,1,0,1
2023-06-01,196609,1,0,1,1,0,1
2023-06-01,42191,3,0,3,1,0,1
2023-06-01,39061,1,0,1,1,0,1
2023-06-01,50995,3,0,3,2,0,2
2023-06-01,49903,2,0,2,3,0,3
2023-06-01,49885,1,1,2,2,2,2
2023-06-01,49891,1,0,1,1,0,1
2023-06-01,12363,3,1,4,2,2,2
2023-06-01,206191,1,0,1,1,0,1
2023-06-01,9161,1,0,1,1,0,1
2023-06-01,209049,4,0,4,1,0,1
2023-06-01,59809,1,0,1,1,0,1
2023-06-01,42172,1,0,1,1,0,1
2023-06-01,12296,4,0,4,1,0,1
2023-06-01,5573,1,0,1,1,0,1
2023-06-01,47988,1,1,2,1,1,1
2023-06-01,48893,1,0,1,1,0,1
2023-06-01,50370,1,1,2,1,1,1
2023-06-01,41346,1,0,1,1,0,1
2023-06-01,213397,1,0,1,1,0,1
2023-06-01,39128,1,0,1,2,0,2
2023-06-01,57306,1,0,1,1,0,1
2023-06-01,202310,1,1,2,2,2,2
2023-06-01,199146,1,0,1,1,0,1
2023-06-01,34399,1,0,1,1,0,1
2023-06-01,8207,3,0,3,1,0,1
2023-06-01,210353,4,0,4,4,0,4
2023-06-01,210613,1,0,1,2,0,2
2023-06-01,210340,1,0,1,3,0,3
2023-06-01,212790,1,0,1,3,0,3
2023-06-01,49227,2,0,2,3,0,3
2023-06-01,209748,1,0,1,3,0,3
2023-06-01,206462,1,0,1,2,0,2
2023-06-01,59536,2,0,2,5,0,5
2023-06-01,57690,1,0,1,1,0,1
2023-06-01,211964,1,0,1,1,0,1
2023-06-01,209727,1,0,1,1,0,1
2023-06-01,29105,1,1,2,2,1,2
2023-06-01,56695,1,0,1,1,0,1
2023-06-01,56585,1,0,1,1,0,1
2023-06-01,64493,1,0,1,1,0,1
2023-06-01,56613,1,0,1,2,0,2
2023-06-01,56607,1,0,1,1,0,1
2023-06-01,56590,1,0,1,2,0,2
2023-06-01,56921,1,0,1,1,0,1
2023-06-01,56609,1,0,1,2,0,2
2023-06-01,56612,1,0,1,1,0,1
2023-06-01,31361,2,0,2,3,0,3
2023-06-01,31440,1,0,1,2,0,2
2023-06-01,31431,1,0,1,2,0,2
2023-06-01,35748,1,0,1,1,0,1
2023-06-01,31470,1,0,1,2,0,2
2023-06-01,199399,1,1,2,3,1,3
2023-06-01,50148,2,0,2,2,0,2
2023-06-01,8618,2,0,2,1,0,1
2023-06-01,42888,1,0,1,1,0,1
2023-06-01,49754,1,1,2,2,2,2
2023-06-01,48735,1,0,1,1,0,1
2023-06-01,48829,1,0,1,3,0,3
2023-06-01,48799,1,0,1,2,0,2
2023-06-01,48733,1,0,1,2,0,2
2023-06-01,16291,1,0,1,2,0,2
2023-06-01,44165,1,0,1,2,0,2
2023-06-01,5530,1,0,1,1,0,1
2023-06-01,50076,1,0,1,2,0,2
2023-06-01,51921,1,0,1,3,0,3
2023-06-01,199539,1,0,1,2,0,2
2023-06-01,202760,1,0,1,3,0,3
2023-06-01,212266,1,0,1,3,0,3
2023-06-01,209702,1,0,1,1,0,1
2023-06-01,206968,1,0,1,1,0,1
2023-06-01,198254,9,0,9,3,0,3
2023-06-01,25165,3,0,3,4,0,4
2023-06-01,44936,5,0,5,1,0,1
2023-06-01,205608,3,0,3,4,0,4
2023-06-01,204744,2,0,2,2,0,2
2023-06-01,202403,1,0,1,1,0,1
2023-06-01,39437,1,0,1,1,0,1
2023-06-01,204412,1,0,1,1,0,1
2023-06-01,204953,2,0,2,3,0,3
2023-06-01,199389,2,0,2,1,0,1
2023-06-01,35604,1,0,1,1,0,1
2023-06-01,35683,1,0,1,2,0,2
2023-06-01,49104,1,0,1,2,0,2
2023-06-01,35789,1,0,1,1,0,1
2023-06-01,35688,1,0,1,2,0,2
2023-06-01,35730,1,0,1,2,0,2
2023-06-01,56680,1,0,1,1,0,1
2023-06-01,29275,2,0,2,4,0,4
2023-06-01,43173,2,0,2,3,0,3
2023-06-01,29358,1,0,1,2,0,2
2023-06-01,29376,1,0,1,1,0,1
2023-06-01,29373,1,0,1,2,0,2
2023-06-01,41905,1,0,1,1,0,1
2023-06-01,29389,1,0,1,1,0,1
2023-06-01,31409,3,0,3,6,0,6
2023-06-01,29421,1,0,1,1,0,1
2023-06-01,6773,4,0,4,3,0,3
2023-06-01,8601,12,0,12,3,0,3
2023-06-01,41530,1,0,1,1,0,1
2023-06-01,41548,1,0,1,1,0,1
2023-06-01,41916,1,0,1,2,0,2
2023-06-01,41580,1,0,1,1,0,1
2023-06-01,41582,1,0,1,3,0,3
2023-06-01,41553,1,0,1,1,0,1
2023-06-01,198344,1,0,1,1,0,1
2023-06-01,41567,1,0,1,1,0,1
2023-06-01,41617,1,1,2,3,3,3
2023-06-01,41632,1,0,1,2,0,2
2023-06-01,41577,1,0,1,1,0,1
2023-06-01,41638,1,0,1,2,0,2
2023-06-01,29432,2,2,4,1,1,1
2023-06-01,29471,3,0,3,1,0,1
2023-06-01,41319,1,0,1,4,0,4
2023-06-01,39095,6,0,6,3,0,3
2023-06-01,212274,1,0,1,2,0,2
2023-06-01,35414,2,0,2,1,0,1
2023-06-01,49618,1,0,1,1,0,1
2023-06-01,207784,4,0,4,3,0,3
2023-06-01,38960,1,0,1,1,0,1
2023-06-01,203870,1,0,1,1,0,1
2023-06-01,51567,1,1,2,2,2,2
2023-06-01,201016,1,0,1,2,0,2
2023-06-01,29272,1,1,2,2,1,2
2023-06-01,29325,1,0,1,1,0,1
2023-06-01,29331,1,0,1,1,0,1
2023-06-01,43081,1,1,2,3,1,3
2023-06-01,35689,1,0,1,1,0,1
2023-06-01,29374,1,0,1,2,0,2
2023-06-01,29445,1,0,1,2,0,2
2023-06-01,29408,1,0,1,1,0,1
2023-06-01,203783,1,0,1,1,0,1
2023-06-01,29450,1,0,1,3,0,3
2023-06-01,31044,1,0,1,1,0,1
2023-06-01,197751,1,0,1,1,0,1
2023-06-01,34420,2,1,3,1,1,1
2023-06-01,29501,1,0,1,3,0,3
2023-06-01,29475,1,0,1,1,0,1
2023-06-01,43321,1,0,1,2,0,2
2023-06-01,197760,1,0,1,3,0,3
2023-06-01,29560,8,4,12,1,3,3
2023-06-01,206687,1,0,1,3,0,3
2023-06-01,203890,1,0,1,1,0,1
2023-06-01,212410,1,0,1,2,0,2
2023-06-01,210914,1,0,1,1,0,1
2023-06-01,204910,1,0,1,2,0,2
2023-06-01,199537,1,0,1,2,0,2
2023-06-01,200830,1,0,1,2,0,2
2023-06-01,35509,2,0,2,1,0,1
2023-06-01,45030,1,0,1,1,0,1
2023-06-01,44780,1,0,1,1,0,1
2023-06-01,47229,1,0,1,2,0,2
2023-06-01,50156,2,1,3,6,3,6
2023-06-01,35627,1,1,2,1,1,1
2023-06-01,35636,1,0,1,1,0,1
2023-06-01,49225,1,1,2,1,1,1
2023-06-01,35663,1,1,2,1,1,1
2023-06-01,34118,2,0,2,2,0,2
2023-06-01,49480,1,0,1,1,0,1
2023-06-01,43381,1,0,1,1,0,1
2023-06-01,34311,5,0,5,2,0,2
2023-06-01,199922,1,0,1,2,0,2
2023-06-01,57222,1,0,1,1,0,1
2023-06-01,207496,2,0,2,4,0,4
2023-06-01,48499,2,0,2,3,0,3
2023-06-01,48502,3,0,3,3,0,3
2023-06-01,48508,3,0,3,3,0,3
2023-06-01,51738,1,0,1,2,0,2
2023-06-01,197466,1,0,1,1,0,1
2023-06-01,197310,1,0,1,1,0,1
2023-06-01,18900,1,0,1,2,0,2
2023-06-01,8568,12,0,12,1,0,1
2023-06-01,206838,2,1,3,3,1,3
2023-06-01,49659,1,0,1,3,0,3
2023-06-01,209251,1,0,1,1,0,1
2023-06-01,209250,1,0,1,1,0,1
2023-06-01,59824,1,1,2,1,1,1
2023-06-01,39809,1,0,1,2,0,2
2023-06-01,39833,1,0,1,1,0,1
2023-06-01,35740,1,0,1,1,0,1
2023-06-01,50921,1,0,1,1,0,1
2023-06-01,212545,1,0,1,2,0,2
2023-06-01,39865,1,0,1,1,0,1
2023-06-01,39872,1,0,1,2,0,2
2023-06-01,196852,1,0,1,2,0,2
2023-06-01,39883,1,0,1,2,0,2
2023-06-01,41699,1,0,1,3,0,3
2023-06-01,41036,1,0,1,1,0,1
2023-06-01,39656,1,0,1,2,0,2
2023-06-01,39897,1,0,1,2,0,2
2023-06-01,202292,2,1,3,1,1,1
2023-06-01,29559,1,0,1,2,0,2
2023-06-01,212818,1,0,1,1,0,1
2023-06-01,34114,1,0,1,1,0,1
2023-06-01,31023,1,0,1,1,0,1
2023-06-01,29634,1,0,1,1,0,1
2023-06-01,44757,1,0,1,5,0,5
2023-06-01,29683,2,1,3,4,2,4
2023-06-01,30735,1,0,1,2,0,2
2023-06-01,49916,1,0,1,2,0,2
2023-06-01,49995,1,0,1,2,0,2
2023-06-01,50052,1,0,1,1,0,1
2023-06-01,39373,1,0,1,3,0,3
2023-06-01,210289,1,0,1,1,0,1
2023-06-01,44388,1,0,1,2,0,2
2023-06-01,57938,1,0,1,1,0,1
2023-06-01,39415,1,0,1,1,0,1
2023-06-01,199409,1,0,1,2,0,2
2023-06-01,39387,1,1,2,2,2,2
2023-06-01,41650,2,0,2,2,0,2
2023-06-01,3319,2,0,2,1,0,1
2023-06-01,209845,2,0,2,1,0,1
2023-06-01,6807,2,1,3,3,2,3
2023-06-01,208643,1,0,1,1,0,1
2023-06-01,213129,1,0,1,1,0,1
2023-06-01,212793,1,7,8,8,7,10
2023-06-01,59412,1,0,1,3,0,3
2023-06-01,2863,1,1,2,2,1,2
2023-06-01,60951,1,0,1,3,0,3
2023-06-01,39171,1,0,1,2,0,2
2023-06-01,39170,1,0,1,2,0,2
2023-06-01,39166,1,0,1,2,0,2
2023-06-01,39162,1,0,1,2,0,2
2023-06-01,47432,1,0,1,1,0,1
2023-06-01,58288,1,0,1,3,0,3
2023-06-01,39198,1,0,1,5,0,5
2023-06-01,207777,4,1,5,1,1,1
2023-06-01,24772,1,0,1,2,0,2
2023-06-01,196848,1,0,1,1,0,1
2023-06-01,47301,1,0,1,4,0,4
2023-06-01,47290,1,0,1,1,0,1
2023-06-01,47249,1,0,1,3,0,3
2023-06-01,47305,1,0,1,4,0,4
2023-06-01,51021,1,0,1,1,0,1
2023-06-01,47928,1,0,1,3,0,3
2023-06-01,196622,1,0,1,3,0,3
2023-06-01,47284,1,0,1,1,0,1
2023-06-01,198822,1,0,1,1,0,1
2023-06-01,47336,1,0,1,2,0,2
2023-06-01,47306,1,0,1,2,0,2
2023-06-01,29306,1,0,1,1,0,1
2023-06-01,49486,2,0,2,3,0,3
2023-06-01,210244,2,0,2,1,0,1
2023-06-01,200900,1,0,1,1,0,1
2023-06-01,201306,1,0,1,1,0,1
2023-06-01,44117,2,0,2,1,0,1
2023-06-01,201426,1,0,1,1,0,1
2023-06-01,209010,1,0,1,1,0,1
2023-06-01,44235,3,0,3,1,0,1
2023-06-01,197543,1,0,1,2,0,2
2023-06-01,44183,1,0,1,2,0,2
2023-06-01,44207,1,0,1,1,0,1
2023-06-01,204388,1,1,2,3,1,3
2023-06-01,213088,1,0,1,2,0,2
2023-06-01,206802,1,0,1,1,0,1
2023-06-01,212837,1,0,1,2,0,2
2023-06-01,34826,2,0,2,2,0,2
2023-06-01,21324,1,0,1,1,0,1
2023-06-01,49035,2,0,2,4,0,4
2023-06-01,39889,2,0,2,1,0,1
2023-06-01,41056,1,0,1,1,0,1
2023-06-01,40990,1,0,1,1,0,1
2023-06-01,202300,1,0,1,2,0,2
2023-06-01,41085,4,0,4,2,0,2
2023-06-01,39624,1,0,1,1,0,1
2023-06-01,200987,1,0,1,1,0,1
2023-06-01,50180,1,1,2,1,1,1
2023-06-01,40982,1,0,1,1,0,1
2023-06-01,207906,4,1,5,2,1,2
2023-06-01,39903,1,0,1,1,0,1
2023-06-01,39908,1,0,1,1,0,1
2023-06-01,39916,3,0,3,2,0,2
2023-06-01,15978,1,0,1,1,0,1
2023-06-01,205347,2,0,2,2,0,2
2023-06-01,41347,1,0,1,1,0,1
2023-06-01,206726,1,0,1,1,0,1
2023-06-01,42524,1,0,1,3,0,3
2023-06-01,41027,2,0,2,2,0,2
2023-06-01,41014,1,0,1,1,0,1
2023-06-01,41654,3,0,3,1,0,1
2023-06-01,211477,1,0,1,1,0,1
2023-06-01,47612,1,0,1,1,0,1
2023-06-01,60454,1,1,2,2,2,2
2023-06-01,41788,1,0,1,2,0,2
2023-06-01,47107,1,0,1,3,0,3
2023-06-01,208945,1,0,1,3,0,3
2023-06-01,47183,1,0,1,1,0,1
2023-06-01,47130,1,0,1,1,0,1
2023-06-01,47120,1,0,1,2,0,2
2023-06-01,47387,1,0,1,1,0,1
2023-06-01,47401,1,0,1,2,0,2
2023-06-01,47715,1,0,1,1,0,1
2023-06-01,8499,33,1,34,3,1,3
2023-06-01,25352,1,0,1,1,0,1
2023-06-01,8727,1,0,1,2,0,2
2023-06-01,25365,1,1,2,1,1,1
2023-06-01,25286,1,1,2,1,1,1
2023-06-01,25419,1,1,2,2,1,2
2023-06-01,21147,1,0,1,2,0,2
2023-06-01,13298,1,0,1,1,0,1
2023-06-01,196870,1,1,2,2,2,2
2023-06-01,207608,2,1,3,1,1,1
2023-06-01,50317,1,1,2,1,1,1
2023-06-01,50341,1,0,1,3,0,3
2023-06-01,50325,2,0,2,3,0,3
2023-06-01,12665,3,0,3,3,0,3
2023-06-01,50347,1,1,2,1,1,1
2023-06-01,50379,1,0,1,2,0,2
2023-06-01,50444,1,0,1,1,0,1
2023-06-01,50403,1,0,1,3,0,3
2023-06-01,50445,2,0,2,3,0,3
2023-06-01,51367,3,0,3,2,0,2
2023-06-01,50460,3,0,3,1,0,1
2023-06-01,50464,1,0,1,1,0,1
2023-06-01,205365,1,4,5,1,3,3
2023-06-01,43731,2,0,2,2,0,2
2023-06-01,50506,1,0,1,1,0,1
2023-06-01,50496,3,0,3,3,0,3
2023-06-01,50487,3,0,3,3,0,3
2023-06-01,198206,3,0,3,3,0,3
2023-06-01,50351,2,0,2,2,0,2
2023-06-01,30840,1,0,1,1,0,1
2023-06-01,50603,1,0,1,1,0,1
2023-06-01,196924,2,0,2,5,0,5
2023-06-01,50536,1,0,1,3,0,3
2023-06-01,50545,1,0,1,1,0,1
2023-06-01,3185,1,0,1,4,0,4
2023-06-01,50570,3,0,3,4,0,4
2023-06-01,50623,2,0,2,1,0,1
2023-06-01,50632,1,0,1,1,0,1
2023-06-01,196934,2,0,2,1,0,1
2023-06-01,50688,1,0,1,4,0,4
2023-06-01,50635,5,0,5,2,0,2
2023-06-01,212395,3,0,3,2,0,2
2023-06-01,50643,1,0,1,1,0,1
2023-06-01,50695,2,1,3,4,4,5
2023-06-01,50775,2,0,2,6,0,6
2023-06-01,50697,2,0,2,1,0,1
2023-06-01,50696,2,0,2,1,0,1
2023-06-01,50689,2,0,2,3,0,3
2023-06-01,196636,1,0,1,3,0,3
2023-06-01,50728,1,0,1,2,0,2
2023-06-01,198402,1,0,1,1,0,1
2023-06-01,41894,2,0,2,2,0,2
2023-06-01,62354,1,0,1,1,0,1
2023-06-01,34396,1,0,1,1,0,1
2023-06-01,41380,1,0,1,1,0,1
2023-06-01,198572,1,0,1,1,0,1
2023-06-01,44721,1,0,1,2,0,2
2023-06-01,42817,1,0,1,1,0,1
2023-06-01,41394,1,0,1,2,0,2
2023-06-01,42356,1,0,1,1,0,1
2023-06-01,197231,1,0,1,3,0,3
2023-06-01,41945,1,0,1,1,0,1
2023-06-01,199780,1,0,1,1,0,1
2023-06-01,41417,1,0,1,1,0,1
2023-06-01,213295,1,0,1,3,0,3
2023-06-01,50211,1,0,1,1,0,1
2023-06-01,43227,1,0,1,2,0,2
2023-06-01,51229,1,0,1,1,0,1
2023-06-01,12803,2,0,2,2,0,2
2023-06-01,58180,1,0,1,2,0,2
2023-06-01,42092,1,0,1,2,0,2
2023-06-01,8669,4,0,4,2,0,2
2023-06-01,197040,2,0,2,2,0,2
2023-06-01,213381,1,1,2,3,1,3
2023-06-01,207692,3,0,3,2,0,2
2023-06-01,207901,2,1,3,5,2,5
2023-06-01,50996,3,0,3,2,0,2
2023-06-01,59906,1,0,1,2,0,2
2023-06-01,57038,1,0,1,1,0,1
2023-06-01,57139,2,0,2,1,0,1
2023-06-01,57296,1,0,1,2,0,2
2023-06-01,16249,1,0,1,1,0,1
2023-06-01,62272,1,0,1,2,0,2
2023-06-01,209415,1,0,1,2,0,2
2023-06-01,8742,1,1,2,3,3,3
2023-06-01,203832,1,0,1,2,0,2
2023-06-01,56939,1,0,1,3,0,3
2023-06-01,56881,1,1,2,3,1,3
2023-06-01,197896,3,0,3,3,0,3
2023-06-01,56952,1,0,1,2,0,2
2023-06-01,25449,1,0,1,2,0,2
2023-06-01,5480,8,0,8,1,0,1
2023-06-01,203803,1,0,1,1,0,1
2023-06-01,6870,1,0,1,1,0,1
2023-06-01,60375,1,0,1,2,0,2
2023-06-01,62128,1,0,1,2,0,2
2023-06-01,39034,1,0,1,2,0,2
2023-06-01,52007,2,0,2,3,0,3
2023-06-01,56374,1,0,1,2,0,2
2023-06-01,57503,2,2,4,7,2,7
2023-06-01,56336,1,0,1,1,0,1
2023-06-01,200575,1,0,1,1,0,1
2023-06-01,201669,1,0,1,3,0,3
2023-06-01,21292,2,0,2,1,0,1
2023-06-01,204237,1,0,1,2,0,2
2023-06-01,204219,1,0,1,3,0,3
2023-06-01,201914,1,0,1,1,0,1
2023-06-01,199521,1,0,1,3,0,3
2023-06-01,61187,1,0,1,2,0,2
2023-06-01,34155,1,0,1,1,0,1
2023-06-01,200452,1,0,1,2,0,2
2023-06-01,199394,1,0,1,2,0,2
2023-06-01,24797,1,0,1,1,0,1
2023-06-01,51111,1,0,1,1,0,1
2023-06-01,51000,1,0,1,3,0,3
2023-06-01,197062,1,0,1,4,0,4
2023-06-01,207088,4,0,4,1,0,1
2023-06-01,49753,1,0,1,1,0,1
2023-06-01,49762,1,2,3,1,1,1
2023-06-01,30738,1,1,2,1,1,1
2023-06-01,49878,1,0,1,1,0,1
2023-06-01,13161,1,0,1,1,0,1
2023-06-01,48533,4,0,4,1,0,1
2023-06-01,34832,7,0,7,4,0,4
2023-06-01,49969,1,0,1,1,0,1
2023-06-01,207875,2,0,2,1,0,1
2023-06-01,50969,1,0,1,2,0,2
2023-06-01,49977,1,0,1,1,0,1
2023-06-01,50074,1,0,1,1,0,1
2023-06-01,31149,1,1,2,1,1,1
2023-06-01,50105,4,0,4,3,0,3
2023-06-01,50098,4,0,4,1,0,1
2023-06-01,49932,1,0,1,2,0,2
2023-06-01,200006,1,0,1,2,0,2
2023-06-01,57886,1,0,1,1,0,1
2023-06-01,8856,26,0,26,5,0,5
2023-06-01,43621,1,0,1,3,0,3
2023-06-01,59623,1,0,1,1,0,1
2023-06-01,44526,2,0,2,3,0,3
2023-06-01,207313,1,0,1,1,0,1
2023-06-01,25057,1,3,4,2,2,2
2023-06-01,56629,1,0,1,1,0,1
2023-06-01,44544,2,0,2,1,0,1
2023-06-01,47167,1,1,2,1,1,1
2023-06-01,47170,1,0,1,3,0,3
2023-06-01,47174,1,0,1,2,0,2
2023-06-01,47186,1,0,1,3,0,3
2023-06-01,47190,1,0,1,1,0,1
2023-06-01,47230,1,0,1,3,0,3
2023-06-01,47278,1,0,1,2,0,2
2023-06-01,210882,1,1,2,1,1,1
2023-06-01,47396,1,0,1,1,0,1
2023-06-01,197843,1,0,1,3,0,3
2023-06-01,43123,1,0,1,1,0,1
2023-06-01,8297,1,1,2,1,1,1
2023-06-01,201582,3,0,3,3,0,3
2023-06-01,41481,1,0,1,2,0,2
2023-06-01,35024,1,0,1,1,0,1
2023-06-01,35034,2,0,2,1,0,1
2023-06-01,197864,1,0,1,2,0,2
2023-06-01,62037,1,0,1,2,0,2
2023-06-01,35123,1,0,1,2,0,2
2023-06-01,35257,1,0,1,1,0,1
2023-06-01,29018,1,2,3,3,1,3
2023-06-01,31481,1,0,1,3,0,3
2023-06-01,202277,1,0,1,1,0,1
2023-06-01,210877,1,0,1,1,0,1
2023-06-01,209339,1,0,1,1,0,1
2023-06-01,21115,1,0,1,2,0,2
2023-06-01,200112,1,0,1,1,0,1
2023-06-01,212055,1,0,1,2,0,2
2023-06-01,204452,1,0,1,1,0,1
2023-06-01,50878,1,0,1,2,0,2
2023-06-01,51363,1,0,1,1,0,1
2023-06-01,51348,1,0,1,2,0,2
2023-06-01,41879,1,0,1,2,0,2
2023-06-01,201775,1,0,1,2,0,2
2023-06-01,51322,1,0,1,1,0,1
2023-06-01,197192,1,0,1,1,0,1
2023-06-01,51325,1,0,1,3,0,3
2023-06-01,42609,1,0,1,1,0,1
2023-06-01,207327,1,0,1,3,0,3
2023-06-01,51361,1,0,1,2,0,2
2023-06-01,209455,1,0,1,3,0,3
2023-06-01,200940,5,0,5,1,0,1
2023-06-01,198021,1,0,1,1,0,1
2023-06-01,44900,1,0,1,2,0,2
2023-06-01,41372,1,0,1,1,0,1
2023-06-01,44991,1,0,1,3,0,3
2023-06-01,44917,1,0,1,2,0,2
2023-06-01,44950,1,0,1,2,0,2
2023-06-01,45002,1,0,1,2,0,2
2023-06-01,16213,1,0,1,1,0,1
2023-06-01,210987,1,0,1,2,0,2
2023-06-01,205364,1,0,1,1,0,1
2023-06-01,8244,2,0,2,1,0,1
2023-06-01,202242,6,0,6,1,0,1
2023-06-01,50037,1,0,1,2,0,2
2023-06-01,51734,1,0,1,1,0,1
2023-06-01,202386,1,0,1,3,0,3
2023-06-01,31215,1,0,1,1,0,1
2023-06-01,25326,1,0,1,1,0,1
2023-06-01,39035,1,0,1,1,0,1
2023-06-01,41526,1,0,1,1,0,1
2023-06-01,35698,1,0,1,1,0,1
2023-06-01,38993,1,0,1,1,0,1
2023-06-01,210367,1,1,2,1,1,1
2023-06-01,57620,4,0,4,1,0,1
2023-06-01,35726,1,0,1,1,0,1
2023-06-01,20935,1,0,1,1,0,1
2023-06-01,29117,1,1,2,2,3,3
2023-06-01,33999,2,1,3,4,1,4
2023-06-01,29213,3,0,3,3,0,3
2023-06-01,34136,2,0,2,1,0,1
2023-06-01,328619,4,0,4,1,0,1
2023-06-01,25253,1,0,1,2,0,2
2023-06-01,25020,1,0,1,2,0,2
2023-06-01,199132,1,0,1,2,0,2
2023-06-01,16182,1,0,1,1,0,1
2023-06-01,25241,1,0,1,1,0,1
2023-06-01,25268,1,0,1,3,0,3
2023-06-01,15398,1,1,2,2,4,4
2023-06-01,13278,1,0,1,1,0,1
2023-06-01,25297,1,0,1,2,0,2
2023-06-01,207774,4,0,4,1,0,1
2023-06-01,25315,1,0,1,2,0,2
2023-06-01,25342,1,0,1,2,0,2
2023-06-01,31354,1,0,1,1,0,1
2023-06-01,25344,1,0,1,1,0,1
2023-06-01,20872,1,0,1,2,0,2
2023-06-01,212847,1,0,1,1,0,1
2023-06-01,25203,1,0,1,1,0,1
2023-06-01,25238,2,1,3,3,2,3
2023-06-01,25275,1,0,1,1,0,1
2023-06-01,25300,2,0,2,2,0,2
2023-06-01,13236,5,0,5,2,0,2
2023-06-01,12789,16,0,16,6,0,6
2023-06-01,29137,2,0,2,1,0,1
2023-06-01,202997,13,0,13,3,0,3
2023-06-01,204654,1,0,1,1,0,1
2023-06-01,50447,1,0,1,2,0,2
2023-06-01,39260,3,0,3,2,0,2
2023-06-01,39276,2,0,2,2,0,2
2023-06-01,41166,1,0,1,1,0,1
2023-06-01,34637,1,0,1,1,0,1
2023-06-01,34910,1,0,1,1,0,1
2023-06-01,34675,1,0,1,1,0,1
2023-06-01,34730,1,0,1,1,0,1
2023-06-01,1032,2,0,2,1,0,1
2023-06-01,34838,2,0,2,2,0,2
2023-06-01,199316,1,0,1,1,0,1
2023-06-01,4292608010,0,0,0,2,0,2
2023-06-01,4292608018,1,0,1,1,0,1
2023-06-01,47783,1,0,1,2,0,2
2023-06-01,34247,1,0,1,1,0,1
2023-06-01,34258,3,0,3,3,0,3
2023-06-01,34344,3,0,3,1,0,1
2023-06-01,34301,1,0,1,3,0,3
2023-06-01,210336,3,0,3,2,0,2
2023-06-01,34324,1,0,1,3,0,3
2023-06-01,34321,2,0,2,1,0,1
2023-06-01,34046,2,0,2,1,0,1
2023-06-01,34355,1,0,1,1,0,1
2023-06-01,41799,3,0,3,3,0,3
2023-06-01,42151,1,0,1,3,0,3
2023-06-01,42068,3,0,3,3,0,3
2023-06-01,44980,2,0,2,4,0,4
2023-06-01,47461,1,0,1,2,0,2
2023-06-01,47472,1,0,1,3,0,3
2023-06-01,56572,2,0,2,1,0,1
2023-06-01,21495,1,0,1,1,0,1
2023-06-01,47483,1,0,1,2,0,2
2023-06-01,47476,1,0,1,3,0,3
2023-06-01,201685,1,0,1,2,0,2
2023-06-01,39546,1,0,1,1,0,1
2023-06-01,24833,1,1,2,2,2,2
2023-06-01,212062,1,0,1,2,0,2
2023-06-01,47566,1,0,1,1,0,1
2023-06-01,39592,1,0,1,1,0,1
2023-06-01,63140,1,0,1,2,0,2
2023-06-01,200444,1,0,1,1,0,1
2023-06-01,205069,1,0,1,1,0,1
2023-06-01,210213,3,1,4,1,1,1
2023-06-01,24972,1,0,1,1,0,1
2023-06-01,62220,1,0,1,1,0,1
2023-06-01,206600,2,0,2,2,0,2
2023-06-01,15383,3,0,3,3,0,3
2023-06-01,34015,1,1,2,2,2,2
2023-06-01,206236,1,1,2,1,1,1
2023-06-01,206222,1,2,3,1,1,1
2023-06-01,33990,1,0,1,2,0,2
2023-06-01,47796,1,0,1,1,0,1
2023-06-01,50114,1,0,1,1,0,1
2023-06-01,210051,1,2,3,1,1,1
2023-06-01,30864,1,0,1,1,0,1
2023-06-01,29429,1,0,1,2,0,2
2023-06-01,34367,1,0,1,3,0,3
2023-06-01,206867,2,0,2,1,0,1
2023-06-01,13134,1,0,1,1,0,1
2023-06-01,211742,1,1,2,1,1,1
2023-06-01,5548,1,0,1,2,0,2
2023-06-01,25499,1,0,1,1,0,1
2023-06-01,28892,1,1,2,4,4,5
2023-06-01,48975,1,0,1,2,0,2
2023-06-01,59942,1,0,1,1,0,1
2023-06-01,25541,1,0,1,3,0,3
2023-06-01,25523,1,0,1,2,0,2
2023-06-01,51350,1,1,2,2,3,3
2023-06-01,21288,1,0,1,2,0,2
2023-06-01,25566,1,0,1,1,0,1
2023-06-01,28741,1,0,1,1,0,1
2023-06-01,28672,1,0,1,2,0,2
2023-06-01,205934,1,1,2,1,2,3
2023-06-01,47121,1,1,2,5,4,5
2023-06-01,50619,1,0,1,2,0,2
2023-06-01,29015,1,0,1,2,0,2
2023-06-01,28724,1,0,1,2,0,2
2023-06-01,28766,1,0,1,1,0,1
2023-06-01,47137,1,1,2,2,1,2
2023-06-01,41739,1,0,1,1,0,1
2023-06-01,47166,1,0,1,1,0,1
2023-06-01,48389,1,0,1,3,0,3
2023-06-01,47532,2,0,2,1,0,1
2023-06-01,197171,1,0,1,1,0,1
2023-06-01,15714,4,0,4,1,0,1
2023-06-01,205804,4,3,7,1,1,1
2023-06-01,15607,2,0,2,3,0,3
2023-06-01,41647,1,0,1,3,0,3
2023-06-01,41649,1,0,1,1,0,1
2023-06-01,51293,1,0,1,1,0,1
2023-06-01,15746,1,0,1,1,0,1
2023-06-01,6851,1,0,1,1,0,1
2023-06-01,39610,3,0,3,1,0,1
2023-06-01,44003,3,0,3,2,0,2
2023-06-01,39635,3,0,3,2,0,2
2023-06-01,196651,2,0,2,3,0,3
2023-06-01,39646,1,0,1,1,0,1
2023-06-01,207753,2,0,2,2,0,2
2023-06-01,33867,1,0,1,2,0,2
2023-06-01,41210,1,0,1,2,0,2
2023-06-01,47369,1,0,1,1,0,1
2023-06-01,41182,1,0,1,2,0,2
2023-06-01,41226,1,0,1,2,0,2
2023-06-01,41188,1,0,1,3,0,3
2023-06-01,209590,1,0,1,1,0,1
2023-06-01,59938,1,0,1,1,0,1
2023-06-01,41214,1,0,1,1,0,1
2023-06-01,41260,1,0,1,3,0,3
2023-06-01,48788,1,0,1,1,0,1
2023-06-01,41251,1,0,1,2,0,2
2023-06-01,42648,1,0,1,2,0,2
2023-06-01,42640,2,0,2,3,0,3
2023-06-01,42677,1,0,1,1,0,1
2023-06-01,42698,1,0,1,1,0,1
2023-06-01,39274,1,0,1,1,0,1
2023-06-01,39262,1,0,1,1,0,1
2023-06-01,39261,1,0,1,3,0,3
2023-06-01,202962,1,0,1,2,0,2
2023-06-01,42027,1,0,1,2,0,2
2023-06-01,29342,1,0,1,2,0,2
2023-06-01,59602,1,0,1,1,0,1
2023-06-01,39296,1,0,1,3,0,3
2023-06-01,39350,1,0,1,4,0,4
2023-06-01,39320,1,0,1,2,0,2
2023-06-01,16199,1,0,1,2,0,2
2023-06-01,39329,1,0,1,2,0,2
2023-06-01,8534,4,0,4,3,0,3
2023-06-01,211884,1,0,1,1,0,1
2023-06-01,201374,1,0,1,1,0,1
2023-06-01,5489,3,0,3,1,0,1
2023-06-01,8617,4,0,4,1,0,1
2023-06-01,31563,3,2,5,1,1,1
2023-06-01,393296,1,0,1,1,0,1
2023-06-01,49652,1,0,1,1,0,1
2023-06-01,39385,1,0,1,2,0,2
2023-06-01,207500,2,0,2,3,0,3
2023-06-01,34068,1,0,1,3,0,3
2023-06-01,209647,1,0,1,3,0,3
2023-06-01,38989,3,0,3,2,0,2
2023-06-01,51038,2,0,2,1,0,1
2023-06-01,51029,1,0,1,2,0,2
2023-06-01,51073,1,0,1,1,0,1
2023-06-01,56753,1,0,1,1,0,1
2023-06-01,198467,1,0,1,3,0,3
2023-06-01,197085,1,0,1,2,0,2
2023-06-01,37708,4,2,6,4,2,4
2023-06-01,36948,3,1,4,3,3,3
2023-06-01,36936,1,1,2,2,1,2
2023-06-01,23021,1,0,1,1,0,1
2023-06-01,55433,2,0,2,3,0,3
2023-06-01,327977,3,0,3,2,0,2
2023-06-01,37247,1,0,1,1,0,1
2023-06-01,37274,1,0,1,2,0,2
2023-06-01,328928,1,0,1,1,0,1
2023-06-01,36929,1,0,1,1,0,1
2023-06-01,3586,12,0,12,1,0,1
2023-06-01,33764,4,4,8,4,3,4
2023-06-01,25429,11,1,12,3,1,3
2023-06-01,37238,1,0,1,1,0,1
2023-06-01,10803,33,0,33,2,0,2
2023-06-01,33777,1,0,1,2,0,2
2023-06-01,27681,2,0,2,1,0,1
2023-06-01,328613,2,0,2,1,0,1
2023-06-01,31960,9,1,10,4,1,4
2023-06-01,327935,14,0,14,4,0,4
2023-06-01,11157,1,0,1,1,0,1
2023-06-01,37441,1,0,1,1,0,1
2023-06-01,22306,8,0,8,2,0,2
2023-06-01,11744,4,0,4,5,0,5
2023-06-01,327863,1,0,1,1,0,1
2023-06-01,327701,2,0,2,1,0,1
2023-06-01,327749,3,0,3,2,0,2
2023-06-01,23058,7,0,7,9,0,9
2023-06-01,37583,2,0,2,2,0,2
2023-06-01,37555,3,0,3,2,0,2
2023-06-01,37588,5,0,5,5,0,5
2023-06-01,37591,5,0,5,2,0,2
2023-06-01,37579,2,0,2,2,0,2
2023-06-01,37587,3,0,3,3,0,3
2023-06-01,37601,1,0,1,2,0,2
2023-06-01,327953,1,0,1,2,0,2
2023-06-01,37578,2,3,5,2,2,2
2023-06-01,327949,1,0,1,1,0,1
2023-06-01,328018,1,0,1,1,0,1
2023-06-01,328192,1,0,1,1,0,1
2023-06-01,328135,1,0,1,1,0,1
2023-06-01,37585,1,0,1,1,0,1
2023-06-01,37667,3,0,3,3,0,3
2023-06-01,37590,1,0,1,2,0,2
2023-06-01,64720,0,0,0,4,0,4
2023-06-01,37663,1,1,2,2,2,2
2023-06-01,37668,1,1,2,2,1,2
2023-06-01,37664,3,0,3,3,0,3
2023-06-01,37610,1,0,1,1,0,1
2023-06-01,327838,1,0,1,2,0,2
2023-06-01,37683,3,0,3,1,0,1
2023-06-01,33769,2,0,2,1,0,1
2023-06-01,327845,1,0,1,1,0,1
2023-06-01,37679,1,0,1,1,0,1
2023-06-01,37691,6,0,6,3,0,3
2023-06-01,37644,1,0,1,1,0,1
2023-06-01,37298,6,0,6,5,0,5
2023-06-01,327713,0,0,0,2,0,2
2023-06-01,37647,3,0,3,1,0,1
2023-06-01,37656,1,0,1,1,0,1
2023-06-01,328272,1,0,1,1,0,1
2023-06-01,37660,1,0,1,1,0,1
2023-06-01,327759,1,0,1,1,0,1
2023-06-01,37505,2,0,2,1,0,1
2023-06-01,37657,1,0,1,1,0,1
2023-06-01,37036,2,0,2,3,0,3
2023-06-01,327748,2,0,2,3,0,3
2023-06-01,327848,1,0,1,1,0,1
2023-06-01,327729,1,0,1,2,0,2
2023-06-01,327730,1,0,1,1,0,1
2023-06-01,37513,8,0,8,2,0,2
2023-06-01,21174,1,0,1,1,0,1
2023-06-01,327951,1,0,1,1,0,1
2023-06-01,327912,1,0,1,2,0,2
2023-06-01,327923,2,0,2,5,0,5
2023-06-01,327917,1,1,2,1,1,1
2023-06-01,328273,1,0,1,1,0,1
2023-06-01,328000,1,0,1,1,0,1
2023-06-01,327942,2,0,2,1,0,1
2023-06-01,37222,2,0,2,2,0,2
2023-06-01,327766,1,0,1,2,0,2
2023-06-01,328102,1,0,1,1,0,1
2023-06-01,327853,1,0,1,1,0,1
2023-06-01,328651,1,0,1,1,0,1
2023-06-01,37630,4,0,4,2,0,2
2023-06-01,327774,1,0,1,1,0,1
2023-06-01,327753,2,0,2,2,0,2
2023-06-01,327787,1,0,1,2,0,2
2023-06-01,327793,1,0,1,2,0,2
2023-06-01,327928,1,0,1,1,0,1
2023-06-01,327939,1,0,1,4,0,4
2023-06-01,327778,1,0,1,1,0,1
2023-06-01,37476,1,0,1,1,0,1
2023-06-01,327801,1,0,1,1,0,1
2023-06-01,327884,1,0,1,1,0,1
2023-06-01,327734,1,0,1,1,0,1
2023-06-01,327843,1,0,1,1,0,1
2023-06-01,327918,1,0,1,1,0,1
2023-06-01,328183,1,0,1,1,0,1
2023-06-01,327944,1,0,1,2,0,2
2023-06-01,327927,1,0,1,3,0,3
2023-06-01,37428,1,0,1,1,0,1
2023-06-01,37438,6,0,6,1,0,1
2023-06-01,38538,2,1,3,1,1,1
2023-06-01,36870,4,0,4,3,0,3
2023-06-01,37129,6,0,6,3,0,3
2023-06-01,36975,3,0,3,3,0,3
2023-06-01,37565,4,0,4,1,0,1
2023-06-01,6968,4,3,7,5,3,5
2023-06-01,11947,4,0,4,1,0,1
2023-06-01,33788,7,0,7,2,0,2
2023-06-01,22386,2,0,2,3,0,3
2023-06-01,327989,3,0,3,1,0,1
2023-06-01,37210,2,0,2,2,0,2
2023-06-01,37402,2,0,2,2,0,2
2023-06-01,37266,24,1,25,4,2,4
2023-06-01,37364,1,1,2,3,2,3
2023-06-01,37570,4,0,4,2,0,2
2023-06-01,327961,1,0,1,3,0,3
2023-06-01,327994,1,0,1,3,0,3
2023-06-01,328006,1,0,1,1,0,1
2023-06-01,328105,1,0,1,1,0,1
2023-06-01,328007,1,0,1,1,0,1
2023-06-01,327974,3,0,3,1,0,1
2023-06-01,328017,1,1,2,1,1,1
2023-06-01,328907,1,0,1,2,0,2
2023-06-01,328027,1,0,1,2,0,2
2023-06-01,328030,1,1,2,1,1,1
2023-06-01,328052,1,0,1,1,0,1
2023-06-01,328053,1,0,1,1,0,1
2023-06-01,328545,1,0,1,1,0,1
2023-06-01,328087,1,0,1,1,0,1
2023-06-01,328090,1,0,1,1,0,1
2023-06-01,328080,1,0,1,1,0,1
2023-06-01,36891,24,11,35,5,4,5
2023-06-01,37261,2,0,2,3,0,3
2023-06-01,327695,1,0,1,1,0,1
2023-06-01,37267,1,0,1,3,0,3
2023-06-01,37344,1,0,1,1,0,1
2023-06-01,37279,1,0,1,3,0,3
2023-06-01,37307,1,0,1,1,0,1
2023-06-01,37304,2,2,4,3,1,3
2023-06-01,37312,1,0,1,1,0,1
2023-06-01,37318,1,0,1,2,0,2
2023-06-01,37319,1,0,1,1,0,1
2023-06-01,37354,4,1,5,1,1,1
2023-06-01,37327,1,0,1,2,0,2
2023-06-01,37328,1,0,1,2,0,2
2023-06-01,37338,1,0,1,2,0,2
2023-06-01,37339,1,0,1,3,0,3
2023-06-01,37346,1,0,1,2,0,2
2023-06-01,37362,1,0,1,1,0,1
2023-06-01,37366,1,0,1,3,0,3
2023-06-01,37392,1,0,1,1,0,1
2023-06-01,37418,1,0,1,1,0,1
2023-06-01,37419,1,2,3,2,1,2
2023-06-01,37426,1,0,1,3,0,3
2023-06-01,327763,1,0,1,1,0,1
2023-06-01,37444,1,0,1,3,0,3
2023-06-01,37470,1,0,1,1,0,1
2023-06-01,37548,1,0,1,2,0,2
2023-06-01,37477,1,0,1,1,0,1
2023-06-01,37490,1,0,1,1,0,1
2023-06-01,37499,1,0,1,3,0,3
2023-06-01,328245,1,1,2,1,1,1
2023-06-01,36904,1,0,1,3,0,3
2023-06-01,37522,1,0,1,3,0,3
2023-06-01,327869,1,0,1,1,0,1
2023-06-01,327851,1,0,1,1,0,1
2023-06-01,37170,3,1,4,1,1,1
2023-06-01,32717,14,0,14,1,0,1
2023-06-01,328606,1,0,1,2,0,2
2023-06-01,37244,1,0,1,1,0,1
2023-06-01,37144,1,0,1,3,0,3
2023-06-01,37147,1,0,1,2,0,2
2023-06-01,37180,2,0,2,2,0,2
2023-06-01,37207,1,0,1,3,0,3
2023-06-01,37201,1,0,1,1,0,1
2023-06-01,32842,3,0,3,1,0,1
2023-06-01,7420,10,0,10,3,0,3
2023-06-01,36946,1,0,1,1,0,1
2023-06-01,327844,1,1,2,2,1,2
2023-06-01,327775,1,1,2,1,1,1
2023-06-01,328014,1,0,1,1,0,1
2023-06-01,327818,1,0,1,1,0,1
2023-06-01,327821,1,0,1,2,0,2
2023-06-01,327831,1,1,2,2,1,2
2023-06-01,328998,2,0,2,1,0,1
2023-06-01,37715,1,0,1,1,0,1
2023-06-01,328022,0,0,0,2,0,2
2023-06-01,37769,1,0,1,1,0,1
2023-06-01,328091,1,0,1,1,0,1
2023-06-01,328147,1,0,1,1,0,1
2023-06-01,328235,1,0,1,2,0,2
2023-06-01,328325,1,1,2,1,1,1
2023-06-01,328326,1,1,2,1,1,1
2023-06-01,328329,1,0,1,2,0,2
2023-06-01,328398,1,0,1,1,0,1
2023-06-01,328452,1,0,1,1,0,1
2023-06-01,328913,1,1,2,1,1,2
2023-06-01,329105,1,0,1,1,0,1
2023-06-01,329158,1,1,2,1,1,1
2023-06-01,329173,1,0,1,1,0,1
2023-06-01,329234,1,1,2,1,1,1
2023-06-01,328374,1,1,2,1,1,1
2023-06-01,328139,1,0,1,1,0,1
2023-06-01,328149,1,0,1,1,0,1
2023-06-01,328124,1,0,1,1,0,1
2023-06-01,400463,2,0,2,1,0,1
2023-06-01,328075,8,0,8,3,0,3
2023-06-01,1000,1,0,1,1,0,1
2023-06-01,328089,2,0,2,3,0,3
2023-06-01,328086,2,0,2,2,0,2
2023-06-01,37272,4,0,4,1,0,1
2023-06-01,328081,1,0,1,1,0,1
2023-06-01,328066,8,0,8,3,0,3
2023-06-01,328623,2,0,2,2,0,2
2023-06-01,327988,6,1,7,4,1,4
2023-06-01,328001,1,1,2,4,1,4
2023-06-01,37301,1,1,2,1,1,1
2023-06-01,328788,1,0,1,1,0,1
2023-06-01,30987,2,0,2,3,0,3
2023-06-01,327937,2,0,2,1,0,1
2023-06-01,3961,0,0,0,3,0,3
2023-06-01,327965,2,0,2,1,0,1
2023-06-01,33778,7,0,7,2,0,2
2023-06-01,21739,3,1,4,2,2,3
2023-06-01,33782,5,0,5,1,0,1
2023-06-01,37528,1,0,1,1,0,1
2023-06-01,37485,1,0,1,2,0,2
2023-06-01,36886,4,0,4,1,0,1
2023-06-01,36906,3,0,3,1,0,1
2023-06-01,36922,5,0,5,3,0,3
2023-06-01,13854,2,0,2,1,0,1
2023-06-01,37351,3,0,3,4,0,4
2023-06-01,37045,1,1,2,1,1,1
2023-06-01,37051,1,0,1,1,0,1
2023-06-01,37177,1,1,2,2,1,2
2023-06-01,37181,1,1,2,2,1,2
2023-06-01,37160,4,0,4,1,0,1
2023-06-01,37206,2,0,2,1,0,1
2023-06-01,37212,4,0,4,3,0,3
2023-06-01,37399,3,1,4,5,3,5
2023-06-01,37452,4,0,4,5,0,5
2023-06-01,327832,1,0,1,1,0,1
2023-06-01,327846,1,0,1,2,0,2
2023-06-01,327842,1,0,1,1,0,1
2023-06-01,37495,1,1,2,1,1,1
2023-06-01,327919,1,0,1,1,0,1
2023-06-01,327888,2,0,2,1,0,1
2023-06-01,328093,2,0,2,2,0,2
2023-06-01,327971,3,0,3,2,0,2
2023-06-01,37534,2,0,2,2,0,2
2023-06-01,37496,2,1,3,2,1,2
2023-06-01,37348,2,0,2,1,0,1
2023-06-01,328301,1,0,1,2,0,2
2023-06-01,37091,1,0,1,3,0,3
2023-06-01,37085,1,0,1,1,0,1
2023-06-01,37062,3,1,4,3,1,3
2023-06-01,37058,2,0,2,2,0,2
2023-06-01,65550,1,1,2,1,1,2
2023-06-01,37568,4,0,4,2,0,2
2023-06-01,327705,2,1,3,1,1,2
2023-06-01,36893,1,0,1,1,0,1
2023-06-01,37405,2,0,2,1,0,1
2023-06-01,327691,1,0,1,2,0,2
2023-06-01,37252,2,0,2,2,0,2
2023-06-01,327694,1,1,2,3,1,3
2023-06-01,37384,1,0,1,2,0,2
2023-06-01,328665,1,0,1,1,0,1
2023-06-01,328140,6,0,6,1,0,1
2023-06-01,328354,1,0,1,1,0,1
2023-06-01,328074,1,0,1,4,0,4
2023-06-01,328120,3,0,3,1,0,1
2023-06-01,328314,1,0,1,1,0,1
2023-06-01,328103,1,0,1,1,0,1
2023-06-01,328136,17,0,17,1,0,1
2023-06-01,328259,1,1,2,1,1,2
2023-06-01,328173,1,1,2,2,1,2
2023-06-01,328125,1,0,1,3,0,3
2023-06-01,328113,1,0,1,1,0,1
2023-06-01,328201,3,2,5,3,1,3
2023-06-01,328133,2,0,2,1,0,1
2023-06-01,328128,4,0,4,1,0,1
2023-06-01,328207,4,0,4,1,0,1
2023-06-01,37703,2,0,2,1,0,1
2023-06-01,37461,40,1,41,4,1,4
2023-06-01,37524,7,1,8,1,1,1
2023-06-01,37462,5,0,5,2,0,2
2023-06-01,37484,32,0,32,3,0,3
2023-06-01,37357,2,0,2,1,0,1
2023-06-01,37479,7,0,7,4,0,4
2023-06-01,37429,7,0,7,1,0,1
2023-06-01,37433,2,0,2,1,0,1
2023-06-01,37413,1,0,1,1,0,1
2023-06-01,37421,7,0,7,2,0,2
2023-06-01,328191,19,1,20,2,1,2
2023-06-01,37559,2,0,2,1,0,1
2023-06-01,327936,36,2,38,4,1,4
2023-06-01,37580,4,1,5,1,1,1
2023-06-01,37342,485,0,485,6,0,6
2023-06-01,37326,17,0,17,1,0,1
2023-06-01,37341,1,0,1,1,0,1
2023-06-01,37552,4,0,4,2,0,2
2023-06-01,37556,2,0,2,1,0,1
2023-06-01,37569,5,0,5,1,0,1
2023-06-01,37586,5,0,5,1,0,1
2023-06-01,37571,4,0,4,2,0,2
2023-06-01,37537,6,0,6,1,0,1
2023-06-01,37547,1,0,1,1,0,1
2023-06-01,37454,2,1,3,2,1,2
2023-06-01,37313,3,0,3,2,0,2
2023-06-01,37323,2,1,3,1,1,1
2023-06-01,36939,10,0,10,1,0,1
2023-06-01,64652,4,0,4,1,0,1
2023-06-01,37445,2,0,2,1,0,1
2023-06-01,22567,2,0,2,2,0,2
2023-06-01,13456,5,0,5,3,0,3
2023-06-01,53981,1,1,2,2,2,2
2023-06-01,397749,3,0,3,2,0,2
2023-06-01,11784,1,0,1,1,0,1
2023-06-01,11092,1,0,1,1,0,1
2023-06-01,6485,4,0,4,1,0,1
2023-06-01,11165,1,0,1,1,0,1
2023-06-01,14151,1,0,1,2,0,2
2023-06-01,21896,22,0,22,4,0,4
2023-06-01,21099,3,0,3,8,0,8
2023-06-01,36565,2,0,2,2,0,2
2023-06-01,400419,2,0,2,3,0,3
2023-06-01,18819,1,0,1,1,0,1
2023-06-01,11787,6,0,6,2,0,2
2023-06-01,62755,1,1,2,1,1,1
2023-06-01,62756,1,1,2,1,1,1
2023-06-01,397953,1,0,1,1,0,1
2023-06-01,27241,1,0,1,2,0,2
2023-06-01,26109,1,0,1,2,0,2
2023-06-01,32984,2,0,2,5,0,5
2023-06-01,22871,1,0,1,1,0,1
2023-06-01,17195,9,0,9,3,0,3
2023-06-01,393851,2,0,2,3,0,3
2023-06-01,46398,1,0,1,1,0,1
2023-06-01,61452,8,0,8,1,0,1
2023-06-01,1447,2,0,2,3,0,3
2023-06-01,53823,2,0,2,1,0,1
2023-06-01,40639,2,0,2,3,0,3
2023-06-01,62480,1,0,1,1,0,1
2023-06-01,14501,1,0,1,1,0,1
2023-06-01,1612,6,0,6,2,0,2
2023-06-01,33268,2,0,2,1,0,1
2023-06-01,62546,1,0,1,1,0,1
2023-06-01,32649,1,0,1,1,0,1
2023-06-01,46727,1,0,1,1,0,1
2023-06-01,11720,2,0,2,1,0,1
2023-06-01,397604,1,0,1,1,0,1
2023-06-01,55205,1,0,1,1,0,1
2023-06-01,30648,1,0,1,2,0,2
2023-06-01,22666,1,0,1,1,0,1
2023-06-01,11765,2,0,2,1,0,1
2023-06-01,264581,3,0,3,2,0,2
2023-06-01,36537,1,0,1,2,0,2
2023-06-01,21600,1,0,1,2,0,2
2023-06-01,14128,1,0,1,1,0,1
2023-06-01,33145,1,0,1,1,0,1
2023-06-01,32887,2,0,2,2,0,2
2023-06-01,54970,1,0,1,2,0,2
2023-06-01,14582,1,0,1,1,0,1
2023-06-01,264583,1,0,1,3,0,3
2023-06-01,264095,1,1,2,1,1,1
2023-06-01,11322,1,0,1,1,0,1
2023-06-01,55146,1,0,1,2,0,2
2023-06-01,54947,14,0,14,5,0,5
2023-06-01,18733,6,0,6,5,0,5
2023-06-01,18535,2,0,2,1,0,1
2023-06-01,396517,2,0,2,1,0,1
2023-06-01,55183,8,0,8,2,0,2
2023-06-01,62479,1,0,1,1,0,1
2023-06-01,55238,1,0,1,1,0,1
2023-06-01,22826,1,0,1,1,0,1
2023-06-01,54063,5,0,5,3,0,3
2023-06-01,36153,2,0,2,3,0,3
2023-06-01,55210,1,0,1,2,0,2
2023-06-01,54269,1,0,1,3,0,3
2023-06-01,26096,3,0,3,1,0,1
2023-06-01,25906,3,0,3,2,0,2
2023-06-01,53699,4,0,4,7,0,7
2023-06-01,62520,2,0,2,2,0,2
2023-06-01,33095,1,0,1,1,0,1
2023-06-01,4151,0,0,0,2,0,2
2023-06-01,26376,1,0,1,1,0,1
2023-06-01,62565,1,0,1,1,0,1
2023-06-01,13785,1,0,1,1,0,1
2023-06-01,21943,1,0,1,1,0,1
2023-06-01,40572,1,0,1,2,0,2
2023-06-01,5026,4,0,4,1,0,1
2023-06-01,46631,1,0,1,2,0,2
2023-06-01,53462,1,0,1,1,0,1
2023-06-01,62530,1,0,1,1,0,1
2023-06-01,55288,1,0,1,1,0,1
2023-06-01,62572,1,0,1,2,0,2
2023-06-01,62569,1,0,1,1,0,1
2023-06-01,18460,2,1,3,1,1,1
2023-06-01,16990,6,0,6,5,0,5
2023-06-01,62608,1,0,1,2,0,2
2023-06-01,4390,5,1,6,1,2,2
2023-06-01,28628,3,0,3,3,0,3
2023-06-01,62541,3,0,3,2,0,2
2023-06-01,54797,1,0,1,2,0,2
2023-06-01,62557,2,0,2,1,0,1
2023-06-01,54215,3,0,3,4,0,4
2023-06-01,20402,1,0,1,1,0,1
2023-06-01,393941,1,3,4,1,1,1
2023-06-01,394061,1,0,1,1,0,1
2023-06-01,40460,1,0,1,2,0,2
2023-06-01,396381,1,0,1,2,0,2
2023-06-01,11446,4,0,4,1,0,1
2023-06-01,10944,3,0,3,1,0,1
2023-06-01,24474,1,0,1,1,0,1
2023-06-01,26320,1,0,1,3,0,3
2023-06-01,53933,1,2,3,4,3,4
2023-06-01,54132,2,0,2,2,0,2
2023-06-01,54822,4,0,4,8,0,8
2023-06-01,395534,2,0,2,4,0,4
2023-06-01,27214,1,0,1,2,0,2
2023-06-01,33250,1,0,1,1,0,1
2023-06-01,11378,1,1,2,3,1,3
2023-06-01,5705,1,0,1,3,0,3
2023-06-01,55279,1,0,1,2,0,2
2023-06-01,19691,6,0,6,4,0,4
2023-06-01,14903,3,0,3,3,0,3
2023-06-01,55076,2,0,2,2,0,2
2023-06-01,394169,5,1,6,3,1,3
2023-06-01,32704,1,0,1,1,0,1
2023-06-01,393241,2,0,2,4,0,4
2023-06-01,3140,1,1,2,1,1,1
2023-06-01,54512,2,0,2,1,0,1
2023-06-01,16556,3,0,3,1,0,1
2023-06-01,18555,2,0,2,4,0,4
2023-06-01,53641,7,0,7,2,0,2
2023-06-01,21758,9,0,9,5,0,5
2023-06-01,397211,1,0,1,2,0,2
2023-06-01,19314,2,0,2,3,0,3
2023-06-01,52441,5,0,5,2,0,2
2023-06-01,26477,1,0,1,2,0,2
2023-06-01,26465,1,0,1,1,0,1
2023-06-01,22656,1,0,1,1,0,1
2023-06-01,11902,1,0,1,1,0,1
2023-06-01,398207,2,0,2,2,0,2
2023-06-01,398272,1,0,1,1,0,1
2023-06-01,23371,2,1,3,3,2,3
2023-06-01,36244,1,0,1,3,0,3
2023-06-01,62673,1,0,1,1,0,1
2023-06-01,22200,4,0,4,2,0,2
2023-06-01,1009,6,0,6,1,0,1
2023-06-01,25973,1,1,2,1,1,1
2023-06-01,62589,1,0,1,3,0,3
2023-06-01,29858,1,0,1,1,0,1
2023-06-01,25825,1,0,1,3,0,3
2023-06-01,11926,1,0,1,3,0,3
2023-06-01,6269,1,0,1,1,0,1
2023-06-01,62647,2,0,2,4,0,4
2023-06-01,15116,5,1,6,1,1,1
2023-06-01,62709,1,0,1,2,0,2
2023-06-01,393261,1,0,1,1,0,1
2023-06-01,55266,1,0,1,2,0,2
2023-06-01,33683,2,0,2,1,0,1
2023-06-01,32150,1,3,4,3,3,5
2023-06-01,263691,4,0,4,2,0,2
2023-06-01,263909,3,0,3,2,0,2
2023-06-01,18993,1,0,1,3,0,3
2023-06-01,40540,3,0,3,2,0,2
2023-06-01,23363,1,0,1,3,0,3
2023-06-01,18916,1,0,1,1,0,1
2023-06-01,62745,1,0,1,1,0,1
2023-06-01,3470,1,0,1,1,0,1
2023-06-01,2633,2,0,2,1,0,1
2023-06-01,46461,3,0,3,2,0,2
2023-06-01,4200010420,16,0,16,1,0,1
2023-06-01,263233,9,0,9,2,0,2
2023-06-01,25984,7,0,7,2,0,2
2023-06-01,23271,1,0,1,3,0,3
2023-06-01,62630,2,0,2,2,0,2
2023-06-01,62603,1,0,1,2,0,2
2023-06-01,33177,7,0,7,4,0,4
2023-06-01,62752,1,0,1,2,0,2
2023-06-01,62779,1,0,1,1,0,1
2023-06-01,20449,1,0,1,1,0,1
2023-06-01,395175,1,0,1,2,0,2
2023-06-01,149176,1,0,1,3,0,3
2023-06-01,46848,1,0,1,1,0,1
2023-06-01,46542,2,0,2,2,0,2
2023-06-01,62735,2,0,2,3,0,3
2023-06-01,15355,4,0,4,1,0,1
2023-06-01,53781,1,0,1,1,0,1
2023-06-01,32971,2,0,2,3,0,3
2023-06-01,46127,1,0,1,1,0,1
2023-06-01,11813,1,0,1,3,0,3
2023-06-01,26763,1,0,1,2,0,2
2023-06-01,20234,6,0,6,1,0,1
2023-06-01,394022,1,0,1,1,0,1
2023-06-01,395409,1,1,2,1,1,1
2023-06-01,14222,10,0,10,1,0,1
2023-06-01,22966,3,0,3,2,0,2
2023-06-01,62792,1,0,1,1,0,1
2023-06-01,62772,1,0,1,2,0,2
2023-06-01,8148,4,0,4,3,0,3
2023-06-01,62690,1,0,1,2,0,2
2023-06-01,394823,2,0,2,3,0,3
2023-06-01,395061,2,0,2,3,0,3
2023-06-01,202808,1,0,1,1,0,1
2023-06-01,62803,1,0,1,1,0,1
2023-06-01,32192,1,0,1,3,0,3
2023-06-01,4470,23,0,23,1,0,1
2023-06-01,16697,1,0,1,1,0,1
2023-06-01,11730,2,0,2,3,0,3
2023-06-01,46946,5,0,5,1,0,1
2023-06-01,33304,1,0,1,3,0,3
2023-06-01,398499,1,1,2,3,3,3
2023-06-01,62702,1,0,1,2,0,2
2023-06-01,10248,1,0,1,2,0,2
2023-06-01,62736,1,0,1,1,0,1
2023-06-01,62562,1,0,1,2,0,2
2023-06-01,393260,1,0,1,1,0,1
2023-06-01,62797,1,0,1,1,0,1
2023-06-01,395133,2,0,2,2,0,2
2023-06-01,19878,6,0,6,4,0,4
2023-06-01,30347,2,0,2,2,0,2
2023-06-01,20391,1,0,1,1,0,1
2023-06-01,22246,2,0,2,3,0,3
2023-06-01,54572,1,0,1,1,0,1
2023-06-01,13836,3,0,3,2,0,2
2023-06-01,25794,4,0,4,2,0,2
2023-06-01,19068,3,0,3,1,0,1
2023-06-01,55037,11,1,12,3,2,3
2023-06-01,396966,3,0,3,2,0,2
2023-06-01,54561,1,1,2,1,1,1
2023-06-01,22512,10,1,11,6,5,7
2023-06-01,3727,1,1,2,3,1,4
2023-06-01,62875,1,0,1,2,0,2
2023-06-01,21961,2,0,2,2,0,2
2023-06-01,54821,1,0,1,3,0,3
2023-06-01,3850,2,0,2,1,0,1
2023-06-01,19011,8,0,8,2,0,2
2023-06-01,394748,3,0,3,1,0,1
2023-06-01,399447,1,0,1,1,0,1
2023-06-01,14174,8,1,9,3,1,3
2023-06-01,394933,4,0,4,3,0,3
2023-06-01,14032,3,1,4,1,1,1
2023-06-01,19648,7,4,11,4,2,4
2023-06-01,32269,2,0,2,2,0,2
2023-06-01,30543,3,0,3,3,0,3
2023-06-01,23527,1,0,1,2,0,2
2023-06-01,393279,1,0,1,1,0,1
2023-06-01,395860,7,0,7,1,0,1
2023-06-01,11285,1,0,1,1,0,1
2023-06-01,2646,1,0,1,1,0,1
2023-06-01,21924,1,0,1,3,0,3
2023-06-01,26582,5,0,5,2,0,2
2023-06-01,394987,2,0,2,3,0,3
2023-06-01,54311,1,0,1,1,0,1
2023-06-01,1045,1,0,1,1,0,1
2023-06-01,31821,1,0,1,2,0,2
2023-06-01,53869,2,1,3,5,2,5
2023-06-01,15111,6,0,6,4,0,4
2023-06-01,395943,2,0,2,3,0,3
2023-06-01,11121,2,0,2,1,0,1
2023-06-01,20010,2,0,2,2,0,2
2023-06-01,398653,1,1,2,1,1,1
2023-06-01,62800,1,0,1,3,0,3
2023-06-01,62758,1,0,1,1,0,1
2023-06-01,19319,3,0,3,1,0,1
2023-06-01,62634,1,0,1,1,0,1
2023-06-01,22290,1,0,1,2,0,2
2023-06-01,393341,8,0,8,3,0,3
2023-06-01,21941,1,0,1,3,0,3
2023-06-01,25813,15,0,15,5,0,5
2023-06-01,19825,3,0,3,3,0,3
2023-06-01,25836,7,0,7,4,0,4
2023-06-01,26287,1,0,1,3,0,3
2023-06-01,14783,2,0,2,2,0,2
2023-06-01,14967,1,0,1,2,0,2
2023-06-01,30281,1,0,1,3,0,3
2023-06-01,35909,1,0,1,2,0,2
2023-06-01,3967,2,0,2,2,0,2
2023-06-01,36674,2,0,2,3,0,3
2023-06-01,62885,1,0,1,1,0,1
2023-06-01,20285,2,0,2,2,0,2
2023-06-01,53868,1,0,1,2,0,2
2023-06-01,36004,9,0,9,2,0,2
2023-06-01,11820,1,1,2,2,1,2
2023-06-01,393304,1,1,2,1,1,1
2023-06-01,18584,1,0,1,3,0,3
2023-06-01,40530,1,0,1,1,0,1
2023-06-01,62839,3,0,3,1,0,1
2023-06-01,32517,1,0,1,1,0,1
2023-06-01,62857,2,0,2,2,0,2
2023-06-01,62877,1,0,1,1,0,1
2023-06-01,62891,2,0,2,3,0,3
2023-06-01,54775,6,0,6,1,0,1
2023-06-01,4563,1,0,1,1,0,1
2023-06-01,14527,3,0,3,3,0,3
2023-06-01,32346,1,0,1,1,0,1
2023-06-01,23479,2,0,2,2,0,2
2023-06-01,11799,7,1,8,1,1,1
2023-06-01,3364,5,0,5,2,0,2
2023-06-01,23940,1,0,1,2,0,2
2023-06-01,23010,2,0,2,1,0,1
2023-06-01,1757,16,0,16,2,0,2
2023-06-01,62863,1,0,1,1,0,1
2023-06-01,53583,2,0,2,3,0,3
2023-06-01,399050,1,0,1,1,0,1
2023-06-01,394165,1,0,1,1,0,1
2023-06-01,32711,1,0,1,1,0,1
2023-06-01,20339,2,0,2,1,0,1
2023-06-01,396151,18,0,18,3,0,3
2023-06-01,22855,17,1,18,2,1,2
2023-06-01,26651,27,0,27,5,0,5
2023-06-01,36279,2,0,2,3,0,3
2023-06-01,393325,1,0,1,1,0,1
2023-06-01,62939,1,0,1,1,0,1
2023-06-01,32897,1,0,1,1,0,1
2023-06-01,19408,1,0,1,1,0,1
2023-06-01,14533,1,0,1,2,0,2
2023-06-01,16693,2,0,2,4,0,4
2023-06-01,32647,6,1,7,2,1,2
2023-06-01,22337,1,0,1,1,0,1
2023-06-01,21846,0,0,0,2,0,2
2023-06-01,393332,1,0,1,3,0,3
2023-06-01,62934,1,0,1,1,0,1
2023-06-01,14358,4,0,4,2,0,2
2023-06-01,393334,1,0,1,1,0,1
2023-06-01,53566,5,0,5,2,0,2
2023-06-01,398954,1,0,1,2,0,2
2023-06-01,62824,2,0,2,1,0,1
2023-06-01,32176,6,0,6,4,0,4
2023-06-01,399410,2,0,2,2,0,2
2023-06-01,62933,1,0,1,1,0,1
2023-06-01,30601,1,0,1,1,0,1
2023-06-01,1083,2,0,2,2,0,2
2023-06-01,47097,1,0,1,2,0,2
2023-06-01,22202,1,0,1,4,0,4
2023-06-01,62854,1,0,1,1,0,1
2023-06-01,25714,3,0,3,4,0,4
2023-06-01,16394,2,0,2,2,0,2
2023-06-01,268313,1,0,1,1,0,1
2023-06-01,393378,1,0,1,3,0,3
2023-06-01,1508,2,1,3,2,2,2
2023-06-01,62965,1,0,1,1,0,1
2023-06-01,62993,1,1,2,3,1,3
2023-06-01,55101,1,0,1,3,0,3
2023-06-01,14035,1,0,1,1,0,1
2023-06-01,27307,6,0,6,2,0,2
2023-06-01,393310,1,0,1,1,0,1
2023-06-01,55127,3,0,3,5,0,5
2023-06-01,26264,1,0,1,1,0,1
2023-06-01,393369,1,0,1,2,0,2
2023-06-01,62474,2,0,2,3,0,3
2023-06-01,23166,2,0,2,4,0,4
2023-06-01,393242,4,0,4,3,0,3
2023-06-01,54992,1,0,1,2,0,2
2023-06-01,23267,1,0,1,1,0,1
2023-06-01,32657,1,0,1,1,0,1
2023-06-01,62991,1,0,1,1,0,1
2023-06-01,11408,6,0,6,1,0,1
2023-06-01,21673,1,0,1,1,0,1
2023-06-01,399665,1,0,1,1,0,1
2023-06-01,23339,7,0,7,2,0,2
2023-06-01,46411,3,0,3,2,0,2
2023-06-01,29998,6,0,6,1,0,1
2023-06-01,22263,1,0,1,1,0,1
2023-06-01,40197,1,0,1,1,0,1
2023-06-01,19771,2,0,2,3,0,3
2023-06-01,62971,1,0,1,2,0,2
2023-06-01,31871,4,0,4,3,0,3
2023-06-01,15081,1,0,1,3,0,3
2023-06-01,19193,1,0,1,2,0,2
2023-06-01,1097,1,0,1,2,0,2
2023-06-01,10411,12,0,12,7,0,7
2023-06-01,393376,1,0,1,2,0,2
2023-06-01,23198,2,0,2,3,0,3
2023-06-01,63011,1,0,1,2,0,2
2023-06-01,21993,9,0,9,3,0,3
2023-06-01,30100,1,0,1,2,0,2
2023-06-01,14995,1,2,3,6,2,6
2023-06-01,399182,1,0,1,1,0,1
2023-06-01,63032,2,0,2,4,0,4
2023-06-01,18639,2,2,4,1,2,3
2023-06-01,62995,1,0,1,3,0,3
2023-06-01,395474,5,0,5,2,0,2
2023-06-01,62992,1,0,1,1,0,1
2023-06-01,13978,2,0,2,1,0,1
2023-06-01,40657,1,0,1,1,0,1
2023-06-01,394619,1,0,1,1,0,1
2023-06-01,23484,11,0,11,3,0,3
2023-06-01,19236,11,0,11,3,0,3
2023-06-01,7455,2,0,2,1,0,1
2023-06-01,40044,1,0,1,3,0,3
2023-06-01,11207,4,0,4,3,0,3
2023-06-01,54367,3,0,3,1,0,1
2023-06-01,291,1,0,1,1,0,1
2023-06-01,292,1,0,1,1,0,1
2023-06-01,399451,1,0,1,1,0,1
2023-06-01,62920,1,0,1,2,0,2
2023-06-01,11045,40,1,41,3,2,3
2023-06-01,62570,1,0,1,2,0,2
2023-06-01,11332,1,0,1,1,0,1
2023-06-01,4869,6,0,6,1,0,1
2023-06-01,203274,1,0,1,1,0,1
2023-06-01,32190,2,0,2,3,0,3
2023-06-01,22559,1,0,1,3,0,3
2023-06-01,22643,1,0,1,1,0,1
2023-06-01,397367,2,0,2,1,0,1
2023-06-01,36500,2,0,2,2,0,2
2023-06-01,400060,8,0,8,2,0,2
2023-06-01,132055,8,0,8,3,0,3
2023-06-01,32027,5,0,5,3,0,3
2023-06-01,53811,1,0,1,1,0,1
2023-06-01,398845,1,0,1,2,0,2
2023-06-01,393348,1,0,1,1,0,1
2023-06-01,30595,6,0,6,3,0,3
2023-06-01,393352,1,0,1,2,0,2
2023-06-01,25879,1,0,1,1,0,1
2023-06-01,54156,2,0,2,4,0,4
2023-06-01,13715,1,0,1,3,0,3
2023-06-01,15346,2,0,2,3,0,3
2023-06-01,11493,3,0,3,3,0,3
2023-06-01,46391,1,0,1,2,0,2
2023-06-01,23196,2,0,2,1,0,1
2023-06-01,40588,5,0,5,2,0,2
2023-06-01,396028,8,0,8,4,0,4
2023-06-01,26261,1,0,1,2,0,2
2023-06-01,19329,3,1,4,3,1,3
2023-06-01,30626,1,0,1,1,0,1
2023-06-01,18802,1,0,1,1,0,1
2023-06-01,30310,1,0,1,3,0,3
2023-06-01,53722,3,2,5,3,4,4
2023-06-01,398136,1,0,1,1,0,1
2023-06-01,54956,1,0,1,1,0,1
2023-06-01,54235,1,6,7,2,2,2
2023-06-01,30068,1,0,1,1,0,1
2023-06-01,14810,1,0,1,1,0,1
2023-06-01,23041,1,0,1,2,0,2
2023-06-01,400012,1,0,1,3,0,3
2023-06-01,4200400617,0,0,0,2,0,2
2023-06-01,4200401885,1,0,1,1,0,1
2023-06-01,62918,2,0,2,1,0,1
2023-06-01,62483,1,0,1,3,0,3
2023-06-01,395700,2,2,4,2,2,2
2023-06-01,63266,2,0,2,1,0,1
2023-06-01,13352,6,0,6,1,0,1
2023-06-01,18973,4,3,7,4,2,4
2023-06-01,27480,1,0,1,2,0,2
2023-06-01,55122,2,0,2,4,0,4
2023-06-01,53249,3,0,3,2,0,2
2023-06-01,55121,1,0,1,1,0,1
2023-06-01,54056,5,0,5,2,0,2
2023-06-01,23331,1,0,1,1,0,1
2023-06-01,14521,7,0,7,6,0,6
2023-06-01,11438,1,0,1,3,0,3
2023-06-01,36011,2,0,2,3,0,3
2023-06-01,399090,2,0,2,2,0,2
2023-06-01,36373,7,0,7,3,0,3
2023-06-01,22736,3,0,3,2,0,2
2023-06-01,36145,3,0,3,2,0,2
2023-06-01,46119,1,0,1,2,0,2
2023-06-01,32481,2,0,2,1,0,1
2023-06-01,62510,1,0,1,1,0,1
2023-06-01,29745,1,0,1,3,0,3
2023-06-01,7350,1,0,1,1,0,1
2023-06-01,30035,16,1,17,2,1,2
2023-06-01,36589,3,0,3,6,0,6
2023-06-01,5702,3,0,3,1,0,1
2023-06-01,2631,18,0,18,7,0,7
2023-06-01,16464,3,0,3,2,0,2
2023-06-01,398957,1,0,1,2,0,2
2023-06-01,3832,20,0,20,1,0,1
2023-06-01,35931,1,0,1,2,0,2
2023-06-01,36450,1,0,1,1,0,1
2023-06-01,393267,1,0,1,1,0,1
2023-06-01,4410,7,2,9,1,1,1
2023-06-01,54877,1,0,1,2,0,2
2023-06-01,20466,2,0,2,2,0,2
2023-06-01,25810,1,0,1,2,0,2
2023-06-01,40817,3,0,3,1,0,1
2023-06-01,46097,1,0,1,3,0,3
2023-06-01,394328,3,0,3,1,0,1
2023-06-01,54772,2,0,2,3,0,3
2023-06-01,63038,1,0,1,1,0,1
2023-06-01,35855,2,0,2,2,0,2
2023-06-01,393350,1,1,2,2,1,2
2023-06-01,4358,9,0,9,2,0,2
2023-06-01,55243,5,4,9,5,4,5
2023-06-01,18920,2,0,2,2,0,2
2023-06-01,27607,1,0,1,1,0,1
2023-06-01,31754,1,0,1,1,0,1
2023-06-01,19997,3,0,3,2,0,2
2023-06-01,133873,4,0,4,4,0,4
2023-06-01,40420,2,0,2,1,0,1
2023-06-01,394216,1,0,1,2,0,2
2023-06-01,16826,6,0,6,1,0,1
2023-06-01,62780,2,0,2,1,0,1
2023-06-01,395963,6,0,6,2,0,2
2023-06-01,30239,1,0,1,2,0,2
2023-06-01,54018,2,0,2,1,0,1
2023-06-01,397089,1,0,1,3,0,3
2023-06-01,393308,1,0,1,2,0,2
2023-06-01,394732,1,0,1,3,0,3
2023-06-01,53575,2,0,2,1,0,1
2023-06-01,22810,1,0,1,3,0,3
2023-06-01,22671,3,0,3,2,0,2
2023-06-01,39966,3,0,3,2,0,2
2023-06-01,8146,1,0,1,1,0,1
2023-06-01,21573,9,0,9,2,0,2
2023-06-01,398996,1,0,1,1,0,1
2023-06-01,55295,1,0,1,2,0,2
2023-06-01,55022,4,2,6,4,3,4
2023-06-01,395804,1,0,1,1,0,1
2023-06-01,30643,5,0,5,4,0,4
2023-06-01,25647,1,0,1,1,0,1
2023-06-01,19866,1,0,1,2,0,2
2023-06-01,46739,1,0,1,1,0,1
2023-06-01,55124,1,0,1,3,0,3
2023-06-01,14043,6,0,6,5,0,5
2023-06-01,18550,3,0,3,3,0,3
2023-06-01,398376,1,0,1,1,0,1
2023-06-01,46451,1,0,1,1,0,1
2023-06-01,8037,11,0,11,3,0,3
2023-06-01,21504,20,0,20,9,0,9
2023-06-01,3620,1,0,1,1,0,1
2023-06-01,30606,2,0,2,2,0,2
2023-06-01,16760,2,0,2,3,0,3
2023-06-01,33246,1,1,2,2,2,2
2023-06-01,26980,1,0,1,1,0,1
2023-06-01,13516,2,0,2,2,0,2
2023-06-01,13491,3,0,3,3,0,3
2023-06-01,27186,1,0,1,3,0,3
2023-06-01,31761,1,0,1,1,0,1
2023-06-01,40742,1,0,1,1,0,1
2023-06-01,399829,1,0,1,1,0,1
2023-06-01,55228,1,2,3,1,1,1
2023-06-01,33594,5,0,5,1,0,1
2023-06-01,27275,1,0,1,3,0,3
2023-06-01,6171,19,0,19,2,0,2
2023-06-01,25925,1,0,1,3,0,3
2023-06-01,36399,1,0,1,1,0,1
2023-06-01,18750,1,1,2,1,1,1
2023-06-01,55024,3,0,3,3,0,3
2023-06-01,14817,1,0,1,3,0,3
2023-06-01,54977,1,0,1,2,0,2
2023-06-01,395444,1,0,1,3,0,3
2023-06-01,23229,11,0,11,3,0,3
2023-06-01,55240,1,0,1,1,0,1
2023-06-01,398155,1,0,1,1,0,1
2023-06-01,394251,1,0,1,1,0,1
2023-06-01,395991,1,0,1,1,0,1
2023-06-01,396129,1,0,1,3,0,3
2023-06-01,53532,1,0,1,2,0,2
2023-06-01,55069,1,0,1,2,0,2
2023-06-01,397070,2,0,2,1,0,1
2023-06-01,54957,2,0,2,4,0,4
2023-06-01,14290,1,0,1,3,0,3
2023-06-01,13931,1,0,1,1,0,1
2023-06-01,398666,1,0,1,1,0,1
2023-06-01,54949,2,0,2,2,0,2
2023-06-01,11262,1,0,1,1,0,1
2023-06-01,46135,2,0,2,3,0,3
2023-06-01,55089,1,0,1,4,0,4
2023-06-01,19041,1,0,1,1,0,1
2023-06-01,394522,3,1,4,1,1,2
2023-06-01,54655,2,0,2,4,0,4
2023-06-01,46716,1,0,1,1,0,1
2023-06-01,17170,5,0,5,3,0,3
2023-06-01,400263,1,0,1,2,0,2
2023-06-01,17238,1,0,1,1,0,1
2023-06-01,53702,2,0,2,1,0,1
2023-06-01,395357,2,0,2,1,0,1
2023-06-01,55099,2,0,2,1,0,1
2023-06-01,54967,1,0,1,2,0,2
2023-06-01,55063,1,0,1,2,0,2
2023-06-01,55179,1,0,1,3,0,3
2023-06-01,21594,1,0,1,2,0,2
2023-06-01,400446,3,0,3,1,0,1
2023-06-01,14697,1,0,1,1,0,1
2023-06-01,55153,1,0,1,3,0,3
2023-06-01,393311,2,0,2,1,0,1
2023-06-01,397421,6,0,6,1,0,1
2023-06-01,397188,2,0,2,1,0,1
2023-06-01,40884,1,0,1,2,0,2
2023-06-01,14336,10,0,10,1,0,1
2023-06-01,55123,1,0,1,1,0,1
2023-06-01,393492,3,0,3,2,0,2
2023-06-01,40814,2,0,2,3,0,3
2023-06-01,17300,2,0,2,3,0,3
2023-06-01,393607,3,0,3,4,0,4
2023-06-01,399424,1,0,1,2,0,2
2023-06-01,397335,3,1,4,1,1,1
2023-06-01,46612,3,0,3,3,0,3
2023-06-01,26176,2,0,2,1,0,1
2023-06-01,393322,1,0,1,3,0,3
2023-06-01,32538,4,0,4,1,0,1
2023-06-01,33455,5,0,5,4,0,4
2023-06-01,25974,1,0,1,3,0,3
2023-06-01,30664,5,0,5,4,0,4
2023-06-01,11184,2,0,2,1,0,1
2023-06-01,20331,11,0,11,3,0,3
2023-06-01,18473,8,0,8,1,0,1
2023-06-01,398460,1,0,1,1,0,1
2023-06-01,29821,2,0,2,3,0,3
2023-06-01,20384,14,0,14,4,0,4
2023-06-01,396062,1,0,1,3,0,3
2023-06-01,63263,2,0,2,1,0,1
2023-06-01,59724,2,0,2,1,0,1
2023-06-01,133782,2,0,2,2,0,2
2023-06-01,400381,2,1,3,1,1,2
2023-06-01,46969,2,1,3,1,1,1
2023-06-01,397973,7,0,7,3,0,3
2023-06-01,11250,10,1,11,3,2,3
2023-06-01,4318,5,0,5,2,0,2
2023-06-01,399434,1,0,1,2,0,2
2023-06-01,19677,5,0,5,4,0,4
2023-06-01,63061,3,0,3,1,0,1
2023-06-01,3719,15,1,16,3,2,3
2023-06-01,40479,12,0,12,3,0,3
2023-06-01,36649,2,0,2,3,0,3
2023-06-01,22215,7,0,7,2,0,2
2023-06-01,40292,5,0,5,2,0,2
2023-06-01,22582,2,0,2,2,0,2
2023-06-01,394724,1,0,1,1,0,1
2023-06-01,393753,3,0,3,2,0,2
2023-06-01,395811,1,0,1,1,0,1
2023-06-01,40017,1,0,1,3,0,3
2023-06-01,55047,1,0,1,2,0,2
2023-06-01,30180,4,0,4,5,0,5
2023-06-01,11395,1,0,1,3,0,3
2023-06-01,23039,4,0,4,1,0,1
2023-06-01,18537,1,0,1,2,0,2
2023-06-01,54684,1,0,1,2,0,2
2023-06-01,11897,5,0,5,2,0,2
2023-06-01,14272,1,0,1,2,0,2
2023-06-01,7695,2,0,2,2,0,2
2023-06-01,54928,1,0,1,1,0,1
2023-06-01,30098,1,0,1,2,0,2
2023-06-01,54303,3,0,3,3,0,3
2023-06-01,36364,3,0,3,4,0,4
2023-06-01,29851,5,0,5,1,0,1
2023-06-01,395155,2,0,2,2,0,2
2023-06-01,14572,2,0,2,2,0,2
2023-06-01,394800,1,0,1,3,0,3
2023-06-01,13496,5,0,5,3,0,3
2023-06-01,19125,2,0,2,1,0,1
2023-06-01,4884,8,0,8,3,0,3
2023-06-01,26587,1,0,1,2,0,2
2023-06-01,11893,5,0,5,2,0,2
2023-06-01,32360,8,1,9,3,3,3
2023-06-01,18682,5,0,5,2,0,2
2023-06-01,3736,3,0,3,1,0,1
2023-06-01,4128,1,1,2,3,3,3
2023-06-01,40071,1,0,1,1,0,1
2023-06-01,399492,1,0,1,1,0,1
2023-06-01,19355,8,2,10,3,1,3
2023-06-01,19594,1,0,1,3,0,3
2023-06-01,22851,4,0,4,2,0,2
2023-06-01,12253,11,1,12,3,2,3
2023-06-01,46508,1,0,1,1,0,1
2023-06-01,36844,10,0,10,1,0,1
2023-06-01,19774,5,0,5,1,0,1
2023-06-01,62975,2,0,2,1,0,1
2023-06-01,27375,1,0,1,1,0,1
2023-06-01,11267,1,0,1,3,0,3
2023-06-01,399524,1,0,1,1,0,1
2023-06-01,395611,1,1,2,2,2,3
2023-06-01,6091,2,0,2,3,0,3
2023-06-01,31801,8,0,8,3,0,3
2023-06-01,10209,1,0,1,1,0,1
2023-06-01,30000,2,0,2,1,0,1
2023-06-01,40722,4,0,4,1,0,1
2023-06-01,46120,1,0,1,2,0,2
2023-06-01,396917,1,1,2,2,2,2
2023-06-01,13702,6,0,6,3,0,3
2023-06-01,32958,2,0,2,2,0,2
2023-06-01,53426,1,0,1,1,0,1
2023-06-01,26379,1,0,1,1,0,1
2023-06-01,9827,1,0,1,1,0,1
2023-06-01,54969,1,0,1,1,0,1
2023-06-01,11230,3,0,3,2,0,2
2023-06-01,62924,1,0,1,1,0,1
2023-06-01,397605,2,0,2,1,0,1
2023-06-01,132414,6,0,6,4,0,4
2023-06-01,132413,6,0,6,4,0,4
2023-06-01,62978,1,0,1,2,0,2
2023-06-01,30019,1,0,1,1,0,1
2023-06-01,30020,2,0,2,1,0,1
2023-06-01,13990,29,0,29,4,0,4
2023-06-01,62909,3,1,4,3,1,3
2023-06-01,397984,4,0,4,3,0,3
2023-06-01,40626,1,0,1,1,0,1
2023-06-01,30331,1,0,1,3,0,3
2023-06-01,19421,3,0,3,2,0,2
2023-06-01,15110,4,0,4,1,0,1
2023-06-01,53353,1,0,1,1,0,1
2023-06-01,21611,1,0,1,3,0,3
2023-06-01,26358,1,0,1,2,0,2
2023-06-01,23251,16,0,16,4,0,4
2023-06-01,397093,12,0,12,2,0,2
2023-06-01,395972,2,0,2,2,0,2
2023-06-01,14437,13,0,13,4,0,4
2023-06-01,16555,1,0,1,1,0,1
2023-06-01,30076,4,0,4,2,0,2
2023-06-01,15299,1,0,1,1,0,1
2023-06-01,13997,2,0,2,1,0,1
2023-06-01,398301,2,0,2,1,0,1
2023-06-01,27301,3,0,3,2,0,2
2023-06-01,393998,1,0,1,3,0,3
2023-06-01,394612,1,0,1,3,0,3
2023-06-01,26010,1,0,1,1,0,1
2023-06-01,18718,3,0,3,4,0,4
2023-06-01,36669,2,0,2,1,0,1
2023-06-01,29875,2,0,2,2,0,2
2023-06-01,19375,1,0,1,1,0,1
2023-06-01,32293,2,0,2,3,0,3
2023-06-01,399485,3,0,3,3,0,3
2023-06-01,40524,2,0,2,1,0,1
2023-06-01,22934,1,0,1,4,0,4
2023-06-01,19002,1,0,1,2,0,2
2023-06-01,40860,2,0,2,2,0,2
2023-06-01,14320,1,0,1,1,0,1
2023-06-01,54918,1,0,1,2,0,2
2023-06-01,6450,5,0,5,2,0,2
2023-06-01,11109,16,0,16,1,0,1
2023-06-01,53528,3,0,3,1,0,1
2023-06-01,22732,4,0,4,1,0,1
2023-06-01,54921,1,0,1,3,0,3
2023-06-01,32403,1,0,1,2,0,2
2023-06-01,33373,2,0,2,3,0,3
2023-06-01,40326,33,0,33,2,0,2
2023-06-01,16844,1,0,1,1,0,1
2023-06-01,32510,2,0,2,1,0,1
2023-06-01,54909,1,0,1,1,0,1
2023-06-01,397822,2,0,2,3,0,3
2023-06-01,46376,5,0,5,2,0,2
2023-06-01,15120,1,0,1,1,0,1
2023-06-01,54469,2,0,2,3,0,3
2023-06-01,3914,2,0,2,3,0,3
2023-06-01,33112,1,0,1,2,0,2
2023-06-01,399270,1,0,1,4,0,4
2023-06-01,40619,5,0,5,3,0,3
2023-06-01,36796,1,0,1,3,0,3
2023-06-01,40877,2,0,2,2,0,2
2023-06-01,399925,4,0,4,2,0,2
2023-06-01,30554,1,0,1,1,0,1
2023-06-01,19569,1,0,1,3,0,3
2023-06-01,40878,1,0,1,2,0,2
2023-06-01,1645,1,1,2,1,1,2
2023-06-01,397458,4,0,4,3,0,3
2023-06-01,14801,1,0,1,1,0,1
2023-06-01,19781,4,0,4,2,0,2
2023-06-01,33163,2,0,2,2,0,2
2023-06-01,46642,1,0,1,1,0,1
2023-06-01,11865,2,0,2,2,0,2
2023-06-01,40211,1,0,1,3,0,3
2023-06-01,47078,1,0,1,1,0,1
2023-06-01,15303,1,0,1,4,0,4
2023-06-01,10551,1,0,1,2,0,2
2023-06-01,12279,1,0,1,1,0,1
2023-06-01,397600,2,0,2,3,0,3
2023-06-01,54348,1,0,1,1,0,1
2023-06-01,29935,4,0,4,1,0,1
2023-06-01,54545,1,0,1,2,0,2
2023-06-01,29763,1,1,2,1,1,1
2023-06-01,21893,3,0,3,1,0,1
2023-06-01,1974,1,0,1,1,0,1
2023-06-01,40932,1,0,1,1,0,1
2023-06-01,1399,18,0,18,6,0,6
2023-06-01,393650,2,0,2,1,0,1
2023-06-01,11304,1,0,1,3,0,3
2023-06-01,47059,1,0,1,1,0,1
2023-06-01,10985,2,0,2,1,0,1
2023-06-01,14431,2,0,2,1,0,1
2023-06-01,22330,6,0,6,7,0,7
2023-06-01,30185,1,0,1,1,0,1
2023-06-01,3916,2,0,2,1,0,1
2023-06-01,36562,4,0,4,3,0,3
2023-06-01,21930,1,0,1,1,0,1
2023-06-01,22182,5,0,5,1,0,1
2023-06-01,23226,1,0,1,3,0,3
2023-06-01,46302,3,0,3,1,0,1
2023-06-01,27483,10,0,10,4,0,4
2023-06-01,27000,1,0,1,1,0,1
2023-06-01,6077,4,0,4,1,0,1
2023-06-01,29701,1,0,1,3,0,3
2023-06-01,19060,2,0,2,2,0,2
2023-06-01,394944,3,0,3,3,0,3
2023-06-01,54943,1,0,1,3,0,3
2023-06-01,16714,4,0,4,2,0,2
2023-06-01,40413,3,0,3,4,0,4
2023-06-01,393247,6,0,6,1,0,1
2023-06-01,395872,1,0,1,2,0,2
2023-06-01,23099,2,1,3,2,1,2
2023-06-01,46596,1,0,1,1,0,1
2023-06-01,393235,3,0,3,3,0,3
2023-06-01,54426,1,0,1,1,0,1
2023-06-01,11501,3,0,3,2,0,2
2023-06-01,212152,2,0,2,1,0,1
2023-06-01,32447,1,0,1,1,0,1
2023-06-01,40910,3,0,3,2,0,2
2023-06-01,62762,1,0,1,1,0,1
2023-06-01,20031,1,0,1,2,0,2
2023-06-01,39943,1,0,1,3,0,3
2023-06-01,15182,7,0,7,3,0,3
2023-06-01,393399,1,0,1,1,0,1
2023-06-01,14200,4,1,5,2,1,2
2023-06-01,47068,1,0,1,1,0,1
2023-06-01,11009,1,0,1,1,0,1
2023-06-01,30512,1,0,1,1,0,1
2023-06-01,30251,1,0,1,3,0,3
2023-06-01,13718,1,0,1,2,0,2
2023-06-01,31911,4,0,4,3,0,3
2023-06-01,17236,1,0,1,3,0,3
2023-06-01,395598,2,0,2,4,0,4
2023-06-01,400373,1,0,1,2,0,2
2023-06-01,23066,1,0,1,3,0,3
2023-06-01,30383,109,6,115,8,3,9
2023-06-01,56274,10,2,12,1,1,1
2023-06-01,45445,4,0,4,4,0,4
2023-06-01,45241,2,0,2,3,0,3
2023-06-01,65420,2,0,2,1,0,1
2023-06-01,54836,5,0,5,1,0,1
2023-06-01,19482,2,0,2,2,0,2
2023-06-01,26856,1,0,1,3,0,3
2023-06-01,26131,7,0,7,1,0,1
2023-06-01,395216,2,0,2,3,0,3
2023-06-01,397741,2,0,2,2,0,2
2023-06-01,16640,6,0,6,1,0,1
2023-06-01,25966,3,0,3,4,0,4
2023-06-01,397779,6,0,6,1,0,1
2023-06-01,397965,3,0,3,3,0,3
2023-06-01,23247,2,0,2,4,0,4
2023-06-01,54099,3,0,3,1,0,1
2023-06-01,21807,5,0,5,1,0,1
2023-06-01,46256,2,0,2,2,0,2
2023-06-01,46648,2,0,2,2,0,2
2023-06-01,399634,1,0,1,1,0,1
2023-06-01,399635,2,0,2,2,0,2
2023-06-01,406,3,0,3,2,0,2
2023-06-01,5672,5,0,5,1,0,1
2023-06-01,399450,2,0,2,2,0,2
2023-06-01,18469,5,6,11,2,2,2
2023-06-01,54013,3,0,3,3,0,3
2023-06-01,3644,3,0,3,1,0,1
2023-06-01,40140,2,0,2,1,0,1
2023-06-01,33674,4,0,4,3,0,3
2023-06-01,22283,22,0,22,12,0,12
2023-06-01,13558,1,0,1,3,0,3
2023-06-01,396208,1,0,1,1,0,1
2023-06-01,54991,1,0,1,2,0,2
2023-06-01,19861,1,0,1,3,0,3
2023-06-01,36847,8,0,8,5,0,5
2023-06-01,30718,2,0,2,1,0,1
2023-06-01,54800,4,0,4,2,0,2
2023-06-01,36044,1,0,1,2,0,2
2023-06-01,40744,1,0,1,1,0,1
2023-06-01,397878,1,0,1,1,0,1
2023-06-01,14973,2,0,2,2,0,2
2023-06-01,54910,7,0,7,2,0,2
2023-06-01,14950,1,0,1,2,0,2
2023-06-01,33240,4,0,4,2,0,2
2023-06-01,395913,4,0,4,3,0,3
2023-06-01,11494,1,0,1,2,0,2
2023-06-01,3933,9,0,9,1,0,1
2023-06-01,40583,1,1,2,2,1,2
2023-06-01,46159,1,0,1,2,0,2
2023-06-01,35929,1,1,2,3,2,3
2023-06-01,397963,1,0,1,1,0,1
2023-06-01,36683,3,0,3,2,0,2
2023-06-01,400539,4,0,4,3,0,3
2023-06-01,53723,1,0,1,1,0,1
2023-06-01,3096,7,0,7,1,0,1
2023-06-01,8729,11,2,13,1,1,1
2023-06-01,3412,2,0,2,2,0,2
2023-06-01,3095,4,0,4,3,0,3
2023-06-01,3083,3,0,3,1,0,1
2023-06-01,3084,3,0,3,1,0,1
2023-06-01,3108,3,0,3,2,0,2
2023-06-01,3107,2,0,2,1,0,1
2023-06-01,14242,1,0,1,2,0,2
2023-06-01,396347,1,0,1,1,0,1
2023-06-01,27003,1,0,1,3,0,3
2023-06-01,18630,2,0,2,1,0,1
2023-06-01,396915,1,0,1,1,0,1
2023-06-01,5655,26,0,26,4,0,4
2023-06-01,55292,11,0,11,2,0,2
2023-06-01,18995,2,1,3,2,1,2
2023-06-01,27603,1,0,1,1,0,1
2023-06-01,18513,1,0,1,1,0,1
2023-06-01,10317,2,0,2,2,0,2
2023-06-01,394206,1,0,1,2,0,2
2023-06-01,394446,22,0,22,3,0,3
2023-06-01,22868,1,0,1,1,0,1
2023-06-01,33129,2,0,2,1,0,1
2023-06-01,396201,1,0,1,1,0,1
2023-06-01,398932,1,0,1,1,0,1
2023-06-01,54848,1,0,1,1,0,1
2023-06-01,16622,1,1,2,2,1,2
2023-06-01,11999,4,0,4,2,0,2
2023-06-01,13892,4,0,4,2,0,2
2023-06-01,2020,1,0,1,2,0,2
2023-06-01,13423,1,0,1,1,0,1
2023-06-01,53499,3,0,3,3,0,3
2023-06-01,399305,2,0,2,3,0,3
2023-06-01,11692,1,0,1,2,0,2
2023-06-01,46150,1,0,1,2,0,2
2023-06-01,31794,2,0,2,1,0,1
2023-06-01,27259,1,0,1,3,0,3
2023-06-01,18527,6,0,6,1,0,1
2023-06-01,33085,5,0,5,5,0,5
2023-06-01,19010,1,0,1,1,0,1
2023-06-01,20177,2,0,2,2,0,2
2023-06-01,27086,6,0,6,1,0,1
2023-06-01,22039,1,0,1,1,0,1
2023-06-01,40521,1,0,1,1,0,1
2023-06-01,54923,1,0,1,1,0,1
2023-06-01,23491,2,0,2,1,0,1
2023-06-01,16652,3,1,4,4,4,5
2023-06-01,22673,1,0,1,2,0,2
2023-06-01,46330,1,0,1,2,0,2
2023-06-01,397013,1,0,1,1,0,1
2023-06-01,400122,1,0,1,1,0,1
2023-06-01,26682,1,0,1,1,0,1
2023-06-01,394058,2,0,2,1,0,1
2023-06-01,12088,1,0,1,2,0,2
2023-06-01,62507,2,0,2,2,0,2
2023-06-01,20047,2,0,2,1,0,1
2023-06-01,400535,2,0,2,2,0,2
2023-06-01,397989,2,0,2,1,0,1
2023-06-01,16517,1,0,1,1,0,1
2023-06-01,31750,1,0,1,2,0,2
2023-06-01,1789,14,0,14,1,0,1
2023-06-01,23508,1,0,1,1,0,1
2023-06-01,36550,1,0,1,2,0,2
2023-06-01,395834,1,0,1,1,0,1
2023-06-01,15157,3,0,3,2,0,2
2023-06-01,19063,2,0,2,2,0,2
2023-06-01,394018,1,1,2,3,5,5
2023-06-01,55227,1,0,1,1,0,1
2023-06-01,40578,2,0,2,1,0,1
2023-06-01,3458,4,0,4,2,0,2
2023-06-01,399896,1,0,1,2,0,2
2023-06-01,16792,1,0,1,1,0,1
2023-06-01,399009,2,0,2,1,0,1
2023-06-01,396440,2,0,2,2,0,2
2023-06-01,4043,3,0,3,5,0,5
2023-06-01,398474,1,0,1,1,0,1
2023-06-01,397138,1,1,2,1,1,1
2023-06-01,20295,9,1,10,1,1,1
2023-06-01,394343,1,0,1,2,0,2
2023-06-01,36598,2,0,2,1,0,1
2023-06-01,26631,1,0,1,1,0,1
2023-06-01,33193,1,0,1,2,0,2
2023-06-01,397075,1,0,1,2,0,2
2023-06-01,16546,1,0,1,1,0,1
2023-06-01,13974,1,0,1,1,0,1
2023-06-01,46869,4,0,4,1,0,1
2023-06-01,19052,1,0,1,3,0,3
2023-06-01,14270,1,0,1,2,0,2
2023-06-01,26670,1,0,1,1,0,1
2023-06-01,14539,4,0,4,1,0,1
2023-06-01,397534,2,0,2,1,0,1
2023-06-01,395395,2,0,2,3,0,3
2023-06-01,396947,5,0,5,1,0,1
2023-06-01,394092,3,0,3,2,0,2
2023-06-01,22450,3,3,6,3,1,3
2023-06-01,3472,1,0,1,1,0,1
2023-06-01,3471,1,0,1,1,0,1
2023-06-01,518,13,2,15,1,1,1
2023-06-01,198260,1,1,2,2,2,2
2023-06-01,394274,1,0,1,2,0,2
2023-06-01,394499,1,0,1,2,0,2
2023-06-01,3648,12,0,12,1,0,1
2023-06-01,46490,4,0,4,3,0,3
2023-06-01,2636,1,0,1,2,0,2
2023-06-01,20201,4,0,4,4,0,4
2023-06-01,11826,2,0,2,1,0,1
2023-06-01,3565,12,0,12,3,0,3
2023-06-01,511,1,0,1,3,0,3
2023-06-01,21577,2,1,3,1,1,1
2023-06-01,19626,10,0,10,4,0,4
2023-06-01,54069,4,0,4,1,0,1
2023-06-01,46655,5,0,5,5,0,5
2023-06-01,54521,1,0,1,3,0,3
2023-06-01,26357,1,0,1,1,0,1
2023-06-01,27227,1,0,1,2,0,2
2023-06-01,26958,3,0,3,3,0,3
2023-06-01,16784,5,0,5,3,0,3
2023-06-01,14379,5,0,5,3,0,3
2023-06-01,21835,3,1,4,3,2,3
2023-06-01,397525,1,0,1,1,0,1
2023-06-01,23313,7,0,7,2,0,2
2023-06-01,17364,2,0,2,2,0,2
2023-06-01,33167,7,0,7,4,0,4
2023-06-01,63403,1,1,2,2,1,2
2023-06-01,13901,1,1,2,2,2,2
2023-06-01,54112,2,1,3,2,2,2
2023-06-01,32478,1,1,2,7,5,7
2023-06-01,10717,6,0,6,4,0,4
2023-06-01,14199,1,0,1,3,0,3
2023-06-01,29811,1,0,1,1,0,1
2023-06-01,10558,2,0,2,3,0,3
2023-06-01,36363,4,1,5,2,1,2
2023-06-01,11439,1,0,1,3,0,3
2023-06-01,13813,1,1,2,1,1,2
2023-06-01,22464,3,1,4,1,1,1
2023-06-01,398557,1,0,1,1,0,1
2023-06-01,394026,1,0,1,3,0,3
2023-06-01,398539,1,0,1,3,0,3
2023-06-01,33516,6,0,6,3,0,3
2023-06-01,26974,6,0,6,2,0,2
2023-06-01,13928,2,0,2,2,0,2
2023-06-01,394603,1,0,1,2,0,2
2023-06-01,36255,1,0,1,3,0,3
2023-06-01,14653,2,0,2,2,0,2
2023-06-01,23299,1,0,1,3,0,3
2023-06-01,23394,3,0,3,2,0,2
2023-06-01,19321,2,0,2,4,0,4
2023-06-01,16624,8,0,8,3,0,3
2023-06-01,3060,1,0,1,1,0,1
2023-06-01,46546,1,0,1,2,0,2
2023-06-01,22472,5,0,5,2,0,2
2023-06-01,395320,2,0,2,3,0,3
2023-06-01,393848,1,0,1,3,0,3
2023-06-01,54752,1,0,1,1,0,1
2023-06-01,31887,1,0,1,1,0,1
2023-06-01,400048,1,0,1,1,0,1
2023-06-01,395018,1,0,1,3,0,3
2023-06-01,398392,1,0,1,1,0,1
2023-06-01,395196,1,0,1,2,0,2
2023-06-01,394478,2,0,2,1,0,1
2023-06-01,6061,1,0,1,1,0,1
2023-06-01,14999,2,0,2,2,0,2
2023-06-01,16520,1,0,1,3,0,3
2023-06-01,14042,3,0,3,6,0,6
2023-06-01,46279,3,0,3,3,0,3
2023-06-01,53590,2,0,2,1,0,1
2023-06-01,19053,9,0,9,3,0,3
2023-06-01,6931,2,0,2,2,0,2
2023-06-01,16409,4,1,5,3,2,4
2023-06-01,36215,4,0,4,1,0,1
2023-06-01,53684,8,0,8,3,0,3
2023-06-01,22038,4,0,4,2,0,2
2023-06-01,46479,8,0,8,1,0,1
2023-06-01,33583,3,0,3,2,0,2
2023-06-01,13532,1,0,1,1,0,1
2023-06-01,17269,3,0,3,2,0,2
2023-06-01,30615,1,0,1,1,0,1
2023-06-01,54962,1,0,1,1,0,1
2023-06-01,25665,1,0,1,3,0,3
2023-06-01,5958,1,0,1,2,0,2
2023-06-01,46504,3,0,3,3,0,3
2023-06-01,397295,1,0,1,1,0,1
2023-06-01,393832,3,0,3,4,0,4
2023-06-01,394404,3,0,3,1,0,1
2023-06-01,394244,2,0,2,2,0,2
2023-06-01,11875,1,0,1,3,0,3
2023-06-01,398881,1,0,1,1,0,1
2023-06-01,32992,1,0,1,3,0,3
2023-06-01,30686,4,0,4,2,0,2
2023-06-01,19044,1,0,1,2,0,2
2023-06-01,397512,2,0,2,4,0,4
2023-06-01,26045,1,0,1,1,0,1
2023-06-01,40369,1,0,1,3,0,3
2023-06-01,14525,6,4,10,3,2,3
2023-06-01,33174,2,3,5,3,3,3
2023-06-01,29781,3,0,3,3,0,3
2023-06-01,36745,8,0,8,1,0,1
2023-06-01,36365,2,0,2,3,0,3
2023-06-01,4880,6,0,6,3,0,3
2023-06-01,395727,0,0,0,3,0,3
2023-06-01,47074,3,0,3,2,0,2
2023-06-01,12155,1,1,2,2,3,3
2023-06-01,36645,3,0,3,1,0,1
2023-06-01,40014,1,0,1,1,0,1
2023-06-01,35958,2,0,2,2,0,2
2023-06-01,5728,3,0,3,1,0,1
2023-06-01,40116,1,0,1,1,0,1
2023-06-01,394299,1,0,1,1,0,1
2023-06-01,27337,2,1,3,1,1,1
2023-06-01,46523,1,0,1,1,0,1
2023-06-01,22748,8,0,8,2,0,2
2023-06-01,47019,1,0,1,1,0,1
2023-06-01,53918,1,0,1,3,0,3
2023-06-01,27267,1,0,1,1,0,1
2023-06-01,17159,1,0,1,2,0,2
2023-06-01,63419,3,0,3,5,0,5
2023-06-01,198998,1,1,2,1,1,1
2023-06-01,61368,1,0,1,1,0,1
2023-06-01,26700,2,0,2,3,0,3
2023-06-01,36256,2,0,2,2,0,2
2023-06-01,54427,22,0,22,1,0,1
2023-06-01,393313,1,0,1,1,0,1
2023-06-01,36467,2,0,2,2,0,2
2023-06-01,29943,2,0,2,2,0,2
2023-06-01,46653,6,0,6,2,0,2
2023-06-01,1666,2,0,2,1,0,1
2023-06-01,62475,1,0,1,2,0,2
2023-06-01,54191,4,0,4,2,0,2
2023-06-01,54233,4,0,4,2,0,2
2023-06-01,46851,3,0,3,4,0,4
2023-06-01,14935,3,3,6,4,2,4
2023-06-01,32401,1,0,1,2,0,2
2023-06-01,53636,7,0,7,8,0,8
2023-06-01,32546,4,0,4,3,0,3
2023-06-01,27434,3,0,3,2,0,2
2023-06-01,26196,1,0,1,1,0,1
2023-06-01,398192,3,0,3,3,0,3
2023-06-01,11277,2,0,2,3,0,3
2023-06-01,394523,1,0,1,1,0,1
2023-06-01,46540,1,0,1,2,0,2
2023-06-01,16614,2,1,3,1,1,1
2023-06-01,395241,2,0,2,3,0,3
2023-06-01,53877,1,1,2,3,2,3
2023-06-01,16841,13,0,13,4,0,4
2023-06-01,14824,0,0,0,3,0,3
2023-06-01,31773,2,0,2,3,0,3
2023-06-01,394889,4,1,5,4,1,4
2023-06-01,33316,5,0,5,3,0,3
2023-06-01,40457,2,0,2,3,0,3
2023-06-01,53312,2,0,2,1,0,1
2023-06-01,10580,1,0,1,1,0,1
2023-06-01,33040,1,1,2,1,1,1
2023-06-01,64231,2,0,2,1,0,1
2023-06-01,33260,7,2,9,1,1,1
2023-06-01,40346,4,0,4,6,0,6
2023-06-01,40810,5,0,5,1,0,1
2023-06-01,3571,20,0,20,2,0,2
2023-06-01,138180,32,0,32,1,0,1
2023-06-01,3104,5,0,5,1,0,1
2023-06-01,3087,5,0,5,1,0,1
2023-06-01,4427,1,0,1,1,0,1
2023-06-01,400612,1,0,1,1,0,1
2023-06-01,23230,8,0,8,2,0,2
2023-06-01,7765,4,0,4,2,0,2
2023-06-01,54022,2,0,2,1,0,1
2023-06-01,36257,1,0,1,1,0,1
2023-06-01,46511,1,0,1,1,0,1
2023-06-01,27256,1,0,1,1,0,1
2023-06-01,283,2,0,2,1,0,1
2023-06-01,32740,6,0,6,2,0,2
2023-06-01,399110,3,0,3,2,0,2
2023-06-01,53652,1,0,1,1,0,1
2023-06-01,29801,1,0,1,2,0,2
2023-06-01,26371,2,0,2,1,0,1
2023-06-01,16886,5,0,5,3,0,3
2023-06-01,62914,4,0,4,1,0,1
2023-06-01,27631,12,0,12,4,0,4
2023-06-01,35891,18,1,19,3,2,3
2023-06-01,29907,6,0,6,2,0,2
2023-06-01,53676,2,0,2,1,0,1
2023-06-01,53687,4,0,4,3,0,3
2023-06-01,53674,2,0,2,1,0,1
2023-06-01,33277,4,0,4,3,0,3
2023-06-01,53661,16,0,16,5,0,5
2023-06-01,40592,1,0,1,1,0,1
2023-06-01,29901,2,0,2,1,0,1
2023-06-01,36056,1,0,1,3,0,3
2023-06-01,18752,1,0,1,1,0,1
2023-06-01,22803,6,0,6,1,0,1
2023-06-01,53665,3,0,3,1,0,1
2023-06-01,14118,2,0,2,1,0,1
2023-06-01,14190,3,0,3,2,0,2
2023-06-01,395807,8,0,8,1,0,1
2023-06-01,46383,5,0,5,3,0,3
2023-06-01,34774,7,0,7,1,0,1
2023-06-01,54282,1,1,2,1,1,1
2023-06-01,35923,3,0,3,5,0,5
2023-06-01,23368,4,0,4,2,0,2
2023-06-01,14409,2,0,2,1,0,1
2023-06-01,27192,4,0,4,1,0,1
2023-06-01,13824,1,0,1,1,0,1
2023-06-01,16619,1,0,1,2,0,2
2023-06-01,36521,3,0,3,1,0,1
2023-06-01,14193,3,0,3,2,0,2
2023-06-01,18560,1,0,1,1,0,1
2023-06-01,54596,3,0,3,1,0,1
2023-06-01,7839,2,0,2,3,0,3
2023-06-01,21722,4,1,5,4,3,5
2023-06-01,19142,7,0,7,1,0,1
2023-06-01,393724,3,0,3,1,0,1
2023-06-01,14930,1,0,1,1,0,1
2023-06-01,35967,7,0,7,5,0,5
2023-06-01,22081,3,0,3,1,0,1
2023-06-01,11190,2,0,2,1,0,1
2023-06-01,30166,1,0,1,1,0,1
2023-06-01,30046,4,0,4,4,0,4
2023-06-01,18614,1,0,1,1,0,1
2023-06-01,11667,8,0,8,2,0,2
2023-06-01,17285,1,0,1,2,0,2
2023-06-01,23295,1,0,1,1,0,1
2023-06-01,32144,4,0,4,1,0,1
2023-06-01,393220,1,1,2,4,4,4
2023-06-01,18588,8,0,8,1,0,1
2023-06-01,395817,4,0,4,3,0,3
2023-06-01,26234,3,0,3,2,0,2
2023-06-01,36235,4,0,4,2,0,2
2023-06-01,394250,1,0,1,3,0,3
2023-06-01,3411,4,0,4,3,0,3
2023-06-01,22445,4,0,4,1,0,1
2023-06-01,398750,2,0,2,1,0,1
2023-06-01,29771,6,0,6,1,0,1
2023-06-01,1730,10,0,10,3,0,3
2023-06-01,29823,4,0,4,5,0,5
2023-06-01,16783,1,0,1,2,0,2
2023-06-01,13751,1,0,1,1,0,1
2023-06-01,46191,5,0,5,1,0,1
2023-06-01,398933,1,0,1,1,0,1
2023-06-01,400356,1,0,1,1,0,1
2023-06-01,394364,1,0,1,1,0,1
2023-06-01,399225,1,0,1,1,0,1
2023-06-01,400527,1,0,1,1,0,1
2023-06-01,20286,2,0,2,2,0,2
2023-06-01,22962,1,0,1,1,0,1
2023-06-01,54560,2,0,2,1,0,1
2023-06-01,19007,1,0,1,1,0,1
2023-06-01,32955,1,0,1,3,0,3
2023-06-01,396402,4,0,4,2,0,2
2023-06-01,400711,1,0,1,1,0,1
2023-06-01,11746,4,0,4,4,0,4
2023-06-01,54237,1,0,1,2,0,2
2023-06-01,397342,2,0,2,3,0,3
2023-06-01,17245,3,0,3,2,0,2
2023-06-01,36272,1,0,1,1,0,1
2023-06-01,11724,7,1,8,3,1,3
2023-06-01,18742,3,0,3,3,0,3
2023-06-01,54313,4,0,4,3,0,3
2023-06-01,33226,3,0,3,1,0,1
2023-06-01,31897,1,0,1,1,0,1
2023-06-01,54305,4,0,4,3,0,3
2023-06-01,29988,1,0,1,2,0,2
2023-06-01,399211,1,0,1,1,0,1
2023-06-01,20383,2,0,2,4,0,4
2023-06-01,20160,3,0,3,1,0,1
2023-06-01,22237,1,0,1,2,0,2
2023-06-01,395997,4,0,4,2,0,2
2023-06-01,394436,1,0,1,1,0,1
2023-06-01,53829,11,0,11,1,0,1
2023-06-01,395498,1,0,1,1,0,1
2023-06-01,32937,1,0,1,1,0,1
2023-06-01,394186,1,1,2,2,1,2
2023-06-01,32006,4,0,4,1,0,1
2023-06-01,54557,1,1,2,2,1,2
2023-06-01,31808,1,0,1,2,0,2
2023-06-01,64218,1,0,1,1,0,1
2023-06-01,63249,2,0,2,2,0,2
2023-06-01,21849,3,0,3,1,0,1
2023-06-01,26814,2,0,2,1,0,1
2023-06-01,19445,1,0,1,2,0,2
2023-06-01,29778,1,0,1,1,0,1
2023-06-01,21913,4,0,4,1,0,1
2023-06-01,27197,1,0,1,1,0,1
2023-06-01,27326,7,0,7,2,0,2
2023-06-01,395952,1,0,1,3,0,3
2023-06-01,395838,2,0,2,2,0,2
2023-06-01,22222,1,0,1,2,0,2
2023-06-01,36797,2,0,2,2,0,2
2023-06-01,47022,5,0,5,1,0,1
2023-06-01,14515,1,0,1,2,0,2
2023-06-01,40018,1,0,1,2,0,2
2023-06-01,19722,1,0,1,1,0,1
2023-06-01,16978,1,0,1,3,0,3
2023-06-01,22487,4,0,4,3,0,3
2023-06-01,22873,4,0,4,2,0,2
2023-06-01,19467,1,0,1,2,0,2
2023-06-01,40539,7,0,7,1,0,1
2023-06-01,23489,12,0,12,1,0,1
2023-06-01,399386,1,0,1,2,0,2
2023-06-01,14932,2,0,2,1,0,1
2023-06-01,14913,3,0,3,1,0,1
2023-06-01,13779,2,0,2,2,0,2
2023-06-01,1809,1,0,1,1,0,1
2023-06-01,394359,1,0,1,1,0,1
2023-06-01,54765,2,0,2,2,0,2
2023-06-01,394598,4,0,4,2,0,2
2023-06-01,394332,1,0,1,1,0,1
2023-06-01,395640,1,0,1,1,0,1
2023-06-01,397171,3,0,3,1,0,1
2023-06-01,33555,2,0,2,1,0,1
2023-06-01,393302,1,0,1,3,0,3
2023-06-01,7963,1,0,1,1,0,1
2023-06-01,399472,1,0,1,1,0,1
2023-06-01,395518,2,1,3,2,2,2
2023-06-01,27474,1,0,1,3,0,3
2023-06-01,36163,1,0,1,1,0,1
2023-06-01,36460,2,0,2,1,0,1
2023-06-01,54342,1,0,1,3,0,3
2023-06-01,4497,5,0,5,1,0,1
2023-06-01,1610,30,1,31,3,1,3
2023-06-01,393585,3,0,3,1,0,1
2023-06-01,11153,0,0,0,2,0,2
2023-06-01,46179,2,0,2,2,0,2
2023-06-01,27500,1,1,2,2,1,2
2023-06-01,46897,1,0,1,3,0,3
2023-06-01,25995,5,0,5,1,0,1
2023-06-01,30054,1,0,1,1,0,1
2023-06-01,54383,1,0,1,2,0,2
2023-06-01,13315,3,0,3,1,0,1
2023-06-01,19065,9,1,10,4,2,4
2023-06-01,54767,1,0,1,4,0,4
2023-06-01,22629,12,0,12,3,0,3
2023-06-01,32536,2,0,2,3,0,3
2023-06-01,46798,2,0,2,4,0,4
2023-06-01,36486,1,0,1,3,0,3
2023-06-01,22861,4,0,4,1,0,1
2023-06-01,46982,1,0,1,1,0,1
2023-06-01,17335,1,0,1,2,0,2
2023-06-01,26745,1,0,1,2,0,2
2023-06-01,53311,1,0,1,1,0,1
2023-06-01,46468,1,0,1,2,0,2
2023-06-01,54015,1,0,1,2,0,2
2023-06-01,393804,1,0,1,1,0,1
2023-06-01,26139,3,0,3,2,0,2
2023-06-01,26661,3,0,3,1,0,1
2023-06-01,29813,3,0,3,3,0,3
2023-06-01,16501,8,0,8,1,0,1
2023-06-01,1414,4,0,4,3,0,3
2023-06-01,20187,6,0,6,6,0,6
2023-06-01,25987,1,0,1,1,0,1
2023-06-01,46110,2,0,2,3,0,3
2023-06-01,395446,5,0,5,2,0,2
2023-06-01,33411,2,0,2,2,0,2
2023-06-01,19185,11,0,11,2,0,2
2023-06-01,33312,1,0,1,2,0,2
2023-06-01,26128,8,0,8,1,0,1
2023-06-01,16939,8,0,8,4,0,4
2023-06-01,33329,6,0,6,1,0,1
2023-06-01,27014,1,0,1,2,0,2
2023-06-01,398048,2,0,2,3,0,3
2023-06-01,14722,1,0,1,3,0,3
2023-06-01,14583,2,0,2,3,0,3
2023-06-01,12272,4,0,4,4,0,4
2023-06-01,20267,1,0,1,1,0,1
2023-06-01,15177,3,0,3,7,0,7
2023-06-01,398400,2,0,2,1,0,1
2023-06-01,36682,1,0,1,1,0,1
2023-06-01,26172,1,0,1,2,0,2
2023-06-01,31751,1,0,1,1,0,1
2023-06-01,11783,3,0,3,5,0,5
2023-06-01,32823,2,0,2,3,0,3
2023-06-01,395349,4,1,5,1,1,1
2023-06-01,22759,1,0,1,1,0,1
2023-06-01,36482,1,0,1,2,0,2
2023-06-01,54860,1,0,1,1,0,1
2023-06-01,54824,1,0,1,2,0,2
2023-06-01,11729,1,0,1,3,0,3
2023-06-01,397632,1,0,1,2,0,2
2023-06-01,10844,4,0,4,4,0,4
2023-06-01,25777,1,0,1,3,0,3
2023-06-01,10868,1,0,1,1,0,1
2023-06-01,32216,4,0,4,1,0,1
2023-06-01,394572,5,0,5,1,0,1
2023-06-01,36157,1,0,1,1,0,1
2023-06-01,3629,1,1,2,2,2,2
2023-06-01,3630,2,1,3,1,1,1
2023-06-01,25680,6,0,6,1,0,1
2023-06-01,5306,28,0,28,2,0,2
2023-06-01,5982,2,0,2,1,0,1
2023-06-01,19964,4,0,4,1,0,1
2023-06-01,33209,1,0,1,1,0,1
2023-06-01,36079,2,0,2,1,0,1
2023-06-01,11239,3,1,4,2,2,2
2023-06-01,32369,5,0,5,2,0,2
2023-06-01,395017,1,0,1,2,0,2
2023-06-01,26181,1,0,1,1,0,1
2023-06-01,394275,1,1,2,3,1,3
2023-06-01,16708,1,0,1,1,0,1
2023-06-01,19160,3,0,3,1,0,1
2023-06-01,393246,1,1,2,2,2,2
2023-06-01,54871,1,0,1,3,0,3
2023-06-01,53659,1,0,1,1,0,1
2023-06-01,400016,1,0,1,1,0,1
2023-06-01,400112,2,0,2,2,0,2
2023-06-01,33514,1,0,1,1,0,1
2023-06-01,36210,1,1,2,4,4,4
2023-06-01,33751,1,0,1,2,0,2
2023-06-01,54491,1,0,1,2,0,2
2023-06-01,27011,16,0,16,8,0,8
2023-06-01,40428,14,7,21,5,4,5
2023-06-01,22518,2,1,3,4,4,4
2023-06-01,36301,1,0,1,3,0,3
2023-06-01,6337,2,0,2,1,0,1
2023-06-01,31900,1,0,1,2,0,2
2023-06-01,394576,6,0,6,1,0,1
2023-06-01,36708,1,0,1,3,0,3
2023-06-01,398010,1,0,1,2,0,2
2023-06-01,15112,1,0,1,2,0,2
2023-06-01,395999,1,0,1,1,0,1
2023-06-01,33155,5,0,5,2,0,2
2023-06-01,23177,7,0,7,3,0,3
2023-06-01,46291,1,0,1,1,0,1
2023-06-01,398749,1,0,1,2,0,2
2023-06-01,33169,1,0,1,1,0,1
2023-06-01,54762,1,0,1,2,0,2
2023-06-01,54760,1,0,1,1,0,1
2023-06-01,64536,0,0,0,2,0,2
2023-06-01,397587,1,0,1,3,0,3
2023-06-01,13858,1,0,1,1,0,1
2023-06-01,396011,2,0,2,3,0,3
2023-06-01,26815,5,0,5,4,0,4
2023-06-01,40782,3,0,3,3,0,3
2023-06-01,399903,2,0,2,3,0,3
2023-06-01,36596,1,0,1,2,0,2
2023-06-01,18905,1,0,1,2,0,2
2023-06-01,54637,1,0,1,1,0,1
2023-06-01,53770,3,0,3,3,0,3
2023-06-01,6298,0,0,0,2,0,2
2023-06-01,53739,3,0,3,1,0,1
2023-06-01,22728,2,0,2,3,0,3
2023-06-01,53797,1,0,1,1,0,1
2023-06-01,20048,1,0,1,1,0,1
2023-06-01,25753,14,0,14,5,0,5
2023-06-01,25919,2,0,2,2,0,2
2023-06-01,23095,3,0,3,3,0,3
2023-06-01,20271,5,0,5,1,0,1
2023-06-01,36587,1,0,1,3,0,3
2023-06-01,14933,1,0,1,3,0,3
2023-06-01,62983,5,0,5,3,0,3
2023-06-01,394020,1,0,1,1,0,1
2023-06-01,394318,1,0,1,3,0,3
2023-06-01,1617,1,0,1,2,0,2
2023-06-01,32379,1,0,1,1,0,1
2023-06-01,23370,1,0,1,1,0,1
2023-06-01,53988,3,1,4,1,1,1
2023-06-01,62504,1,0,1,3,0,3
2023-06-01,400553,1,0,1,1,0,1
2023-06-01,395925,1,0,1,1,0,1
2023-06-01,54413,3,2,5,1,1,1
2023-06-01,22101,4,0,4,1,0,1
2023-06-01,26150,1,0,1,3,0,3
2023-06-01,7733,10,0,10,1,0,1
2023-06-01,40943,3,1,4,2,1,2
2023-06-01,26646,14,0,14,1,0,1
2023-06-01,53715,3,0,3,1,0,1
2023-06-01,14632,3,0,3,3,0,3
2023-06-01,397331,1,0,1,2,0,2
2023-06-01,32556,1,0,1,2,0,2
2023-06-01,395189,5,0,5,5,0,5
2023-06-01,14575,1,0,1,2,0,2
2023-06-01,396286,4,0,4,3,0,3
2023-06-01,54507,1,0,1,1,0,1
2023-06-01,54593,2,0,2,5,0,5
2023-06-01,46721,2,0,2,2,0,2
2023-06-01,62907,2,4,6,2,1,2
2023-06-01,27002,1,0,1,1,0,1
2023-06-01,26001,9,0,9,4,0,4
2023-06-01,27595,2,0,2,2,0,2
2023-06-01,22906,4,3,7,2,1,2
2023-06-01,20447,10,0,10,1,0,1
2023-06-01,27600,2,0,2,2,0,2
2023-06-01,6562,1,0,1,1,0,1
2023-06-01,53494,4,0,4,3,0,3
2023-06-01,395101,1,0,1,1,0,1
2023-06-01,54851,1,0,1,1,0,1
2023-06-01,5110,5,0,5,2,0,2
2023-06-01,54310,1,1,2,3,1,3
2023-06-01,14850,2,0,2,3,0,3
2023-06-01,398085,1,0,1,2,0,2
2023-06-01,393673,1,0,1,2,0,2
2023-06-01,6976,12,0,12,1,0,1
2023-06-01,53535,3,3,6,2,2,2
2023-06-01,32529,1,0,1,2,0,2
2023-06-01,19034,2,0,2,2,0,2
2023-06-01,36466,2,0,2,3,0,3
2023-06-01,53872,2,1,3,2,1,2
2023-06-01,22770,3,0,3,3,0,3
2023-06-01,22160,1,0,1,1,0,1
2023-06-01,19634,1,0,1,1,0,1
2023-06-01,54764,1,0,1,2,0,2
2023-06-01,398551,1,0,1,3,0,3
2023-06-01,399701,1,0,1,2,0,2
2023-06-01,22043,2,0,2,3,0,3
2023-06-01,47032,1,0,1,1,0,1
2023-06-01,22609,1,0,1,1,0,1
2023-06-01,53571,16,0,16,10,0,10
2023-06-01,33374,1,0,1,3,0,3
2023-06-01,398319,1,1,2,2,2,2
2023-06-01,30283,5,0,5,2,0,2
2023-06-01,35965,1,0,1,2,0,2
2023-06-01,400375,1,0,1,3,0,3
2023-06-01,54618,2,0,2,3,0,3
2023-06-01,54636,1,0,1,3,0,3
2023-06-01,54539,3,0,3,3,0,3
2023-06-01,397526,1,0,1,1,0,1
2023-06-01,397626,1,0,1,2,0,2
2023-06-01,54110,9,0,9,2,0,2
2023-06-01,18442,1,0,1,1,0,1
2023-06-01,27223,4,0,4,1,0,1
2023-06-01,198862,1,0,1,1,0,1
2023-06-01,54634,1,0,1,1,0,1
2023-06-01,13972,1,0,1,4,0,4
2023-06-01,54558,1,0,1,1,0,1
2023-06-01,11610,1,0,1,1,0,1
2023-06-01,13801,1,0,1,2,0,2
2023-06-01,19793,1,0,1,1,0,1
2023-06-01,25711,2,0,2,3,0,3
2023-06-01,53529,1,0,1,2,0,2
2023-06-01,14584,1,0,1,1,0,1
2023-06-01,21592,2,0,2,1,0,1
2023-06-01,63236,4,0,4,3,0,3
2023-06-01,54662,1,0,1,1,0,1
2023-06-01,32792,1,0,1,1,0,1
2023-06-01,394650,1,0,1,1,0,1
2023-06-01,396951,1,0,1,1,0,1
2023-06-01,396960,1,0,1,1,0,1
2023-06-01,395156,3,0,3,3,0,3
2023-06-01,393468,2,1,3,3,1,3
2023-06-01,33096,2,0,2,4,0,4
2023-06-01,398399,1,1,2,1,1,1
2023-06-01,399119,1,0,1,1,0,1
2023-06-01,13699,1,1,2,2,1,2
2023-06-01,32667,12,0,12,4,0,4
2023-06-01,22485,1,0,1,1,0,1
2023-06-01,395778,3,0,3,4,0,4
2023-06-01,399776,2,0,2,1,0,1
2023-06-01,27429,2,0,2,1,0,1
2023-06-01,398126,1,0,1,1,0,1
2023-06-01,13377,1,0,1,1,0,1
2023-06-01,47043,1,0,1,2,0,2
2023-06-01,53838,2,0,2,3,0,3
2023-06-01,18890,1,0,1,2,0,2
2023-06-01,33116,1,0,1,1,0,1
2023-06-01,13578,1,1,2,1,1,1
2023-06-01,40424,4,0,4,3,0,3
2023-06-01,32576,2,0,2,3,0,3
2023-06-01,53871,4,0,4,1,0,1
2023-06-01,53836,8,0,8,2,0,2
2023-06-01,54260,1,0,1,1,0,1
2023-06-01,40646,1,1,2,1,1,1
2023-06-01,14940,1,0,1,1,0,1
2023-06-01,35895,5,0,5,1,0,1
2023-06-01,26574,2,0,2,2,0,2
2023-06-01,36431,5,0,5,3,0,3
2023-06-01,396206,18,0,18,3,0,3
2023-06-01,19470,2,1,3,1,1,1
2023-06-01,46635,1,0,1,1,0,1
2023-06-01,53909,2,0,2,2,0,2
2023-06-01,53941,4,0,4,3,0,3
2023-06-01,22784,7,0,7,2,0,2
2023-06-01,32410,3,0,3,2,0,2
2023-06-01,31832,1,0,1,2,0,2
2023-06-01,32435,1,1,2,1,1,1
2023-06-01,20338,1,0,1,3,0,3
2023-06-01,26428,6,0,6,2,0,2
2023-06-01,11326,4,0,4,1,0,1
2023-06-01,400157,2,0,2,1,0,1
2023-06-01,11082,2,0,2,1,0,1
2023-06-01,397308,2,0,2,1,0,1
2023-06-01,40628,8,0,8,3,0,3
2023-06-01,54656,1,0,1,1,0,1
2023-06-01,18760,4,0,4,3,0,3
2023-06-01,395750,1,0,1,2,0,2
2023-06-01,32117,2,0,2,2,0,2
2023-06-01,12116,2,0,2,1,0,1
2023-06-01,394349,1,0,1,1,0,1
2023-06-01,23398,1,0,1,1,0,1
2023-06-01,46561,3,0,3,1,0,1
2023-06-01,398711,1,0,1,1,0,1
2023-06-01,33553,1,0,1,1,0,1
2023-06-01,19023,8,0,8,1,0,1
2023-06-01,19713,3,0,3,2,0,2
2023-06-01,53975,8,0,8,2,0,2
2023-06-01,20101,15,0,15,3,0,3
2023-06-01,14243,1,0,1,2,0,2
2023-06-01,394825,1,0,1,1,0,1
2023-06-01,394696,1,0,1,2,0,2
2023-06-01,396049,1,0,1,1,0,1
2023-06-01,53911,4,0,4,1,0,1
2023-06-01,53948,4,0,4,1,0,1
2023-06-01,40187,8,1,9,4,1,4
2023-06-01,26027,2,0,2,1,0,1
2023-06-01,400332,1,0,1,1,0,1
2023-06-01,27305,1,0,1,1,0,1
2023-06-01,16837,6,0,6,2,0,2
2023-06-01,4514,3,0,3,3,0,3
2023-06-01,53757,4,0,4,1,0,1
2023-06-01,927,2,0,2,2,0,2
2023-06-01,7252,1,0,1,2,0,2
2023-06-01,16440,0,0,0,2,0,2
2023-06-01,18925,1,0,1,3,0,3
2023-06-01,132576,4,0,4,3,0,3
2023-06-01,394841,1,0,1,2,0,2
2023-06-01,16638,8,0,8,2,0,2
2023-06-01,10808,2,0,2,1,0,1
2023-06-01,1634,1,0,1,1,0,1
2023-06-01,54722,1,1,2,3,1,4
2023-06-01,4199,2,0,2,3,0,3
2023-06-01,4205,3,0,3,3,0,3
2023-06-01,11458,1,0,1,3,0,3
2023-06-01,25720,9,3,12,4,3,4
2023-06-01,30680,3,0,3,2,0,2
2023-06-01,21635,1,0,1,3,0,3
2023-06-01,40198,5,0,5,3,0,3
2023-06-01,53605,2,0,2,1,0,1
2023-06-01,12259,2,3,5,3,2,3
2023-06-01,397949,1,0,1,3,0,3
2023-06-01,398236,0,0,0,2,0,2
2023-06-01,397814,2,0,2,1,0,1
2023-06-01,26257,1,0,1,2,0,2
2023-06-01,399607,1,0,1,2,0,2
2023-06-01,3677,1,1,2,1,1,1
2023-06-01,397607,2,0,2,1,0,1
2023-06-01,26323,1,0,1,1,0,1
2023-06-01,13686,1,0,1,2,0,2
2023-06-01,13552,1,0,1,1,0,1
2023-06-01,26304,2,0,2,3,0,3
2023-06-01,32735,1,0,1,3,0,3
2023-06-01,13625,2,0,2,3,0,3
2023-06-01,10359,1,1,2,2,2,2
2023-06-01,36506,1,0,1,2,0,2
2023-06-01,53713,3,0,3,5,0,5
2023-06-01,32605,2,0,2,1,0,1
2023-06-01,11189,8,0,8,2,0,2
2023-06-01,32659,1,0,1,1,0,1
2023-06-01,36018,1,0,1,1,0,1
2023-06-01,199829,1,0,1,2,0,2
2023-06-01,40035,3,2,5,2,2,2
2023-06-01,29994,8,0,8,3,0,3
2023-06-01,40059,4,0,4,2,0,2
2023-06-01,7227,33,0,33,5,0,5
2023-06-01,5978,3,1,4,1,1,1
2023-06-01,664,2,0,2,1,0,1
2023-06-01,393225,1,1,2,4,4,4
2023-06-01,54397,2,0,2,2,0,2
2023-06-01,17181,1,0,1,3,0,3
2023-06-01,33389,2,0,2,2,0,2
2023-06-01,15158,3,0,3,4,0,4
2023-06-01,395593,1,0,1,1,0,1
2023-06-01,9327,2,0,2,2,0,2
2023-06-01,13374,1,0,1,1,0,1
2023-06-01,16881,1,1,2,1,1,1
2023-06-01,395863,3,0,3,1,0,1
2023-06-01,399630,1,1,2,1,1,2
2023-06-01,395741,2,0,2,1,0,1
2023-06-01,837,1,0,1,1,0,1
2023-06-01,31765,2,0,2,2,0,2
2023-06-01,32789,3,0,3,1,0,1
2023-06-01,25872,1,0,1,2,0,2
2023-06-01,54477,1,0,1,2,0,2
2023-06-01,54941,1,0,1,4,0,4
2023-06-01,54453,2,0,2,2,0,2
2023-06-01,32142,2,0,2,3,0,3
2023-06-01,22713,2,0,2,3,0,3
2023-06-01,14205,2,0,2,1,0,1
2023-06-01,399828,1,0,1,2,0,2
2023-06-01,3713,17,2,19,5,1,5
2023-06-01,22537,2,0,2,3,0,3
2023-06-01,26043,3,0,3,3,0,3
2023-06-01,395402,3,0,3,1,0,1
2023-06-01,14672,8,0,8,3,0,3
2023-06-01,17172,1,1,2,3,1,3
2023-06-01,54559,4,0,4,2,0,2
2023-06-01,16587,1,0,1,1,0,1
2023-06-01,397855,1,0,1,2,0,2
2023-06-01,53634,1,0,1,3,0,3
2023-06-01,26470,9,1,10,2,2,2
2023-06-01,29805,1,0,1,1,0,1
2023-06-01,133412,1,0,1,1,0,1
2023-06-01,9410,1,0,1,1,0,1
2023-06-01,139914,4,0,4,1,0,1
2023-06-01,32662,1,0,1,3,0,3
2023-06-01,10376,3,0,3,4,0,4
2023-06-01,22539,1,0,1,1,0,1
2023-06-01,11047,12,0,12,4,0,4
2023-06-01,399352,1,0,1,2,0,2
2023-06-01,54671,4,0,4,4,0,4
2023-06-01,54749,4,0,4,1,0,1
2023-06-01,54465,3,0,3,1,0,1
2023-06-01,46838,5,0,5,2,0,2
2023-06-01,16958,2,1,3,3,1,3
2023-06-01,397123,1,0,1,2,0,2
2023-06-01,399515,4,0,4,3,0,3
2023-06-01,15053,2,1,3,4,2,4
2023-06-01,395141,1,0,1,1,0,1
2023-06-01,36179,1,0,1,1,0,1
2023-06-01,32294,1,0,1,2,0,2
2023-06-01,54350,1,0,1,1,0,1
2023-06-01,63118,1,0,1,3,0,3
2023-06-01,31950,3,1,4,8,4,8
2023-06-01,26031,1,0,1,3,0,3
2023-06-01,62493,1,0,1,1,0,1
2023-06-01,54575,1,0,1,1,0,1
2023-06-01,30498,1,0,1,1,0,1
2023-06-01,397045,1,1,2,1,2,3
2023-06-01,397795,1,2,3,1,3,3
2023-06-01,7975,1,0,1,3,0,3
2023-06-01,40467,2,0,2,3,0,3
2023-06-01,26743,1,0,1,1,0,1
2023-06-01,23310,2,0,2,3,0,3
2023-06-01,26343,2,0,2,1,0,1
2023-06-01,19988,1,0,1,1,0,1
2023-06-01,33105,34,0,34,2,0,2
2023-06-01,13581,6,0,6,6,0,6
2023-06-01,22746,1,0,1,1,0,1
2023-06-01,46757,1,1,2,2,2,2
2023-06-01,30634,2,0,2,1,0,1
2023-06-01,21676,1,0,1,1,0,1
2023-06-01,62548,1,0,1,3,0,3
2023-06-01,40425,1,0,1,2,0,2
2023-06-01,400502,1,0,1,1,0,1
2023-06-01,13930,1,0,1,1,0,1
2023-06-01,54547,1,0,1,2,0,2
2023-06-01,46651,1,0,1,2,0,2
2023-06-01,399330,2,0,2,1,0,1
2023-06-01,11852,1,0,1,3,0,3
2023-06-01,398433,1,0,1,3,0,3
2023-06-01,3804,1,0,1,1,0,1
2023-06-01,53421,2,0,2,2,0,2
2023-06-01,401306,2,0,2,1,0,1
2023-06-01,21983,1,0,1,1,0,1
2023-06-01,40355,4,1,5,1,1,1
2023-06-01,54732,2,0,2,3,0,3
2023-06-01,27409,1,0,1,2,0,2
2023-06-01,396288,2,1,3,3,2,3
2023-06-01,54859,1,0,1,3,0,3
2023-06-01,16542,2,0,2,2,0,2
2023-06-01,19801,1,0,1,1,0,1
2023-06-01,394088,3,0,3,5,0,5
2023-06-01,395914,1,0,1,2,0,2
2023-06-01,54464,1,0,1,2,0,2
2023-06-01,2886,2,0,2,1,0,1
2023-06-01,400184,1,0,1,1,0,1
2023-06-01,40758,2,0,2,3,0,3
2023-06-01,393572,3,0,3,2,0,2
2023-06-01,55030,1,0,1,3,0,3
2023-06-01,394964,2,0,2,2,0,2
2023-06-01,393315,1,0,1,1,0,1
2023-06-01,393228,1,0,1,1,0,1
2023-06-01,17101,1,0,1,2,0,2
2023-06-01,18691,1,0,1,1,0,1
2023-06-01,46556,5,0,5,4,0,4
2023-06-01,54366,5,0,5,4,0,4
2023-06-01,47102,1,0,1,1,0,1
2023-06-01,25864,4,2,6,4,3,4
2023-06-01,22483,1,0,1,1,0,1
2023-06-01,30630,9,0,9,5,0,5
2023-06-01,32815,2,0,2,1,0,1
2023-06-01,7885,1,0,1,1,0,1
2023-06-01,398837,3,3,6,3,1,3
2023-06-01,33499,4,0,4,2,0,2
2023-06-01,27237,5,0,5,2,0,2
2023-06-01,35907,1,0,1,1,0,1
2023-06-01,15340,1,0,1,1,0,1
2023-06-01,16799,60,0,60,1,0,1
2023-06-01,400127,3,0,3,4,0,4
2023-06-01,393709,1,0,1,1,0,1
2023-06-01,397940,1,0,1,1,0,1
2023-06-01,21512,2,0,2,3,0,3
2023-06-01,16859,1,0,1,1,0,1
2023-06-01,396459,1,0,1,1,0,1
2023-06-01,22733,1,0,1,1,0,1
2023-06-01,54371,1,0,1,2,0,2
2023-06-01,397082,1,0,1,2,0,2
2023-06-01,54550,1,0,1,1,0,1
2023-06-01,26986,2,0,2,3,0,3
2023-06-01,40040,1,0,1,3,0,3
2023-06-01,15314,1,0,1,1,0,1
2023-06-01,23322,1,0,1,1,0,1
2023-06-01,18673,5,0,5,2,0,2
2023-06-01,47041,1,0,1,1,0,1
2023-06-01,16731,4,0,4,2,0,2
2023-06-01,19124,13,0,13,1,0,1
2023-06-01,26459,9,0,9,11,0,11
2023-06-01,8104,5,0,5,3,0,3
2023-06-01,394893,4,0,4,2,0,2
2023-06-01,397053,1,0,1,2,0,2
2023-06-01,19311,7,0,7,3,0,3
2023-06-01,393568,8,0,8,2,0,2
2023-06-01,13660,1,0,1,2,0,2
2023-06-01,394077,11,0,11,3,0,3
2023-06-01,40200,2,0,2,3,0,3
2023-06-01,399518,2,0,2,1,0,1
2023-06-01,53459,1,1,2,2,2,2
2023-06-01,46358,7,0,7,1,0,1
2023-06-01,54452,1,0,1,3,0,3
2023-06-01,4314,22,0,22,4,0,4
2023-06-01,395589,1,0,1,1,0,1
2023-06-01,39954,4,0,4,1,0,1
2023-06-01,4356,1,0,1,1,0,1
2023-06-01,13572,5,0,5,2,0,2
2023-06-01,13410,5,0,5,3,0,3
2023-06-01,32719,28,1,29,3,1,3
2023-06-01,22913,1,0,1,2,0,2
2023-06-01,398797,6,0,6,1,0,1
2023-06-01,53498,2,0,2,3,0,3
2023-06-01,55056,6,0,6,3,0,3
2023-06-01,1420,1,0,1,2,0,2
2023-06-01,53504,8,0,8,1,0,1
2023-06-01,11763,10,1,11,5,1,5
2023-06-01,13816,12,0,12,3,0,3
2023-06-01,263251,7,1,8,5,2,5
2023-06-01,28017,1,0,1,1,0,1
2023-06-01,27820,6,1,7,1,1,1
2023-06-01,61760,1,0,1,3,0,3
2023-06-01,270461,1,1,2,1,1,1
2023-06-01,61455,1,1,2,6,5,6
2023-06-01,61843,1,0,1,3,0,3
2023-06-01,61656,1,1,2,3,3,3
2023-06-01,264102,1,1,2,2,1,2
2023-06-01,52224,3,2,5,4,3,4
2023-06-01,61571,1,0,1,4,0,4
2023-06-01,264198,1,0,1,1,0,1
2023-06-01,264185,1,0,1,2,0,2
2023-06-01,28460,1,0,1,1,0,1
2023-06-01,264261,1,1,2,2,1,2
2023-06-01,27946,1,0,1,1,0,1
2023-06-01,27779,1,0,1,1,0,1
2023-06-01,27654,1,0,1,1,0,1
2023-06-01,27972,1,0,1,1,0,1
2023-06-01,271573,3,1,4,1,1,1
2023-06-01,27785,1,0,1,2,0,2
2023-06-01,272116,3,0,3,2,0,2
2023-06-01,7340,1,0,1,1,0,1
2023-06-01,28039,1,1,2,2,1,3
2023-06-01,267909,2,0,2,3,0,3
2023-06-01,27663,1,0,1,1,0,1
2023-06-01,270308,1,1,2,1,1,1
2023-06-01,20305,3,0,3,3,0,3
2023-06-01,27980,1,0,1,1,0,1
2023-06-01,27782,8,0,8,2,0,2
2023-06-01,6121,1,0,1,1,0,1
2023-06-01,270074,1,1,2,1,1,1
2023-06-01,52240,1,0,1,1,0,1
2023-06-01,270530,1,1,2,2,2,2
2023-06-01,27677,1,0,1,1,0,1
2023-06-01,16701,2,1,3,3,1,4
2023-06-01,21756,5,0,5,3,0,3
2023-06-01,27655,1,0,1,1,0,1
2023-06-01,271884,2,1,3,2,1,2
2023-06-01,27731,3,0,3,3,0,3
2023-06-01,266161,1,1,2,3,3,3
2023-06-01,18492,1,0,1,2,0,2
2023-06-01,21753,1,0,1,1,0,1
2023-06-01,207036,1,3,4,5,4,7
2023-06-01,269941,1,0,1,1,0,1
2023-06-01,3496,2,0,2,1,0,1
2023-06-01,52247,1,0,1,1,0,1
2023-06-01,27838,1,0,1,2,0,2
2023-06-01,27795,8,1,9,4,2,5
2023-06-01,265822,1,0,1,1,0,1
2023-06-01,7965,9,0,9,2,0,2
2023-06-01,27963,3,0,3,3,0,3
2023-06-01,14966,1,0,1,3,0,3
2023-06-01,20015,65,1,66,4,2,4
2023-06-01,263182,1,0,1,4,0,4
2023-06-01,27957,6,0,6,4,0,4
2023-06-01,269929,2,0,2,1,0,1
2023-06-01,28001,1,1,2,4,4,4
2023-06-01,26594,6,0,6,5,0,5
2023-06-01,262156,8,16,24,4,2,4
2023-06-01,52488,2,0,2,2,2,3
2023-06-01,28069,1,0,1,1,0,1
2023-06-01,28070,1,0,1,1,0,1
2023-06-01,27935,11,0,11,3,0,3
2023-06-01,28084,1,0,1,1,0,1
2023-06-01,270457,7,1,8,1,1,1
2023-06-01,17126,12,0,12,1,0,1
2023-06-01,27809,1,0,1,1,0,1
2023-06-01,271628,1,1,2,1,1,1
2023-06-01,28117,1,0,1,3,0,3
2023-06-01,8026,4,0,4,1,0,1
2023-06-01,14249,15,0,15,3,0,3
2023-06-01,20173,8,0,8,1,0,1
2023-06-01,27830,1,0,1,1,0,1
2023-06-01,22699,2,0,2,1,0,1
2023-06-01,18532,7,0,7,1,0,1
2023-06-01,271385,7,1,8,5,2,5
2023-06-01,271371,2,2,4,1,1,1
2023-06-01,271290,7,16,23,2,2,2
2023-06-01,271479,4,3,7,6,3,6
2023-06-01,271332,4,0,4,5,0,5
2023-06-01,271739,1,1,2,5,3,6
2023-06-01,271359,3,1,4,2,1,2
2023-06-01,271351,4,6,10,2,2,2
2023-06-01,271413,3,1,4,4,1,4
2023-06-01,272528,0,1,1,4,2,4
2023-06-01,5708,1,0,1,1,0,1
2023-06-01,27774,3,0,3,1,0,1
2023-06-01,23534,4,0,4,1,0,1
2023-06-01,264256,1,0,1,3,0,3
2023-06-01,262326,2,0,2,1,0,1
2023-06-01,53119,1,1,2,2,2,2
2023-06-01,20117,1,0,1,3,0,3
2023-06-01,27856,1,0,1,1,0,1
2023-06-01,27862,1,0,1,2,0,2
2023-06-01,19723,12,1,13,3,2,3
2023-06-01,271188,1,3,4,3,1,3
2023-06-01,270681,1,0,1,3,0,3
2023-06-01,270420,3,4,7,2,2,2
2023-06-01,27873,1,0,1,2,0,2
2023-06-01,27899,1,0,1,4,0,4
2023-06-01,27904,1,0,1,1,0,1
2023-06-01,27905,1,0,1,2,0,2
2023-06-01,269967,2,0,2,1,0,1
2023-06-01,6193,1,0,1,2,0,2
2023-06-01,270717,3,1,4,1,1,1
2023-06-01,270458,4,2,6,3,2,3
2023-06-01,270436,5,11,16,2,1,2
2023-06-01,264314,2,1,3,1,1,1
2023-06-01,52234,1,1,2,4,1,4
2023-06-01,52305,1,1,2,1,1,1
2023-06-01,61922,3,7,10,7,5,7
2023-06-01,264339,3,1,4,5,1,5
2023-06-01,28033,1,0,1,3,0,3
2023-06-01,28034,1,0,1,2,0,2
2023-06-01,52397,4,0,4,1,0,1
2023-06-01,27828,16,4,20,1,1,1
2023-06-01,264291,1,0,1,3,0,3
2023-06-01,263773,1,0,1,1,0,1
2023-06-01,266224,5,1,6,4,1,4
2023-06-01,266190,5,3,8,1,1,1
2023-06-01,264304,1,0,1,2,0,2
2023-06-01,263859,1,1,2,2,2,3
2023-06-01,61921,3,1,4,2,1,2
2023-06-01,28085,1,0,1,1,0,1
2023-06-01,10671,5,0,5,2,0,2
2023-06-01,264347,1,0,1,1,0,1
2023-06-01,264313,1,1,2,3,3,3
2023-06-01,263850,1,0,1,3,0,3
2023-06-01,263892,3,1,4,5,3,5
2023-06-01,264671,1,0,1,1,0,1
2023-06-01,264029,2,1,3,1,1,1
2023-06-01,271051,1,1,2,1,1,1
2023-06-01,40143,1,0,1,2,0,2
2023-06-01,264670,1,0,1,1,0,1
2023-06-01,263889,1,0,1,2,0,2
2023-06-01,265212,3,0,3,3,0,3
2023-06-01,264061,1,0,1,2,0,2
2023-06-01,263890,1,1,2,1,1,2
2023-06-01,264044,1,0,1,2,0,2
2023-06-01,270666,1,0,1,1,0,1
2023-06-01,264653,2,0,2,1,0,1
2023-06-01,263953,1,1,2,4,3,4
2023-06-01,264614,1,0,1,3,0,3
2023-06-01,28393,1,0,1,1,0,1
2023-06-01,265165,1,0,1,3,0,3
2023-06-01,264623,1,0,1,2,0,2
2023-06-01,28396,4,0,4,2,0,2
2023-06-01,264037,1,0,1,1,0,1
2023-06-01,265193,1,0,1,3,0,3
2023-06-01,265235,2,3,5,1,2,2
2023-06-01,264040,1,0,1,2,0,2
2023-06-01,264019,1,1,2,3,1,3
2023-06-01,27907,1,0,1,1,0,1
2023-06-01,264664,1,0,1,1,0,1
2023-06-01,264083,1,0,1,2,0,2
2023-06-01,264080,1,0,1,1,0,1
2023-06-01,27933,1,0,1,2,0,2
2023-06-01,27853,1,0,1,3,0,3
2023-06-01,27936,1,0,1,1,0,1
2023-06-01,270075,3,0,3,1,0,1
2023-06-01,263259,7,1,8,2,2,2
2023-06-01,61930,7,1,8,3,1,3
2023-06-01,264633,1,1,2,3,2,4
2023-06-01,28043,1,0,1,1,0,1
2023-06-01,264661,1,0,1,1,0,1
2023-06-01,264690,2,0,2,3,0,3
2023-06-01,52315,2,0,2,3,0,3
2023-06-01,264648,1,0,1,1,0,1
2023-06-01,64113,9,0,9,3,0,3
2023-06-01,264727,1,0,1,3,0,3
2023-06-01,265149,1,0,1,1,0,1
2023-06-01,265179,1,0,1,1,0,1
2023-06-01,265218,1,0,1,3,0,3
2023-06-01,265202,1,0,1,2,0,2
2023-06-01,264650,1,0,1,3,0,3
2023-06-01,265073,3,0,3,1,0,1
2023-06-01,262266,1,1,2,3,1,3
2023-06-01,27949,1,0,1,1,0,1
2023-06-01,264687,1,0,1,1,0,1
2023-06-01,27999,2,0,2,3,0,3
2023-06-01,265236,1,0,1,3,0,3
2023-06-01,265502,2,0,2,1,0,1
2023-06-01,265284,1,2,3,4,1,4
2023-06-01,27733,1,1,2,1,1,1
2023-06-01,15208,4,0,4,4,0,4
2023-06-01,265273,1,0,1,2,0,2
2023-06-01,265325,1,1,2,3,1,3
2023-06-01,28248,6,1,7,3,1,3
2023-06-01,28074,1,0,1,2,0,2
2023-06-01,270437,3,3,6,1,1,1
2023-06-01,271723,0,3,3,4,1,4
2023-06-01,270438,5,1,6,4,1,4
2023-06-01,272248,0,1,1,2,1,2
2023-06-01,270557,1,0,1,1,0,1
2023-06-01,28524,71,0,71,2,0,2
2023-06-01,7080,1,0,1,2,0,2
2023-06-01,265362,1,1,2,2,2,2
2023-06-01,27874,2,0,2,2,0,2
2023-06-01,52227,1,0,1,3,0,3
2023-06-01,270807,1,1,2,2,2,2
2023-06-01,265353,1,0,1,1,0,1
2023-06-01,262920,1,0,1,1,0,1
2023-06-01,11237,5,0,5,3,0,3
2023-06-01,52293,1,0,1,2,0,2
2023-06-01,52248,1,0,1,3,0,3
2023-06-01,52274,3,2,5,3,2,3
2023-06-01,27860,2,0,2,2,0,2
2023-06-01,272036,1,0,1,2,0,2
2023-06-01,272041,1,0,1,2,0,2
2023-06-01,269716,1,0,1,1,0,1
2023-06-01,28475,9,0,9,2,0,2
2023-06-01,52296,5,0,5,3,0,3
2023-06-01,270440,4,1,5,3,1,3
2023-06-01,17249,5,0,5,4,0,4
2023-06-01,52287,1,0,1,1,0,1
2023-06-01,27806,8,0,8,1,0,1
2023-06-01,28547,2,0,2,1,0,1
2023-06-01,263748,2,0,2,3,0,3
2023-06-01,27810,6,0,6,3,2,4
2023-06-01,269963,1,0,1,3,0,3
2023-06-01,271893,1,0,1,2,0,2
2023-06-01,271894,1,0,1,2,0,2
2023-06-01,271895,1,0,1,3,0,3
2023-06-01,262148,1,1,2,1,1,1
2023-06-01,270013,1,1,2,5,2,5
2023-06-01,52353,1,0,1,1,0,1
2023-06-01,262157,1,0,1,1,0,1
2023-06-01,27746,3,0,3,4,0,4
2023-06-01,27766,1,0,1,3,0,3
2023-06-01,27726,1,0,1,1,0,1
2023-06-01,270573,1,7,8,3,2,3
2023-06-01,22975,8,0,8,3,0,3
2023-06-01,6495,18,0,18,5,0,5
2023-06-01,262152,3,0,3,2,0,2
2023-06-01,52334,1,0,1,3,0,3
2023-06-01,271638,1,1,2,1,1,2
2023-06-01,262162,1,0,1,1,0,1
2023-06-01,52345,2,0,2,2,0,2
2023-06-01,262176,1,0,1,1,0,1
2023-06-01,676,9,0,9,4,0,4
2023-06-01,52306,1,1,2,3,1,3
2023-06-01,27674,1,0,1,2,0,2
2023-06-01,26605,2,1,3,3,1,3
2023-06-01,27826,9,0,9,1,0,1
2023-06-01,10715,9,3,12,1,1,1
2023-06-01,52992,6,0,6,1,0,1
2023-06-01,28498,2,2,4,3,2,3
2023-06-01,27673,3,0,3,3,0,3
2023-06-01,28496,1,1,2,1,1,1
2023-06-01,264895,1,1,2,2,1,2
2023-06-01,19259,4,0,4,5,0,5
2023-06-01,262247,2,1,3,4,2,4
2023-06-01,270018,1,1,2,1,1,1
2023-06-01,26620,2,0,2,1,0,1
2023-06-01,264695,1,0,1,1,0,1
2023-06-01,271887,1,0,1,1,0,1
2023-06-01,13579,50,3,53,1,1,1
2023-06-01,28375,2,0,2,2,0,2
2023-06-01,28493,1,0,1,1,0,1
2023-06-01,264693,1,0,1,1,0,1
2023-06-01,264958,1,1,2,3,1,3
2023-06-01,265449,1,0,1,1,0,1
2023-06-01,265392,1,1,2,2,1,2
2023-06-01,265071,1,1,2,1,1,1
2023-06-01,265064,3,0,3,2,0,2
2023-06-01,270083,1,0,1,2,0,2
2023-06-01,61932,5,9,14,1,1,1
2023-06-01,264979,1,1,2,2,2,2
2023-06-01,264792,1,0,1,2,0,2
2023-06-01,263876,1,0,1,3,0,3
2023-06-01,61766,1,1,2,1,1,1
2023-06-01,61790,5,0,5,2,0,2
2023-06-01,61877,3,1,4,2,2,2
2023-06-01,270964,3,0,3,2,0,2
2023-06-01,271647,5,1,6,1,1,1
2023-06-01,271608,3,5,8,5,4,5
2023-06-01,271611,7,1,8,1,1,1
2023-06-01,271679,1,3,4,3,1,4
2023-06-01,27934,8,0,8,3,0,3
2023-06-01,64124,2,1,3,2,2,2
2023-06-01,27763,32,0,32,4,0,4
2023-06-01,272178,1,1,2,1,1,1
2023-06-01,272095,1,0,1,1,0,1
2023-06-01,52301,1,0,1,1,0,1
2023-06-01,269870,1,0,1,1,0,1
2023-06-01,269706,7,1,8,2,1,2
2023-06-01,269907,4,1,5,1,1,1
2023-06-01,270574,5,2,7,1,2,2
2023-06-01,270459,3,1,4,2,2,2
2023-06-01,270443,1,1,2,1,1,1
2023-06-01,270444,5,3,8,2,2,2
2023-06-01,25718,1,0,1,3,0,3
2023-06-01,14708,1,0,1,1,0,1
2023-06-01,27941,25,8,33,4,5,5
2023-06-01,263174,6,1,7,1,1,1
2023-06-01,272130,1,0,1,1,0,1
2023-06-01,10964,10,0,10,1,0,1
2023-06-01,28457,1,0,1,1,0,1
2023-06-01,10706,13,0,13,3,0,3
2023-06-01,21692,2,1,3,3,2,3
2023-06-01,28395,1,0,1,3,0,3
2023-06-01,264662,1,0,1,1,0,1
2023-06-01,61465,1,0,1,1,0,1
2023-06-01,13440,3,0,3,2,0,2
2023-06-01,265589,1,0,1,1,0,1
2023-06-01,264995,1,1,2,2,3,3
2023-06-01,265431,1,1,2,2,2,2
2023-06-01,263831,1,1,2,1,1,1
2023-06-01,61585,1,0,1,1,0,1
2023-06-01,264747,1,0,1,1,0,1
2023-06-01,28371,1,0,1,1,0,1
2023-06-01,265101,1,1,2,1,1,1
2023-06-01,265456,3,0,3,2,0,2
2023-06-01,61947,1,1,2,1,1,1
2023-06-01,265450,1,1,2,3,1,3
2023-06-01,266212,1,1,2,1,1,1
2023-06-01,7399,4,0,4,1,0,1
2023-06-01,264745,1,0,1,1,0,1
2023-06-01,269958,1,0,1,1,0,1
2023-06-01,265376,1,0,1,1,0,1
2023-06-01,61457,1,0,1,2,0,2
2023-06-01,26595,3,0,3,1,0,1
2023-06-01,10479,36,0,36,1,0,1
2023-06-01,7120,1,0,1,1,0,1
2023-06-01,8140,4,0,4,1,0,1
2023-06-01,61463,1,1,2,1,1,1
2023-06-01,265508,1,0,1,2,0,2
2023-06-01,28421,1,0,1,3,0,3
2023-06-01,28406,1,0,1,3,0,3
2023-06-01,263722,1,0,1,2,0,2
2023-06-01,28448,1,0,1,3,0,3
2023-06-01,22726,2,0,2,1,0,1
2023-06-01,28089,4,0,4,2,0,2
2023-06-01,270881,3,1,4,6,1,6
2023-06-01,272184,0,1,1,2,1,3
2023-06-01,270042,1,0,1,1,0,1
2023-06-01,10847,1,0,1,1,0,1
2023-06-01,271288,7,0,7,2,0,2
2023-06-01,271388,7,3,10,4,2,4
2023-06-01,271334,4,1,5,2,1,2
2023-06-01,271440,3,3,6,1,1,1
2023-06-01,271287,5,1,6,3,1,3
2023-06-01,271880,4,3,7,1,1,1
2023-06-01,271866,3,0,3,2,0,2
2023-06-01,271438,1,1,2,1,1,1
2023-06-01,271879,1,0,1,1,0,1
2023-06-01,271428,7,1,8,2,1,2
2023-06-01,271423,1,0,1,1,0,1
2023-06-01,271292,4,1,5,3,1,3
2023-06-01,271284,6,7,13,4,3,4
2023-06-01,271867,4,1,5,2,1,2
2023-06-01,271283,3,1,4,4,3,4
2023-06-01,16689,4,0,4,3,0,3
2023-06-01,271333,1,1,2,1,1,1
2023-06-01,271343,7,7,14,6,4,6
2023-06-01,271402,4,4,8,3,4,4
2023-06-01,271425,4,3,7,3,2,3
2023-06-01,271524,5,3,8,1,1,1
2023-06-01,271419,6,1,7,4,3,4
2023-06-01,271857,3,0,3,2,0,2
2023-06-01,271898,4,1,5,2,1,3
2023-06-01,270756,6,1,7,1,1,1
2023-06-01,270757,5,5,10,3,3,3
2023-06-01,270024,1,0,1,1,0,1
2023-06-01,270758,5,1,6,1,1,1
2023-06-01,270012,2,4,6,1,1,1
2023-06-01,270786,3,0,3,1,0,1
2023-06-01,270010,1,0,1,1,0,1
2023-06-01,270818,3,1,4,3,1,3
2023-06-01,28052,1,0,1,2,0,2
2023-06-01,23360,1,0,1,2,0,2
2023-06-01,28061,1,0,1,2,0,2
2023-06-01,27749,1,0,1,1,0,1
2023-06-01,22010,1,0,1,1,0,1
2023-06-01,22227,1,0,1,1,0,1
2023-06-01,28062,1,0,1,1,0,1
2023-06-01,27760,1,0,1,2,0,2
2023-06-01,27783,1,0,1,1,0,1
2023-06-01,27679,1,0,1,1,0,1
2023-06-01,27788,1,0,1,1,0,1
2023-06-01,27961,1,0,1,1,0,1
2023-06-01,271022,7,1,8,4,2,4
2023-06-01,271229,3,1,4,2,1,2
2023-06-01,27950,9,0,9,3,0,3
2023-06-01,270138,1,0,1,1,0,1
2023-06-01,10697,5,0,5,1,0,1
2023-06-01,270445,4,3,7,1,1,1
2023-06-01,270474,4,1,5,1,1,1
2023-06-01,270467,5,1,6,1,1,1
2023-06-01,270476,4,0,4,1,0,1
2023-06-01,270482,5,5,10,5,5,6
2023-06-01,270450,1,1,2,1,1,1
2023-06-01,270451,3,1,4,1,1,1
2023-06-01,270460,5,0,5,6,0,6
2023-06-01,271338,7,6,13,2,2,2
2023-06-01,271358,3,3,6,1,1,1
2023-06-01,27958,1,0,1,1,0,1
2023-06-01,271077,7,2,9,3,2,3
2023-06-01,271018,5,3,8,4,3,5
2023-06-01,270296,4,1,5,2,1,2
2023-06-01,270263,4,2,6,5,3,6
2023-06-01,271504,5,3,8,2,2,2
2023-06-01,271304,5,1,6,3,3,5
2023-06-01,271718,0,1,1,2,1,2
2023-06-01,272230,0,1,1,3,3,4
2023-06-01,271289,2,0,2,3,0,3
2023-06-01,271316,1,1,2,1,1,1
2023-06-01,271365,5,1,6,3,2,3
2023-06-01,271298,1,1,2,1,1,1
2023-06-01,271432,7,1,8,5,4,5
2023-06-01,271347,7,3,10,6,3,6
2023-06-01,52310,1,0,1,1,0,1
2023-06-01,52230,1,0,1,1,0,1
2023-06-01,27880,1,0,1,1,0,1
2023-06-01,27732,1,0,1,2,0,2
2023-06-01,262154,8,0,8,3,0,3
2023-06-01,270473,5,4,9,3,1,3
2023-06-01,16732,26,0,26,1,0,1
2023-06-01,10617,198,0,198,5,0,5
2023-06-01,11498,1,0,1,1,0,1
2023-06-01,27994,7,0,7,5,0,5
2023-06-01,264778,8,1,9,4,1,4
2023-06-01,269998,1,0,1,1,0,1
2023-06-01,270002,5,0,5,2,0,2
2023-06-01,270671,3,0,3,1,0,1
2023-06-01,11193,11,0,11,1,0,1
2023-06-01,15034,7,0,7,5,0,5
2023-06-01,52394,2,0,2,5,0,5
2023-06-01,27727,16,0,16,2,0,2
2023-06-01,27969,1,0,1,1,0,1
2023-06-01,265807,1,0,1,1,0,1
2023-06-01,10986,12,0,12,2,0,2
2023-06-01,28065,10,0,10,4,0,4
2023-06-01,266191,3,1,4,5,3,5
2023-06-01,266206,6,0,6,1,0,1
2023-06-01,266216,4,3,7,3,1,3
2023-06-01,270078,1,1,2,1,1,1
2023-06-01,270453,3,1,4,3,2,3
2023-06-01,270477,3,1,4,4,2,5
2023-06-01,61787,2,0,2,1,0,1
2023-06-01,27965,1,0,1,1,0,1
2023-06-01,27900,1,0,1,1,0,1
2023-06-01,26194,8,0,8,1,0,1
2023-06-01,270483,1,1,2,3,1,3
2023-06-01,270462,4,1,5,2,2,2
2023-06-01,21980,41,0,41,6,0,6
2023-06-01,28050,8,1,9,3,1,3
2023-06-01,61782,7,0,7,1,0,1
2023-06-01,61767,5,1,6,1,1,1
2023-06-01,61444,4,0,4,1,0,1
2023-06-01,64702,2,17,19,1,1,2
2023-06-01,28381,8,0,8,2,0,2
2023-06-01,271706,2,0,2,2,0,2
2023-06-01,271285,7,1,8,1,1,1
2023-06-01,271547,4,1,5,4,1,4
2023-06-01,271369,7,3,10,4,4,4
2023-06-01,271342,4,1,5,1,1,1
2023-06-01,271313,1,0,1,1,0,1
2023-06-01,271291,4,2,6,4,4,4
2023-06-01,22678,1,0,1,3,0,3
2023-06-01,11571,1,0,1,1,0,1
2023-06-01,61443,1,0,1,1,0,1
2023-06-01,17401,62,0,62,2,0,2
2023-06-01,262175,17,0,17,1,0,1
2023-06-01,270463,7,1,8,1,1,1
2023-06-01,273680,0,1,1,3,2,3
2023-06-01,52258,4,0,4,2,0,2
2023-06-01,270934,4,8,12,4,2,4
2023-06-01,270063,5,0,5,1,0,1
2023-06-01,52386,1,0,1,1,0,1
2023-06-01,271906,9,0,9,1,0,1
2023-06-01,265708,1,1,2,2,1,2
2023-06-01,272913,1,0,1,1,0,1
2023-06-01,211397,1,0,1,2,0,2
2023-06-01,28037,1,0,1,2,0,2
2023-06-01,28021,8,0,8,1,0,1
2023-06-01,61447,1,1,2,1,1,1
2023-06-01,271040,5,1,6,1,1,1
2023-06-01,272489,0,1,1,3,2,3
2023-06-01,264859,4,0,4,1,0,1
2023-06-01,15180,5,0,5,1,0,1
2023-06-01,27744,4,0,4,3,0,3
2023-06-01,270478,1,1,2,1,1,1
2023-06-01,270466,1,1,2,1,1,1
2023-06-01,270468,5,3,8,5,4,5
2023-06-01,266155,3,3,6,3,2,3
2023-06-01,271252,5,0,5,4,0,4
2023-06-01,271264,5,0,5,1,0,1
2023-06-01,271262,7,1,8,2,1,2
2023-06-01,271257,1,1,2,3,3,3
2023-06-01,271779,2,0,2,2,0,2
2023-06-01,271256,4,5,9,1,1,1
2023-06-01,271809,1,2,3,1,1,1
2023-06-01,271270,4,0,4,1,0,1
2023-06-01,271249,7,7,14,1,1,1
2023-06-01,271248,3,1,4,1,1,1
2023-06-01,271250,2,1,3,1,1,1
2023-06-01,271886,3,0,3,1,0,1
2023-06-01,271337,3,3,6,5,4,6
2023-06-01,52355,2,0,2,3,0,3
2023-06-01,262185,1,0,1,3,0,3
2023-06-01,28055,1,0,1,2,0,2
2023-06-01,28020,1,0,1,3,0,3
2023-06-01,270249,2,1,3,2,1,2
2023-06-01,270248,7,11,18,5,3,5
2023-06-01,27898,4,1,5,1,1,1
2023-06-01,27912,8,0,8,3,0,3
2023-06-01,270250,5,2,7,2,1,2
2023-06-01,270259,1,1,2,1,1,1
2023-06-01,27926,9,0,9,3,0,3
2023-06-01,10476,2,0,2,3,0,3
2023-06-01,26593,29,0,29,6,0,6
2023-06-01,52283,8,0,8,1,0,1
2023-06-01,27669,14,0,14,1,0,1
2023-06-01,270312,4,0,4,2,0,2
2023-06-01,270265,3,2,5,3,2,3
2023-06-01,270257,3,1,4,1,1,1
2023-06-01,270264,2,1,3,3,1,3
2023-06-01,265624,3,0,3,2,0,2
2023-06-01,270465,1,1,2,3,2,4
2023-06-01,269928,1,1,2,1,1,1
2023-06-01,270251,3,1,4,1,1,1
2023-06-01,270260,2,3,5,1,1,1
2023-06-01,270252,4,17,21,2,1,2
2023-06-01,270261,2,0,2,2,0,2
2023-06-01,271472,0,0,0,4,0,4
2023-06-01,46614,12,0,12,1,0,1
2023-06-01,52377,8,0,8,1,0,1
2023-06-01,13381,8,0,8,1,0,1
2023-06-01,270065,4,0,4,1,0,1
2023-06-01,28120,8,0,8,1,0,1
2023-06-01,52418,1,0,1,1,0,1
2023-06-01,262250,1,0,1,1,0,1
2023-06-01,52429,1,0,1,1,0,1
2023-06-01,52437,1,0,1,1,0,1
2023-06-01,27784,2,0,2,2,0,2
2023-06-01,270885,6,7,13,5,3,5
2023-06-01,18667,4,0,4,2,0,2
2023-06-01,52370,1,0,1,1,0,1
2023-06-01,52403,1,0,1,1,0,1
2023-06-01,269919,3,0,3,2,0,2
2023-06-01,270268,3,1,4,6,3,6
2023-06-01,270287,3,1,4,1,2,2
2023-06-01,270267,4,2,6,2,1,2
2023-06-01,270269,7,0,7,2,0,2
2023-06-01,272832,1,1,2,1,1,1
2023-06-01,269923,2,1,3,2,1,2
2023-06-01,272969,1,0,1,1,0,1
2023-06-01,270272,7,3,10,1,1,1
2023-06-01,264734,1,0,1,1,0,1
2023-06-01,262205,1,0,1,1,0,1
2023-06-01,262225,1,0,1,1,0,1
2023-06-01,262238,1,1,2,2,1,2
2023-06-01,262226,1,0,1,1,0,1
2023-06-01,52382,1,1,2,1,1,1
2023-06-01,262233,1,0,1,1,0,1
2023-06-01,52406,1,0,1,1,0,1
2023-06-01,52410,3,0,3,4,0,4
2023-06-01,52422,4,1,5,1,1,1
2023-06-01,272114,2,0,2,1,0,1
2023-06-01,272885,2,0,2,1,0,1
2023-06-01,27692,1,0,1,1,0,1
2023-06-01,270262,6,1,7,1,1,1
2023-06-01,269913,3,0,3,4,0,4
2023-06-01,270288,3,3,6,1,1,1
2023-06-01,270270,7,5,12,1,1,1
2023-06-01,52402,1,0,1,1,0,1
2023-06-01,270271,6,1,7,7,4,7
2023-06-01,269921,3,1,4,1,1,1
2023-06-01,270273,5,1,6,5,5,5
2023-06-01,270289,3,1,4,2,1,2
2023-06-01,270275,6,5,11,3,3,3
2023-06-01,270276,7,1,8,4,1,5
2023-06-01,52378,1,3,4,1,1,1
2023-06-01,262200,1,0,1,2,0,2
2023-06-01,262203,1,0,1,1,0,1
2023-06-01,52357,1,0,1,2,0,2
2023-06-01,262214,2,0,2,2,0,2
2023-06-01,262201,1,0,1,3,0,3
2023-06-01,265625,5,1,6,2,1,2
2023-06-01,270277,1,3,4,1,1,1
2023-06-01,270278,1,1,2,1,1,1
2023-06-01,270279,7,1,8,3,1,3
2023-06-01,52401,1,0,1,2,0,2
2023-06-01,271180,1,1,2,2,2,2
2023-06-01,270280,3,2,5,4,2,4
2023-06-01,270281,6,5,11,6,4,6
2023-06-01,263214,2,0,2,1,0,1
2023-06-01,61482,8,0,8,4,0,4
2023-06-01,26118,21,0,21,6,0,6
2023-06-01,26104,3,3,6,4,3,4
2023-06-01,61949,9,1,10,2,2,2
2023-06-01,53049,7,3,10,1,1,1
2023-06-01,61950,1,1,2,1,1,1
2023-06-01,270922,1,13,14,4,1,4
2023-06-01,270293,3,3,6,6,6,7
2023-06-01,270687,3,3,6,3,2,3
2023-06-01,270001,2,0,2,1,0,1
2023-06-01,14204,2,1,3,6,2,6
2023-06-01,52703,2,0,2,3,0,3
2023-06-01,27652,24,0,24,1,0,1
2023-06-01,26598,9,0,9,2,0,2
2023-06-01,272612,0,1,1,3,3,4
2023-06-01,272671,0,4,4,2,2,3
2023-06-01,61876,2,3,5,4,2,4
2023-06-01,272649,0,0,0,3,0,3
2023-06-01,26218,6,5,11,3,2,3
2023-06-01,26616,51,0,51,2,0,2
2023-06-01,14463,12,1,13,9,3,9
2023-06-01,22706,12,0,12,1,0,1
2023-06-01,21571,44,0,44,6,0,6
2023-06-01,28122,1,1,2,1,1,1
2023-06-01,28589,18,7,25,4,3,4
2023-06-01,23128,7,0,7,2,0,2
2023-06-01,11706,24,8,32,4,3,5
2023-06-01,22148,3,0,3,3,0,3
2023-06-01,22133,1,0,1,1,0,1
2023-06-01,22819,2,1,3,3,2,3
2023-06-01,22128,7,0,7,1,0,1
2023-06-01,22341,7,0,7,4,0,4
2023-06-01,28274,3,1,4,4,2,4
2023-06-01,7298,4,0,4,2,0,2
2023-06-01,23289,1,0,1,1,0,1
2023-06-01,22129,1,1,2,1,1,1
2023-06-01,22515,1,0,1,1,0,1
2023-06-01,19763,3,0,3,3,0,3
2023-06-01,52976,6,0,6,1,0,1
2023-06-01,21741,15,0,15,1,0,1
2023-06-01,22250,2,1,3,5,3,5
2023-06-01,270683,3,1,4,2,2,3
2023-06-01,270684,5,10,15,4,4,4
2023-06-01,270699,3,0,3,3,0,3
2023-06-01,27697,24,0,24,1,0,1
2023-06-01,20044,16,1,17,1,1,1
2023-06-01,18836,5,0,5,2,0,2
2023-06-01,13914,2,0,2,3,0,3
2023-06-01,13761,17,0,17,1,0,1
2023-06-01,10906,2,2,4,6,3,7
2023-06-01,28345,2,0,2,1,0,1
2023-06-01,18739,5,0,5,2,0,2
2023-06-01,7465,22,0,22,5,0,5
2023-06-01,14886,2,0,2,2,0,2
2023-06-01,13357,15,1,16,5,3,5
2023-06-01,14026,11,2,13,4,2,4
2023-06-01,264762,1,0,1,1,0,1
2023-06-01,13522,3,0,3,4,0,4
2023-06-01,28572,16,4,20,1,1,1
2023-06-01,14723,1,0,1,1,0,1
2023-06-01,11284,3,3,6,4,3,4
2023-06-01,13495,2,0,2,4,0,4
2023-06-01,16594,7,0,7,3,0,3
2023-06-01,28582,14,0,14,7,0,7
2023-06-01,12140,5,0,5,1,0,1
2023-06-01,14346,7,0,7,3,0,3
2023-06-01,10670,4,1,5,2,2,2
2023-06-01,10412,3,1,4,2,1,2
2023-06-01,20116,16,0,16,3,0,3
2023-06-01,8141,4,0,4,3,0,3
2023-06-01,10688,1,0,1,1,0,1
2023-06-01,10531,6,0,6,1,0,1
2023-06-01,271868,3,1,4,4,2,4
2023-06-01,271943,4,1,5,1,1,1
2023-06-01,270614,5,1,6,1,1,1
2023-06-01,270569,3,3,6,2,3,3
2023-06-01,269981,2,1,3,2,2,2
2023-06-01,270615,1,1,2,1,1,1
2023-06-01,10362,3,0,3,4,0,4
2023-06-01,22407,2,0,2,1,0,1
2023-06-01,22055,5,0,5,3,0,3
2023-06-01,28594,20,4,24,3,3,3
2023-06-01,271017,6,0,6,3,0,3
2023-06-01,270066,1,1,2,2,2,2
2023-06-01,270805,4,2,6,3,2,3
2023-06-01,270806,7,0,7,1,0,1
2023-06-01,270810,7,0,7,5,0,5
2023-06-01,270811,7,1,8,1,1,1
2023-06-01,270812,6,1,7,4,1,4
2023-06-01,270826,7,1,8,4,3,4
2023-06-01,270803,7,0,7,1,0,1
2023-06-01,270800,6,3,9,3,1,3
2023-06-01,270041,2,0,2,1,0,1
2023-06-01,270117,3,0,3,1,0,1
2023-06-01,270801,3,0,3,2,0,2
2023-06-01,271815,4,0,4,2,0,2
2023-06-01,7313,3,0,3,2,0,2
2023-06-01,10897,4,0,4,3,0,3
2023-06-01,53035,1,1,2,1,1,1
2023-06-01,264971,1,1,2,1,1,1
2023-06-01,11644,2,2,4,4,3,4
2023-06-01,14650,2,3,5,4,4,5
2023-06-01,5772,3,0,3,2,0,2
2023-06-01,28581,17,0,17,4,0,4
2023-06-01,7365,2,0,2,1,0,1
2023-06-01,270694,4,12,16,4,4,4
2023-06-01,61788,3,0,3,1,0,1
2023-06-01,270054,2,1,3,2,1,2
2023-06-01,61771,1,0,1,3,0,3
2023-06-01,61774,3,1,4,1,1,1
2023-06-01,16891,8,0,8,3,0,3
2023-06-01,28588,1,0,1,1,0,1
2023-06-01,273573,1,0,1,1,0,1
2023-06-01,61798,5,6,11,3,1,3
2023-06-01,273666,0,1,1,2,1,2
2023-06-01,18547,5,1,6,2,2,2
2023-06-01,61778,3,1,4,2,1,2
2023-06-01,267781,1,0,1,1,0,1
2023-06-01,270834,5,2,7,4,2,4
2023-06-01,270815,5,0,5,1,0,1
2023-06-01,12136,3,3,6,5,4,5
2023-06-01,265458,1,0,1,2,0,2
2023-06-01,266336,1,0,1,2,0,2
2023-06-01,270688,7,0,7,1,0,1
2023-06-01,270808,1,0,1,1,0,1
2023-06-01,270027,3,0,3,1,0,1
2023-06-01,10704,42,0,42,5,0,5
2023-06-01,28597,16,0,16,4,0,4
2023-06-01,271640,129,0,129,2,0,2
2023-06-01,262511,1,1,2,1,1,1
2023-06-01,28627,17,0,17,2,0,2
2023-06-01,28593,1,0,1,1,0,1
2023-06-01,263291,7,0,7,1,0,1
2023-06-01,28595,10,0,10,3,0,3
2023-06-01,61808,5,2,7,3,1,3
2023-06-01,61697,4,0,4,5,0,5
2023-06-01,61836,7,0,7,1,0,1
2023-06-01,61799,1,0,1,2,0,2
2023-06-01,28599,3,3,6,1,1,1
2023-06-01,28619,9,0,9,3,0,3
2023-06-01,272710,28,66,94,5,4,5
2023-06-01,28275,11,0,11,6,0,6
2023-06-01,28278,30,0,30,2,0,2
2023-06-01,28603,13,0,13,4,0,4
2023-06-01,270239,2,5,7,2,1,2
2023-06-01,265621,4,0,4,2,0,2
2023-06-01,270307,7,1,8,2,2,2
2023-06-01,265623,1,1,2,2,1,2
2023-06-01,272019,1,1,2,2,2,3
2023-06-01,269986,5,1,6,1,1,1
2023-06-01,270570,4,3,7,3,3,3
2023-06-01,270571,5,2,7,1,1,1
2023-06-01,53159,4,1,5,2,2,2
2023-06-01,264468,3,0,3,2,0,2
2023-06-01,264467,3,0,3,2,0,2
2023-06-01,264469,3,0,3,3,0,3
2023-06-01,61569,1,0,1,2,0,2
2023-06-01,28602,1,1,2,3,1,3
2023-06-01,271466,13,5,18,7,6,8
2023-06-01,28645,2,0,2,2,0,2
2023-06-01,271673,0,7,7,4,2,5
2023-06-01,270954,2,0,2,2,0,2
2023-06-01,270894,5,0,5,3,0,3
2023-06-01,270887,1,0,1,1,0,1
2023-06-01,28629,4,0,4,3,0,3
2023-06-01,28623,5,0,5,2,0,2
2023-06-01,271055,2,1,3,1,1,1
2023-06-01,271236,5,0,5,2,0,2
2023-06-01,271137,4,2,6,1,1,1
2023-06-01,28616,5,1,6,3,2,3
2023-06-01,28630,4,0,4,4,0,4
2023-06-01,28620,37,0,37,1,0,1
2023-06-01,262585,21,0,21,7,0,7
2023-06-01,28626,10,0,10,6,0,6
2023-06-01,28631,7,1,8,3,3,3
2023-06-01,53203,2,0,2,2,0,2
2023-06-01,269925,3,0,3,1,0,1
2023-06-01,270282,4,7,11,6,2,6
2023-06-01,272207,0,0,0,6,0,6
2023-06-01,270283,3,1,4,5,2,5
2023-06-01,270284,2,0,2,2,0,2
2023-06-01,270285,5,0,5,6,0,6
2023-06-01,270286,4,1,5,3,1,3
2023-06-01,271745,0,1,1,5,3,5
2023-06-01,272615,0,1,1,2,1,2
2023-06-01,270290,4,1,5,4,2,4
2023-06-01,273675,3,1,4,1,1,1
2023-06-01,270761,1,0,1,1,0,1
2023-06-01,270763,5,4,9,4,3,4
2023-06-01,270762,1,1,2,1,1,1
2023-06-01,28635,16,8,24,1,1,1
2023-06-01,270292,5,0,5,2,0,2
2023-06-01,270301,5,3,8,2,1,2
2023-06-01,265626,4,3,7,1,1,1
2023-06-01,271056,1,1,2,2,1,2
2023-06-01,271082,3,1,4,2,1,2
2023-06-01,271115,5,3,8,6,1,6
2023-06-01,272477,0,1,1,3,3,5
2023-06-01,27656,1,0,1,3,0,3
2023-06-01,28653,23,1,24,3,2,4
2023-06-01,28650,3,0,3,4,0,4
2023-06-01,270709,3,1,4,3,1,3
2023-06-01,28646,4,1,5,2,1,2
2023-06-01,270294,5,4,9,9,5,9
2023-06-01,270309,4,1,5,4,3,6
2023-06-01,265627,5,2,7,3,2,3
2023-06-01,270310,3,0,3,1,0,1
2023-06-01,61601,7,2,9,1,1,1
2023-06-01,270295,1,0,1,2,0,2
2023-06-01,270302,7,0,7,1,0,1
2023-06-01,28660,9,0,9,3,0,3
2023-06-01,28662,13,0,13,3,0,3
2023-06-01,271487,3,1,4,1,1,1
2023-06-01,272535,4,1,5,1,1,1
2023-06-01,272553,5,3,8,1,1,1
2023-06-01,28412,1,0,1,1,0,1
2023-06-01,27705,3,0,3,1,0,1
2023-06-01,61822,3,3,6,5,4,5
2023-06-01,61793,7,0,7,2,0,2
2023-06-01,28521,2,0,2,2,0,2
2023-06-01,271093,1,1,2,1,2,3
2023-06-01,61471,2,0,2,3,0,3
2023-06-01,61938,3,1,4,1,1,1
2023-06-01,61924,1,1,2,3,3,3
2023-06-01,263115,1,0,1,1,0,1
2023-06-01,270645,1,0,1,1,0,1
2023-06-01,28392,1,1,2,2,2,3
2023-06-01,28480,1,0,1,2,0,2
2023-06-01,270693,1,1,2,2,2,2
2023-06-01,28478,1,0,1,1,0,1
2023-06-01,263138,1,0,1,3,0,3
2023-06-01,263158,1,0,1,2,0,2
2023-06-01,28476,1,0,1,1,0,1
2023-06-01,28449,1,0,1,1,0,1
2023-06-01,263141,2,0,2,3,0,3
2023-06-01,28515,1,0,1,3,0,3
2023-06-01,61464,1,0,1,1,0,1
2023-06-01,61475,1,0,1,1,0,1
2023-06-01,27780,1,0,1,1,0,1
2023-06-01,263709,1,0,1,1,0,1
2023-06-01,263707,1,0,1,2,0,2
2023-06-01,28520,1,0,1,2,0,2
2023-06-01,263723,1,0,1,1,0,1
2023-06-01,263727,1,0,1,3,0,3
2023-06-01,28563,4,0,4,1,0,1
2023-06-01,269945,1,0,1,1,0,1
2023-06-01,271793,1,0,1,1,0,1
2023-06-01,61513,1,0,1,2,0,2
2023-06-01,263714,1,0,1,3,0,3
2023-06-01,263721,1,0,1,3,0,3
2023-06-01,263685,1,0,1,3,0,3
2023-06-01,263731,1,0,1,3,0,3
2023-06-01,266736,1,1,2,1,1,1
2023-06-01,28567,1,0,1,2,0,2
2023-06-01,263680,1,0,1,1,0,1
2023-06-01,61604,1,1,2,1,1,1
2023-06-01,28553,1,0,1,2,0,2
2023-06-01,262925,1,0,1,1,0,1
2023-06-01,28372,2,0,2,3,0,3
2023-06-01,61502,1,0,1,1,0,1
2023-06-01,28560,1,0,1,1,0,1
2023-06-01,262926,1,0,1,1,0,1
2023-06-01,262158,1,0,1,1,0,1
2023-06-01,28374,2,0,2,3,0,3
2023-06-01,263810,1,0,1,1,0,1
2023-06-01,263825,1,0,1,1,0,1
2023-06-01,263695,3,0,3,3,0,3
2023-06-01,28383,7,1,8,3,3,3
2023-06-01,270998,7,1,8,4,3,5
2023-06-01,61824,1,0,1,1,0,1
2023-06-01,61829,7,1,8,1,1,1
2023-06-01,61819,7,1,8,3,1,3
2023-06-01,61842,5,1,6,2,2,4
2023-06-01,61820,2,1,3,3,2,3
2023-06-01,61821,1,1,2,1,2,2
2023-06-01,61801,5,0,5,3,0,3
2023-06-01,61800,1,1,2,1,1,1
2023-06-01,18449,3,0,3,1,0,1
2023-06-01,61833,7,1,8,1,1,1
2023-06-01,61762,5,3,8,5,5,5
2023-06-01,61946,5,0,5,1,0,1
2023-06-01,28503,2,1,3,2,2,4
2023-06-01,61941,6,1,7,6,3,6
2023-06-01,270915,7,1,8,1,1,1
2023-06-01,266148,1,7,8,1,1,1
2023-06-01,61830,7,2,9,2,2,2
2023-06-01,61853,6,0,6,1,0,1
2023-06-01,61831,1,3,4,3,1,3
2023-06-01,61854,3,2,5,2,1,2
2023-06-01,61865,3,3,6,1,1,1
2023-06-01,61703,1,0,1,1,0,1
2023-06-01,61845,7,7,14,1,1,1
2023-06-01,61803,2,0,2,2,0,2
2023-06-01,61779,3,1,4,2,3,3
2023-06-01,61838,7,7,14,4,3,4
2023-06-01,61839,3,1,4,1,1,2
2023-06-01,61846,5,0,5,1,0,1
2023-06-01,61847,1,1,2,3,3,3
2023-06-01,61872,3,0,3,1,0,1
2023-06-01,61850,5,7,12,1,1,1
2023-06-01,61859,4,3,7,3,2,3
2023-06-01,61825,6,0,6,2,0,2
2023-06-01,61699,4,0,4,2,0,2
2023-06-01,61720,2,3,5,1,1,1
2023-06-01,61806,3,1,4,1,1,1
2023-06-01,28346,1,1,2,1,1,1
2023-06-01,272654,1,5,6,1,2,2
2023-06-01,28514,9,0,9,2,0,2
2023-06-01,61936,8,3,11,4,3,4
2023-06-01,61810,5,0,5,7,0,7
2023-06-01,272928,3,0,3,1,0,1
2023-06-01,269696,4,0,4,2,0,2
2023-06-01,61935,15,5,20,4,3,4
2023-06-01,270124,2,1,3,3,2,4
2023-06-01,61764,1,0,1,3,0,3
2023-06-01,272585,2,0,2,1,0,1
2023-06-01,273681,6,1,7,1,1,1
2023-06-01,270793,6,3,9,4,2,4
2023-06-01,270784,3,1,4,1,1,1
2023-06-01,28373,1,0,1,1,0,1
2023-06-01,61796,3,3,6,1,1,1
2023-06-01,28552,24,0,24,3,0,3
2023-06-01,64801,1,0,1,1,0,1
2023-06-01,61818,7,16,23,4,4,4
2023-06-01,265810,2,0,2,1,0,1
2023-06-01,267496,7,19,26,6,5,6
2023-06-01,267497,5,0,5,4,0,4
2023-06-01,267492,6,7,13,3,2,4
2023-06-01,265793,5,0,5,2,0,2
2023-06-01,265811,2,0,2,1,0,1
2023-06-01,267493,2,1,3,1,1,1
2023-06-01,267505,5,3,8,3,2,3
2023-06-01,267514,1,0,1,1,0,1
2023-06-01,267520,2,1,3,1,1,1
2023-06-01,267515,1,0,1,2,0,2
2023-06-01,267509,1,1,2,2,1,2
2023-06-01,267525,1,1,2,3,2,3
2023-06-01,267499,7,7,14,1,1,1
2023-06-01,267500,1,0,1,1,0,1
2023-06-01,267502,4,1,5,3,1,3
2023-06-01,267506,3,0,3,2,0,2
2023-06-01,265797,3,0,3,1,0,1
2023-06-01,265799,4,2,6,2,1,2
2023-06-01,267516,3,1,4,3,3,3
2023-06-01,267510,2,0,2,3,0,3
2023-06-01,267507,7,1,8,6,3,6
2023-06-01,267511,3,0,3,1,0,1
2023-06-01,267508,3,3,6,1,1,1
2023-06-01,265800,7,0,7,1,0,1
2023-06-01,265808,1,0,1,1,0,1
2023-06-01,267517,3,1,4,1,1,1
2023-06-01,267518,3,1,4,3,3,3
2023-06-01,61554,1,0,1,1,0,1
2023-06-01,61521,1,0,1,1,0,1
2023-06-01,64106,1,0,1,1,0,1
2023-06-01,61553,1,1,2,1,1,1
2023-06-01,52509,1,1,2,1,1,1
2023-06-01,273637,1,1,2,1,1,1
2023-06-01,267539,1,0,1,1,0,1
2023-06-01,265815,3,0,3,2,0,2
2023-06-01,267519,7,0,7,2,0,2
2023-06-01,271237,3,0,3,2,0,2
2023-06-01,267523,1,1,2,1,1,1
2023-06-01,267554,5,1,6,3,2,3
2023-06-01,267536,7,7,14,6,5,6
2023-06-01,267528,3,3,6,2,2,2
2023-06-01,267529,3,0,3,1,0,1
2023-06-01,267548,3,4,7,3,2,3
2023-06-01,272792,1,3,4,2,2,3
2023-06-01,265805,5,0,5,2,0,2
2023-06-01,267530,7,5,12,4,5,5
2023-06-01,267531,5,1,6,1,1,1
2023-06-01,267532,3,0,3,2,0,2
2023-06-01,267555,1,1,2,1,1,1
2023-06-01,267533,1,1,2,1,1,1
2023-06-01,267540,1,1,2,1,1,1
2023-06-01,267534,2,0,2,1,0,1
2023-06-01,267571,5,0,5,3,0,3
2023-06-01,267549,1,2,3,1,1,1
2023-06-01,270009,3,1,4,3,2,4
2023-06-01,267550,5,1,6,2,2,2
2023-06-01,270610,1,1,2,1,1,1
2023-06-01,270559,5,17,22,3,2,3
2023-06-01,270567,4,2,6,3,1,3
2023-06-01,272253,0,3,3,2,1,2
2023-06-01,270613,4,2,6,1,1,1
2023-06-01,270568,3,1,4,1,1,1
2023-06-01,270565,3,4,7,1,1,1
2023-06-01,270297,5,1,6,2,1,2
2023-06-01,272645,7,4,11,1,1,1
2023-06-01,270329,4,2,6,2,3,3
2023-06-01,270321,4,5,9,6,3,7
2023-06-01,270303,7,1,8,1,1,1
2023-06-01,270305,7,4,11,2,3,3
2023-06-01,270304,4,2,6,4,3,4
2023-06-01,20321,1,0,1,1,0,1
2023-06-01,64130,1,0,1,2,0,2
2023-06-01,271426,3,0,3,1,2,2
2023-06-01,271481,5,1,6,1,1,1
2023-06-01,271370,7,7,14,3,3,3
2023-06-01,270135,1,0,1,1,0,1
2023-06-01,270137,3,0,3,1,0,1
2023-06-01,271631,2,1,3,3,1,3
2023-06-01,28031,1,0,1,1,0,1
2023-06-01,262198,1,0,1,1,0,1
2023-06-01,28018,1,0,1,1,0,1
2023-06-01,27915,1,0,1,3,0,3
2023-06-01,27944,1,0,1,1,0,1
2023-06-01,264665,1,1,2,1,1,1
2023-06-01,52413,1,0,1,2,0,2
2023-06-01,262258,1,0,1,2,0,2
2023-06-01,52445,1,0,1,1,0,1
2023-06-01,52452,1,0,1,2,0,2
2023-06-01,262151,1,0,1,3,0,3
2023-06-01,52463,1,0,1,3,0,3
2023-06-01,52456,1,1,2,1,1,1
2023-06-01,393629,5,0,5,1,0,1
2023-06-01,271294,4,5,9,2,1,2
2023-06-01,262245,1,1,2,1,1,1
2023-06-01,52417,1,0,1,1,0,1
2023-06-01,61823,7,3,10,4,3,5
2023-06-01,271277,1,0,1,1,0,1
2023-06-01,271266,5,3,8,5,2,5
2023-06-01,271782,1,0,1,1,0,1
2023-06-01,270129,1,0,1,1,0,1
2023-06-01,271973,1,0,1,1,0,1
2023-06-01,271783,1,0,1,3,0,3
2023-06-01,52440,5,0,5,3,0,3
2023-06-01,52454,1,0,1,1,0,1
2023-06-01,27872,1,0,1,3,0,3
2023-06-01,27888,1,0,1,1,0,1
2023-06-01,4690,1,1,2,1,1,1
2023-06-01,198321,1,0,1,1,0,1
2023-06-01,55324,1,0,1,3,0,3
2023-06-01,10234,9,0,9,1,0,1
2023-06-01,56192,1,0,1,3,0,3
2023-06-01,56283,1,0,1,2,0,2
2023-06-01,24079,3,0,3,2,0,2
2023-06-01,139617,1,0,1,1,0,1
2023-06-01,141695,2,0,2,2,0,2
2023-06-01,141197,1,1,2,1,1,1
2023-06-01,17814,3,0,3,4,0,4
2023-06-01,24058,1,0,1,1,0,1
2023-06-01,9289,1,0,1,2,0,2
2023-06-01,9520,1,0,1,1,0,1
2023-06-01,56182,1,0,1,1,0,1
2023-06-01,56195,1,0,1,4,0,4
2023-06-01,45924,3,0,3,2,0,2
2023-06-01,23964,1,0,1,1,0,1
2023-06-01,131971,2,0,2,1,0,1
2023-06-01,45908,1,0,1,3,0,3
2023-06-01,131225,1,0,1,3,0,3
2023-06-01,24198,2,0,2,3,0,3
2023-06-01,45723,0,0,0,2,0,2
2023-06-01,55659,1,0,1,1,0,1
2023-06-01,133105,1,0,1,3,0,3
2023-06-01,55426,1,0,1,3,0,3
2023-06-01,45787,5,0,5,1,0,1
2023-06-01,9564,6,0,6,1,0,1
2023-06-01,133038,17,0,17,1,0,1
2023-06-01,37900,6,5,11,6,5,6
2023-06-01,23917,6,0,6,4,0,4
2023-06-01,137470,4,0,4,2,0,2
2023-06-01,9242,1,0,1,1,0,1
2023-06-01,132279,6,0,6,1,0,1
2023-06-01,45927,1,0,1,3,0,3
2023-06-01,38170,8,0,8,1,0,1
2023-06-01,9653,1,0,1,3,0,3
2023-06-01,23938,1,0,1,1,0,1
2023-06-01,55563,1,0,1,2,0,2
2023-06-01,45347,2,0,2,1,0,1
2023-06-01,132696,1,1,2,4,4,5
2023-06-01,7471,2,0,2,2,0,2
2023-06-01,24477,11,4,15,4,3,4
2023-06-01,18173,3,0,3,3,0,3
2023-06-01,132738,1,0,1,1,0,1
2023-06-01,9831,1,0,1,1,0,1
2023-06-01,10097,5,0,5,3,0,3
2023-06-01,7306,9,0,9,4,0,4
2023-06-01,10232,1,0,1,1,0,1
2023-06-01,18355,3,0,3,1,0,1
2023-06-01,45915,1,1,2,1,1,1
2023-06-01,45917,2,0,2,5,0,5
2023-06-01,55326,1,0,1,1,0,1
2023-06-01,45939,1,0,1,1,0,1
2023-06-01,45901,1,0,1,4,0,4
2023-06-01,45726,1,0,1,1,0,1
2023-06-01,45936,1,0,1,1,0,1
2023-06-01,45937,1,0,1,2,0,2
2023-06-01,45902,1,0,1,3,0,3
2023-06-01,45526,1,0,1,2,0,2
2023-06-01,38233,1,0,1,1,0,1
2023-06-01,17535,12,0,12,5,0,5
2023-06-01,9435,17,0,17,2,0,2
2023-06-01,58626,4,0,4,1,0,1
2023-06-01,17659,21,0,21,2,0,2
2023-06-01,10076,1,1,2,2,2,2
2023-06-01,24035,1,0,1,1,0,1
2023-06-01,24299,2,0,2,1,0,1
2023-06-01,56026,1,0,1,1,0,1
2023-06-01,132695,1,0,1,1,0,1
2023-06-01,9670,0,0,0,2,0,2
2023-06-01,23901,7,2,9,2,2,3
2023-06-01,45494,1,1,2,3,2,4
2023-06-01,18421,1,0,1,2,0,2
2023-06-01,9745,2,0,2,3,0,3
2023-06-01,17450,14,0,14,5,0,5
2023-06-01,4774,4,0,4,1,0,1
2023-06-01,23755,4,0,4,1,0,1
2023-06-01,4830,13,0,13,5,0,5
2023-06-01,23658,1,0,1,1,0,1
2023-06-01,17630,1,0,1,1,0,1
2023-06-01,17555,1,0,1,1,0,1
2023-06-01,140629,1,0,1,1,0,1
2023-06-01,55509,1,0,1,1,0,1
2023-06-01,46048,2,0,2,1,0,1
2023-06-01,55510,1,0,1,2,0,2
2023-06-01,55310,1,0,1,3,0,3
2023-06-01,131128,1,0,1,2,0,2
2023-06-01,9399,1,0,1,1,0,1
2023-06-01,55529,1,0,1,3,0,3
2023-06-01,63789,3,0,3,2,0,2
2023-06-01,9462,2,0,2,1,0,1
2023-06-01,18383,1,0,1,1,0,1
2023-06-01,24017,9,0,9,3,0,3
2023-06-01,23826,3,0,3,1,0,1
2023-06-01,150358,3,0,3,2,0,2
2023-06-01,18267,2,1,3,1,1,1
2023-06-01,18021,4,1,5,1,1,1
2023-06-01,24286,4,0,4,1,0,1
2023-06-01,23984,1,0,1,2,0,2
2023-06-01,4777,2,2,4,12,8,14
2023-06-01,18366,1,1,2,2,1,2
2023-06-01,18220,5,1,6,3,2,3
2023-06-01,137472,1,0,1,1,0,1
2023-06-01,24074,5,0,5,1,0,1
2023-06-01,59096,5,0,5,2,0,2
2023-06-01,24264,1,0,1,3,0,3
2023-06-01,37915,2,0,2,1,0,1
2023-06-01,45249,11,0,11,1,0,1
2023-06-01,45748,4,0,4,4,0,4
2023-06-01,131239,9,0,9,2,0,2
2023-06-01,56058,1,0,1,1,0,1
2023-06-01,17827,5,1,6,1,1,1
2023-06-01,136612,3,0,3,1,0,1
2023-06-01,56062,1,0,1,1,0,1
2023-06-01,131458,4,0,4,4,0,4
2023-06-01,9533,19,0,19,4,0,4
2023-06-01,24543,14,0,14,4,0,4
2023-06-01,10110,3,0,3,1,0,1
2023-06-01,133061,3,0,3,3,0,3
2023-06-01,24057,1,0,1,1,0,1
2023-06-01,17509,2,1,3,2,2,2
2023-06-01,55910,1,0,1,3,0,3
2023-06-01,131940,3,0,3,2,0,2
2023-06-01,132345,1,0,1,2,0,2
2023-06-01,136157,1,0,1,1,0,1
2023-06-01,38473,2,0,2,1,0,1
2023-06-01,133166,2,0,2,3,0,3
2023-06-01,55627,11,0,11,1,0,1
2023-06-01,56175,1,0,1,1,0,1
2023-06-01,23976,2,0,2,3,0,3
2023-06-01,38589,6,1,7,3,1,3
2023-06-01,23728,2,2,4,3,2,4
2023-06-01,137215,1,0,1,1,0,1
2023-06-01,58421,6,0,6,2,0,2
2023-06-01,33103,1,0,1,3,0,3
2023-06-01,24002,3,0,3,1,0,1
2023-06-01,23648,5,0,5,5,0,5
2023-06-01,23799,4,0,4,1,0,1
2023-06-01,7599,1,0,1,1,0,1
2023-06-01,56039,16,0,16,4,0,4
2023-06-01,139828,4,0,4,2,0,2
2023-06-01,134118,3,0,3,3,0,3
2023-06-01,17479,15,1,16,3,1,3
2023-06-01,9562,4,1,5,3,2,3
2023-06-01,137850,4,1,5,2,1,2
2023-06-01,132514,1,0,1,1,0,1
2023-06-01,135616,3,1,4,1,1,2
2023-06-01,9475,4,0,4,3,0,3
2023-06-01,149800,1,0,1,1,0,1
2023-06-01,4762,65,2,67,5,2,5
2023-06-01,131246,1,0,1,1,0,1
2023-06-01,141714,4,1,5,2,1,2
2023-06-01,147312,1,0,1,2,0,2
2023-06-01,131257,1,0,1,2,0,2
2023-06-01,138547,1,0,1,1,0,1
2023-06-01,132879,1,1,2,1,1,1
2023-06-01,136624,1,1,2,3,1,3
2023-06-01,150107,1,0,1,1,0,1
2023-06-01,45847,1,0,1,1,0,1
2023-06-01,135528,1,1,2,3,3,3
2023-06-01,132701,1,0,1,1,0,1
2023-06-01,140075,1,0,1,1,0,1
2023-06-01,131221,2,0,2,1,0,1
2023-06-01,133042,5,0,5,1,0,1
2023-06-01,132250,1,0,1,1,0,1
2023-06-01,23687,1,0,1,3,0,3
2023-06-01,10227,2,0,2,1,0,1
2023-06-01,149503,1,0,1,1,0,1
2023-06-01,150410,1,0,1,2,0,2
2023-06-01,134690,1,0,1,1,0,1
2023-06-01,133919,16,1,17,3,1,3
2023-06-01,2385,9,0,9,1,0,1
2023-06-01,10045,13,0,13,2,0,2
2023-06-01,38131,6,0,6,2,0,2
2023-06-01,9494,32,0,32,1,0,1
2023-06-01,17603,2,0,2,2,0,2
2023-06-01,7627,2,0,2,2,0,2
2023-06-01,17848,1,0,1,2,0,2
2023-06-01,59124,1,0,1,2,0,2
2023-06-01,58784,3,0,3,2,0,2
2023-06-01,7657,0,0,0,2,0,2
2023-06-01,9898,8,0,8,1,0,1
2023-06-01,37999,5,0,5,1,0,1
2023-06-01,56174,1,0,1,3,0,3
2023-06-01,134099,3,0,3,1,0,1
2023-06-01,4831,2,0,2,1,0,1
2023-06-01,55516,3,0,3,2,0,2
2023-06-01,55926,3,0,3,2,0,2
2023-06-01,139275,2,0,2,1,0,1
2023-06-01,45164,2,0,2,1,0,1
2023-06-01,55719,2,0,2,2,0,2
2023-06-01,140548,2,0,2,2,0,2
2023-06-01,9559,8,0,8,4,0,4
2023-06-01,131196,1,0,1,1,0,1
2023-06-01,23737,1,0,1,1,0,1
2023-06-01,131272,8,0,8,1,0,1
2023-06-01,55747,2,0,2,1,0,1
2023-06-01,9896,1,1,2,2,1,2
2023-06-01,131130,3,0,3,2,0,2
2023-06-01,131323,1,0,1,1,0,1
2023-06-01,45140,1,0,1,1,0,1
2023-06-01,23916,3,0,3,1,0,1
2023-06-01,17485,5,0,5,2,0,2
2023-06-01,23910,6,5,11,2,21,22
2023-06-01,23993,2,0,2,1,0,1
2023-06-01,4783,5,0,5,3,0,3
2023-06-01,24127,1,0,1,3,0,3
2023-06-01,17793,1,0,1,1,0,1
2023-06-01,138647,3,0,3,2,0,2
2023-06-01,138155,1,1,2,1,1,1
2023-06-01,24110,6,0,6,1,0,1
2023-06-01,23761,1,0,1,3,0,3
2023-06-01,23711,1,0,1,1,0,1
2023-06-01,23713,1,0,1,1,0,1
2023-06-01,24103,1,0,1,2,0,2
2023-06-01,9672,1,0,1,1,0,1
2023-06-01,17825,10,1,11,5,1,5
2023-06-01,37942,15,1,16,2,1,2
2023-06-01,38198,3,1,4,1,1,1
2023-06-01,45793,3,0,3,1,0,1
2023-06-01,131184,1,0,1,1,0,1
2023-06-01,45947,5,0,5,2,0,2
2023-06-01,17802,16,0,16,8,0,8
2023-06-01,149282,1,0,1,1,0,1
2023-06-01,149651,1,0,1,1,0,1
2023-06-01,18076,1,0,1,3,0,3
2023-06-01,17541,2,0,2,2,0,2
2023-06-01,46079,6,0,6,4,0,4
2023-06-01,45446,3,0,3,4,0,4
2023-06-01,38011,8,0,8,3,0,3
2023-06-01,17458,12,0,12,2,0,2
2023-06-01,24303,1,1,2,1,1,1
2023-06-01,9903,46,0,46,1,0,1
2023-06-01,55323,1,0,1,2,0,2
2023-06-01,7588,2,0,2,2,0,2
2023-06-01,17928,1,0,1,1,0,1
2023-06-01,24327,2,0,2,2,0,2
2023-06-01,131280,3,0,3,1,0,1
2023-06-01,24314,5,2,7,2,1,2
2023-06-01,45630,1,1,2,7,4,7
2023-06-01,38005,6,4,10,1,1,1
2023-06-01,38567,2,1,3,2,1,2
2023-06-01,45268,3,0,3,1,0,1
2023-06-01,24236,2,1,3,3,1,3
2023-06-01,17624,3,0,3,3,0,3
2023-06-01,63491,3,0,3,3,0,3
2023-06-01,18056,4,1,5,1,1,1
2023-06-01,133532,3,2,5,1,1,1
2023-06-01,133745,1,1,2,1,1,1
2023-06-01,23869,2,1,3,1,1,1
2023-06-01,45285,4,10,14,3,3,3
2023-06-01,38064,4,7,11,3,3,3
2023-06-01,46018,1,0,1,2,0,2
2023-06-01,46020,1,0,1,1,0,1
2023-06-01,139360,1,0,1,1,0,1
2023-06-01,45554,1,1,2,2,1,2
2023-06-01,23902,2,2,4,2,3,3
2023-06-01,24280,2,0,2,2,0,2
2023-06-01,38906,1,0,1,1,0,1
2023-06-01,17472,2,0,2,2,0,2
2023-06-01,45359,3,0,3,2,0,2
2023-06-01,134692,6,0,6,1,0,1
2023-06-01,56204,5,0,5,1,0,1
2023-06-01,9483,1,0,1,1,0,1
2023-06-01,133915,4,0,4,4,0,4
2023-06-01,65101,1,0,1,1,0,1
2023-06-01,38626,5,0,5,2,0,2
2023-06-01,17792,1,0,1,1,0,1
2023-06-01,55878,1,0,1,2,0,2
2023-06-01,55696,2,0,2,1,0,1
2023-06-01,133928,2,0,2,1,0,1
2023-06-01,18199,2,0,2,1,0,1
2023-06-01,24504,5,0,5,1,0,1
2023-06-01,23950,3,1,4,2,1,2
2023-06-01,38509,3,0,3,2,0,2
2023-06-01,56190,32,0,32,7,0,7
2023-06-01,24113,1,0,1,1,0,1
2023-06-01,23670,3,0,3,3,0,3
2023-06-01,10220,2,0,2,1,0,1
2023-06-01,18052,1,0,1,2,0,2
2023-06-01,55534,1,0,1,3,0,3
2023-06-01,131234,1,0,1,1,0,1
2023-06-01,55543,1,0,1,3,0,3
2023-06-01,55312,1,0,1,3,0,3
2023-06-01,46058,3,0,3,1,0,1
2023-06-01,55570,1,0,1,3,0,3
2023-06-01,55574,2,0,2,3,0,3
2023-06-01,17725,1,0,1,1,0,1
2023-06-01,10106,2,0,2,1,0,1
2023-06-01,55848,1,0,1,3,0,3
2023-06-01,45324,2,0,2,1,0,1
2023-06-01,55709,1,0,1,1,0,1
2023-06-01,55710,1,0,1,1,0,1
2023-06-01,55377,1,0,1,2,0,2
2023-06-01,38217,1,0,1,1,0,1
2023-06-01,9501,15,0,15,1,0,1
2023-06-01,137008,1,0,1,2,0,2
2023-06-01,38643,3,0,3,2,0,2
2023-06-01,38886,6,0,6,3,0,3
2023-06-01,23635,2,0,2,1,0,1
2023-06-01,38600,4,4,8,1,1,1
2023-06-01,18075,21,0,21,1,0,1
2023-06-01,45885,2,0,2,2,0,2
2023-06-01,18234,1,0,1,1,0,1
2023-06-01,9656,6,1,7,2,1,2
2023-06-01,18112,2,0,2,2,0,2
2023-06-01,141016,2,0,2,4,0,4
2023-06-01,58706,1,0,1,3,0,3
2023-06-01,24383,1,0,1,1,0,1
2023-06-01,18110,2,0,2,1,0,1
2023-06-01,24020,16,0,16,2,0,2
2023-06-01,23828,2,0,2,1,0,1
2023-06-01,45660,1,0,1,1,0,1
2023-06-01,45537,1,0,1,1,0,1
2023-06-01,134584,2,0,2,3,0,3
2023-06-01,24526,2,0,2,1,0,1
2023-06-01,17653,3,0,3,2,0,2
2023-06-01,9417,2,0,2,3,0,3
2023-06-01,55358,1,0,1,1,0,1
2023-06-01,55474,1,0,1,2,0,2
2023-06-01,45678,1,0,1,2,0,2
2023-06-01,55365,2,0,2,1,0,1
2023-06-01,46027,1,0,1,1,0,1
2023-06-01,45900,1,0,1,1,0,1
2023-06-01,138451,1,0,1,1,0,1
2023-06-01,24003,3,0,3,1,0,1
2023-06-01,10025,5,0,5,2,0,2
2023-06-01,4802,30,5,35,2,1,2
2023-06-01,23633,1,1,2,4,3,5
2023-06-01,9825,4,1,5,3,1,3
2023-06-01,55731,3,0,3,2,0,2
2023-06-01,55743,1,0,1,1,0,1
2023-06-01,55773,1,0,1,1,0,1
2023-06-01,45635,2,0,2,2,0,2
2023-06-01,55318,3,3,6,5,1,5
2023-06-01,37970,13,0,13,1,0,1
2023-06-01,23833,1,0,1,1,0,1
2023-06-01,4825,4,0,4,1,0,1
2023-06-01,45779,1,0,1,1,0,1
2023-06-01,55804,1,0,1,1,0,1
2023-06-01,55807,2,0,2,2,0,2
2023-06-01,55656,3,0,3,1,0,1
2023-06-01,55661,2,0,2,2,0,2
2023-06-01,9941,1,0,1,3,0,3
2023-06-01,9906,16,0,16,1,0,1
2023-06-01,45850,1,0,1,3,0,3
2023-06-01,45851,1,0,1,2,0,2
2023-06-01,10213,1,0,1,3,0,3
2023-06-01,10138,3,1,4,2,1,2
2023-06-01,10074,4,0,4,2,0,2
2023-06-01,38584,26,3,29,3,1,3
2023-06-01,17641,3,0,3,3,0,3
2023-06-01,17812,7,0,7,2,0,2
2023-06-01,10131,34,0,34,5,0,5
2023-06-01,46051,7,0,7,4,0,4
2023-06-01,18017,1,0,1,2,0,2
2023-06-01,18360,1,0,1,2,0,2
2023-06-01,4645,1,0,1,1,0,1
2023-06-01,10031,15,1,16,4,1,4
2023-06-01,24038,2,0,2,1,0,1
2023-06-01,23798,1,0,1,3,0,3
2023-06-01,141043,1,0,1,2,0,2
2023-06-01,23977,1,0,1,2,0,2
2023-06-01,55296,1,0,1,1,0,1
2023-06-01,46035,1,0,1,1,0,1
2023-06-01,55373,1,0,1,1,0,1
2023-06-01,24128,5,0,5,1,0,1
2023-06-01,24443,8,0,8,5,0,5
2023-06-01,9543,5,0,5,1,0,1
2023-06-01,18153,9,0,9,1,0,1
2023-06-01,38210,6,0,6,2,0,2
2023-06-01,24320,8,0,8,2,0,2
2023-06-01,138899,1,0,1,1,0,1
2023-06-01,55852,1,0,1,3,0,3
2023-06-01,55857,1,0,1,1,0,1
2023-06-01,55860,1,0,1,1,0,1
2023-06-01,55870,1,1,2,1,1,1
2023-06-01,55876,1,0,1,1,0,1
2023-06-01,141690,1,0,1,1,0,1
2023-06-01,55317,3,0,3,2,0,2
2023-06-01,55887,1,0,1,1,0,1
2023-06-01,24522,3,0,3,1,0,1
2023-06-01,9463,6,0,6,3,0,3
2023-06-01,4658,25,8,33,7,4,7
2023-06-01,24250,1,0,1,1,0,1
2023-06-01,23948,7,0,7,3,0,3
2023-06-01,38784,3,0,3,1,0,1
2023-06-01,24331,6,0,6,6,0,6
2023-06-01,4623,7,0,7,2,0,2
2023-06-01,9925,33,1,34,5,2,5
2023-06-01,24501,1,0,1,2,0,2
2023-06-01,23703,1,1,2,2,3,3
2023-06-01,139829,2,0,2,3,0,3
2023-06-01,24283,3,0,3,2,0,2
2023-06-01,24253,1,1,2,5,4,6
2023-06-01,23699,15,1,16,2,1,2
2023-06-01,9731,2,0,2,1,0,1
2023-06-01,45881,3,3,6,1,1,1
2023-06-01,23692,4,0,4,1,0,1
2023-06-01,24306,4,0,4,1,0,1
2023-06-01,18065,2,1,3,2,2,3
2023-06-01,9538,1,0,1,3,0,3
2023-06-01,26799,1,0,1,1,0,1
2023-06-01,142143,1,0,1,3,0,3
2023-06-01,17781,12,0,12,2,0,2
2023-06-01,10231,7,0,7,1,0,1
2023-06-01,17619,1,0,1,2,0,2
2023-06-01,18255,5,0,5,3,0,3
2023-06-01,37934,1,0,1,2,0,2
2023-06-01,140702,5,0,5,2,0,2
2023-06-01,38249,1,0,1,1,0,1
2023-06-01,24321,1,0,1,1,0,1
2023-06-01,24202,8,0,8,2,0,2
2023-06-01,24201,7,0,7,2,0,2
2023-06-01,38004,1,0,1,1,0,1
2023-06-01,45666,1,0,1,2,0,2
2023-06-01,45670,1,0,1,1,0,1
2023-06-01,17587,4,0,4,2,0,2
2023-06-01,18409,5,4,9,4,3,4
2023-06-01,134994,1,0,1,2,0,2
2023-06-01,38292,1,0,1,1,0,1
2023-06-01,138337,4,0,4,3,0,3
2023-06-01,138342,3,0,3,3,0,3
2023-06-01,23967,7,0,7,1,0,1
2023-06-01,38779,3,0,3,2,0,2
2023-06-01,24528,6,0,6,1,0,1
2023-06-01,17452,6,1,7,4,2,5
2023-06-01,131245,1,0,1,3,0,3
2023-06-01,135162,1,1,2,2,1,2
2023-06-01,45209,1,1,2,3,3,3
2023-06-01,45600,1,1,2,1,2,2
2023-06-01,132792,1,0,1,1,0,1
2023-06-01,131281,1,0,1,3,0,3
2023-06-01,132795,1,0,1,1,0,1
2023-06-01,132796,1,0,1,2,0,2
2023-06-01,55679,8,0,8,1,0,1
2023-06-01,23952,1,0,1,1,0,1
2023-06-01,23696,13,0,13,2,0,2
2023-06-01,4382,14,1,15,2,1,2
2023-06-01,38724,1,0,1,3,0,3
2023-06-01,55918,1,0,1,1,0,1
2023-06-01,55941,3,0,3,2,0,2
2023-06-01,55949,1,0,1,1,0,1
2023-06-01,17736,1,0,1,1,0,1
2023-06-01,133455,1,0,1,1,0,1
2023-06-01,38261,1,0,1,1,0,1
2023-06-01,58571,1,1,2,1,1,1
2023-06-01,9401,2,0,2,1,0,1
2023-06-01,24350,3,4,7,1,2,3
2023-06-01,24352,1,0,1,1,2,3
2023-06-01,24209,8,0,8,3,0,3
2023-06-01,24393,8,0,8,3,0,3
2023-06-01,24317,1,0,1,2,0,2
2023-06-01,24540,1,0,1,2,0,2
2023-06-01,38615,1,0,1,1,0,1
2023-06-01,24262,1,1,2,2,2,2
2023-06-01,17721,1,0,1,2,0,2
2023-06-01,23613,2,0,2,2,0,2
2023-06-01,17910,34,0,34,3,0,3
2023-06-01,18379,9,0,9,1,0,1
2023-06-01,10127,3,0,3,4,0,4
2023-06-01,46037,2,0,2,2,0,2
2023-06-01,46042,4,1,5,3,2,3
2023-06-01,55307,1,0,1,3,0,3
2023-06-01,55456,3,0,3,2,0,2
2023-06-01,10205,3,0,3,1,0,1
2023-06-01,55459,1,0,1,2,0,2
2023-06-01,45192,2,2,4,2,2,2
2023-06-01,55472,1,0,1,1,0,1
2023-06-01,55477,1,0,1,2,0,2
2023-06-01,55485,1,0,1,3,0,3
2023-06-01,45201,2,0,2,2,0,2
2023-06-01,24229,2,1,3,3,2,3
2023-06-01,23929,0,0,0,2,2,2
2023-06-01,146976,5,0,5,3,0,3
2023-06-01,24396,8,0,8,5,0,5
2023-06-01,56098,1,0,1,1,0,1
2023-06-01,45484,3,0,3,2,0,2
2023-06-01,55487,1,0,1,1,0,1
2023-06-01,45992,2,0,2,1,0,1
2023-06-01,38236,1,0,1,1,0,1
2023-06-01,10202,2,0,2,1,0,1
2023-06-01,45655,9,0,9,3,0,3
2023-06-01,45340,1,0,1,1,0,1
2023-06-01,45350,1,0,1,1,0,1
2023-06-01,38781,5,1,6,5,2,5
2023-06-01,9254,1,0,1,2,0,2
2023-06-01,45417,1,0,1,2,0,2
2023-06-01,45548,2,0,2,2,0,2
2023-06-01,45737,1,0,1,3,0,3
2023-06-01,45760,3,0,3,3,0,3
2023-06-01,24010,1,0,1,1,0,1
2023-06-01,4828,1,0,1,2,0,2
2023-06-01,45237,12,0,12,1,0,1
2023-06-01,17423,1,0,1,1,0,1
2023-06-01,17443,2,0,2,1,0,1
2023-06-01,24200,8,0,8,3,0,3
2023-06-01,24399,11,0,11,2,0,2
2023-06-01,7467,1,1,2,1,1,1
2023-06-01,45955,1,0,1,1,0,1
2023-06-01,55435,1,0,1,1,0,1
2023-06-01,131125,1,0,1,2,0,2
2023-06-01,38810,1,0,1,1,0,1
2023-06-01,398276,1,0,1,1,0,1
2023-06-01,134531,5,0,5,1,0,1
2023-06-01,131254,1,0,1,1,0,1
2023-06-01,131256,5,0,5,2,0,2
2023-06-01,38241,2,0,2,2,0,2
2023-06-01,9497,1,0,1,1,0,1
2023-06-01,9474,17,1,18,1,1,1
2023-06-01,137927,7,0,7,3,0,3
2023-06-01,139066,3,0,3,1,0,1
2023-06-01,136034,1,0,1,1,0,1
2023-06-01,134793,1,0,1,3,0,3
2023-06-01,23836,2,1,3,3,3,4
2023-06-01,134065,3,0,3,1,0,1
2023-06-01,56158,1,0,1,1,0,1
2023-06-01,24336,13,0,13,3,0,3
2023-06-01,38298,9,1,10,2,1,2
2023-06-01,137483,1,0,1,2,0,2
2023-06-01,137478,1,0,1,1,0,1
2023-06-01,18365,6,0,6,7,0,7
2023-06-01,18088,5,0,5,3,0,3
2023-06-01,56318,3,0,3,2,0,2
2023-06-01,38754,4,0,4,2,0,2
2023-06-01,24212,14,0,14,3,0,3
2023-06-01,23957,4,0,4,2,0,2
2023-06-01,4857,32,0,32,5,0,5
2023-06-01,18156,8,0,8,1,0,1
2023-06-01,150703,4,1,5,1,1,1
2023-06-01,17826,42,0,42,1,0,1
2023-06-01,24465,4,0,4,3,0,3
2023-06-01,24480,1,0,1,1,0,1
2023-06-01,38242,1,0,1,3,0,3
2023-06-01,24453,9,1,10,2,1,2
2023-06-01,24449,6,0,6,4,0,4
2023-06-01,4434,46,17,63,1,1,1
2023-06-01,9216,4,1,5,1,1,2
2023-06-01,4795,94,0,94,2,0,2
2023-06-01,17753,25,2,27,3,1,4
2023-06-01,38147,4,0,4,3,0,3
2023-06-01,45460,1,0,1,1,0,1
2023-06-01,45118,3,0,3,3,0,3
2023-06-01,134631,32,0,32,1,0,1
2023-06-01,24006,2,1,3,1,1,1
2023-06-01,38251,3,0,3,3,0,3
2023-06-01,17733,3,0,3,2,0,2
2023-06-01,11919,1,0,1,1,0,1
2023-06-01,38030,4,0,4,2,0,2
2023-06-01,45610,1,0,1,1,0,1
2023-06-01,45278,1,1,2,5,1,5
2023-06-01,9834,2,0,2,1,0,1
2023-06-01,23732,7,0,7,5,0,5
2023-06-01,9590,4,0,4,1,0,1
2023-06-01,38746,3,1,4,1,1,1
2023-06-01,7589,2,0,2,2,0,2
2023-06-01,58740,1,1,2,1,1,1
2023-06-01,38834,2,0,2,2,0,2
2023-06-01,24107,2,0,2,1,0,1
2023-06-01,45288,3,0,3,2,0,2
2023-06-01,9774,20,0,20,1,0,1
2023-06-01,134796,1,0,1,2,0,2
2023-06-01,4845,1,0,1,2,0,2
2023-06-01,38857,1,0,1,2,0,2
2023-06-01,136020,1,0,1,1,0,1
2023-06-01,18382,1,0,1,1,0,1
2023-06-01,10125,2,0,2,4,0,4
2023-06-01,38866,1,0,1,1,0,1
2023-06-01,7484,2,0,2,3,0,3
2023-06-01,38143,19,0,19,3,0,3
2023-06-01,7581,1,0,1,1,0,1
2023-06-01,24090,14,4,18,2,2,2
2023-06-01,134189,8,0,8,4,0,4
2023-06-01,37905,1,0,1,2,0,2
2023-06-01,9671,14,2,16,3,3,4
2023-06-01,23695,20,0,20,3,0,3
2023-06-01,9648,58,0,58,4,0,4
2023-06-01,38312,1,0,1,3,0,3
2023-06-01,38902,5,1,6,2,1,2
2023-06-01,38872,1,0,1,2,0,2
2023-06-01,38873,1,0,1,1,0,1
2023-06-01,45119,2,0,2,1,0,1
2023-06-01,131583,17,0,17,2,0,2
2023-06-01,9285,4,0,4,2,0,2
2023-06-01,24271,7,1,8,5,1,5
2023-06-01,9796,9,0,9,3,0,3
2023-06-01,24392,2,0,2,2,0,2
2023-06-01,38759,4,4,8,2,1,2
2023-06-01,17934,2,1,3,4,4,5
2023-06-01,38145,8,0,8,1,0,1
2023-06-01,24512,1,0,1,1,0,1
2023-06-01,38472,7,0,7,5,0,5
2023-06-01,7636,0,0,0,2,0,2
2023-06-01,23927,4,0,4,1,0,1
2023-06-01,9536,3,1,4,4,2,4
2023-06-01,7499,12,0,12,3,0,3
2023-06-01,23988,3,0,3,2,0,2
2023-06-01,23794,1,1,2,1,1,1
2023-06-01,24237,1,0,1,1,0,1
2023-06-01,65295,4,0,4,1,0,1
2023-06-01,24205,3,1,4,2,1,2
2023-06-01,38727,3,0,3,1,0,1
2023-06-01,24356,1,0,1,1,0,1
2023-06-01,23817,4,0,4,4,0,4
2023-06-01,131989,1,0,1,3,0,3
2023-06-01,23628,2,0,2,3,0,3
2023-06-01,18127,14,2,16,2,1,2
2023-06-01,59120,1,0,1,1,0,1
2023-06-01,131980,1,1,2,1,1,1
2023-06-01,24260,1,0,1,3,0,3
2023-06-01,4695,4,0,4,1,0,1
2023-06-01,18123,2,1,3,1,2,2
2023-06-01,131946,3,0,3,2,0,2
2023-06-01,17678,3,1,4,1,1,1
2023-06-01,23631,2,1,3,1,1,1
2023-06-01,63783,3,0,3,2,0,2
2023-06-01,37888,3,0,3,2,0,2
2023-06-01,131961,3,0,3,2,0,2
2023-06-01,18091,3,0,3,2,0,2
2023-06-01,55890,2,0,2,4,0,4
2023-06-01,18143,1,0,1,1,0,1
2023-06-01,23614,2,0,2,2,0,2
2023-06-01,18279,1,0,1,1,0,1
2023-06-01,131078,1,0,1,1,0,1
2023-06-01,137938,1,0,1,1,0,1
2023-06-01,59246,3,0,3,2,0,2
2023-06-01,23722,3,0,3,2,0,2
2023-06-01,134347,1,1,2,1,1,1
2023-06-01,133787,10,0,10,2,0,2
2023-06-01,132728,6,0,6,1,0,1
2023-06-01,56227,9,0,9,3,0,3
2023-06-01,137906,1,0,1,1,0,1
2023-06-01,38263,8,0,8,1,0,1
2023-06-01,23646,3,0,3,1,0,1
2023-06-01,133081,12,0,12,2,0,2
2023-06-01,55924,3,0,3,1,0,1
2023-06-01,38863,3,0,3,1,0,1
2023-06-01,37990,3,1,4,3,1,3
2023-06-01,4820,1,0,1,1,0,1
2023-06-01,38438,5,0,5,4,0,4
2023-06-01,149872,5,0,5,3,0,3
2023-06-01,138390,2,0,2,1,0,1
2023-06-01,139760,1,0,1,1,0,1
2023-06-01,136392,1,0,1,2,0,2
2023-06-01,138201,1,0,1,1,0,1
2023-06-01,56101,1,0,1,1,0,1
2023-06-01,139862,1,0,1,3,0,3
2023-06-01,24476,2,0,2,2,0,2
2023-06-01,18431,4,0,4,2,0,2
2023-06-01,46073,1,0,1,2,0,2
2023-06-01,7722,14,0,14,2,0,2
2023-06-01,135653,1,1,2,1,1,1
2023-06-01,141365,1,0,1,1,0,1
2023-06-01,398762,1,0,1,3,0,3
2023-06-01,139612,2,1,3,1,1,2
2023-06-01,45333,6,0,6,3,0,3
2023-06-01,10150,3,0,3,1,0,1
2023-06-01,139465,2,0,2,1,0,1
2023-06-01,45466,1,0,1,3,0,3
2023-06-01,56108,2,0,2,1,0,1
2023-06-01,56142,1,0,1,1,0,1
2023-06-01,141989,1,0,1,1,0,1
2023-06-01,7175,6,2,8,2,1,3
2023-06-01,139661,13,0,13,2,0,2
2023-06-01,55775,1,0,1,1,0,1
2023-06-01,24461,9,0,9,1,0,1
2023-06-01,24046,4,0,4,2,0,2
2023-06-01,136931,6,0,6,2,0,2
2023-06-01,17807,3,0,3,3,0,3
2023-06-01,24021,2,0,2,2,0,2
2023-06-01,58532,2,0,2,1,0,1
2023-06-01,137907,2,0,2,1,0,1
2023-06-01,56117,1,0,1,1,0,1
2023-06-01,17906,12,0,12,4,0,4
2023-06-01,58509,1,0,1,3,0,3
2023-06-01,56105,6,0,6,2,0,2
2023-06-01,24346,1,0,1,1,0,1
2023-06-01,133091,4,0,4,1,0,1
2023-06-01,9421,2,0,2,1,0,1
2023-06-01,45912,1,0,1,2,0,2
2023-06-01,137442,2,2,4,2,2,2
2023-06-01,17463,2,0,2,1,0,1
2023-06-01,64090,1,0,1,2,0,2
2023-06-01,10218,2,0,2,1,0,1
2023-06-01,7703,7,0,7,1,0,1
2023-06-01,138154,0,0,0,2,0,2
2023-06-01,133069,1,0,1,1,0,1
2023-06-01,135569,1,0,1,3,0,3
2023-06-01,135879,8,0,8,3,0,3
2023-06-01,24015,5,0,5,1,0,1
2023-06-01,4643,6,0,6,1,0,1
2023-06-01,139050,3,0,3,1,0,1
2023-06-01,45770,1,1,2,3,1,3
2023-06-01,24065,1,0,1,1,0,1
2023-06-01,142010,1,0,1,1,0,1
2023-06-01,18165,2,0,2,1,0,1
2023-06-01,137214,2,0,2,1,0,1
2023-06-01,7550,1,0,1,1,0,1
2023-06-01,139322,1,0,1,3,0,3
2023-06-01,139324,1,0,1,4,0,4
2023-06-01,142422,5,0,5,2,0,2
2023-06-01,23652,1,0,1,1,0,1
2023-06-01,9518,2,0,2,2,0,2
2023-06-01,131190,1,0,1,2,0,2
2023-06-01,137558,1,0,1,1,0,1
2023-06-01,1029,0,0,0,4,0,4
2023-06-01,9438,1,0,1,1,0,1
2023-06-01,137060,1,0,1,2,0,2
2023-06-01,45601,3,0,3,1,0,1
2023-06-01,17632,2,0,2,1,0,1
2023-06-01,136132,2,0,2,1,0,1
2023-06-01,9461,5,0,5,1,0,1
2023-06-01,38564,2,0,2,3,0,3
2023-06-01,56166,1,1,2,2,1,2
2023-06-01,7647,4,0,4,1,0,1
2023-06-01,45765,1,0,1,2,0,2
2023-06-01,142590,3,0,3,1,0,1
2023-06-01,55157,2,0,2,1,0,1
2023-06-01,138499,1,0,1,1,0,1
2023-06-01,45167,1,0,1,1,0,1
2023-06-01,24315,8,0,8,2,0,2
2023-06-01,9984,2,1,3,1,1,1
2023-06-01,45434,1,0,1,2,0,2
2023-06-01,136013,1,0,1,1,0,1
2023-06-01,140724,6,0,6,1,0,1
2023-06-01,139745,0,0,0,2,0,2
2023-06-01,38012,1,0,1,1,0,1
2023-06-01,4846,2,0,2,1,0,1
2023-06-01,7585,3,0,3,1,0,1
2023-06-01,139910,6,0,6,1,0,1
2023-06-01,4778,2,0,2,4,0,4
2023-06-01,7716,1,0,1,1,0,1
2023-06-01,24448,1,1,2,2,1,2
2023-06-01,133015,1,0,1,1,0,1
2023-06-01,56118,2,0,2,2,0,2
2023-06-01,17728,3,0,3,1,0,1
2023-06-01,132093,4,0,4,2,0,2
2023-06-01,58716,1,0,1,5,0,5
2023-06-01,137896,3,0,3,3,0,3
2023-06-01,24463,10,0,10,2,0,2
2023-06-01,135415,4,1,5,4,2,4
2023-06-01,149305,1,1,2,1,1,1
2023-06-01,55506,6,0,6,5,0,5
2023-06-01,140977,1,0,1,1,0,1
2023-06-01,24069,1,0,1,2,0,2
2023-06-01,137864,1,0,1,1,0,1
2023-06-01,59262,1,0,1,1,0,1
2023-06-01,135894,1,0,1,1,0,1
2023-06-01,9544,8,0,8,4,0,4
2023-06-01,394881,1,0,1,1,0,1
2023-06-01,10145,9,0,9,1,0,1
2023-06-01,150672,1,0,1,1,0,1
2023-06-01,18349,1,0,1,1,0,1
2023-06-01,140603,1,1,2,1,1,1
2023-06-01,45315,4,0,4,3,0,3
2023-06-01,131480,1,0,1,2,0,2
2023-06-01,37993,1,0,1,1,0,1
2023-06-01,23863,2,0,2,2,0,2
2023-06-01,55762,5,0,5,3,0,3
2023-06-01,136423,1,0,1,1,0,1
2023-06-01,135128,1,0,1,1,0,1
2023-06-01,132619,1,1,2,2,2,2
2023-06-01,7699,5,0,5,3,0,3
2023-06-01,17487,5,1,6,2,3,3
2023-06-01,18212,3,0,3,2,0,2
2023-06-01,24502,1,0,1,1,0,1
2023-06-01,55525,1,0,1,3,0,3
2023-06-01,23706,1,0,1,1,0,1
2023-06-01,135350,3,0,3,2,0,2
2023-06-01,40395,32,1,33,2,2,2
2023-06-01,140623,1,0,1,1,0,1
2023-06-01,23965,1,0,1,3,0,3
2023-06-01,58723,1,0,1,1,0,1
2023-06-01,136154,1,0,1,2,0,2
2023-06-01,133758,1,0,1,3,0,3
2023-06-01,58734,3,0,3,2,0,2
2023-06-01,55467,1,0,1,2,0,2
2023-06-01,135399,2,0,2,1,0,1
2023-06-01,133853,4,0,4,3,0,3
2023-06-01,23886,1,0,1,1,0,1
2023-06-01,140211,1,0,1,1,0,1
2023-06-01,135104,1,0,1,1,0,1
2023-06-01,141437,1,0,1,1,0,1
2023-06-01,38295,2,0,2,1,0,1
2023-06-01,133116,1,0,1,1,0,1
2023-06-01,149164,1,0,1,1,0,1
2023-06-01,137054,2,0,2,1,0,1
2023-06-01,9661,1,0,1,3,0,3
2023-06-01,17720,1,0,1,1,0,1
2023-06-01,18385,3,0,3,3,0,3
2023-06-01,24316,3,0,3,2,0,2
2023-06-01,40669,1,0,1,2,0,2
2023-06-01,55580,1,0,1,1,0,1
2023-06-01,38603,1,0,1,1,0,1
2023-06-01,133175,1,0,1,2,0,2
2023-06-01,140639,1,0,1,1,0,1
2023-06-01,139342,1,0,1,1,0,1
2023-06-01,399735,1,0,1,1,0,1
2023-06-01,149512,1,1,2,1,1,1
2023-06-01,23994,2,0,2,2,0,2
2023-06-01,135073,1,1,2,1,1,1
2023-06-01,138537,1,0,1,1,0,1
2023-06-01,38219,1,0,1,2,0,2
2023-06-01,133885,6,0,6,2,0,2
2023-06-01,134808,1,1,2,1,1,1
2023-06-01,58777,1,42,43,1,2,2
2023-06-01,139819,2,0,2,1,0,1
2023-06-01,147051,1,1,2,1,1,1
2023-06-01,138503,1,0,1,1,0,1
2023-06-01,24178,2,0,2,3,0,3
2023-06-01,135358,1,0,1,1,0,1
2023-06-01,38314,1,0,1,2,0,2
2023-06-01,38775,2,1,3,1,1,1
2023-06-01,45551,1,0,1,3,0,3
2023-06-01,38596,2,0,2,1,0,1
2023-06-01,132740,1,0,1,1,0,1
2023-06-01,23769,2,0,2,1,0,1
2023-06-01,56287,1,0,1,3,0,3
2023-06-01,45830,1,0,1,2,0,2
2023-06-01,137555,3,0,3,3,0,3
2023-06-01,38594,1,0,1,3,0,3
2023-06-01,38232,1,0,1,1,0,1
2023-06-01,45824,1,0,1,2,0,2
2023-06-01,137400,1,0,1,1,0,1
2023-06-01,24542,1,0,1,1,0,1
2023-06-01,151052,1,0,1,1,0,1
2023-06-01,133085,2,0,2,1,0,1
2023-06-01,38591,2,0,2,1,0,1
2023-06-01,38049,1,0,1,1,0,1
2023-06-01,45692,1,0,1,1,0,1
2023-06-01,131739,2,0,2,1,0,1
2023-06-01,45427,1,0,1,1,0,1
2023-06-01,23733,3,0,3,1,0,1
2023-06-01,53252,1,0,1,3,0,3
2023-06-01,4662,7,0,7,1,0,1
2023-06-01,38648,1,1,2,2,1,2
2023-06-01,9660,4,0,4,1,0,1
2023-06-01,24509,1,0,1,3,0,3
2023-06-01,24174,1,0,1,2,0,2
2023-06-01,17913,6,0,6,2,0,2
2023-06-01,18393,9,0,9,3,0,3
2023-06-01,9228,28,0,28,2,0,2
2023-06-01,18402,8,1,9,3,1,3
2023-06-01,2756,1,0,1,1,0,1
2023-06-01,18362,7,0,7,2,0,2
2023-06-01,18395,1,0,1,1,0,1
2023-06-01,23839,3,0,3,1,0,1
2023-06-01,17481,8,0,8,1,0,1
2023-06-01,45825,1,0,1,1,0,1
2023-06-01,45874,2,0,2,1,0,1
2023-06-01,131142,16,2,18,1,1,1
2023-06-01,4655,1,0,1,2,0,2
2023-06-01,24204,8,0,8,4,0,4
2023-06-01,17988,10,0,10,4,0,4
2023-06-01,4656,1,0,1,1,0,1
2023-06-01,24184,1,0,1,1,0,1
2023-06-01,202595,2,0,2,1,0,1
2023-06-01,38884,2,0,2,2,0,2
2023-06-01,38677,1,0,1,2,0,2
2023-06-01,23730,3,0,3,2,0,2
2023-06-01,9513,11,0,11,2,0,2
2023-06-01,17540,1,0,1,3,0,3
2023-06-01,141183,1,0,1,1,0,1
2023-06-01,4748,36,1,37,2,2,3
2023-06-01,38452,1,0,1,2,0,2
2023-06-01,150972,1,0,1,2,0,2
2023-06-01,23641,2,1,3,2,1,2
2023-06-01,37912,1,1,2,1,1,1
2023-06-01,38475,3,0,3,4,0,4
2023-06-01,45749,1,0,1,3,0,3
2023-06-01,45747,2,0,2,3,0,3
2023-06-01,45702,3,0,3,1,0,1
2023-06-01,142011,1,0,1,2,0,2
2023-06-01,45767,4,0,4,3,0,3
2023-06-01,38486,2,0,2,3,0,3
2023-06-01,4858,2,2,4,2,2,2
2023-06-01,23842,10,0,10,1,0,1
2023-06-01,24575,2,0,2,1,0,1
2023-06-01,9237,1,1,2,1,1,1
2023-06-01,65483,1,0,1,1,0,1
2023-06-01,18264,4,0,4,2,0,2
2023-06-01,65555,1,0,1,1,0,1
2023-06-01,17739,1,0,1,2,0,2
2023-06-01,17904,21,0,21,2,0,2
2023-06-01,58434,2,1,3,3,1,3
2023-06-01,55722,4,0,4,4,0,4
2023-06-01,141368,3,0,3,2,0,2
2023-06-01,24288,1,0,1,1,0,1
2023-06-01,131909,3,0,3,2,0,2
2023-06-01,45473,1,0,1,1,0,1
2023-06-01,38905,1,0,1,1,0,1
2023-06-01,38911,1,0,1,1,0,1
2023-06-01,24515,8,6,14,3,1,3
2023-06-01,38536,3,2,5,4,2,4
2023-06-01,10096,2,0,2,3,0,3
2023-06-01,142599,1,0,1,3,0,3
2023-06-01,9618,2,1,3,1,1,1
2023-06-01,24485,2,0,2,3,0,3
2023-06-01,7611,4,0,4,3,0,3
2023-06-01,45697,3,0,3,5,0,5
2023-06-01,45703,2,0,2,3,0,3
2023-06-01,45071,1,0,1,2,0,2
2023-06-01,23774,1,1,2,5,3,7
2023-06-01,9735,2,4,6,2,2,2
2023-06-01,23660,1,0,1,2,0,2
2023-06-01,4622,5,2,7,4,2,4
2023-06-01,24049,1,1,2,1,1,2
2023-06-01,24252,1,1,2,5,1,5
2023-06-01,24089,1,1,2,2,1,2
2023-06-01,38736,1,1,2,1,1,1
2023-06-01,131415,1,1,2,2,1,2
2023-06-01,38737,1,1,2,1,1,1
2023-06-01,135412,1,0,1,1,0,1
2023-06-01,55439,1,1,2,1,1,1
2023-06-01,18368,1,1,2,2,1,2
2023-06-01,56266,2,2,4,1,1,1
2023-06-01,18369,1,1,2,1,1,1
2023-06-01,56088,1,1,2,2,1,2
2023-06-01,37989,3,1,4,6,4,7
2023-06-01,140982,1,0,1,1,0,1
2023-06-01,137468,0,0,0,2,0,2
2023-06-01,45736,1,0,1,3,0,3
2023-06-01,38755,3,0,3,2,0,2
2023-06-01,4855,1,0,1,1,0,1
2023-06-01,38196,3,0,3,1,0,1
2023-06-01,17495,9,0,9,1,0,1
2023-06-01,132873,1,1,2,1,1,1
2023-06-01,10238,21,0,21,3,0,3
2023-06-01,38211,15,0,15,1,0,1
2023-06-01,45797,2,0,2,3,0,3
2023-06-01,45808,2,0,2,3,0,3
2023-06-01,17518,1,0,1,1,0,1
2023-06-01,45153,1,0,1,1,0,1
2023-06-01,45160,1,0,1,2,0,2
2023-06-01,23717,1,0,1,1,0,1
2023-06-01,10116,1,0,1,1,0,1
2023-06-01,18426,1,0,1,2,0,2
2023-06-01,17565,1,0,1,1,0,1
2023-06-01,45155,4,0,4,1,0,1
2023-06-01,131074,0,0,0,2,0,2
2023-06-01,139226,1,0,1,1,0,1
2023-06-01,56012,3,0,3,3,0,3
2023-06-01,24040,4,0,4,3,0,3
2023-06-01,38184,2,0,2,1,0,1
2023-06-01,23644,2,0,2,2,0,2
2023-06-01,38296,18,0,18,7,0,7
2023-06-01,38578,1,0,1,4,0,4
2023-06-01,45519,1,0,1,2,0,2
2023-06-01,45293,2,0,2,4,0,4
2023-06-01,45518,3,0,3,3,0,3
2023-06-01,17478,3,0,3,4,0,4
2023-06-01,134089,1,0,1,1,0,1
2023-06-01,9649,90,1,91,6,1,6
2023-06-01,23665,4,0,4,4,0,4
2023-06-01,137546,5,1,6,1,1,1
2023-06-01,135588,1,0,1,1,0,1
2023-06-01,135129,1,0,1,2,0,2
2023-06-01,135141,1,0,1,1,0,1
2023-06-01,45575,16,1,17,2,2,3
2023-06-01,37932,17,1,18,3,1,3
2023-06-01,136737,3,0,3,3,0,3
2023-06-01,132482,9,1,10,3,1,3
2023-06-01,142437,1,1,2,1,1,1
2023-06-01,135586,1,1,2,1,1,1
2023-06-01,137856,1,1,2,1,1,1
2023-06-01,141362,1,1,2,1,1,1
2023-06-01,24517,3,0,3,2,0,2
2023-06-01,45229,3,0,3,3,0,3
2023-06-01,45525,1,0,1,1,0,1
2023-06-01,24160,1,0,1,1,0,1
2023-06-01,45556,1,0,1,3,0,3
2023-06-01,131217,1,1,2,1,1,1
2023-06-01,45221,1,0,1,3,0,3
2023-06-01,9223,1,0,1,2,0,2
2023-06-01,45319,1,0,1,1,0,1
2023-06-01,9334,1,0,1,1,0,1
2023-06-01,38315,8,0,8,3,0,3
2023-06-01,4850,1,0,1,1,0,1
2023-06-01,45533,7,1,8,2,1,2
2023-06-01,17912,1,0,1,1,0,1
2023-06-01,23883,1,1,2,1,1,1
2023-06-01,45626,1,0,1,2,0,2
2023-06-01,7619,3,0,3,1,0,1
2023-06-01,38605,1,1,2,1,1,1
2023-06-01,45573,1,0,1,3,0,3
2023-06-01,45583,1,0,1,1,0,1
2023-06-01,137392,2,0,2,3,0,3
2023-06-01,45171,1,0,1,1,0,1
2023-06-01,24290,2,0,2,1,0,1
2023-06-01,24495,1,0,1,1,0,1
2023-06-01,23731,4,0,4,4,0,4
2023-06-01,45591,1,0,1,3,0,3
2023-06-01,45627,1,0,1,1,0,1
2023-06-01,38271,1,0,1,1,0,1
2023-06-01,9836,1,1,2,2,1,2
2023-06-01,45597,2,0,2,5,0,5
2023-06-01,135400,3,0,3,1,0,1
2023-06-01,45875,1,0,1,1,0,1
2023-06-01,24141,2,0,2,1,0,1
2023-06-01,45190,1,0,1,1,0,1
2023-06-01,45195,1,0,1,3,0,3
2023-06-01,37973,1,0,1,3,0,3
2023-06-01,132595,1,0,1,1,0,1
2023-06-01,139798,1,0,1,1,0,1
2023-06-01,24179,1,0,1,2,0,2
2023-06-01,45343,1,0,1,1,0,1
2023-06-01,9460,1,0,1,1,0,1
2023-06-01,45188,1,0,1,1,0,1
2023-06-01,55760,9,0,9,2,0,2
2023-06-01,38463,4,0,4,2,0,2
2023-06-01,18194,4,0,4,1,0,1
2023-06-01,38006,1,0,1,2,0,2
2023-06-01,38730,5,0,5,3,0,3
2023-06-01,45202,1,0,1,2,0,2
2023-06-01,45205,1,0,1,1,0,1
2023-06-01,45207,1,0,1,2,0,2
2023-06-01,45304,4,1,5,3,2,3
2023-06-01,17537,17,1,18,6,5,6
2023-06-01,55609,1,0,1,2,0,2
2023-06-01,45211,1,0,1,3,0,3
2023-06-01,38510,2,0,2,2,0,2
2023-06-01,24397,3,2,5,3,1,3
2023-06-01,45218,2,0,2,2,0,2
2023-06-01,17748,1,0,1,1,0,1
2023-06-01,17723,1,0,1,1,0,1
2023-06-01,38021,1,0,1,2,0,2
2023-06-01,38050,2,0,2,3,0,3
2023-06-01,38658,1,0,1,1,0,1
2023-06-01,63951,6,0,6,3,0,3
2023-06-01,23804,1,0,1,1,0,1
2023-06-01,24304,2,0,2,2,0,2
2023-06-01,131762,1,0,1,2,0,2
2023-06-01,45541,6,0,6,3,0,3
2023-06-01,136615,1,0,1,1,0,1
2023-06-01,45624,1,0,1,3,0,3
2023-06-01,45476,1,0,1,1,0,1
2023-06-01,45616,1,0,1,1,0,1
2023-06-01,45314,1,0,1,2,0,2
2023-06-01,17810,4,0,4,2,0,2
2023-06-01,141238,3,0,3,1,0,1
2023-06-01,147044,1,0,1,1,0,1
2023-06-01,149519,1,0,1,3,0,3
2023-06-01,134154,1,0,1,1,0,1
2023-06-01,140549,2,0,2,1,0,1
2023-06-01,137395,1,0,1,3,0,3
2023-06-01,58735,2,1,3,3,1,3
2023-06-01,17545,2,0,2,3,0,3
2023-06-01,133321,3,1,4,3,1,3
2023-06-01,56200,1,0,1,2,0,2
2023-06-01,17787,20,1,21,3,1,3
2023-06-01,45810,4,0,4,1,0,1
2023-06-01,45813,1,0,1,1,0,1
2023-06-01,45827,1,0,1,2,0,2
2023-06-01,131195,4,0,4,3,0,3
2023-06-01,45712,4,1,5,4,1,4
2023-06-01,45636,1,0,1,3,0,3
2023-06-01,45640,1,0,1,1,0,1
2023-06-01,9273,3,0,3,2,0,2
2023-06-01,45385,61,0,61,3,0,3
2023-06-01,10194,1,0,1,2,0,2
2023-06-01,9493,2,0,2,3,0,3
2023-06-01,38098,2,0,2,2,0,2
2023-06-01,10162,3,0,3,3,0,3
2023-06-01,17599,7,0,7,2,0,2
2023-06-01,18325,5,0,5,2,0,2
2023-06-01,18297,27,0,27,1,0,1
2023-06-01,17868,4,0,4,1,0,1
2023-06-01,24026,9,0,9,1,0,1
2023-06-01,9637,7,0,7,1,0,1
2023-06-01,18309,2,0,2,2,0,2
2023-06-01,3608,9,0,9,2,0,2
2023-06-01,17881,6,0,6,1,0,1
2023-06-01,9859,27,0,27,1,0,1
2023-06-01,18331,6,0,6,3,0,3
2023-06-01,55611,7,0,7,2,0,2
2023-06-01,10198,2,0,2,1,0,1
2023-06-01,9572,7,0,7,1,0,1
2023-06-01,7557,23,0,23,2,0,2
2023-06-01,10156,3,0,3,1,0,1
2023-06-01,18035,7,0,7,2,0,2
2023-06-01,17855,2,0,2,2,0,2
2023-06-01,9491,3,0,3,2,0,2
2023-06-01,38686,3,0,3,2,0,2
2023-06-01,9979,1,0,1,2,0,2
2023-06-01,9575,1,0,1,1,0,1
2023-06-01,10166,5,0,5,1,0,1
2023-06-01,23983,3,0,3,2,0,2
2023-06-01,17614,4,0,4,2,0,2
2023-06-01,18319,7,0,7,1,0,1
2023-06-01,23586,1,0,1,2,0,2
2023-06-01,38694,10,0,10,2,0,2
2023-06-01,9492,5,0,5,1,0,1
2023-06-01,4669,17,0,17,1,0,1
2023-06-01,45373,1,0,1,1,0,1
2023-06-01,131794,2,0,2,2,0,2
2023-06-01,9577,4,0,4,4,0,4
2023-06-01,131820,3,0,3,2,0,2
2023-06-01,9527,2,0,2,2,0,2
2023-06-01,9953,1,0,1,2,0,2
2023-06-01,17865,11,0,11,1,0,1
2023-06-01,9320,5,0,5,2,0,2
2023-06-01,17869,2,0,2,1,0,1
2023-06-01,9645,2,0,2,3,0,3
2023-06-01,45977,3,0,3,1,0,1
2023-06-01,10044,7,0,7,2,0,2
2023-06-01,9568,32,0,32,1,0,1
2023-06-01,131830,3,0,3,1,0,1
2023-06-01,131795,13,0,13,1,0,1
2023-06-01,9780,12,0,12,1,0,1
2023-06-01,10189,6,0,6,1,0,1
2023-06-01,9783,1,0,1,1,0,1
2023-06-01,18315,4,0,4,2,0,2
2023-06-01,46012,15,0,15,1,0,1
2023-06-01,17591,2,0,2,1,0,1
2023-06-01,24027,8,0,8,2,0,2
2023-06-01,17606,1,0,1,1,0,1
2023-06-01,10063,10,0,10,3,0,3
2023-06-01,45963,1,0,1,2,0,2
2023-06-01,55589,11,0,11,3,0,3
2023-06-01,9867,21,0,21,1,0,1
2023-06-01,18330,13,0,13,1,0,1
2023-06-01,9978,2,0,2,1,0,1
2023-06-01,55621,5,0,5,2,0,2
2023-06-01,17593,21,0,21,2,0,2
2023-06-01,55618,66,0,66,1,0,1
2023-06-01,9769,10,0,10,2,0,2
2023-06-01,9521,5,0,5,1,0,1
2023-06-01,55617,2,0,2,3,0,3
2023-06-01,18308,1,0,1,1,0,1
2023-06-01,10180,1,0,1,3,0,3
2023-06-01,45984,3,0,3,1,0,1
2023-06-01,17576,2,0,2,2,0,2
2023-06-01,10051,3,0,3,2,0,2
2023-06-01,10070,2,0,2,1,0,1
2023-06-01,17861,5,0,5,1,0,1
2023-06-01,9970,12,0,12,2,0,2
2023-06-01,23975,6,0,6,1,0,1
2023-06-01,9975,1,0,1,1,0,1
2023-06-01,26812,3,0,3,2,0,2
2023-06-01,397601,3,14,17,1,7,7
2023-06-01,64404,1,2,3,5,5,7
2023-06-01,3939,2,0,2,1,0,1
2023-06-01,6111,6,0,6,5,0,5
2023-06-01,54407,7,0,7,2,0,2
2023-06-01,13372,1,0,1,3,0,3
2023-06-01,399738,1,0,1,2,0,2
2023-06-01,272591,3,0,3,1,0,1
2023-06-01,4991,1,0,1,1,0,1
2023-06-01,27443,3,0,3,1,0,1
2023-06-01,11248,2,0,2,4,0,4
2023-06-01,26017,1,0,1,3,0,3
2023-06-01,22218,2,0,2,1,0,1
2023-06-01,18968,4,0,4,1,0,1
2023-06-01,32540,3,0,3,3,0,3
2023-06-01,10563,2,0,2,1,0,1
2023-06-01,54516,1,0,1,2,0,2
2023-06-01,30574,3,0,3,4,0,4
2023-06-01,397941,1,0,1,2,0,2
2023-06-01,396077,2,0,2,4,0,4
2023-06-01,328165,1,0,1,1,0,1
2023-06-01,328241,1,0,1,1,0,1
2023-06-01,328158,1,0,1,1,0,1
2023-06-01,328221,1,0,1,3,0,3
2023-06-01,32825,1,0,1,3,0,3
2023-06-01,395338,1,0,1,3,0,3
2023-06-01,395412,1,0,1,3,0,3
2023-06-01,395664,1,0,1,1,0,1
2023-06-01,32782,1,0,1,1,0,1
2023-06-01,394918,1,0,1,2,0,2
2023-06-01,25617,5,0,5,1,0,1
2023-06-01,30259,17,1,18,2,1,2
2023-06-01,23458,5,0,5,3,0,3
2023-06-01,18913,2,0,2,4,0,4
2023-06-01,33254,9,0,9,2,0,2
2023-06-01,10554,4,0,4,3,0,3
2023-06-01,54733,1,0,1,2,0,2
2023-06-01,33397,2,1,3,2,1,2
2023-06-01,22154,1,0,1,1,0,1
2023-06-01,21750,6,0,6,3,0,3
2023-06-01,6465,1,1,2,1,1,1
2023-06-01,23351,1,0,1,2,0,2
2023-06-01,397813,1,0,1,2,0,2
2023-06-01,397432,3,0,3,2,0,2
2023-06-01,21553,2,0,2,3,0,3
2023-06-01,394565,2,0,2,1,0,1
2023-06-01,35980,4,0,4,1,0,1
2023-06-01,1011,1,1,2,4,3,5
2023-06-01,22169,2,2,4,2,2,2
2023-06-01,16861,1,0,1,2,0,2
2023-06-01,20229,3,0,3,2,0,2
2023-06-01,36155,1,0,1,2,0,2
2023-06-01,397841,1,0,1,1,0,1
2023-06-01,16541,1,0,1,1,0,1
2023-06-01,399285,2,3,5,1,1,1
2023-06-01,397424,1,0,1,3,0,3
2023-06-01,207600,1,0,1,1,0,1
2023-06-01,16932,2,0,2,2,0,2
2023-06-01,32511,1,0,1,3,0,3
2023-06-01,34936,1,1,2,2,3,3
2023-06-01,400764,1,1,2,1,1,1
2023-06-01,33365,2,0,2,4,0,4
2023-06-01,30398,3,0,3,1,0,1
2023-06-01,33419,4,2,6,4,4,4
2023-06-01,22107,5,0,5,2,0,2
2023-06-01,11166,3,0,3,3,0,3
2023-06-01,23211,1,0,1,2,0,2
2023-06-01,29709,1,0,1,4,0,4
2023-06-01,36536,7,0,7,3,0,3
2023-06-01,11753,1,0,1,3,0,3
2023-06-01,17009,3,0,3,2,0,2
2023-06-01,32952,3,0,3,1,0,1
2023-06-01,22268,10,0,10,4,0,4
2023-06-01,11110,1,1,2,1,1,1
2023-06-01,394698,1,0,1,2,0,2
2023-06-01,33556,2,1,3,1,1,1
2023-06-01,33743,2,0,2,2,0,2
2023-06-01,22265,1,0,1,1,0,1
2023-06-01,22395,2,0,2,2,0,2
2023-06-01,35934,2,0,2,3,0,3
2023-06-01,16427,1,0,1,3,0,3
2023-06-01,394339,1,0,1,1,0,1
2023-06-01,394836,1,0,1,1,0,1
2023-06-01,12265,1,0,1,6,0,6
2023-06-01,36349,2,0,2,1,0,1
2023-06-01,33569,9,0,9,1,0,1
2023-06-01,15137,1,0,1,3,0,3
2023-06-01,33190,1,0,1,2,0,2
2023-06-01,12215,1,0,1,2,0,2
2023-06-01,15176,6,1,7,3,2,3
2023-06-01,18612,1,0,1,1,0,1
2023-06-01,18918,1,0,1,1,0,1
2023-06-01,2740,2,2,4,1,1,1
2023-06-01,398228,1,0,1,1,0,1
2023-06-01,29754,2,0,2,1,0,1
2023-06-01,400716,1,0,1,3,0,3
2023-06-01,19586,8,8,16,1,1,1
2023-06-01,31931,1,0,1,2,0,2
2023-06-01,19609,2,0,2,3,0,3
2023-06-01,14387,2,0,2,2,0,2
2023-06-01,398896,1,0,1,1,0,1
2023-06-01,31915,2,0,2,2,0,2
2023-06-01,14712,1,1,2,1,1,1
2023-06-01,32991,4,0,4,1,0,1
2023-06-01,36212,1,0,1,1,0,1
2023-06-01,32257,4,0,4,3,0,3
2023-06-01,16900,4,0,4,2,0,2
2023-06-01,54164,2,0,2,3,0,3
2023-06-01,400352,1,0,1,1,0,1
2023-06-01,394430,1,0,1,4,0,4
2023-06-01,36022,1,0,1,3,0,3
2023-06-01,33377,2,0,2,2,0,2
2023-06-01,19972,4,0,4,1,0,1
2023-06-01,26452,3,0,3,1,0,1
2023-06-01,13734,1,0,1,1,0,1
2023-06-01,26735,5,0,5,2,0,2
2023-06-01,19557,1,1,2,1,1,1
2023-06-01,32132,1,0,1,2,0,2
2023-06-01,14312,3,0,3,3,0,3
2023-06-01,11733,2,0,2,3,0,3
2023-06-01,54626,1,0,1,1,0,1
2023-06-01,19542,2,0,2,2,0,2
2023-06-01,213154,1,4,5,3,4,4
2023-06-01,40796,1,0,1,1,0,1
2023-06-01,19511,2,0,2,3,0,3
2023-06-01,397417,3,0,3,1,0,1
2023-06-01,40737,1,0,1,3,0,3
2023-06-01,53792,1,0,1,1,0,1
2023-06-01,29820,1,0,1,2,0,2
2023-06-01,25989,1,0,1,1,0,1
2023-06-01,395759,5,0,5,3,0,3
2023-06-01,53754,1,0,1,2,0,2
2023-06-01,54672,2,0,2,2,0,2
2023-06-01,11435,5,0,5,2,0,2
2023-06-01,40599,1,0,1,2,0,2
2023-06-01,53794,1,0,1,1,0,1
2023-06-01,22251,10,0,10,2,0,2
2023-06-01,63451,1,0,1,2,0,2
2023-06-01,36319,5,0,5,2,0,2
2023-06-01,18558,134,1,135,1,1,1
2023-06-01,395002,1,0,1,2,0,2
2023-06-01,30592,1,0,1,3,0,3
2023-06-01,54219,1,0,1,1,0,1
2023-06-01,21602,1,0,1,1,0,1
2023-06-01,11012,3,0,3,1,0,1
2023-06-01,33714,3,0,3,3,0,3
2023-06-01,40798,1,0,1,1,0,1
2023-06-01,393979,1,0,1,1,0,1
2023-06-01,399118,1,0,1,3,0,3
2023-06-01,20182,1,2,3,2,1,2
2023-06-01,53515,1,0,1,2,0,2
2023-06-01,1438,2,0,2,3,0,3
2023-06-01,46724,4,0,4,2,0,2
2023-06-01,22155,2,0,2,3,0,3
2023-06-01,21543,6,0,6,3,0,3
2023-06-01,53789,1,0,1,1,0,1
2023-06-01,55046,2,0,2,1,0,1
2023-06-01,18751,1,0,1,1,0,1
2023-06-01,40580,1,0,1,2,0,2
2023-06-01,32525,2,0,2,2,0,2
2023-06-01,19014,1,1,2,2,1,2
2023-06-01,3954,7,0,7,2,0,2
2023-06-01,514,1,0,1,1,0,1
2023-06-01,858,1,0,1,1,0,1
2023-06-01,859,1,0,1,1,0,1
2023-06-01,860,1,0,1,1,0,1
2023-06-01,861,1,0,1,1,0,1
2023-06-01,862,1,0,1,1,0,1
2023-06-01,863,1,0,1,1,0,1
2023-06-01,864,1,0,1,1,0,1
2023-06-01,865,1,0,1,1,0,1
2023-06-01,866,1,0,1,1,0,1
2023-06-01,867,1,0,1,1,0,1
2023-06-01,868,1,0,1,1,0,1
2023-06-01,869,1,0,1,1,0,1
2023-06-01,870,1,0,1,1,0,1
2023-06-01,871,1,0,1,1,0,1
2023-06-01,872,1,0,1,1,0,1
2023-06-01,873,1,0,1,1,0,1
2023-06-01,874,1,0,1,1,0,1
2023-06-01,875,1,0,1,1,0,1
2023-06-01,876,1,0,1,1,0,1
2023-06-01,877,1,0,1,1,0,1
2023-06-01,878,1,0,1,1,0,1
2023-06-01,879,1,0,1,1,0,1
2023-06-01,880,1,0,1,1,0,1
2023-06-01,881,1,0,1,1,0,1
2023-06-01,882,1,0,1,1,0,1
2023-06-01,883,1,0,1,1,0,1
2023-06-01,884,1,0,1,1,0,1
2023-06-01,885,1,0,1,1,0,1
2023-06-01,6172,3,0,3,4,0,4
2023-06-01,29954,24,0,24,4,0,4
2023-06-01,53883,1,0,1,1,0,1
2023-06-01,33159,1,0,1,1,0,1
2023-06-01,22971,3,0,3,3,0,3
2023-06-01,27376,2,0,2,2,0,2
2023-06-01,26280,7,0,7,2,0,2
2023-06-01,4186,1,0,1,1,0,1
2023-06-01,14095,1,0,1,2,0,2
2023-06-01,54067,3,0,3,4,0,4
2023-06-01,53874,1,0,1,1,0,1
2023-06-01,23439,1,0,1,1,0,1
2023-06-01,400079,1,0,1,1,0,1
2023-06-01,30667,2,0,2,1,0,1
2023-06-01,23065,1,0,1,1,0,1
2023-06-01,19126,1,0,1,2,0,2
2023-06-01,399586,4,0,4,3,0,3
2023-06-01,46482,1,1,2,3,1,4
2023-06-01,54130,2,0,2,2,0,2
2023-06-01,36350,2,0,2,2,0,2
2023-06-01,26011,1,0,1,1,0,1
2023-06-01,32031,1,1,2,1,1,1
2023-06-01,40360,1,0,1,3,0,3
2023-06-01,4393,4,0,4,2,0,2
2023-06-01,393390,1,0,1,1,0,1
2023-06-01,62944,1,0,1,2,0,2
2023-06-01,18581,2,0,2,3,0,3
2023-06-01,264823,8,1,9,3,2,3
2023-06-01,133750,5,1,6,2,1,2
2023-06-01,150717,2,0,2,1,0,1
2023-06-01,26648,2,0,2,1,0,1
2023-06-01,26995,3,0,3,5,0,5
2023-06-01,33056,1,0,1,2,0,2
2023-06-01,394770,2,0,2,2,0,2
2023-06-01,36861,8,0,8,3,0,3
2023-06-01,395490,2,0,2,1,0,1
2023-06-01,397551,1,0,1,2,0,2
2023-06-01,33173,1,0,1,2,0,2
2023-06-01,32057,1,0,1,1,0,1
2023-06-01,22229,3,0,3,1,0,1
2023-06-01,10632,10,0,10,3,0,3
2023-06-01,40502,1,0,1,2,0,2
2023-06-01,18694,4,2,6,2,1,2
2023-06-01,33595,1,0,1,2,0,2
2023-06-01,23431,4,1,5,4,1,4
2023-06-01,393222,2,0,2,2,0,2
2023-06-01,54209,2,0,2,1,0,1
2023-06-01,15041,1,0,1,1,0,1
2023-06-01,394741,2,0,2,2,0,2
2023-06-01,17091,2,0,2,3,0,3
2023-06-01,398114,1,0,1,3,0,3
2023-06-01,395609,1,0,1,1,0,1
2023-06-01,395615,1,0,1,1,0,1
2023-06-01,16419,1,0,1,1,0,1
2023-06-01,16660,1,0,1,1,0,1
2023-06-01,19769,1,0,1,1,0,1
2023-06-01,26336,1,0,1,2,0,2
2023-06-01,33482,2,0,2,3,0,3
2023-06-01,27583,2,0,2,1,0,1
2023-06-01,33016,2,0,2,2,0,2
2023-06-01,397320,2,0,2,3,0,3
2023-06-01,393274,2,0,2,2,0,2
2023-06-01,54214,1,0,1,2,0,2
2023-06-01,25792,1,0,1,2,0,2
2023-06-01,395367,4,0,4,2,0,2
2023-06-01,396218,2,0,2,2,0,2
2023-06-01,19280,3,0,3,1,0,1
2023-06-01,36410,1,0,1,3,0,3
2023-06-01,400411,1,0,1,1,0,1
2023-06-01,393826,1,0,1,1,0,1
2023-06-01,394516,2,0,2,3,0,3
2023-06-01,20109,3,2,5,3,1,3
2023-06-01,396522,2,0,2,2,0,2
2023-06-01,36259,2,0,2,3,0,3
2023-06-01,23049,6,0,6,2,0,2
2023-06-01,1648,17,0,17,2,0,2
2023-06-01,12047,5,0,5,3,0,3
2023-06-01,39936,1,0,1,2,0,2
2023-06-01,40337,1,1,2,2,2,2
2023-06-01,19510,61,0,61,7,0,7
2023-06-01,14915,1,0,1,2,0,2
2023-06-01,395832,1,0,1,2,0,2
2023-06-01,54189,1,0,1,1,0,1
2023-06-01,394333,1,0,1,2,0,2
2023-06-01,11695,1,0,1,1,0,1
2023-06-01,32062,6,0,6,6,0,6
2023-06-01,399160,2,2,4,1,1,1
2023-06-01,399163,2,2,4,1,1,1
2023-06-01,399154,2,2,4,1,1,1
2023-06-01,399156,2,2,4,1,1,1
2023-06-01,399159,2,2,4,1,1,1
2023-06-01,23068,7,0,7,2,0,2
2023-06-01,26245,23,0,23,6,0,6
2023-06-01,11089,1,0,1,2,0,2
2023-06-01,1428,1,0,1,2,0,2
2023-06-01,53878,2,0,2,2,0,2
2023-06-01,7735,5,0,5,1,0,1
2023-06-01,16679,1,0,1,2,0,2
2023-06-01,46571,2,1,3,1,1,2
2023-06-01,53796,1,0,1,2,0,2
2023-06-01,22638,1,0,1,1,0,1
2023-06-01,40883,1,0,1,2,0,2
2023-06-01,20314,9,0,9,3,0,3
2023-06-01,398378,4,2,6,3,3,3
2023-06-01,53858,1,0,1,2,0,2
2023-06-01,63254,5,0,5,2,0,2
2023-06-01,15230,1,0,1,2,0,2
2023-06-01,396336,7,0,7,2,0,2
2023-06-01,13620,3,0,3,3,0,3
2023-06-01,13566,2,0,2,1,0,1
2023-06-01,16957,3,1,4,3,2,3
2023-06-01,400328,1,0,1,1,0,1
2023-06-01,32019,3,1,4,3,3,3
2023-06-01,35918,3,0,3,2,0,2
2023-06-01,54055,1,0,1,1,0,1
2023-06-01,18507,1,0,1,1,0,1
2023-06-01,36822,1,0,1,1,0,1
2023-06-01,46760,3,0,3,3,0,3
2023-06-01,54068,1,0,1,3,0,3
2023-06-01,40096,1,0,1,2,0,2
2023-06-01,54079,1,0,1,2,0,2
2023-06-01,21672,1,0,1,3,0,3
2023-06-01,54061,1,0,1,1,0,1
2023-06-01,26521,1,0,1,1,0,1
2023-06-01,54047,1,0,1,1,0,1
2023-06-01,46550,3,0,3,2,0,2
2023-06-01,19576,6,0,6,4,0,4
2023-06-01,394126,31,0,31,3,0,3
2023-06-01,31923,5,0,5,4,0,4
2023-06-01,30457,1,0,1,1,0,1
2023-06-01,20090,2,0,2,1,0,1
2023-06-01,394718,2,0,2,1,0,1
2023-06-01,394712,4,0,4,1,0,1
2023-06-01,27284,1,0,1,1,0,1
2023-06-01,54091,1,0,1,2,0,2
2023-06-01,17120,2,0,2,1,0,1
2023-06-01,30324,4,0,4,2,0,2
2023-06-01,397894,1,2,3,1,1,2
2023-06-01,20197,3,0,3,1,0,1
2023-06-01,17085,1,0,1,3,0,3
2023-06-01,53954,1,0,1,2,0,2
2023-06-01,396843,2,0,2,4,0,4
2023-06-01,11811,3,0,3,1,0,1
2023-06-01,3930,6,0,6,1,0,1
2023-06-01,21860,2,0,2,2,0,2
2023-06-01,54059,1,0,1,1,0,1
2023-06-01,399436,1,0,1,1,0,1
2023-06-01,18517,1,0,1,1,0,1
2023-06-01,13676,28,0,28,2,0,2
2023-06-01,5036,2,0,2,2,0,2
2023-06-01,398282,1,0,1,1,0,1
2023-06-01,394052,1,0,1,1,0,1
2023-06-01,46594,1,0,1,3,0,3
2023-06-01,397728,1,0,1,2,0,2
2023-06-01,21932,1,0,1,1,0,1
2023-06-01,46939,1,1,2,1,1,2
2023-06-01,32941,1,0,1,1,0,1
2023-06-01,53647,4,0,4,2,0,2
2023-06-01,40248,1,0,1,2,0,2
2023-06-01,11307,3,0,3,4,0,4
2023-06-01,54961,1,0,1,2,0,2
2023-06-01,399028,2,0,2,1,0,1
2023-06-01,396260,2,0,2,1,0,1
2023-06-01,10596,11,1,12,1,1,1
2023-06-01,36194,1,0,1,1,0,1
2023-06-01,398334,1,1,2,6,4,6
2023-06-01,6491,2,1,3,1,1,1
2023-06-01,32928,1,0,1,4,0,4
2023-06-01,11020,2,0,2,1,0,1
2023-06-01,15258,1,0,1,1,0,1
2023-06-01,46670,4,0,4,1,0,1
2023-06-01,40170,11,0,11,3,0,3
2023-06-01,53819,1,0,1,2,0,2
2023-06-01,53970,1,0,1,1,0,1
2023-06-01,29964,1,0,1,3,0,3
2023-06-01,46221,1,0,1,1,0,1
2023-06-01,16790,1,0,1,1,0,1
2023-06-01,4133,4,0,4,1,0,1
2023-06-01,6521,1,1,2,1,1,1
2023-06-01,16403,8,0,8,3,0,3
2023-06-01,33017,7,0,7,1,0,1
2023-06-01,16487,3,0,3,2,0,2
2023-06-01,54788,1,0,1,3,0,3
2023-06-01,23117,13,0,13,1,0,1
2023-06-01,13418,1,0,1,1,0,1
2023-06-01,397040,1,0,1,2,0,2
2023-06-01,46678,3,0,3,3,0,3
2023-06-01,53747,1,0,1,2,0,2
2023-06-01,27511,1,0,1,3,0,3
2023-06-01,6216,1,0,1,2,0,2
2023-06-01,53748,1,0,1,3,0,3
2023-06-01,27296,1,0,1,2,0,2
2023-06-01,394191,1,1,2,2,2,2
2023-06-01,54881,1,0,1,3,0,3
2023-06-01,63204,1,0,1,2,0,2
2023-06-01,21518,1,0,1,3,0,3
2023-06-01,36401,1,0,1,1,0,1
2023-06-01,5098,3,0,3,3,0,3
2023-06-01,30193,5,0,5,1,0,1
2023-06-01,394258,1,0,1,1,0,1
2023-06-01,22192,19,1,20,5,1,5
2023-06-01,398774,5,2,7,2,2,2
2023-06-01,11005,1,0,1,2,0,2
2023-06-01,46224,1,0,1,2,0,2
2023-06-01,33723,3,0,3,2,0,2
2023-06-01,396940,9,0,9,2,0,2
2023-06-01,396936,7,0,7,2,0,2
2023-06-01,5101,1,0,1,1,0,1
2023-06-01,19558,6,0,6,3,0,3
2023-06-01,27009,2,0,2,2,0,2
2023-06-01,21694,5,1,6,2,1,2
2023-06-01,19269,3,0,3,2,0,2
2023-06-01,4309,4,0,4,2,0,2
2023-06-01,22838,10,0,10,2,0,2
2023-06-01,395135,1,0,1,1,0,1
2023-06-01,393837,1,1,2,1,1,1
2023-06-01,36230,1,0,1,2,0,2
2023-06-01,19477,9,0,9,3,0,3
2023-06-01,15205,3,0,3,2,0,2
2023-06-01,11345,1,0,1,1,0,1
2023-06-01,395323,3,0,3,3,0,3
2023-06-01,53562,2,0,2,2,0,2
2023-06-01,53700,1,0,1,1,0,1
2023-06-01,32454,2,0,2,2,0,2
2023-06-01,16882,1,0,1,1,0,1
2023-06-01,26701,1,0,1,1,0,1
2023-06-01,53709,1,0,1,1,0,1
2023-06-01,15275,1,0,1,3,0,3
2023-06-01,14687,1,0,1,3,0,3
2023-06-01,22228,2,0,2,2,0,2
2023-06-01,22385,2,0,2,1,0,1
2023-06-01,21964,4,0,4,4,0,4
2023-06-01,63016,1,1,2,2,1,2
2023-06-01,32619,9,0,9,3,0,3
2023-06-01,36397,1,0,1,1,0,1
2023-06-01,46567,3,0,3,4,0,4
2023-06-01,40056,1,0,1,2,0,2
2023-06-01,46334,5,0,5,1,0,1
2023-06-01,39999,1,0,1,1,0,1
2023-06-01,16480,1,0,1,1,0,1
2023-06-01,54843,3,0,3,2,0,2
2023-06-01,54776,4,0,4,1,0,1
2023-06-01,11679,3,0,3,3,0,3
2023-06-01,400520,1,0,1,1,0,1
2023-06-01,33315,1,0,1,1,0,1
2023-06-01,33539,4,0,4,1,0,1
2023-06-01,12092,4,0,4,2,0,2
2023-06-01,11296,2,0,2,4,0,4
2023-06-01,7748,2,0,2,2,0,2
2023-06-01,397793,1,0,1,3,0,3
2023-06-01,40691,1,0,1,1,0,1
2023-06-01,15172,1,0,1,1,0,1
2023-06-01,53714,1,0,1,2,0,2
2023-06-01,46984,3,0,3,4,0,4
2023-06-01,53718,1,0,1,3,0,3
2023-06-01,11334,10,0,10,4,0,4
2023-06-01,397398,1,0,1,1,0,1
2023-06-01,393244,1,0,1,3,0,3
2023-06-01,23147,1,0,1,1,0,1
2023-06-01,33120,3,0,3,2,0,2
2023-06-01,394040,2,0,2,3,0,3
2023-06-01,22076,1,0,1,2,0,2
2023-06-01,26182,3,0,3,3,0,3
2023-06-01,397776,2,0,2,1,0,1
2023-06-01,271959,2,0,2,1,0,1
2023-06-01,30425,1,0,1,2,0,2
2023-06-01,14003,1,0,1,1,0,1
2023-06-01,33510,2,0,2,1,0,1
2023-06-01,40042,4,0,4,2,0,2
2023-06-01,33417,1,0,1,3,0,3
2023-06-01,6092,1,0,1,3,0,3
2023-06-01,63153,1,0,1,1,0,1
2023-06-01,399968,1,0,1,3,0,3
2023-06-01,26830,1,1,2,2,1,2
2023-06-01,4468,10,0,10,2,0,2
2023-06-01,20235,2,0,2,4,0,4
2023-06-01,54703,1,0,1,1,0,1
2023-06-01,394934,1,0,1,2,0,2
2023-06-01,26846,1,0,1,1,0,1
2023-06-01,21914,1,0,1,1,0,1
2023-06-01,15037,1,0,1,1,0,1
2023-06-01,397263,1,1,2,3,3,3
2023-06-01,396299,2,0,2,3,0,3
2023-06-01,14034,1,0,1,1,0,1
2023-06-01,20186,0,0,0,2,0,2
2023-06-01,40319,1,0,1,1,0,1
2023-06-01,13940,5,0,5,1,0,1
2023-06-01,395519,4,0,4,2,0,2
2023-06-01,14767,1,0,1,4,0,4
2023-06-01,395982,3,0,3,3,0,3
2023-06-01,20352,7,0,7,4,0,4
2023-06-01,54924,1,0,1,1,0,1
2023-06-01,53663,1,0,1,1,0,1
2023-06-01,396276,1,0,1,1,0,1
2023-06-01,11091,1,0,1,2,0,2
2023-06-01,17015,5,0,5,2,0,2
2023-06-01,19076,14,0,14,1,0,1
2023-06-01,397024,1,0,1,3,0,3
2023-06-01,397157,1,0,1,3,0,3
2023-06-01,4200010285,1,0,1,1,0,1
2023-06-01,11465,1,0,1,3,0,3
2023-06-01,18955,1,0,1,1,0,1
2023-06-01,22881,2,0,2,3,0,3
2023-06-01,33655,0,7,7,3,1,3
2023-06-01,272055,1,1,2,1,1,1
2023-06-01,272054,4,1,5,2,1,2
2023-06-01,400350,1,0,1,1,0,1
2023-06-01,40435,1,0,1,1,0,1
2023-06-01,33113,1,0,1,2,0,2
2023-06-01,19110,1,0,1,1,0,1
2023-06-01,46908,1,0,1,3,0,3
2023-06-01,19297,1,0,1,1,0,1
2023-06-01,19276,6,0,6,5,0,5
2023-06-01,30559,1,0,1,2,0,2
2023-06-01,16434,1,0,1,2,0,2
2023-06-01,53656,1,0,1,3,0,3
2023-06-01,47057,3,0,3,2,0,2
2023-06-01,15080,1,0,1,3,0,3
2023-06-01,395711,4,0,4,3,0,3
2023-06-01,22342,1,0,1,1,0,1
2023-06-01,18964,12,0,12,5,0,5
2023-06-01,11935,1,0,1,2,0,2
2023-06-01,275,1,1,2,1,1,1
2023-06-01,6210,3,0,3,2,0,2
2023-06-01,3938,1,1,2,1,1,1
2023-06-01,17005,2,0,2,1,0,1
2023-06-01,396071,1,1,2,2,2,2
2023-06-01,46563,1,0,1,1,0,1
2023-06-01,32305,1,0,1,1,0,1
2023-06-01,395001,1,0,1,1,0,1
2023-06-01,13346,3,0,3,4,0,4
2023-06-01,399726,4,1,5,1,1,1
2023-06-01,397405,1,0,1,2,0,2
2023-06-01,62469,1,0,1,2,0,2
2023-06-01,394697,1,0,1,1,0,1
2023-06-01,23427,5,0,5,2,0,2
2023-06-01,20302,1,0,1,2,0,2
2023-06-01,46656,1,1,2,2,2,2
2023-06-01,399269,1,0,1,1,0,1
2023-06-01,17010,1,0,1,3,0,3
2023-06-01,21974,1,0,1,2,0,2
2023-06-01,54223,1,0,1,2,0,2
2023-06-01,13700,1,0,1,1,0,1
2023-06-01,21802,1,0,1,2,0,2
2023-06-01,21695,2,0,2,1,0,1
2023-06-01,15048,32,0,32,1,0,1
2023-06-01,25979,1,1,2,2,2,2
2023-06-01,396979,3,0,3,1,0,1
2023-06-01,4367,3,0,3,1,0,1
2023-06-01,23038,4,0,4,2,0,2
2023-06-01,25891,1,0,1,2,0,2
2023-06-01,14645,1,0,1,1,0,1
2023-06-01,32520,3,0,3,2,0,2
2023-06-01,40288,2,0,2,3,0,3
2023-06-01,393366,2,0,2,2,0,2
2023-06-01,53746,2,0,2,2,0,2
2023-06-01,25861,1,1,2,2,1,2
2023-06-01,7133,2,2,4,1,3,3
2023-06-01,17089,7,0,7,2,0,2
2023-06-01,396890,2,0,2,3,0,3
2023-06-01,23134,2,0,2,1,0,1
2023-06-01,10595,2,0,2,1,0,1
2023-06-01,7007,1,1,2,1,1,2
2023-06-01,397323,2,0,2,4,0,4
2023-06-01,398412,1,0,1,1,0,1
2023-06-01,27542,1,0,1,3,0,3
2023-06-01,396875,2,0,2,1,0,1
2023-06-01,12062,2,0,2,1,0,1
2023-06-01,36535,3,0,3,2,0,2
2023-06-01,26124,1,0,1,1,0,1
2023-06-01,22977,1,0,1,1,0,1
2023-06-01,55126,1,0,1,2,0,2
2023-06-01,19621,5,0,5,1,0,1
2023-06-01,23245,1,0,1,1,0,1
2023-06-01,40016,2,0,2,4,0,4
2023-06-01,6946,1,0,1,2,0,2
2023-06-01,3660,1,0,1,1,0,1
2023-06-01,14175,1,0,1,2,0,2
2023-06-01,18721,1,0,1,1,0,1
2023-06-01,22662,1,0,1,1,0,1
2023-06-01,46586,2,0,2,1,0,1
2023-06-01,397884,2,0,2,1,0,1
2023-06-01,5743,1,0,1,2,0,2
2023-06-01,4297,4,0,4,1,0,1
2023-06-01,23290,1,0,1,3,0,3
2023-06-01,400344,1,0,1,1,0,1
2023-06-01,22588,2,0,2,1,0,1
2023-06-01,15225,8,0,8,2,0,2
2023-06-01,19923,8,0,8,3,0,3
2023-06-01,17214,1,0,1,1,0,1
2023-06-01,32215,1,0,1,2,0,2
2023-06-01,18578,1,0,1,1,0,1
2023-06-01,14498,1,0,1,3,0,3
2023-06-01,21828,3,0,3,1,0,1
2023-06-01,398440,1,0,1,3,0,3
2023-06-01,54062,2,0,2,1,0,1
2023-06-01,25913,1,0,1,2,0,2
2023-06-01,6904,0,0,0,2,0,2
2023-06-01,5790,5,0,5,2,0,2
2023-06-01,394927,4,0,4,1,0,1
2023-06-01,14446,6,0,6,2,0,2
2023-06-01,399745,2,0,2,1,0,1
2023-06-01,16492,3,0,3,3,0,3
2023-06-01,13349,3,0,3,2,0,2
2023-06-01,272951,1,1,2,1,1,1
2023-06-01,273648,1,1,2,1,1,1
2023-06-01,271769,1,3,4,1,1,1
2023-06-01,271948,1,1,2,1,1,1
2023-06-01,272930,1,0,1,1,0,1
2023-06-01,265446,1,1,2,1,1,1
2023-06-01,273659,7,7,14,3,3,3
2023-06-01,272868,1,1,2,1,1,1
2023-06-01,271956,2,1,3,3,1,3
2023-06-01,271982,1,1,2,1,1,1
2023-06-01,272830,1,0,1,2,0,2
2023-06-01,10812,2,1,3,1,1,1
2023-06-01,1650,1,0,1,1,0,1
2023-06-01,36035,1,0,1,1,0,1
2023-06-01,14088,2,0,2,3,0,3
2023-06-01,399572,1,0,1,1,0,1
2023-06-01,62692,1,1,2,1,1,1
2023-06-01,54368,4,0,4,1,0,1
2023-06-01,20247,1,0,1,3,0,3
2023-06-01,14696,1,0,1,2,0,2
2023-06-01,17383,1,0,1,1,0,1
2023-06-01,22574,1,0,1,1,0,1
2023-06-01,25869,5,0,5,3,0,3
2023-06-01,21596,2,0,2,3,0,3
2023-06-01,53866,3,0,3,1,0,1
2023-06-01,19055,2,0,2,2,0,2
2023-06-01,25953,1,0,1,1,0,1
2023-06-01,32261,2,0,2,7,0,7
2023-06-01,62720,1,0,1,1,0,1
2023-06-01,16548,1,0,1,1,0,1
2023-06-01,46362,2,0,2,1,0,1
2023-06-01,27396,1,0,1,1,0,1
2023-06-01,51113,1,0,1,2,0,2
2023-06-01,14456,2,0,2,1,0,1
2023-06-01,29862,1,0,1,2,0,2
2023-06-01,36452,2,0,2,1,0,1
2023-06-01,400009,1,0,1,1,0,1
2023-06-01,25747,1,0,1,1,0,1
2023-06-01,27455,1,0,1,3,0,3
2023-06-01,54811,6,0,6,2,0,2
2023-06-01,54136,1,0,1,1,0,1
2023-06-01,133017,3,0,3,4,0,4
2023-06-01,400776,4,0,4,1,0,1
2023-06-01,53937,2,0,2,3,0,3
2023-06-01,19721,19,0,19,3,0,3
2023-06-01,10616,8,1,9,1,1,1
2023-06-01,53417,1,0,1,1,0,1
2023-06-01,399785,1,0,1,3,0,3
2023-06-01,54145,2,0,2,1,0,1
2023-06-01,6913,4,2,6,1,1,1
2023-06-01,2928,7,0,7,2,0,2
2023-06-01,10390,1,1,2,1,1,1
2023-06-01,30037,1,1,2,1,1,1
2023-06-01,11928,5,0,5,1,0,1
2023-06-01,397161,1,1,2,2,2,2
2023-06-01,46788,2,0,2,4,0,4
2023-06-01,63466,4,0,4,1,0,1
2023-06-01,12204,3,0,3,4,0,4
2023-06-01,22321,1,0,1,3,0,3
2023-06-01,23163,1,0,1,1,0,1
2023-06-01,398081,1,1,2,1,1,1
2023-06-01,27236,1,0,1,1,0,1
2023-06-01,40902,1,0,1,1,0,1
2023-06-01,62596,1,0,1,1,0,1
2023-06-01,19760,2,0,2,3,0,3
2023-06-01,398671,1,0,1,1,0,1
2023-06-01,10482,3,0,3,2,0,2
2023-06-01,18587,3,0,3,3,0,3
2023-06-01,393810,1,0,1,2,0,2
2023-06-01,33449,1,0,1,1,0,1
2023-06-01,6595,1,0,1,1,0,1
2023-06-01,14738,2,1,3,1,3,3
2023-06-01,5957,3,1,4,1,1,1
2023-06-01,267346,1,0,1,3,0,3
2023-06-01,33326,3,0,3,1,0,1
2023-06-01,399205,1,0,1,2,0,2
2023-06-01,5764,1,0,1,1,0,1
2023-06-01,395462,1,0,1,2,0,2
2023-06-01,15270,0,0,0,2,0,2
2023-06-01,396900,1,0,1,2,0,2
2023-06-01,395219,1,0,1,1,0,1
2023-06-01,7820,3,0,3,3,0,3
2023-06-01,22123,1,0,1,1,0,1
2023-06-01,397264,1,0,1,3,0,3
2023-06-01,397786,1,0,1,1,0,1
2023-06-01,27453,2,0,2,4,0,4
2023-06-01,400714,1,0,1,1,0,1
2023-06-01,399615,2,0,2,1,0,1
2023-06-01,11941,23,0,23,9,0,9
2023-06-01,32920,2,0,2,1,0,1
2023-06-01,62671,3,0,3,1,0,1
2023-06-01,30136,2,0,2,2,0,2
2023-06-01,32630,2,0,2,1,0,1
2023-06-01,46459,3,0,3,3,0,3
2023-06-01,398403,1,0,1,3,0,3
2023-06-01,32457,15,0,15,4,0,4
2023-06-01,32626,2,0,2,1,0,1
2023-06-01,20097,1,0,1,1,0,1
2023-06-01,396229,1,0,1,1,0,1
2023-06-01,32596,1,0,1,1,0,1
2023-06-01,205615,1,0,1,1,0,1
2023-06-01,396345,1,0,1,1,0,1
2023-06-01,11227,4,0,4,4,0,4
2023-06-01,27368,1,0,1,2,0,2
2023-06-01,19946,1,0,1,2,0,2
2023-06-01,40275,1,0,1,1,0,1
2023-06-01,399751,1,0,1,2,0,2
2023-06-01,46828,1,0,1,2,0,2
2023-06-01,16470,1,0,1,1,0,1
2023-06-01,32096,1,0,1,4,0,4
2023-06-01,21516,1,0,1,2,0,2
2023-06-01,395166,1,0,1,3,0,3
2023-06-01,33390,1,0,1,2,0,2
2023-06-01,398484,1,0,1,2,0,2
2023-06-01,23425,1,0,1,1,0,1
2023-06-01,22424,4,0,4,1,0,1
2023-06-01,398087,1,0,1,3,0,3
2023-06-01,32562,2,0,2,1,0,1
2023-06-01,23301,1,0,1,1,0,1
2023-06-01,400489,1,0,1,2,0,2
2023-06-01,21934,1,0,1,1,0,1
2023-06-01,54442,2,0,2,3,0,3
2023-06-01,53549,1,0,1,2,0,2
2023-06-01,398983,4,0,4,2,0,2
2023-06-01,393966,2,0,2,1,0,1
2023-06-01,396005,1,0,1,2,0,2
2023-06-01,40236,1,0,1,1,0,1
2023-06-01,40808,6,0,6,2,0,2
2023-06-01,27514,1,0,1,2,0,2
2023-06-01,10939,1,0,1,3,0,3
2023-06-01,394475,11,0,11,2,0,2
2023-06-01,11973,1,0,1,1,0,1
2023-06-01,36309,1,0,1,2,0,2
2023-06-01,400471,3,0,3,3,0,3
2023-06-01,21638,1,0,1,1,0,1
2023-06-01,2933,1,0,1,1,0,1
2023-06-01,5237,11,0,11,2,0,2
2023-06-01,5371,202,0,202,3,0,3
2023-06-01,6566,17,0,17,5,0,5
2023-06-01,398034,3,0,3,3,0,3
2023-06-01,398247,2,0,2,1,0,1
2023-06-01,7234,1,0,1,2,0,2
2023-06-01,32728,1,0,1,2,0,2
2023-06-01,46318,15,0,15,2,0,2
2023-06-01,33478,9,0,9,2,0,2
2023-06-01,395130,5,0,5,3,0,3
2023-06-01,12142,3,0,3,3,0,3
2023-06-01,32046,1,0,1,1,0,1
2023-06-01,32048,1,0,1,3,0,3
2023-06-01,32049,1,0,1,3,0,3
2023-06-01,32047,1,0,1,2,0,2
2023-06-01,32050,2,0,2,4,0,4
2023-06-01,32052,2,0,2,2,0,2
2023-06-01,32051,1,0,1,1,0,1
2023-06-01,32053,3,0,3,3,0,3
2023-06-01,38531,1,0,1,2,0,2
2023-06-01,62568,4,0,4,4,0,4
2023-06-01,54353,1,0,1,1,0,1
2023-06-01,19043,4,0,4,3,0,3
2023-06-01,29826,7,0,7,4,0,4
2023-06-01,4255,1,0,1,1,0,1
2023-06-01,26334,2,0,2,2,0,2
2023-06-01,399385,1,0,1,1,0,1
2023-06-01,398668,1,1,2,3,3,3
2023-06-01,32629,1,1,2,1,3,3
2023-06-01,26059,1,0,1,1,0,1
2023-06-01,14893,1,0,1,2,0,2
2023-06-01,54485,1,0,1,1,0,1
2023-06-01,54629,3,0,3,2,0,2
2023-06-01,33414,3,0,3,2,0,2
2023-06-01,395268,1,0,1,1,0,1
2023-06-01,54832,1,0,1,1,0,1
2023-06-01,36015,1,0,1,3,0,3
2023-06-01,26252,4,0,4,2,0,2
2023-06-01,20441,1,0,1,2,0,2
2023-06-01,26575,1,0,1,1,0,1
2023-06-01,18533,3,0,3,3,0,3
2023-06-01,63362,3,0,3,3,0,3
2023-06-01,55203,2,0,2,4,0,4
2023-06-01,46913,5,0,5,3,0,3
2023-06-01,396334,9,0,9,1,0,1
2023-06-01,6508,2,0,2,1,0,1
2023-06-01,14450,3,0,3,1,0,1
2023-06-01,29913,2,0,2,1,0,1
2023-06-01,53598,5,0,5,2,0,2
2023-06-01,398022,3,0,3,3,0,3
2023-06-01,13919,13,0,13,4,0,4
2023-06-01,62732,1,0,1,1,0,1
2023-06-01,23152,2,0,2,2,0,2
2023-06-01,10718,7,0,7,6,0,6
2023-06-01,6402,0,0,0,2,0,2
2023-06-01,46895,2,0,2,2,0,2
2023-06-01,14207,2,0,2,2,0,2
2023-06-01,62819,5,0,5,1,0,1
2023-06-01,46352,2,0,2,1,0,1
2023-06-01,18962,1,0,1,2,0,2
2023-06-01,396323,2,0,2,2,0,2
2023-06-01,18757,10,0,10,3,0,3
2023-06-01,27344,1,0,1,1,0,1
2023-06-01,11046,9,0,9,7,0,7
2023-06-01,22097,21,0,21,8,0,8
2023-06-01,54451,1,0,1,1,0,1
2023-06-01,54649,1,0,1,1,0,1
2023-06-01,399394,1,0,1,1,0,1
2023-06-01,394137,1,0,1,3,0,3
2023-06-01,33328,3,0,3,2,0,2
2023-06-01,12082,3,0,3,3,0,3
2023-06-01,393463,1,0,1,2,0,2
2023-06-01,54355,8,0,8,2,0,2
2023-06-01,23003,3,0,3,3,0,3
2023-06-01,32988,1,0,1,1,0,1
2023-06-01,26263,1,0,1,1,0,1
2023-06-01,19857,2,0,2,2,0,2
2023-06-01,18772,1,0,1,3,0,3
2023-06-01,63475,3,0,3,2,0,2
2023-06-01,54532,3,0,3,2,0,2
2023-06-01,394076,1,0,1,1,0,1
2023-06-01,13981,1,0,1,1,0,1
2023-06-01,398963,6,0,6,2,0,2
2023-06-01,33585,1,0,1,2,0,2
2023-06-01,14898,18,0,18,4,0,4
2023-06-01,54121,1,0,1,2,0,2
2023-06-01,397004,4,0,4,1,0,1
2023-06-01,394926,1,0,1,2,0,2
2023-06-01,396065,1,0,1,2,0,2
2023-06-01,395104,1,0,1,2,0,2
2023-06-01,397747,1,0,1,2,0,2
2023-06-01,397738,1,0,1,2,0,2
2023-06-01,396138,11,0,11,2,0,2
2023-06-01,10942,1,0,1,3,0,3
2023-06-01,399691,1,0,1,1,0,1
2023-06-01,395553,1,0,1,2,0,2
2023-06-01,397791,1,0,1,3,0,3
2023-06-01,53814,1,0,1,2,0,2
2023-06-01,33288,2,0,2,4,0,4
2023-06-01,30113,6,0,6,2,0,2
2023-06-01,398314,1,0,1,2,0,2
2023-06-01,53287,1,0,1,2,0,2
2023-06-01,32350,1,0,1,1,0,1
2023-06-01,30333,1,0,1,2,0,2
2023-06-01,36128,1,0,1,3,0,3
2023-06-01,40587,1,0,1,1,0,1
2023-06-01,16956,1,0,1,1,0,1
2023-06-01,11015,4,0,4,4,0,4
2023-06-01,31884,1,0,1,1,0,1
2023-06-01,10586,1,0,1,1,0,1
2023-06-01,19081,1,0,1,1,0,1
2023-06-01,55139,1,0,1,1,0,1
2023-06-01,272686,3,3,6,2,2,2
2023-06-01,271341,1,2,3,1,1,1
2023-06-01,400639,1,0,1,1,0,1
2023-06-01,271683,1,1,2,1,1,1
2023-06-01,400699,1,0,1,1,0,1
2023-06-01,396090,1,0,1,3,0,3
2023-06-01,399099,1,0,1,1,0,1
2023-06-01,30692,1,0,1,1,0,1
2023-06-01,399877,1,0,1,2,0,2
2023-06-01,54419,1,0,1,1,0,1
2023-06-01,54410,1,0,1,2,0,2
2023-06-01,961,1,0,1,1,0,1
2023-06-01,15067,2,0,2,3,0,3
2023-06-01,397251,1,0,1,1,0,1
2023-06-01,15280,1,0,1,3,0,3
2023-06-01,30587,1,0,1,3,0,3
2023-06-01,32885,2,0,2,1,0,1
2023-06-01,26916,1,0,1,1,0,1
2023-06-01,18445,1,0,1,3,0,3
2023-06-01,20203,1,0,1,3,0,3
2023-06-01,46137,2,0,2,1,0,1
2023-06-01,21712,2,0,2,3,0,3
2023-06-01,14736,2,0,2,3,0,3
2023-06-01,46575,3,0,3,3,0,3
2023-06-01,53901,2,0,2,3,0,3
2023-06-01,18453,1,0,1,1,0,1
2023-06-01,32509,1,0,1,2,0,2
2023-06-01,6534,2,0,2,1,0,1
2023-06-01,7312,1,0,1,3,0,3
2023-06-01,47101,1,1,2,1,1,1
2023-06-01,397908,4,0,4,1,0,1
2023-06-01,40585,4,0,4,5,0,5
2023-06-01,399721,1,0,1,2,0,2
2023-06-01,23494,4,0,4,2,0,2
2023-06-01,397267,1,0,1,1,0,1
2023-06-01,7153,5,0,5,2,0,2
2023-06-01,17270,9,0,9,1,0,1
2023-06-01,32139,3,0,3,3,0,3
2023-06-01,23050,2,0,2,3,0,3
2023-06-01,396165,1,0,1,1,0,1
2023-06-01,20289,7,0,7,2,0,2
2023-06-01,53296,1,0,1,1,0,1
2023-06-01,25850,4,0,4,2,0,2
2023-06-01,395220,4,0,4,2,0,2
2023-06-01,46471,1,0,1,1,0,1
2023-06-01,46522,1,0,1,2,0,2
2023-06-01,393784,2,0,2,1,0,1
2023-06-01,132720,3,0,3,1,0,1
2023-06-01,136492,2,0,2,1,0,1
2023-06-01,40204,3,0,3,2,0,2
2023-06-01,32755,1,0,1,2,0,2
2023-06-01,62705,8,0,8,1,0,1
2023-06-01,54179,2,0,2,2,0,2
2023-06-01,22972,1,0,1,1,0,1
2023-06-01,26748,1,0,1,2,0,2
2023-06-01,59248,4,0,4,3,0,3
2023-06-01,62377,3,0,3,3,0,3
2023-06-01,40677,1,0,1,1,0,1
2023-06-01,19352,1,0,1,2,0,2
2023-06-01,20263,1,0,1,2,0,2
2023-06-01,36799,1,0,1,1,0,1
2023-06-01,271849,1,1,2,1,1,1
2023-06-01,13910,1,0,1,2,0,2
2023-06-01,399564,1,0,1,1,0,1
2023-06-01,54332,1,0,1,1,0,1
2023-06-01,393898,2,1,3,1,1,1
2023-06-01,22491,1,0,1,2,0,2
2023-06-01,35964,1,0,1,2,0,2
2023-06-01,394238,2,0,2,1,0,1
2023-06-01,32170,1,1,2,2,1,2
2023-06-01,54352,1,0,1,1,0,1
2023-06-01,54362,2,0,2,1,0,1
2023-06-01,53625,1,0,1,1,0,1
2023-06-01,210532,1,1,2,1,1,1
2023-06-01,394554,1,0,1,1,0,1
2023-06-01,10329,5,0,5,4,0,4
2023-06-01,30618,1,0,1,1,0,1
2023-06-01,2667,2,0,2,2,0,2
2023-06-01,397558,1,0,1,2,0,2
2023-06-01,11124,2,0,2,3,0,3
2023-06-01,4902,1,0,1,1,0,1
2023-06-01,54391,2,2,4,4,3,5
2023-06-01,11874,1,0,1,2,0,2
2023-06-01,54409,1,0,1,1,0,1
2023-06-01,53337,1,0,1,3,0,3
2023-06-01,26977,1,0,1,2,0,2
2023-06-01,54424,1,0,1,1,0,1
2023-06-01,4182,1,0,1,1,0,1
2023-06-01,33393,1,0,1,2,0,2
2023-06-01,15354,2,0,2,2,0,2
2023-06-01,54937,1,0,1,2,0,2
2023-06-01,396870,1,0,1,2,0,2
2023-06-01,394422,1,0,1,1,0,1
2023-06-01,399923,1,0,1,1,0,1
2023-06-01,395247,1,0,1,2,0,2
2023-06-01,395905,1,0,1,2,0,2
2023-06-01,23042,1,0,1,1,0,1
2023-06-01,22835,1,0,1,3,0,3
2023-06-01,20467,7,0,7,2,0,2
2023-06-01,1035,3,0,3,3,0,3
2023-06-01,137504,1,0,1,2,0,2
2023-06-01,400406,2,0,2,3,0,3
2023-06-01,1041,3,0,3,3,0,3
2023-06-01,398277,1,0,1,1,0,1
2023-06-01,36490,2,0,2,3,0,3
2023-06-01,53710,1,1,2,1,1,1
2023-06-01,22705,1,0,1,1,0,1
2023-06-01,54184,1,0,1,2,0,2
2023-06-01,1604,1,0,1,1,0,1
2023-06-01,40444,7,0,7,5,0,5
2023-06-01,54496,2,2,4,2,1,2
2023-06-01,33271,1,0,1,3,0,3
2023-06-01,396126,1,0,1,1,0,1
2023-06-01,54095,1,0,1,2,0,2
2023-06-01,19900,1,0,1,1,0,1
2023-06-01,30261,1,0,1,1,0,1
2023-06-01,53539,1,0,1,3,0,3
2023-06-01,46779,3,0,3,3,0,3
2023-06-01,54307,1,1,2,2,1,3
2023-06-01,20274,1,0,1,2,0,2
2023-06-01,54461,1,0,1,1,0,1
2023-06-01,54587,1,0,1,1,0,1
2023-06-01,30033,1,0,1,1,0,1
2023-06-01,21813,4,0,4,2,0,2
2023-06-01,54525,1,0,1,1,0,1
2023-06-01,17353,5,0,5,1,0,1
2023-06-01,63359,1,0,1,1,0,1
2023-06-01,394567,3,0,3,3,0,3
2023-06-01,54093,1,0,1,1,0,1
2023-06-01,33300,1,0,1,1,0,1
2023-06-01,54070,3,0,3,1,0,1
2023-06-01,40347,1,0,1,1,0,1
2023-06-01,395514,1,0,1,1,0,1
2023-06-01,22066,1,0,1,1,0,1
2023-06-01,53599,1,0,1,1,0,1
2023-06-01,64251,1,1,2,2,2,2
2023-06-01,55133,1,0,1,3,0,3
2023-06-01,26638,4,0,4,1,0,1
2023-06-01,397076,3,0,3,3,0,3
2023-06-01,19300,2,0,2,4,0,4
2023-06-01,396444,1,0,1,1,0,1
2023-06-01,396938,1,0,1,1,0,1
2023-06-01,19983,1,0,1,2,0,2
2023-06-01,54849,1,0,1,3,0,3
2023-06-01,11894,3,1,4,3,1,3
2023-06-01,26946,10,0,10,2,0,2
2023-06-01,27316,8,0,8,1,0,1
2023-06-01,36634,1,0,1,2,0,2
2023-06-01,32073,9,0,9,3,0,3
2023-06-01,40468,8,0,8,5,0,5
2023-06-01,13698,6,0,6,4,0,4
2023-06-01,7970,6,0,6,2,0,2
2023-06-01,18258,7,0,7,4,0,4
2023-06-01,16804,1,0,1,1,0,1
2023-06-01,29922,2,0,2,1,0,1
2023-06-01,21649,1,0,1,1,0,1
2023-06-01,925,1,0,1,1,0,1
2023-06-01,14662,1,0,1,1,0,1
2023-06-01,36811,1,1,2,1,1,1
2023-06-01,11605,1,0,1,1,0,1
2023-06-01,45633,1,0,1,1,0,1
2023-06-01,54181,1,0,1,1,0,1
2023-06-01,12059,2,1,3,5,2,5
2023-06-01,397375,2,0,2,2,0,2
2023-06-01,22446,3,0,3,2,0,2
2023-06-01,36041,1,0,1,2,0,2
2023-06-01,10819,2,0,2,1,0,1
2023-06-01,14355,1,0,1,1,0,1
2023-06-01,394163,1,0,1,2,0,2
2023-06-01,395097,1,0,1,2,0,2
2023-06-01,400322,1,0,1,1,0,1
2023-06-01,14951,6,0,6,1,0,1
2023-06-01,21806,3,0,3,3,0,3
2023-06-01,40391,12,0,12,3,0,3
2023-06-01,23025,1,0,1,3,0,3
2023-06-01,19707,1,0,1,3,0,3
2023-06-01,13942,3,0,3,1,0,1
2023-06-01,400067,1,0,1,1,0,1
2023-06-01,54264,1,0,1,1,0,1
2023-06-01,54261,1,0,1,2,0,2
2023-06-01,399593,1,0,1,2,0,2
2023-06-01,54267,1,0,1,2,0,2
2023-06-01,30348,17,0,17,2,0,2
2023-06-01,13610,1,0,1,1,0,1
2023-06-01,54279,1,0,1,1,0,1
2023-06-01,54783,1,0,1,1,0,1
2023-06-01,13927,10,0,10,2,0,2
2023-06-01,26532,2,0,2,4,0,4
2023-06-01,19105,5,0,5,4,0,4
2023-06-01,40508,1,0,1,1,0,1
2023-06-01,17301,2,0,2,2,0,2
2023-06-01,18571,1,0,1,1,0,1
2023-06-01,11140,1,0,1,2,0,2
2023-06-01,11316,2,0,2,2,0,2
2023-06-01,11132,1,0,1,1,0,1
2023-06-01,399232,1,0,1,2,0,2
2023-06-01,40900,1,1,2,2,2,2
2023-06-01,14145,2,1,3,3,3,3
2023-06-01,10801,18,6,24,3,3,3
2023-06-01,272129,1,5,6,1,2,2
2023-06-01,272636,1,7,8,2,2,2
2023-06-01,271761,3,3,6,4,2,4
2023-06-01,272859,3,0,3,1,0,1
2023-06-01,272120,2,1,3,2,1,2
2023-06-01,271992,3,1,4,3,1,3
2023-06-01,272807,2,1,3,1,1,1
2023-06-01,272963,1,0,1,1,0,1
2023-06-01,33292,3,0,3,2,0,2
2023-06-01,13839,8,0,8,5,0,5
2023-06-01,63398,3,0,3,2,0,2
2023-06-01,11880,5,0,5,3,0,3
2023-06-01,20085,5,1,6,1,1,2
2023-06-01,54645,3,0,3,4,0,4
2023-06-01,22140,1,1,2,1,1,1
2023-06-01,30227,1,0,1,1,0,1
2023-06-01,19856,1,0,1,4,0,4
2023-06-01,33211,20,2,22,3,3,4
2023-06-01,7021,4,0,4,1,0,1
2023-06-01,394958,1,0,1,2,0,2
2023-06-01,396110,1,0,1,3,0,3
2023-06-01,26246,1,0,1,1,0,1
2023-06-01,18969,1,0,1,2,0,2
2023-06-01,17157,30,0,30,2,0,2
2023-06-01,15115,1,0,1,1,0,1
2023-06-01,7070,1,0,1,1,0,1
2023-06-01,46884,1,0,1,2,0,2
2023-06-01,395848,8,0,8,2,0,2
2023-06-01,400712,1,0,1,1,0,1
2023-06-01,400508,1,0,1,3,0,3
2023-06-01,32927,7,0,7,4,0,4
2023-06-01,393581,12,0,12,1,0,1
2023-06-01,10818,3,0,3,2,0,2
2023-06-01,212601,2,0,2,1,0,1
2023-06-01,271764,1,1,2,1,1,1
2023-06-01,33394,1,0,1,1,0,1
2023-06-01,399967,2,0,2,2,0,2
2023-06-01,25600,1,0,1,1,0,1
2023-06-01,27502,2,0,2,1,0,1
2023-06-01,26403,3,0,3,1,0,1
2023-06-01,21915,3,0,3,1,0,1
2023-06-01,20400,1,0,1,1,0,1
2023-06-01,30678,13,0,13,2,0,2
2023-06-01,7912,2,0,2,2,0,2
2023-06-01,31854,1,0,1,1,0,1
2023-06-01,26570,1,0,1,1,0,1
2023-06-01,8046,1,1,2,1,1,1
2023-06-01,1287,1,0,1,1,0,1
2023-06-01,11523,5,0,5,2,0,2
2023-06-01,26839,1,0,1,1,0,1
2023-06-01,4232,15,0,15,2,0,2
2023-06-01,23540,1,0,1,1,0,1
2023-06-01,11471,16,0,16,1,0,1
2023-06-01,40518,8,0,8,2,0,2
2023-06-01,40514,4,0,4,1,0,1
2023-06-01,396270,2,0,2,2,0,2
2023-06-01,8123,1,0,1,1,0,1
2023-06-01,139686,1,5,6,1,2,2
2023-06-01,33563,1,0,1,4,0,4
2023-06-01,14058,2,1,3,1,1,1
2023-06-01,22711,3,3,6,3,3,3
2023-06-01,14157,3,3,6,2,2,2
2023-06-01,32138,1,0,1,2,0,2
2023-06-01,26259,8,1,9,4,1,4
2023-06-01,271957,2,1,3,2,1,2
2023-06-01,272138,1,1,2,1,1,1
2023-06-01,147094,3,0,3,1,0,1
2023-06-01,272910,1,1,2,2,1,2
2023-06-01,272241,1,1,2,1,1,1
2023-06-01,51438,1,0,1,1,0,1
2023-06-01,14386,1,0,1,3,0,3
2023-06-01,11449,2,0,2,1,0,1
2023-06-01,393424,1,2,3,5,5,6
2023-06-01,35850,1,0,1,2,0,2
2023-06-01,54964,1,0,1,2,0,2
2023-06-01,16944,1,0,1,1,0,1
2023-06-01,16408,1,0,1,1,0,1
2023-06-01,11162,1,0,1,1,0,1
2023-06-01,398905,2,0,2,1,0,1
2023-06-01,11389,4,0,4,4,0,4
2023-06-01,46494,3,0,3,2,0,2
2023-06-01,26545,1,0,1,1,0,1
2023-06-01,16933,4,0,4,1,0,1
2023-06-01,30401,1,0,1,2,0,2
2023-06-01,22181,4,0,4,3,0,3
2023-06-01,398007,1,0,1,2,0,2
2023-06-01,36366,2,0,2,2,0,2
2023-06-01,14086,1,1,2,4,2,4
2023-06-01,6349,7,0,7,1,0,1
2023-06-01,14432,1,1,2,1,1,1
2023-06-01,54866,2,0,2,4,0,4
2023-06-01,394725,1,1,2,1,2,2
2023-06-01,18572,1,1,2,1,1,1
2023-06-01,40165,24,1,25,8,2,8
2023-06-01,4891,1,0,1,2,0,2
2023-06-01,46654,5,0,5,2,0,2
2023-06-01,400185,1,0,1,1,0,1
2023-06-01,395235,1,0,1,1,0,1
2023-06-01,30120,5,0,5,3,0,3
2023-06-01,22831,1,0,1,1,0,1
2023-06-01,30638,1,0,1,3,0,3
2023-06-01,10678,2,0,2,1,0,1
2023-06-01,398824,1,0,1,1,0,1
2023-06-01,17339,1,0,1,3,0,3
2023-06-01,19779,1,0,1,3,0,3
2023-06-01,46885,1,0,1,1,0,1
2023-06-01,26656,1,0,1,3,0,3
2023-06-01,16937,1,0,1,1,0,1
2023-06-01,5715,1,0,1,4,0,4
2023-06-01,136510,1,0,1,1,0,1
2023-06-01,139228,1,0,1,1,0,1
2023-06-01,14688,1,0,1,1,0,1
2023-06-01,27200,2,0,2,1,0,1
2023-06-01,11819,1,0,1,1,0,1
2023-06-01,19402,2,0,2,2,0,2
2023-06-01,60618,3,0,3,2,0,2
2023-06-01,60204,6,0,6,2,0,2
2023-06-01,398187,1,0,1,2,0,2
2023-06-01,397116,1,0,1,1,0,1
2023-06-01,394890,1,0,1,2,0,2
2023-06-01,18619,2,0,2,1,0,1
2023-06-01,396882,7,0,7,3,0,3
2023-06-01,7816,1,0,1,2,0,2
2023-06-01,397967,1,0,1,3,0,3
2023-06-01,53437,1,0,1,1,0,1
2023-06-01,25779,2,0,2,1,0,1
2023-06-01,399759,10,0,10,2,0,2
2023-06-01,46410,4,0,4,1,0,1
2023-06-01,400671,1,2,3,1,1,1
2023-06-01,40075,1,0,1,2,0,2
2023-06-01,29728,1,0,1,3,0,3
2023-06-01,393510,1,0,1,3,0,3
2023-06-01,55092,1,0,1,1,0,1
2023-06-01,395396,1,0,1,1,0,1
2023-06-01,29824,1,0,1,3,0,3
2023-06-01,62621,1,2,3,1,2,2
2023-06-01,20168,1,0,1,2,0,2
2023-06-01,11387,1,0,1,1,0,1
2023-06-01,19176,6,0,6,1,0,1
2023-06-01,20320,2,0,2,2,0,2
2023-06-01,63344,8,0,8,3,0,3
2023-06-01,63345,3,0,3,2,0,2
2023-06-01,395413,1,0,1,2,0,2
2023-06-01,27023,2,0,2,1,0,1
2023-06-01,10602,1,0,1,1,0,1
2023-06-01,53976,1,0,1,1,0,1
2023-06-01,397658,1,0,1,1,0,1
2023-06-01,13948,1,0,1,1,0,1
2023-06-01,32148,3,0,3,2,0,2
2023-06-01,46669,1,0,1,1,0,1
2023-06-01,19253,1,0,1,1,0,1
2023-06-01,40721,1,0,1,2,0,2
2023-06-01,26084,4,0,4,3,0,3
2023-06-01,36293,1,0,1,1,0,1
2023-06-01,54713,3,0,3,1,0,1
2023-06-01,397918,1,0,1,2,0,2
2023-06-01,46744,6,0,6,5,0,5
2023-06-01,26848,23,1,24,6,1,6
2023-06-01,16482,2,0,2,1,0,1
2023-06-01,63044,6,0,6,4,0,4
2023-06-01,19534,1,0,1,2,0,2
2023-06-01,40213,1,0,1,2,0,2
2023-06-01,55278,1,0,1,4,0,4
2023-06-01,32384,1,0,1,1,0,1
2023-06-01,17197,1,1,2,1,1,1
2023-06-01,40433,1,0,1,1,0,1
2023-06-01,17163,9,0,9,3,0,3
2023-06-01,26844,6,0,6,3,0,3
2023-06-01,36827,2,1,3,2,1,2
2023-06-01,396382,1,0,1,1,0,1
2023-06-01,19694,1,1,2,5,3,5
2023-06-01,55084,3,0,3,3,0,3
2023-06-01,39992,2,0,2,3,0,3
2023-06-01,30197,6,0,6,3,0,3
2023-06-01,12205,2,0,2,1,0,1
2023-06-01,62799,1,0,1,2,0,2
2023-06-01,400510,2,0,2,2,0,2
2023-06-01,18556,1,0,1,3,0,3
2023-06-01,54153,2,0,2,2,0,2
2023-06-01,393936,4,0,4,2,0,2
2023-06-01,54982,1,0,1,3,0,3
2023-06-01,399658,1,0,1,1,0,1
2023-06-01,398952,1,0,1,1,0,1
2023-06-01,399575,2,0,2,2,0,2
2023-06-01,19243,1,0,1,2,0,2
2023-06-01,395671,1,0,1,3,0,3
2023-06-01,53397,1,0,1,1,0,1
2023-06-01,399356,22,1,23,3,1,3
2023-06-01,29923,3,0,3,2,0,2
2023-06-01,393876,1,0,1,2,0,2
2023-06-01,14690,1,0,1,1,0,1
2023-06-01,22272,1,0,1,1,0,1
2023-06-01,55059,5,0,5,4,0,4
2023-06-01,394682,1,0,1,1,0,1
2023-06-01,35956,8,0,8,4,0,4
2023-06-01,19837,2,0,2,1,0,1
2023-06-01,33026,3,0,3,1,0,1
2023-06-01,53519,4,0,4,2,0,2
2023-06-01,26191,1,0,1,1,0,1
2023-06-01,14301,3,0,3,3,0,3
2023-06-01,22734,6,0,6,2,0,2
2023-06-01,400532,1,0,1,1,0,1
2023-06-01,23548,1,0,1,2,0,2
2023-06-01,16910,4,0,4,2,0,2
2023-06-01,395091,1,0,1,1,0,1
2023-06-01,7163,25,0,25,3,0,3
2023-06-01,3834,1,1,2,3,1,3
2023-06-01,394762,3,0,3,1,0,1
2023-06-01,16426,3,0,3,2,0,2
2023-06-01,19472,6,0,6,2,0,2
2023-06-01,30551,2,0,2,2,0,2
2023-06-01,27161,2,0,2,1,0,1
2023-06-01,14851,12,0,12,2,0,2
2023-06-01,6646,20,0,20,4,0,4
2023-06-01,1360,1,0,1,1,0,1
2023-06-01,21513,14,1,15,3,1,3
2023-06-01,31966,5,0,5,3,0,3
2023-06-01,17570,9,0,9,1,0,1
2023-06-01,40469,1,0,1,1,0,1
2023-06-01,46963,2,0,2,2,0,2
2023-06-01,223,12,0,12,3,0,3
2023-06-01,21814,1,0,1,1,0,1
2023-06-01,7761,1,0,1,2,0,2
2023-06-01,13494,1,0,1,2,0,2
2023-06-01,400537,4,0,4,1,0,1
2023-06-01,62552,1,0,1,1,0,1
2023-06-01,399962,1,0,1,1,0,1
2023-06-01,19458,4,0,4,1,0,1
2023-06-01,46204,1,0,1,1,0,1
2023-06-01,36677,2,0,2,1,0,1
2023-06-01,22041,1,0,1,1,0,1
2023-06-01,17344,1,0,1,3,0,3
2023-06-01,400466,1,0,1,1,0,1
2023-06-01,32335,2,1,3,1,1,1
2023-06-01,40357,1,0,1,2,0,2
2023-06-01,40486,3,0,3,1,0,1
2023-06-01,400480,1,0,1,1,0,1
2023-06-01,400155,3,0,3,2,0,2
2023-06-01,46994,3,0,3,4,0,4
2023-06-01,30049,15,0,15,3,0,3
2023-06-01,20439,1,0,1,1,0,1
2023-06-01,36774,1,0,1,1,0,1
2023-06-01,400246,1,0,1,1,0,1
2023-06-01,23329,7,0,7,1,0,1
2023-06-01,63205,2,0,2,2,0,2
2023-06-01,11204,2,0,2,3,0,3
2023-06-01,398071,3,0,3,1,0,1
2023-06-01,398068,4,0,4,1,0,1
2023-06-01,1965,13,0,13,3,0,3
2023-06-01,40320,1,0,1,1,0,1
2023-06-01,33560,1,0,1,1,0,1
2023-06-01,400104,2,0,2,1,0,1
2023-06-01,16692,2,2,4,2,1,2
2023-06-01,18790,1,0,1,1,0,1
2023-06-01,30544,1,0,1,1,0,1
2023-06-01,11194,5,0,5,1,0,1
2023-06-01,30341,2,0,2,1,0,1
2023-06-01,14142,1,0,1,1,0,1
2023-06-01,32021,2,0,2,1,0,1
2023-06-01,4908,3,0,3,1,0,1
2023-06-01,6650,27,0,27,2,0,2
2023-06-01,399086,4,1,5,2,1,2
2023-06-01,395360,4,1,5,3,1,3
2023-06-01,10402,1,0,1,1,0,1
2023-06-01,15293,4,0,4,1,0,1
2023-06-01,397436,1,0,1,2,0,2
2023-06-01,26917,1,0,1,2,0,2
2023-06-01,14079,1,1,2,1,1,1
2023-06-01,400214,1,0,1,1,0,1
2023-06-01,395915,1,2,3,1,1,1
2023-06-01,19868,3,0,3,1,0,1
2023-06-01,62583,1,0,1,1,0,1
2023-06-01,46604,1,0,1,1,0,1
2023-06-01,22973,2,0,2,3,0,3
2023-06-01,397543,1,0,1,1,0,1
2023-06-01,20330,10,0,10,3,0,3
2023-06-01,46729,1,0,1,3,0,3
2023-06-01,19277,1,0,1,2,0,2
2023-06-01,33031,2,0,2,4,0,4
2023-06-01,46492,1,0,1,3,0,3
2023-06-01,46409,2,0,2,2,0,2
2023-06-01,12096,2,0,2,1,0,1
2023-06-01,25696,1,0,1,3,0,3
2023-06-01,394406,2,0,2,2,0,2
2023-06-01,35946,3,0,3,3,0,3
2023-06-01,16467,2,0,2,1,0,1
2023-06-01,46840,1,0,1,2,0,2
2023-06-01,394813,1,0,1,1,0,1
2023-06-01,27560,2,0,2,2,0,2
2023-06-01,54315,2,0,2,1,0,1
2023-06-01,2827,1,0,1,1,0,1
2023-06-01,53478,1,0,1,1,0,1
2023-06-01,53564,1,0,1,3,0,3
2023-06-01,26492,1,0,1,1,0,1
2023-06-01,53643,1,0,1,1,0,1
2023-06-01,36655,1,0,1,1,0,1
2023-06-01,397271,1,0,1,1,0,1
2023-06-01,40685,1,0,1,2,0,2
2023-06-01,4258,4,1,5,14,9,16
2023-06-01,11608,43,1,44,8,1,8
2023-06-01,36182,3,0,3,7,0,7
2023-06-01,396906,2,0,2,1,0,1
2023-06-01,395487,2,0,2,6,0,6
2023-06-01,40168,1,0,1,2,0,2
2023-06-01,16982,1,0,1,1,0,1
2023-06-01,10708,19,0,19,3,0,3
2023-06-01,394241,4,0,4,3,0,3
2023-06-01,10988,1,0,1,3,0,3
2023-06-01,54050,1,0,1,1,0,1
2023-06-01,26962,12,0,12,4,0,4
2023-06-01,18707,3,0,3,2,0,2
2023-06-01,27019,2,0,2,3,0,3
2023-06-01,53456,1,0,1,1,0,1
2023-06-01,393314,1,0,1,1,0,1
2023-06-01,30558,1,0,1,3,0,3
2023-06-01,7064,1,0,1,1,0,1
2023-06-01,395206,1,0,1,2,0,2
2023-06-01,395440,1,0,1,1,0,1
2023-06-01,54474,1,0,1,3,0,3
2023-06-01,394961,1,0,1,2,0,2
2023-06-01,64237,1,0,1,1,0,1
2023-06-01,398769,1,0,1,1,0,1
2023-06-01,399082,2,0,2,2,0,2
2023-06-01,36299,3,0,3,3,0,3
2023-06-01,400283,1,1,2,1,1,1
2023-06-01,36093,1,0,1,2,0,2
2023-06-01,53947,1,0,1,2,0,2
2023-06-01,62822,1,0,1,1,0,1
2023-06-01,63077,1,0,1,3,0,3
2023-06-01,21884,1,0,1,1,0,1
2023-06-01,39940,1,0,1,1,0,1
2023-06-01,18899,1,0,1,3,0,3
2023-06-01,27031,1,0,1,3,0,3
2023-06-01,400088,1,0,1,2,0,2
2023-06-01,29732,5,0,5,3,0,3
2023-06-01,19880,6,0,6,1,0,1
2023-06-01,46637,2,0,2,2,0,2
2023-06-01,40926,19,0,19,2,0,2
2023-06-01,32635,1,0,1,2,0,2
2023-06-01,33643,1,0,1,2,0,2
2023-06-01,395548,1,0,1,2,0,2
2023-06-01,36635,2,0,2,1,0,1
2023-06-01,398961,1,0,1,1,0,1
2023-06-01,21645,1,0,1,1,0,1
2023-06-01,36514,28,0,28,2,0,2
2023-06-01,40618,1,0,1,1,0,1
2023-06-01,6586,1,0,1,1,0,1
2023-06-01,399257,1,0,1,2,0,2
2023-06-01,46814,6,0,6,5,0,5
2023-06-01,5182,9,0,9,2,0,2
2023-06-01,6379,26,1,27,5,1,5
2023-06-01,14591,3,0,3,2,0,2
2023-06-01,397782,2,0,2,1,0,1
2023-06-01,54325,2,0,2,1,0,1
2023-06-01,63341,1,0,1,2,0,2
2023-06-01,25762,2,0,2,3,0,3
2023-06-01,46218,2,1,3,2,1,2
2023-06-01,395998,1,0,1,1,0,1
2023-06-01,40212,2,0,2,2,0,2
2023-06-01,398713,1,1,2,3,3,3
2023-06-01,11970,1,0,1,2,0,2
2023-06-01,6838,9,15,24,1,1,1
2023-06-01,32539,1,1,2,1,1,2
2023-06-01,397909,1,0,1,1,0,1
2023-06-01,394871,12,0,12,1,0,1
2023-06-01,929,1,0,1,1,0,1
2023-06-01,11918,1,0,1,1,0,1
2023-06-01,923,1,4,5,2,4,4
2023-06-01,400363,1,1,2,3,1,3
2023-06-01,397393,1,0,1,1,0,1
2023-06-01,6266,1,0,1,1,0,1
2023-06-01,393298,4,0,4,1,0,1
2023-06-01,397340,4,0,4,2,0,2
2023-06-01,394966,1,0,1,2,0,2
2023-06-01,393739,1,0,1,3,0,3
2023-06-01,393541,1,0,1,2,0,2
2023-06-01,21998,2,0,2,2,0,2
2023-06-01,36595,1,0,1,3,0,3
2023-06-01,31916,1,0,1,1,0,1
2023-06-01,400640,1,0,1,1,0,1
2023-06-01,26157,1,2,3,1,2,2
2023-06-01,400583,1,2,3,1,1,1
2023-06-01,54123,1,0,1,2,0,2
2023-06-01,36333,2,0,2,3,0,3
2023-06-01,54438,1,0,1,2,0,2
2023-06-01,54530,1,0,1,2,0,2
2023-06-01,11770,3,0,3,1,0,1
2023-06-01,15212,2,0,2,1,0,1
2023-06-01,32747,2,0,2,1,0,1
2023-06-01,32441,1,0,1,1,0,1
2023-06-01,54405,1,0,1,4,0,4
2023-06-01,1430,1,0,1,1,0,1
2023-06-01,19967,1,0,1,2,0,2
2023-06-01,26987,1,0,1,1,0,1
2023-06-01,30454,1,0,1,1,0,1
2023-06-01,398058,1,0,1,1,0,1
2023-06-01,398558,1,0,1,1,0,1
2023-06-01,398802,1,0,1,1,0,1
2023-06-01,30460,1,0,1,1,0,1
2023-06-01,398550,1,0,1,1,0,1
2023-06-01,398829,1,0,1,1,0,1
2023-06-01,398455,1,0,1,1,0,1
2023-06-01,398449,1,0,1,1,0,1
2023-06-01,398470,1,0,1,1,0,1
2023-06-01,398443,1,0,1,1,0,1
2023-06-01,398751,1,0,1,1,0,1
2023-06-01,397132,1,0,1,1,0,1
2023-06-01,6583,2,0,2,1,0,1
2023-06-01,6551,1,0,1,1,0,1
2023-06-01,393901,1,0,1,1,0,1
2023-06-01,397856,1,0,1,1,0,1
2023-06-01,26353,1,0,1,1,0,1
2023-06-01,19154,2,0,2,3,0,3
2023-06-01,399042,1,0,1,2,0,2
2023-06-01,397445,1,0,1,2,0,2
2023-06-01,22668,1,0,1,1,0,1
2023-06-01,13992,1,0,1,2,0,2
2023-06-01,397038,6,0,6,3,0,3
2023-06-01,11749,1,0,1,2,0,2
2023-06-01,32274,7,1,8,2,1,2
2023-06-01,270322,5,0,5,1,0,1
2023-06-01,269924,4,0,4,3,0,3
2023-06-01,270330,7,7,14,1,1,1
2023-06-01,269927,4,0,4,2,0,2
2023-06-01,63005,48,0,48,2,0,2
2023-06-01,36479,2,0,2,2,0,2
2023-06-01,11858,1,0,1,3,0,3
2023-06-01,22899,1,0,1,1,0,1
2023-06-01,395942,2,0,2,1,0,1
2023-06-01,12109,3,0,3,2,0,2
2023-06-01,40847,1,0,1,2,0,2
2023-06-01,5656,5,0,5,1,0,1
2023-06-01,8000,11,0,11,1,0,1
2023-06-01,7384,15,0,15,4,0,4
2023-06-01,15264,1,0,1,1,0,1
2023-06-01,25955,16,0,16,5,0,5
2023-06-01,5697,1,0,1,2,0,2
2023-06-01,5069,1,0,1,2,0,2
2023-06-01,26362,9,0,9,4,0,4
2023-06-01,22600,3,4,7,1,1,1
2023-06-01,393722,1,0,1,2,0,2
2023-06-01,14023,1,0,1,3,0,3
2023-06-01,46111,1,0,1,1,0,1
2023-06-01,393659,1,0,1,1,0,1
2023-06-01,19728,1,0,1,2,0,2
2023-06-01,396404,1,0,1,1,0,1
2023-06-01,396127,1,0,1,3,0,3
2023-06-01,26440,1,0,1,3,0,3
2023-06-01,395296,1,0,1,2,0,2
2023-06-01,395595,1,0,1,2,0,2
2023-06-01,395825,1,0,1,3,0,3
2023-06-01,396014,3,0,3,2,0,2
2023-06-01,396271,1,0,1,2,0,2
2023-06-01,396927,1,0,1,1,0,1
2023-06-01,25739,3,2,5,2,1,2
2023-06-01,400449,1,1,2,1,1,1
2023-06-01,14984,3,0,3,1,0,1
2023-06-01,16615,1,0,1,2,0,2
2023-06-01,62633,2,2,4,1,1,1
2023-06-01,26673,10,6,16,10,4,10
2023-06-01,36109,1,0,1,2,0,2
2023-06-01,16707,1,0,1,1,0,1
2023-06-01,27244,1,0,1,2,0,2
2023-06-01,27210,1,0,1,1,0,1
2023-06-01,30694,1,0,1,1,0,1
2023-06-01,395271,1,0,1,1,0,1
2023-06-01,30250,2,0,2,1,0,1
2023-06-01,22015,1,0,1,1,0,1
2023-06-01,13391,2,0,2,3,0,3
2023-06-01,22484,1,0,1,3,0,3
2023-06-01,398890,1,0,1,1,0,1
2023-06-01,3708,1,0,1,2,0,2
2023-06-01,7941,2,1,3,2,1,2
2023-06-01,12240,1,0,1,1,0,1
2023-06-01,46107,1,0,1,3,0,3
2023-06-01,63354,1,0,1,1,0,1
2023-06-01,399143,14,19,33,3,3,3
2023-06-01,22623,1,0,1,3,0,3
2023-06-01,1620,3,0,3,3,0,3
2023-06-01,26142,1,0,1,1,0,1
2023-06-01,395684,1,0,1,2,0,2
2023-06-01,394465,1,0,1,2,0,2
2023-06-01,18803,7,0,7,3,0,3
2023-06-01,6606,6,0,6,1,0,1
2023-06-01,21617,1,1,2,1,1,1
2023-06-01,19796,8,0,8,7,0,7
2023-06-01,271330,5,8,13,7,5,7
2023-06-01,271302,5,4,9,4,4,5
2023-06-01,271878,2,0,2,2,0,2
2023-06-01,271335,4,7,11,4,1,4
2023-06-01,271670,0,3,3,4,4,5
2023-06-01,272163,0,1,1,2,1,2
2023-06-01,271309,7,7,14,4,4,4
2023-06-01,265521,1,0,1,2,0,2
2023-06-01,264782,1,0,1,1,0,1
2023-06-01,52506,1,0,1,1,0,1
2023-06-01,265479,1,0,1,2,0,2
2023-06-01,263247,1,0,1,3,0,3
2023-06-01,264775,1,0,1,1,0,1
2023-06-01,265511,1,0,1,2,0,2
2023-06-01,28494,1,0,1,3,0,3
2023-06-01,8007,32,0,32,3,0,3
2023-06-01,20114,1,0,1,1,0,1
2023-06-01,13492,2,0,2,2,0,2
2023-06-01,396053,1,0,1,2,0,2
2023-06-01,394571,1,0,1,1,0,1
2023-06-01,27356,1,0,1,3,0,3
2023-06-01,394338,2,0,2,1,0,1
2023-06-01,19266,1,0,1,1,0,1
2023-06-01,22476,2,0,2,3,0,3
2023-06-01,395337,8,1,9,4,3,4
2023-06-01,30377,6,1,7,3,3,3
2023-06-01,22109,1,0,1,4,0,4
2023-06-01,22019,0,0,0,1,0,1
2023-06-01,31755,1,0,1,2,0,2
2023-06-01,54246,3,0,3,4,0,4
2023-06-01,396445,4,0,4,2,0,2
2023-06-01,394145,1,0,1,2,0,2
2023-06-01,30320,19,0,19,7,0,7
2023-06-01,14961,1,0,1,2,0,2
2023-06-01,19242,3,0,3,2,0,2
2023-06-01,31757,2,0,2,1,0,1
2023-06-01,27238,1,0,1,1,0,1
2023-06-01,394188,1,0,1,1,0,1
2023-06-01,8021,1,0,1,1,0,1
2023-06-01,30699,2,0,2,1,0,1
2023-06-01,32149,5,0,5,2,0,2
2023-06-01,23062,1,0,1,1,0,1
2023-06-01,40565,1,0,1,3,0,3
2023-06-01,22585,1,0,1,2,0,2
2023-06-01,396112,1,0,1,1,0,1
2023-06-01,31819,1,0,1,1,0,1
2023-06-01,18976,1,0,1,1,0,1
2023-06-01,22073,1,0,1,1,0,1
2023-06-01,19887,1,0,1,2,0,2
2023-06-01,32516,1,0,1,1,0,1
2023-06-01,14998,1,0,1,2,0,2
2023-06-01,63226,1,0,1,2,0,2
2023-06-01,399036,1,0,1,3,0,3
2023-06-01,399319,1,0,1,1,0,1
2023-06-01,398902,1,0,1,3,0,3
2023-06-01,399262,1,0,1,2,0,2
2023-06-01,399249,3,0,3,1,0,1
2023-06-01,399267,1,0,1,1,0,1
2023-06-01,36013,1,0,1,2,0,2
2023-06-01,25732,1,0,1,3,0,3
2023-06-01,136473,1,0,1,1,0,1
2023-06-01,396494,1,0,1,1,0,1
2023-06-01,395583,1,0,1,3,0,3
2023-06-01,23386,1,0,1,2,0,2
2023-06-01,20393,1,0,1,2,0,2
2023-06-01,21958,2,0,2,2,0,2
2023-06-01,30260,2,0,2,2,0,2
2023-06-01,46211,1,0,1,2,0,2
2023-06-01,36533,1,0,1,2,0,2
2023-06-01,13803,2,0,2,2,0,2
2023-06-01,398263,1,1,2,1,1,1
2023-06-01,399256,3,0,3,2,0,2
2023-06-01,16388,1,0,1,3,0,3
2023-06-01,32705,1,0,1,1,0,1
2023-06-01,15008,8,0,8,4,0,4
2023-06-01,400507,1,0,1,1,0,1
2023-06-01,32004,1,0,1,2,0,2
2023-06-01,20017,1,0,1,2,0,2
2023-06-01,21952,4,0,4,2,0,2
2023-06-01,63106,2,0,2,2,0,2
2023-06-01,63105,3,0,3,1,0,1
2023-06-01,36277,1,0,1,1,0,1
2023-06-01,29753,1,0,1,2,0,2
2023-06-01,11472,8,2,10,2,1,2
2023-06-01,39951,1,0,1,1,0,1
2023-06-01,26351,5,0,5,3,0,3
2023-06-01,30434,2,0,2,2,0,2
2023-06-01,398061,2,0,2,2,0,2
2023-06-01,36475,4,0,4,4,0,4
2023-06-01,16538,1,0,1,2,0,2
2023-06-01,14839,1,0,1,3,0,3
2023-06-01,30309,1,0,1,1,0,1
2023-06-01,14600,3,0,3,1,0,1
2023-06-01,36501,2,0,2,1,0,1
2023-06-01,36594,1,0,1,1,0,1
2023-06-01,262,1,1,2,2,1,2
2023-06-01,53299,0,0,0,1,0,1
2023-06-01,25642,2,0,2,1,0,1
2023-06-01,32661,2,0,2,3,0,3
2023-06-01,30625,3,0,3,1,0,1
2023-06-01,17279,3,0,3,1,0,1
2023-06-01,23510,1,0,1,2,0,2
2023-06-01,32247,1,0,1,1,0,1
2023-06-01,10915,1,0,1,2,0,2
2023-06-01,36783,2,0,2,2,0,2
2023-06-01,19455,1,0,1,1,0,1
2023-06-01,21959,2,0,2,1,0,1
2023-06-01,22436,4,0,4,3,0,3
2023-06-01,36854,3,0,3,4,0,4
2023-06-01,33279,1,0,1,2,0,2
2023-06-01,26869,1,0,1,1,0,1
2023-06-01,30714,2,0,2,2,0,2
2023-06-01,18658,1,0,1,1,0,1
2023-06-01,21895,4,0,4,1,0,1
2023-06-01,40013,1,0,1,2,0,2
2023-06-01,39973,3,0,3,3,0,3
2023-06-01,400182,1,0,1,2,0,2
2023-06-01,26233,1,0,1,1,0,1
2023-06-01,26448,1,0,1,1,0,1
2023-06-01,395576,1,0,1,1,0,1
2023-06-01,39983,2,0,2,1,0,1
2023-06-01,40049,1,0,1,2,0,2
2023-06-01,22053,2,0,2,2,0,2
2023-06-01,25740,4,0,4,4,0,4
2023-06-01,13846,4,0,4,1,0,1
2023-06-01,40175,3,0,3,2,0,2
2023-06-01,30141,1,0,1,1,0,1
2023-06-01,36543,8,0,8,2,0,2
2023-06-01,26956,1,0,1,1,0,1
2023-06-01,36003,2,1,3,2,1,2
2023-06-01,20123,2,0,2,3,0,3
2023-06-01,20122,1,0,1,3,0,3
2023-06-01,30040,2,0,2,2,0,2
2023-06-01,40189,1,0,1,1,0,1
2023-06-01,11354,2,0,2,3,0,3
2023-06-01,23000,5,0,5,3,0,3
2023-06-01,33638,2,0,2,1,0,1
2023-06-01,40068,4,0,4,3,0,3
2023-06-01,40226,3,0,3,2,0,2
2023-06-01,32172,2,0,2,2,0,2
2023-06-01,26467,5,0,5,2,0,2
2023-06-01,14287,19,0,19,1,0,1
2023-06-01,40218,1,0,1,1,0,1
2023-06-01,20204,2,0,2,1,0,1
2023-06-01,29730,5,0,5,2,0,2
2023-06-01,40298,8,1,9,2,2,2
2023-06-01,394622,3,0,3,1,0,1
2023-06-01,393864,2,0,2,1,0,1
2023-06-01,36546,2,0,2,1,0,1
2023-06-01,40261,1,0,1,1,0,1
2023-06-01,40243,3,0,3,1,0,1
2023-06-01,21604,1,0,1,3,0,3
2023-06-01,13612,1,0,1,1,0,1
2023-06-01,23318,1,0,1,1,0,1
2023-06-01,14849,5,0,5,2,0,2
2023-06-01,23462,3,0,3,3,0,3
2023-06-01,36213,3,1,4,7,1,7
2023-06-01,40252,9,0,9,4,0,4
2023-06-01,40262,4,0,4,6,0,6
2023-06-01,398125,3,0,3,3,0,3
2023-06-01,6129,1,0,1,1,0,1
2023-06-01,13902,1,0,1,1,0,1
2023-06-01,10936,1,0,1,1,0,1
2023-06-01,40074,2,0,2,4,0,4
2023-06-01,10694,5,0,5,4,0,4
2023-06-01,22157,7,0,7,3,0,3
2023-06-01,14476,2,0,2,2,0,2
2023-06-01,19918,1,0,1,1,0,1
2023-06-01,14419,2,0,2,1,0,1
2023-06-01,397108,2,0,2,2,0,2
2023-06-01,3789,3,0,3,3,0,3
2023-06-01,16993,4,0,4,4,0,4
2023-06-01,25713,5,0,5,3,0,3
2023-06-01,29912,5,0,5,3,0,3
2023-06-01,54838,3,0,3,1,0,1
2023-06-01,21519,1,0,1,1,0,1
2023-06-01,18605,1,0,1,1,0,1
2023-06-01,36000,2,0,2,4,0,4
2023-06-01,13575,1,0,1,1,0,1
2023-06-01,14005,1,0,1,2,0,2
2023-06-01,22103,11,0,11,6,0,6
2023-06-01,32113,4,0,4,3,0,3
2023-06-01,22841,3,0,3,3,0,3
2023-06-01,36508,8,0,8,2,0,2
2023-06-01,54779,2,0,2,1,0,1
2023-06-01,36294,1,0,1,3,0,3
2023-06-01,18793,4,0,4,1,0,1
2023-06-01,40335,1,1,2,1,1,1
2023-06-01,40363,1,0,1,1,0,1
2023-06-01,36481,1,0,1,1,0,1
2023-06-01,40377,1,0,1,1,0,1
2023-06-01,33642,3,0,3,2,0,2
2023-06-01,40399,7,0,7,1,0,1
2023-06-01,21937,4,0,4,2,0,2
2023-06-01,22145,1,0,1,1,0,1
2023-06-01,31981,1,0,1,2,0,2
2023-06-01,22481,8,0,8,2,0,2
2023-06-01,33536,2,0,2,2,0,2
2023-06-01,40408,1,0,1,2,0,2
2023-06-01,40436,2,0,2,1,0,1
2023-06-01,10240,6,0,6,5,0,5
2023-06-01,40429,1,0,1,2,0,2
2023-06-01,13754,2,0,2,3,0,3
2023-06-01,33009,1,0,1,1,0,1
2023-06-01,18640,3,1,4,3,1,3
2023-06-01,11856,3,0,3,3,0,3
2023-06-01,40176,1,0,1,1,0,1
2023-06-01,15126,1,0,1,1,0,1
2023-06-01,12010,3,0,3,2,0,2
2023-06-01,33053,1,0,1,3,0,3
2023-06-01,19898,5,0,5,3,0,3
2023-06-01,30393,5,0,5,1,0,1
2023-06-01,14585,7,2,9,3,2,3
2023-06-01,6999,8,0,8,1,0,1
2023-06-01,3820,1,0,1,1,0,1
2023-06-01,40499,4,0,4,4,0,4
2023-06-01,11374,4,3,7,1,4,5
2023-06-01,33533,1,0,1,3,0,3
2023-06-01,14444,2,0,2,3,0,3
2023-06-01,36265,2,0,2,2,0,2
2023-06-01,16773,3,0,3,2,0,2
2023-06-01,10340,5,0,5,1,0,1
2023-06-01,11241,6,0,6,2,0,2
2023-06-01,40522,1,0,1,2,0,2
2023-06-01,33444,1,0,1,2,0,2
2023-06-01,23268,12,0,12,4,0,4
2023-06-01,32850,3,0,3,3,0,3
2023-06-01,36242,2,0,2,1,0,1
2023-06-01,19687,4,0,4,3,0,3
2023-06-01,26030,1,0,1,1,0,1
2023-06-01,394913,2,0,2,1,0,1
2023-06-01,394595,1,0,1,2,0,2
2023-06-01,19071,4,0,4,3,0,3
2023-06-01,11455,5,0,5,4,0,4
2023-06-01,53915,1,0,1,4,0,4
2023-06-01,10974,1,0,1,1,0,1
2023-06-01,399722,1,0,1,2,0,2
2023-06-01,21608,1,0,1,2,0,2
2023-06-01,62609,4,0,4,2,0,2
2023-06-01,13822,1,0,1,2,0,2
2023-06-01,14006,3,0,3,2,0,2
2023-06-01,63117,7,0,7,4,0,4
2023-06-01,14625,2,0,2,3,0,3
2023-06-01,19268,1,0,1,1,0,1
2023-06-01,399536,1,0,1,1,0,1
2023-06-01,10990,1,0,1,3,0,3
2023-06-01,29776,1,0,1,2,0,2
2023-06-01,26824,1,1,2,1,1,1
2023-06-01,14856,1,1,2,2,2,2
2023-06-01,11901,2,0,2,3,0,3
2023-06-01,10351,4,0,4,1,0,1
2023-06-01,18634,1,0,1,2,0,2
2023-06-01,30400,3,0,3,2,0,2
2023-06-01,17382,3,0,3,4,0,4
2023-06-01,32005,4,0,4,3,0,3
2023-06-01,33010,1,0,1,2,0,2
2023-06-01,399412,1,0,1,1,0,1
2023-06-01,27621,8,0,8,2,0,2
2023-06-01,18827,6,0,6,4,0,4
2023-06-01,19345,1,0,1,1,0,1
2023-06-01,15328,9,0,9,3,0,3
2023-06-01,19432,2,1,3,2,1,2
2023-06-01,18959,3,0,3,2,0,2
2023-06-01,395814,1,0,1,3,0,3
2023-06-01,18482,3,0,3,2,0,2
2023-06-01,16674,4,0,4,3,0,3
2023-06-01,20216,1,0,1,1,0,1
2023-06-01,20038,1,0,1,2,0,2
2023-06-01,39998,4,0,4,1,0,1
2023-06-01,15231,1,1,2,1,1,2
2023-06-01,14922,9,0,9,2,0,2
2023-06-01,14899,3,0,3,6,0,6
2023-06-01,21576,4,0,4,2,0,2
2023-06-01,22414,1,2,3,5,3,5
2023-06-01,20164,2,0,2,4,0,4
2023-06-01,29807,1,1,2,2,2,2
2023-06-01,395902,1,0,1,2,0,2
2023-06-01,23082,2,0,2,2,0,2
2023-06-01,18749,4,0,4,4,0,4
2023-06-01,13958,1,0,1,2,0,2
2023-06-01,22391,4,0,4,2,0,2
2023-06-01,22752,2,0,2,4,0,4
2023-06-01,40031,1,0,1,1,0,1
2023-06-01,32802,4,0,4,3,0,3
2023-06-01,17240,3,0,3,2,0,2
2023-06-01,26156,1,1,2,4,5,5
2023-06-01,396135,2,0,2,4,0,4
2023-06-01,395244,2,0,2,2,0,2
2023-06-01,36798,4,0,4,3,0,3
2023-06-01,26199,4,0,4,4,0,4
2023-06-01,26828,1,0,1,1,0,1
2023-06-01,26948,1,0,1,1,0,1
2023-06-01,22955,1,0,1,3,0,3
2023-06-01,27379,1,0,1,1,0,1
2023-06-01,33131,4,0,4,2,0,2
2023-06-01,23337,1,0,1,1,0,1
2023-06-01,26220,3,0,3,1,0,1
2023-06-01,16507,2,1,3,4,2,4
2023-06-01,14070,2,0,2,2,0,2
2023-06-01,30144,1,1,2,1,1,1
2023-06-01,18830,3,0,3,2,0,2
2023-06-01,11337,1,0,1,3,0,3
2023-06-01,328179,1,0,1,3,0,3
2023-06-01,29832,1,0,1,3,0,3
2023-06-01,19636,1,0,1,1,0,1
2023-06-01,33586,3,0,3,4,0,4
2023-06-01,14160,5,0,5,2,0,2
2023-06-01,33368,1,1,2,2,1,2
2023-06-01,22104,5,0,5,5,0,5
2023-06-01,54912,1,0,1,3,0,3
2023-06-01,29963,3,0,3,3,0,3
2023-06-01,22253,1,0,1,1,0,1
2023-06-01,30708,2,0,2,1,0,1
2023-06-01,16563,1,0,1,3,0,3
2023-06-01,394997,1,0,1,3,0,3
2023-06-01,14549,3,0,3,3,0,3
2023-06-01,22886,4,0,4,3,0,3
2023-06-01,40552,1,0,1,1,0,1
2023-06-01,11171,4,0,4,1,0,1
2023-06-01,40563,1,0,1,3,0,3
2023-06-01,33488,1,0,1,1,0,1
2023-06-01,14389,1,0,1,2,0,2
2023-06-01,16947,1,0,1,1,0,1
2023-06-01,16568,4,0,4,4,0,4
2023-06-01,46926,3,0,3,4,0,4
2023-06-01,23176,1,0,1,1,0,1
2023-06-01,54820,2,0,2,2,0,2
2023-06-01,54016,1,0,1,1,0,1
2023-06-01,32025,3,0,3,2,0,2
2023-06-01,19153,4,0,4,2,0,2
2023-06-01,11558,4,0,4,1,0,1
2023-06-01,23281,4,0,4,1,0,1
2023-06-01,62261,5,0,5,5,0,5
2023-06-01,40616,2,0,2,2,0,2
2023-06-01,26961,2,0,2,3,0,3
2023-06-01,33737,1,0,1,2,0,2
2023-06-01,26192,5,0,5,3,0,3
2023-06-01,40558,2,0,2,3,0,3
2023-06-01,35984,5,0,5,3,0,3
2023-06-01,32284,2,0,2,2,0,2
2023-06-01,40689,3,0,3,1,0,1
2023-06-01,40668,2,0,2,2,0,2
2023-06-01,36824,1,0,1,1,0,1
2023-06-01,395157,2,0,2,2,0,2
2023-06-01,32788,1,0,1,1,0,1
2023-06-01,16671,1,0,1,1,0,1
2023-06-01,40752,2,0,2,4,0,4
2023-06-01,27550,3,0,3,1,0,1
2023-06-01,32362,3,0,3,2,0,2
2023-06-01,23446,3,0,3,3,0,3
2023-06-01,11386,3,0,3,1,0,1
2023-06-01,29931,1,0,1,3,0,3
2023-06-01,55249,1,0,1,1,0,1
2023-06-01,47071,4,0,4,1,0,1
2023-06-01,19968,1,0,1,2,0,2
2023-06-01,397415,2,9,11,4,4,4
2023-06-01,30445,1,0,1,1,0,1
2023-06-01,400770,1,0,1,1,0,1
2023-06-01,32593,4,0,4,1,0,1
2023-06-01,19284,4,0,4,1,0,1
2023-06-01,63472,1,0,1,2,0,2
2023-06-01,11637,4,0,4,4,0,4
2023-06-01,40778,1,0,1,3,0,3
2023-06-01,40648,3,0,3,3,0,3
2023-06-01,23485,1,0,1,1,0,1
2023-06-01,40757,1,0,1,2,0,2
2023-06-01,20443,1,0,1,2,0,2
2023-06-01,40738,4,0,4,1,0,1
2023-06-01,40764,3,1,4,5,2,5
2023-06-01,15145,1,0,1,2,0,2
2023-06-01,40666,2,0,2,1,0,1
2023-06-01,40834,1,0,1,3,0,3
2023-06-01,393895,3,0,3,5,0,5
2023-06-01,36302,1,0,1,1,0,1
2023-06-01,40553,1,0,1,2,0,2
2023-06-01,393996,1,1,2,1,1,1
2023-06-01,26239,4,0,4,2,0,2
2023-06-01,398821,1,0,1,1,0,1
2023-06-01,31995,2,0,2,2,0,2
2023-06-01,17103,3,1,4,4,2,4
2023-06-01,23018,4,0,4,3,0,3
2023-06-01,6456,4,1,5,7,3,8
2023-06-01,46682,1,0,1,2,0,2
2023-06-01,40915,1,0,1,1,0,1
2023-06-01,30423,3,0,3,2,0,2
2023-06-01,15019,2,0,2,3,0,3
2023-06-01,40947,5,0,5,2,0,2
2023-06-01,32010,2,0,2,1,0,1
2023-06-01,40661,1,0,1,3,0,3
2023-06-01,22592,4,0,4,2,0,2
2023-06-01,27233,1,0,1,1,0,1
2023-06-01,30184,1,0,1,1,0,1
2023-06-01,46099,1,0,1,1,0,1
2023-06-01,40667,1,0,1,2,0,2
2023-06-01,26461,4,0,4,7,0,7
2023-06-01,46095,1,0,1,2,0,2
2023-06-01,40931,3,1,4,1,1,1
2023-06-01,27374,1,0,1,2,0,2
2023-06-01,40780,2,0,2,2,0,2
2023-06-01,63395,1,0,1,1,0,1
2023-06-01,40946,4,0,4,1,0,1
2023-06-01,397059,1,0,1,1,0,1
2023-06-01,46155,6,0,6,3,0,3
2023-06-01,46083,1,0,1,1,0,1
2023-06-01,46209,5,1,6,5,1,6
2023-06-01,46258,1,0,1,2,0,2
2023-06-01,394448,3,0,3,2,0,2
2023-06-01,11793,1,0,1,1,0,1
2023-06-01,46244,3,0,3,2,0,2
2023-06-01,22821,1,0,1,3,0,3
2023-06-01,29893,3,0,3,2,0,2
2023-06-01,46357,1,1,2,3,2,3
2023-06-01,40748,1,0,1,3,0,3
2023-06-01,46359,6,0,6,1,0,1
2023-06-01,36116,1,0,1,3,0,3
2023-06-01,29816,1,0,1,1,0,1
2023-06-01,35981,3,0,3,1,0,1
2023-06-01,46368,0,0,0,2,0,2
2023-06-01,14220,8,0,8,1,0,1
2023-06-01,13629,3,0,3,2,0,2
2023-06-01,46406,1,0,1,1,0,1
2023-06-01,11954,3,0,3,4,0,4
2023-06-01,11476,1,0,1,2,0,2
2023-06-01,27314,1,0,1,1,0,1
2023-06-01,1446,2,0,2,3,0,3
2023-06-01,397429,2,0,2,2,0,2
2023-06-01,46438,1,0,1,1,0,1
2023-06-01,46207,1,0,1,1,0,1
2023-06-01,46443,4,0,4,3,0,3
2023-06-01,33382,1,0,1,2,0,2
2023-06-01,15342,4,0,4,3,0,3
2023-06-01,23441,1,0,1,1,0,1
2023-06-01,46460,1,0,1,2,0,2
2023-06-01,14830,2,0,2,2,0,2
2023-06-01,46735,1,0,1,2,0,2
2023-06-01,394806,4,0,4,1,0,1
2023-06-01,32648,1,0,1,1,0,1
2023-06-01,36613,1,0,1,3,0,3
2023-06-01,1017,1,0,1,1,0,1
2023-06-01,400109,1,0,1,1,0,1
2023-06-01,30530,7,0,7,1,0,1
2023-06-01,26025,1,0,1,1,0,1
2023-06-01,19471,1,0,1,1,0,1
2023-06-01,29749,1,3,4,1,1,1
2023-06-01,399986,1,0,1,1,0,1
2023-06-01,7720,1,1,2,1,7,7
2023-06-01,141237,1,2,3,1,82,82
2023-06-01,399849,1,0,1,1,0,1
2023-06-01,32582,1,1,2,2,2,2
2023-06-01,398840,1,0,1,1,0,1
2023-06-01,400006,1,1,2,1,1,1
2023-06-01,398820,3,0,3,2,0,2
2023-06-01,40549,1,0,1,1,0,1
2023-06-01,395126,1,0,1,1,0,1
2023-06-01,397948,1,0,1,1,0,1
2023-06-01,396231,1,1,2,1,1,1
2023-06-01,17218,1,1,2,2,2,2
2023-06-01,395229,1,0,1,1,0,1
2023-06-01,31858,1,0,1,3,0,3
2023-06-01,22741,1,0,1,1,0,1
2023-06-01,22396,1,0,1,1,0,1
2023-06-01,63169,1,0,1,2,0,2
2023-06-01,199406,1,0,1,1,0,1
2023-06-01,22536,1,0,1,1,0,1
2023-06-01,30156,1,0,1,2,0,2
2023-06-01,396953,1,0,1,1,0,1
2023-06-01,396848,1,0,1,2,0,2
2023-06-01,398560,1,0,1,2,0,2
2023-06-01,394327,1,0,1,1,0,1
2023-06-01,29941,1,0,1,4,0,4
2023-06-01,14734,9,0,9,3,0,3
2023-06-01,394399,8,0,8,4,0,4
2023-06-01,30290,1,0,1,2,0,2
2023-06-01,40732,1,0,1,2,0,2
2023-06-01,31777,5,0,5,2,0,2
2023-06-01,397518,1,1,2,1,2,2
2023-06-01,397522,1,1,2,2,4,4
2023-06-01,397520,1,1,2,2,3,3
2023-06-01,397517,1,1,2,1,2,2
2023-06-01,398103,0,0,0,2,2,2
2023-06-01,12284,3,1,4,1,1,1
2023-06-01,26862,16,0,16,3,0,3
2023-06-01,23218,1,0,1,1,0,1
2023-06-01,399777,3,0,3,1,0,1
2023-06-01,32856,2,0,2,3,0,3
2023-06-01,39961,13,0,13,4,0,4
2023-06-01,36794,26,0,26,3,0,3
2023-06-01,398171,1,0,1,2,0,2
2023-06-01,36052,2,0,2,1,0,1
2023-06-01,13975,1,0,1,1,0,1
2023-06-01,19840,1,0,1,2,0,2
2023-06-01,16688,2,0,2,3,0,3
2023-06-01,14524,3,0,3,1,0,1
2023-06-01,19617,1,0,1,2,0,2
2023-06-01,46407,1,1,2,1,1,1
2023-06-01,396209,2,0,2,1,0,1
2023-06-01,19839,2,0,2,3,0,3
2023-06-01,397037,1,0,1,1,0,1
2023-06-01,31859,1,1,2,2,1,3
2023-06-01,26920,1,0,1,1,0,1
2023-06-01,393615,1,0,1,2,0,2
2023-06-01,26552,1,0,1,1,0,1
2023-06-01,395006,1,0,1,1,0,1
2023-06-01,54740,1,0,1,3,0,3
2023-06-01,399117,2,0,2,3,0,3
2023-06-01,30084,1,0,1,1,0,1
2023-06-01,18476,1,0,1,1,0,1
2023-06-01,54549,1,0,1,2,0,2
2023-06-01,33192,1,0,1,3,0,3
2023-06-01,19966,2,31,33,3,1,3
2023-06-01,399053,1,0,1,2,0,2
2023-06-01,399056,1,0,1,1,0,1
2023-06-01,40734,1,0,1,2,0,2
2023-06-01,23514,3,0,3,3,0,3
2023-06-01,17002,1,0,1,3,0,3
2023-06-01,53689,1,0,1,2,0,2
2023-06-01,53277,1,0,1,2,0,2
2023-06-01,40537,1,0,1,3,0,3
2023-06-01,22028,1,0,1,3,0,3
2023-06-01,27519,5,0,5,1,0,1
2023-06-01,21979,1,0,1,3,0,3
2023-06-01,22970,11,0,11,1,0,1
2023-06-01,399730,1,1,2,3,3,3
2023-06-01,399731,1,1,2,3,3,3
2023-06-01,46585,1,0,1,2,0,2
2023-06-01,63148,2,0,2,2,0,2
2023-06-01,397858,1,0,1,1,0,1
2023-06-01,26065,1,0,1,2,0,2
2023-06-01,13710,1,0,1,2,0,2
2023-06-01,11437,6,0,6,4,0,4
2023-06-01,15134,1,0,1,2,0,2
2023-06-01,32377,1,0,1,2,0,2
2023-06-01,46919,1,0,1,3,0,3
2023-06-01,21542,1,0,1,1,0,1
2023-06-01,39997,2,0,2,2,0,2
2023-06-01,394809,1,0,1,1,0,1
2023-06-01,11441,1,0,1,1,0,1
2023-06-01,394331,1,0,1,2,0,2
2023-06-01,30430,1,0,1,1,0,1
2023-06-01,19664,1,0,1,1,0,1
2023-06-01,47083,1,0,1,1,0,1
2023-06-01,32252,6,0,6,1,0,1
2023-06-01,19302,1,0,1,1,0,1
2023-06-01,35853,1,0,1,1,0,1
2023-06-01,21754,1,0,1,1,0,1
2023-06-01,395278,2,0,2,2,0,2
2023-06-01,36461,4,0,4,1,0,1
2023-06-01,22243,1,0,1,2,0,2
2023-06-01,32166,1,0,1,2,0,2
2023-06-01,23357,8,0,8,1,0,1
2023-06-01,54007,1,0,1,1,0,1
2023-06-01,399876,1,0,1,3,0,3
2023-06-01,395372,2,0,2,1,0,1
2023-06-01,273653,1,1,2,1,1,1
2023-06-01,272462,1,1,2,3,2,3
2023-06-01,272764,1,3,4,2,3,5
2023-06-01,272702,1,1,2,1,1,1
2023-06-01,272602,1,2,3,1,1,2
2023-06-01,397396,1,0,1,1,0,1
2023-06-01,397489,1,0,1,2,0,2
2023-06-01,209411,1,1,2,1,2,2
2023-06-01,202590,1,1,2,1,3,3
2023-06-01,1219,1,1,2,1,2,2
2023-06-01,10444,33,0,33,4,0,4
2023-06-01,30477,1,0,1,3,0,3
2023-06-01,4965,13,0,13,4,0,4
2023-06-01,1911,3,0,3,1,0,1
2023-06-01,64140,5,0,5,1,0,1
2023-06-01,722,7,0,7,2,0,2
2023-06-01,3931,2,0,2,2,0,2
2023-06-01,33462,1,0,1,2,0,2
2023-06-01,26868,1,1,2,3,1,3
2023-06-01,62526,1,0,1,2,0,2
2023-06-01,30712,17,0,17,3,0,3
2023-06-01,62808,1,0,1,2,0,2
2023-06-01,400727,2,1,3,2,1,2
2023-06-01,213176,12,0,12,7,0,7
2023-06-01,399198,1,0,1,1,0,1
2023-06-01,398943,2,0,2,3,0,3
2023-06-01,26657,1,0,1,3,0,3
2023-06-01,25725,1,0,1,1,0,1
2023-06-01,397765,7,0,7,2,0,2
2023-06-01,14166,6,0,6,1,0,1
2023-06-01,32407,1,0,1,3,0,3
2023-06-01,34437,1,1,2,3,3,3
2023-06-01,22525,1,0,1,3,0,3
2023-06-01,25760,1,0,1,1,0,1
2023-06-01,396020,1,0,1,3,0,3
2023-06-01,15239,1,0,1,1,0,1
2023-06-01,30153,1,0,1,3,0,3
2023-06-01,399660,1,0,1,1,0,1
2023-06-01,22989,1,1,2,2,2,3
2023-06-01,16954,5,0,5,4,0,4
2023-06-01,400724,16,0,16,2,0,2
2023-06-01,140911,1,1,2,1,1,1
2023-06-01,139309,1,1,2,1,1,1
2023-06-01,398958,1,0,1,3,0,3
2023-06-01,398971,1,0,1,2,0,2
2023-06-01,14848,2,0,2,2,0,2
2023-06-01,397337,1,0,1,1,0,1
2023-06-01,29794,2,0,2,4,0,4
2023-06-01,17167,1,0,1,2,0,2
2023-06-01,398972,1,0,1,1,0,1
2023-06-01,397350,2,0,2,3,0,3
2023-06-01,398260,1,0,1,1,0,1
2023-06-01,54828,1,0,1,2,0,2
2023-06-01,63012,1,0,1,2,0,2
2023-06-01,398201,1,0,1,1,0,1
2023-06-01,36862,1,0,1,2,0,2
2023-06-01,397910,1,0,1,1,0,1
2023-06-01,393948,1,0,1,1,0,1
2023-06-01,40920,1,0,1,1,0,1
2023-06-01,40422,3,0,3,1,0,1
2023-06-01,10855,1,0,1,1,0,1
2023-06-01,22935,3,0,3,1,0,1
2023-06-01,14240,3,0,3,1,0,1
2023-06-01,46800,1,0,1,2,0,2
2023-06-01,36752,3,1,4,1,1,1
2023-06-01,36229,3,1,4,1,1,1
2023-06-01,32492,1,0,1,1,0,1
2023-06-01,46134,1,0,1,1,0,1
2023-06-01,55185,1,1,2,2,1,2
2023-06-01,33314,1,0,1,1,0,1
2023-06-01,14771,4,0,4,1,0,1
2023-06-01,22196,2,0,2,2,0,2
2023-06-01,40064,3,0,3,1,0,1
2023-06-01,14170,1,0,1,1,0,1
2023-06-01,398856,1,0,1,3,0,3
2023-06-01,398018,1,0,1,2,0,2
2023-06-01,7805,1,0,1,1,0,1
2023-06-01,26705,2,0,2,4,0,4
2023-06-01,62876,1,0,1,1,0,1
2023-06-01,14941,1,0,1,1,0,1
2023-06-01,40680,4,3,7,2,1,2
2023-06-01,32732,0,0,0,2,0,2
2023-06-01,22259,1,0,1,1,0,1
2023-06-01,8120,2,0,2,1,0,1
2023-06-01,53487,1,0,1,1,0,1
2023-06-01,7158,1,0,1,1,0,1
2023-06-01,10676,4,0,4,2,0,2
2023-06-01,62703,1,0,1,1,0,1
2023-06-01,31797,1,1,2,1,1,2
2023-06-01,27220,1,0,1,1,0,1
2023-06-01,13673,5,0,5,1,0,1
2023-06-01,397178,5,0,5,1,0,1
2023-06-01,398023,2,0,2,3,0,3
2023-06-01,397194,1,1,2,2,2,2
2023-06-01,10386,1,0,1,1,0,1
2023-06-01,40836,1,0,1,3,0,3
2023-06-01,10701,1,0,1,1,0,1
2023-06-01,393356,1,0,1,2,0,2
2023-06-01,23378,1,0,1,1,0,1
2023-06-01,46462,1,0,1,1,0,1
2023-06-01,394389,1,0,1,3,0,3
2023-06-01,26420,2,0,2,5,0,5
2023-06-01,6493,6,0,6,1,0,1
2023-06-01,54724,1,0,1,2,0,2
2023-06-01,16766,1,0,1,3,0,3
2023-06-01,30138,1,0,1,3,0,3
2023-06-01,394398,1,0,1,2,0,2
2023-06-01,36070,3,0,3,2,0,2
2023-06-01,396862,3,0,3,2,0,2
2023-06-01,11905,1,0,1,1,0,1
2023-06-01,397276,1,0,1,2,0,2
2023-06-01,400138,3,0,3,5,0,5
2023-06-01,398205,1,0,1,2,0,2
2023-06-01,398168,1,0,1,2,0,2
2023-06-01,11785,1,0,1,1,0,1
2023-06-01,396188,1,0,1,2,0,2
2023-06-01,396096,1,0,1,2,0,2
2023-06-01,398175,1,0,1,2,0,2
2023-06-01,62740,2,0,2,2,0,2
2023-06-01,40575,7,0,7,1,0,1
2023-06-01,399574,1,0,1,1,0,1
2023-06-01,33398,3,1,4,2,2,2
2023-06-01,399265,1,0,1,1,0,1
2023-06-01,399140,2,1,3,3,1,3
2023-06-01,26537,1,0,1,3,0,3
2023-06-01,8082,1,0,1,1,0,1
2023-06-01,30008,1,0,1,1,0,1
2023-06-01,64288,1,0,1,1,0,1
2023-06-01,10445,17,0,17,1,0,1
2023-06-01,54161,1,0,1,1,0,1
2023-06-01,63143,1,0,1,1,0,1
2023-06-01,393671,1,0,1,1,0,1
2023-06-01,399454,1,0,1,1,0,1
2023-06-01,21586,7,0,7,1,0,1
2023-06-01,397851,1,0,1,1,0,1
2023-06-01,40097,1,0,1,1,0,1
2023-06-01,394289,1,0,1,1,0,1
2023-06-01,40476,4,0,4,1,0,1
2023-06-01,398918,1,0,1,3,0,3
2023-06-01,25643,1,0,1,1,0,1
2023-06-01,399131,1,0,1,1,0,1
2023-06-01,398894,1,1,2,2,1,2
2023-06-01,54518,1,0,1,3,0,3
2023-06-01,397090,1,0,1,1,0,1
2023-06-01,33184,2,0,2,2,0,2
2023-06-01,46085,1,0,1,4,0,4
2023-06-01,54317,1,0,1,1,0,1
2023-06-01,135005,2,0,2,1,0,1
2023-06-01,400464,2,0,2,1,0,1
2023-06-01,63392,1,0,1,1,0,1
2023-06-01,22042,1,0,1,2,0,2
2023-06-01,36193,1,0,1,2,0,2
2023-06-01,36846,1,0,1,1,0,1
2023-06-01,6598,2,0,2,1,0,1
2023-06-01,29734,4,0,4,1,0,1
2023-06-01,5081,1,1,2,3,3,3
2023-06-01,393452,1,0,1,1,0,1
2023-06-01,23137,2,0,2,1,0,1
2023-06-01,22919,2,0,2,1,0,1
2023-06-01,22660,1,0,1,1,0,1
2023-06-01,397885,1,0,1,1,0,1
2023-06-01,19048,1,0,1,1,0,1
2023-06-01,54544,1,1,2,3,1,3
2023-06-01,395408,1,0,1,2,0,2
2023-06-01,395053,1,0,1,2,0,2
2023-06-01,32213,1,0,1,1,0,1
2023-06-01,16740,8,0,8,2,0,2
2023-06-01,62985,0,0,0,2,0,2
2023-06-01,20222,33,0,33,1,0,1
2023-06-01,6983,2,0,2,2,0,2
2023-06-01,54677,1,0,1,2,0,2
2023-06-01,27579,2,0,2,3,0,3
2023-06-01,397537,1,0,1,1,0,1
2023-06-01,12069,15,0,15,2,0,2
2023-06-01,39986,7,0,7,3,0,3
2023-06-01,7770,2,0,2,1,0,1
2023-06-01,6479,1,1,2,2,1,2
2023-06-01,393289,1,0,1,2,0,2
2023-06-01,1702,1,0,1,1,0,1
2023-06-01,395327,1,0,1,3,0,3
2023-06-01,18465,14,0,14,5,0,5
2023-06-01,33324,1,0,1,2,0,2
2023-06-01,4200010506,1,0,1,1,0,1
2023-06-01,36089,2,0,2,3,0,3
2023-06-01,54691,2,0,2,4,0,4
2023-06-01,55015,1,0,1,1,0,1
2023-06-01,53362,1,0,1,3,0,3
2023-06-01,11619,1,0,1,3,0,3
2023-06-01,399628,2,2,4,1,1,1
2023-06-01,54249,12,0,12,1,0,1
2023-06-01,394525,1,0,1,1,0,1
2023-06-01,22190,4,0,4,3,0,3
2023-06-01,394773,1,0,1,1,0,1
2023-06-01,393641,1,0,1,3,0,3
2023-06-01,19179,2,0,2,1,0,1
2023-06-01,36023,1,0,1,1,0,1
2023-06-01,398172,1,0,1,1,0,1
2023-06-01,32039,2,0,2,2,0,2
2023-06-01,207419,1,0,1,4,0,4
2023-06-01,32547,1,0,1,3,0,3
2023-06-01,394204,1,0,1,1,0,1
2023-06-01,62846,1,0,1,2,0,2
2023-06-01,6354,1,0,1,1,0,1
2023-06-01,11881,1,0,1,1,0,1
2023-06-01,33114,1,0,1,1,0,1
2023-06-01,46759,1,0,1,1,0,1
2023-06-01,55118,1,0,1,3,0,3
2023-06-01,25833,1,0,1,1,0,1
2023-06-01,395193,3,0,3,2,0,2
2023-06-01,395720,2,0,2,4,0,4
2023-06-01,206285,1,0,1,1,0,1
2023-06-01,55280,1,0,1,2,0,2
2023-06-01,400038,1,0,1,3,0,3
2023-06-01,399400,2,0,2,3,0,3
2023-06-01,40494,1,0,1,3,0,3
2023-06-01,399209,1,1,2,2,1,2
2023-06-01,399332,1,1,2,1,1,1
2023-06-01,399484,1,0,1,2,0,2
2023-06-01,399387,1,0,1,1,0,1
2023-06-01,399582,1,0,1,2,0,2
2023-06-01,400501,1,0,1,1,0,1
2023-06-01,399580,1,5,6,4,1,4
2023-06-01,399620,1,0,1,3,0,3
2023-06-01,398457,1,0,1,3,0,3
2023-06-01,400472,1,0,1,1,0,1
2023-06-01,54196,1,0,1,1,0,1
2023-06-01,30473,1,0,1,1,0,1
2023-06-01,40832,1,0,1,1,0,1
2023-06-01,31811,15,1,16,1,1,1
2023-06-01,14686,16,0,16,2,0,2
2023-06-01,13805,1,0,1,1,0,1
2023-06-01,6381,5,0,5,1,0,1
2023-06-01,394710,3,3,6,3,4,4
2023-06-01,7258,2,0,2,1,0,1
2023-06-01,396074,1,0,1,1,0,1
2023-06-01,395908,1,0,1,1,0,1
2023-06-01,31813,1,0,1,1,0,1
2023-06-01,30713,7,0,7,1,0,1
2023-06-01,30698,35,2,37,2,2,2
2023-06-01,394843,1,0,1,1,0,1
2023-06-01,395098,10,0,10,3,0,3
2023-06-01,63260,2,0,2,1,0,1
2023-06-01,394742,2,0,2,2,0,2
2023-06-01,397829,1,0,1,2,0,2
2023-06-01,46086,1,0,1,1,0,1
2023-06-01,26066,1,0,1,2,0,2
2023-06-01,396505,1,0,1,2,0,2
2023-06-01,63316,1,0,1,1,0,1
2023-06-01,394816,1,0,1,3,0,3
2023-06-01,395162,8,0,8,3,0,3
2023-06-01,7334,7,0,7,3,0,3
2023-06-01,26565,1,0,1,1,0,1
2023-06-01,393368,1,0,1,2,0,2
2023-06-01,399413,1,0,1,1,0,1
2023-06-01,62645,1,1,2,1,1,1
2023-06-01,399837,12,0,12,2,0,2
2023-06-01,22675,1,0,1,1,0,1
2023-06-01,36094,1,0,1,2,0,2
2023-06-01,10469,1,0,1,1,0,1
2023-06-01,10732,6,1,7,2,1,2
2023-06-01,11238,4,1,5,1,2,2
2023-06-01,13950,4,0,4,2,0,2
2023-06-01,36328,2,0,2,1,0,1
2023-06-01,33051,1,0,1,1,0,1
2023-06-01,132428,1,0,1,2,0,2
2023-06-01,14182,4,1,5,3,3,3
2023-06-01,22681,1,0,1,2,0,2
2023-06-01,11011,2,0,2,1,0,1
2023-06-01,53799,1,0,1,1,0,1
2023-06-01,36557,1,0,1,2,0,2
2023-06-01,53793,1,0,1,3,0,3
2023-06-01,62665,2,0,2,4,0,4
2023-06-01,32948,1,0,1,1,0,1
2023-06-01,23482,1,0,1,2,0,2
2023-06-01,394589,1,0,1,2,0,2
2023-06-01,53888,1,0,1,1,0,1
2023-06-01,10489,20,0,20,1,0,1
2023-06-01,395050,9,0,9,1,0,1
2023-06-01,11036,12,0,12,2,0,2
2023-06-01,11023,1,0,1,3,0,3
2023-06-01,10685,6,0,6,4,0,4
2023-06-01,32750,1,0,1,2,0,2
2023-06-01,33640,1,0,1,1,0,1
2023-06-01,397002,1,0,1,2,0,2
2023-06-01,207009,2,0,2,2,0,2
2023-06-01,10930,6,0,6,2,0,2
2023-06-01,29755,1,0,1,2,0,2
2023-06-01,397012,1,0,1,1,0,1
2023-06-01,395178,1,0,1,2,0,2
2023-06-01,4578,1,0,1,1,0,1
2023-06-01,395342,1,0,1,1,0,1
2023-06-01,33275,1,0,1,1,0,1
2023-06-01,64241,1,1,2,5,3,6
2023-06-01,394207,1,0,1,2,0,2
2023-06-01,18799,1,0,1,1,0,1
2023-06-01,14100,1,0,1,1,0,1
2023-06-01,17776,1,0,1,1,0,1
2023-06-01,38299,2,2,4,1,1,1
2023-06-01,17890,8,0,8,2,0,2
2023-06-01,4817,20,7,27,6,6,7
2023-06-01,38483,1,0,1,2,0,2
2023-06-01,18114,16,0,16,1,0,1
2023-06-01,38358,1,0,1,3,0,3
2023-06-01,4759,65,0,65,2,0,2
2023-06-01,136464,1,0,1,3,0,3
2023-06-01,9306,5,0,5,2,0,2
2023-06-01,24370,1,0,1,1,0,1
2023-06-01,24367,1,2,3,1,1,2
2023-06-01,138393,1,0,1,1,0,1
2023-06-01,138369,1,0,1,1,0,1
2023-06-01,4202202306,0,0,0,2,0,2
2023-06-01,4202202006,0,0,0,2,0,2
2023-06-01,4202202256,1,0,1,1,0,1
2023-06-01,55793,1,0,1,1,0,1
2023-06-01,55746,1,0,1,3,0,3
2023-06-01,38881,2,0,2,4,0,4
2023-06-01,18224,1,0,1,2,0,2
2023-06-01,141697,4,0,4,1,0,1
2023-06-01,38142,17,0,17,4,0,4
2023-06-01,4781,9,0,9,3,0,3
2023-06-01,17420,4,1,5,3,2,3
2023-06-01,9807,4,0,4,2,0,2
2023-06-01,7640,1,0,1,1,0,1
2023-06-01,58866,7,2,9,3,1,3
2023-06-01,137767,1,0,1,1,0,1
2023-06-01,18241,8,0,8,3,0,3
2023-06-01,1670,1,0,1,1,0,1
2023-06-01,136182,2,0,2,2,0,2
2023-06-01,55790,1,0,1,2,0,2
2023-06-01,4672,3,3,6,2,2,2
2023-06-01,23568,3,0,3,2,0,2
2023-06-01,10192,1,0,1,2,0,2
2023-06-01,9855,4,0,4,2,0,2
2023-06-01,23668,25,0,25,2,0,2
2023-06-01,23971,2,0,2,2,0,2
2023-06-01,10171,62,0,62,2,0,2
2023-06-01,17601,2,0,2,1,0,1
2023-06-01,18343,7,0,7,2,0,2
2023-06-01,131869,1,0,1,1,0,1
2023-06-01,131097,1,0,1,1,0,1
2023-06-01,23759,16,0,16,1,0,1
2023-06-01,9455,27,0,27,4,0,4
2023-06-01,23589,2,0,2,1,0,1
2023-06-01,10170,2,0,2,2,0,2
2023-06-01,18324,5,0,5,2,0,2
2023-06-01,9852,4,0,4,2,0,2
2023-06-01,17876,1,0,1,1,0,1
2023-06-01,17833,14,0,14,1,0,1
2023-06-01,7559,13,0,13,1,0,1
2023-06-01,7558,4,0,4,4,0,4
2023-06-01,9709,1,0,1,4,0,4
2023-06-01,23561,14,0,14,1,0,1
2023-06-01,9632,5,0,5,1,0,1
2023-06-01,23619,6,0,6,2,0,2
2023-06-01,37898,1,0,1,1,0,1
2023-06-01,9358,1,0,1,1,0,1
2023-06-01,18142,13,0,13,2,0,2
2023-06-01,7678,2,0,2,1,0,1
2023-06-01,4718,1,1,2,2,2,2
2023-06-01,7503,3,2,5,4,4,4
2023-06-01,7663,12,0,12,3,0,3
2023-06-01,24296,5,0,5,2,0,2
2023-06-01,59113,1,1,2,1,1,1
2023-06-01,18074,1,1,2,3,3,3
2023-06-01,23585,2,0,2,1,0,1
2023-06-01,10039,2,0,2,2,0,2
2023-06-01,9458,1,0,1,2,0,2
2023-06-01,9706,8,0,8,1,0,1
2023-06-01,10173,2,0,2,2,0,2
2023-06-01,38421,2,0,2,2,0,2
2023-06-01,9690,2,0,2,2,0,2
2023-06-01,18312,1,0,1,1,0,1
2023-06-01,9779,1,0,1,1,0,1
2023-06-01,9861,1,0,1,2,0,2
2023-06-01,135499,1,0,1,1,0,1
2023-06-01,38465,1,0,1,2,0,2
2023-06-01,17852,7,0,7,1,0,1
2023-06-01,9531,6,0,6,2,0,2
2023-06-01,18336,2,0,2,1,0,1
2023-06-01,55598,2,0,2,2,0,2
2023-06-01,45364,2,0,2,2,0,2
2023-06-01,10177,1,0,1,2,0,2
2023-06-01,46005,3,0,3,1,0,1
2023-06-01,7530,3,1,4,4,3,4
2023-06-01,59099,1,1,2,1,1,1
2023-06-01,23773,1,0,1,2,0,2
2023-06-01,7478,4,0,4,1,0,1
2023-06-01,23925,1,0,1,1,0,1
2023-06-01,9715,2,0,2,2,0,2
2023-06-01,17901,6,0,6,3,0,3
2023-06-01,7485,2,0,2,2,0,2
2023-06-01,65206,2,1,3,1,1,1
2023-06-01,18027,27,0,27,3,0,3
2023-06-01,9276,1,0,1,1,0,1
2023-06-01,55594,1,0,1,1,0,1
2023-06-01,38704,1,0,1,1,0,1
2023-06-01,9646,4,0,4,3,0,3
2023-06-01,45387,1,0,1,1,0,1
2023-06-01,17594,1,0,1,2,0,2
2023-06-01,131868,1,0,1,2,0,2
2023-06-01,17585,2,0,2,1,0,1
2023-06-01,9771,3,0,3,1,0,1
2023-06-01,17588,1,0,1,3,0,3
2023-06-01,18045,12,0,12,1,0,1
2023-06-01,18181,3,0,3,3,0,3
2023-06-01,38837,3,0,3,2,0,2
2023-06-01,18179,1,0,1,1,0,1
2023-06-01,24416,11,0,11,1,0,1
2023-06-01,9803,10,0,10,2,0,2
2023-06-01,45969,1,0,1,2,0,2
2023-06-01,55605,1,0,1,2,0,2
2023-06-01,9853,12,0,12,1,0,1
2023-06-01,18299,2,0,2,1,0,1
2023-06-01,9990,1,0,1,1,0,1
2023-06-01,23841,19,0,19,1,0,1
2023-06-01,9810,6,0,6,2,0,2
2023-06-01,23851,4,0,4,1,0,1
2023-06-01,17430,32,0,32,2,0,2
2023-06-01,38430,1,0,1,1,0,1
2023-06-01,17850,3,0,3,2,0,2
2023-06-01,45964,1,0,1,2,0,2
2023-06-01,10165,6,0,6,3,0,3
2023-06-01,55584,1,0,1,2,0,2
2023-06-01,17875,1,0,1,1,0,1
2023-06-01,55620,4,0,4,1,0,1
2023-06-01,55601,1,0,1,1,0,1
2023-06-01,45986,3,0,3,2,0,2
2023-06-01,18303,2,0,2,3,0,3
2023-06-01,17840,1,0,1,2,0,2
2023-06-01,131827,1,0,1,1,0,1
2023-06-01,17611,3,0,3,2,0,2
2023-06-01,45406,1,0,1,2,0,2
2023-06-01,9487,1,0,1,1,0,1
2023-06-01,45362,1,0,1,1,0,1
2023-06-01,9777,9,0,9,2,0,2
2023-06-01,10042,8,0,8,2,0,2
2023-06-01,17856,8,0,8,1,0,1
2023-06-01,45999,1,0,1,1,0,1
2023-06-01,9763,5,0,5,3,0,3
2023-06-01,7626,1,0,1,2,0,2
2023-06-01,10161,1,0,1,3,0,3
2023-06-01,131839,1,0,1,2,0,2
2023-06-01,17867,1,0,1,1,0,1
2023-06-01,55596,1,0,1,2,0,2
2023-06-01,23590,1,0,1,2,0,2
2023-06-01,203477,1,0,1,3,0,3
2023-06-01,57241,1,0,1,2,0,2
2023-06-01,61130,0,0,0,2,0,2
2023-06-01,59888,4,0,4,1,0,1
2023-06-01,12288,1,0,1,1,0,1
2023-06-01,48271,8,0,8,1,0,1
2023-06-01,197228,1,0,1,3,0,3
2023-06-01,8719,1,0,1,1,0,1
2023-06-01,202634,1,2,3,1,1,1
2023-06-01,202690,1,0,1,3,0,3
2023-06-01,207533,1,0,1,2,0,2
2023-06-01,205116,1,0,1,1,0,1
2023-06-01,207551,1,1,2,3,5,5
2023-06-01,59470,1,0,1,1,0,1
2023-06-01,210789,1,0,1,1,0,1
2023-06-01,50376,1,0,1,1,0,1
2023-06-01,207546,1,0,1,1,0,1
2023-06-01,12321,3,0,3,1,0,1
2023-06-01,8884,5,1,6,4,1,4
2023-06-01,202712,2,0,2,1,0,1
2023-06-01,203941,1,0,1,1,0,1
2023-06-01,42671,1,0,1,1,0,1
2023-06-01,42008,5,1,6,3,1,3
2023-06-01,9030,1,0,1,4,0,4
2023-06-01,8787,1,1,2,1,1,1
2023-06-01,8942,2,0,2,1,0,1
2023-06-01,12813,6,1,7,2,2,2
2023-06-01,8675,3,0,3,1,0,1
2023-06-01,8846,1,0,1,2,0,2
2023-06-01,198372,1,0,1,2,0,2
2023-06-01,20846,3,0,3,5,0,5
2023-06-01,15804,30,0,30,1,0,1
2023-06-01,12305,1,0,1,3,0,3
2023-06-01,8830,2,0,2,1,0,1
2023-06-01,211025,9,0,9,1,0,1
2023-06-01,199855,1,0,1,2,0,2
2023-06-01,49563,1,0,1,2,0,2
2023-06-01,61118,1,0,1,1,0,1
2023-06-01,209273,1,0,1,2,0,2
2023-06-01,212215,1,0,1,1,0,1
2023-06-01,60314,1,0,1,2,0,2
2023-06-01,64399,2,0,2,1,0,1
2023-06-01,44966,1,0,1,1,0,1
2023-06-01,12659,1,1,2,1,1,1
2023-06-01,56842,1,0,1,1,0,1
2023-06-01,201304,1,1,2,1,1,1
2023-06-01,201303,1,1,2,1,1,1
2023-06-01,200856,1,2,3,1,1,1
2023-06-01,65252,1,0,1,1,0,1
2023-06-01,12362,1,0,1,4,0,4
2023-06-01,8913,1,1,2,4,3,4
2023-06-01,205434,10,0,10,2,0,2
2023-06-01,15463,4,0,4,1,0,1
2023-06-01,56856,1,0,1,1,0,1
2023-06-01,48528,1,0,1,1,0,1
2023-06-01,209655,1,0,1,1,0,1
2023-06-01,206803,2,0,2,1,0,1
2023-06-01,211708,1,0,1,1,0,1
2023-06-01,211712,1,0,1,1,0,1
2023-06-01,200733,1,0,1,1,0,1
2023-06-01,212169,1,0,1,1,0,1
2023-06-01,49029,1,0,1,1,0,1
2023-06-01,210474,1,0,1,1,0,1
2023-06-01,210509,1,0,1,2,0,2
2023-06-01,212688,1,5,6,1,1,1
2023-06-01,213357,1,0,1,2,0,2
2023-06-01,29519,1,0,1,2,0,2
2023-06-01,15654,2,0,2,6,0,6
2023-06-01,12292,1,0,1,2,0,2
2023-06-01,13010,1,0,1,2,0,2
2023-06-01,12468,2,0,2,1,0,1
2023-06-01,8721,1,0,1,1,0,1
2023-06-01,50233,1,0,1,2,0,2
2023-06-01,207321,1,0,1,2,0,2
2023-06-01,203723,1,0,1,2,0,2
2023-06-01,203578,1,0,1,2,0,2
2023-06-01,24639,1,2,3,1,1,1
2023-06-01,212632,2,0,2,2,0,2
2023-06-01,13042,1,1,2,3,1,3
2023-06-01,12294,1,1,2,4,1,5
2023-06-01,24682,1,0,1,3,0,3
2023-06-01,8904,5,0,5,3,0,3
2023-06-01,209084,2,0,2,3,0,3
2023-06-01,8801,1,0,1,1,0,1
2023-06-01,12579,1,1,2,3,1,3
2023-06-01,12650,1,0,1,4,0,4
2023-06-01,47125,1,0,1,2,0,2
2023-06-01,50267,1,0,1,1,0,1
2023-06-01,205883,1,0,1,1,0,1
2023-06-01,210363,1,0,1,1,0,1
2023-06-01,50414,1,3,4,8,7,11
2023-06-01,208077,1,0,1,1,0,1
2023-06-01,12345,1,0,1,1,0,1
2023-06-01,208058,1,0,1,1,0,1
2023-06-01,200624,1,0,1,1,0,1
2023-06-01,199329,1,0,1,4,0,4
2023-06-01,48064,1,0,1,2,0,2
2023-06-01,51082,1,3,4,1,2,3
2023-06-01,62207,1,0,1,1,0,1
2023-06-01,210492,1,0,1,5,0,5
2023-06-01,210524,1,0,1,1,0,1
2023-06-01,8536,2,0,2,1,0,1
2023-06-01,12335,3,1,4,4,4,4
2023-06-01,203878,1,0,1,1,0,1
2023-06-01,57546,2,0,2,1,0,1
2023-06-01,12690,7,0,7,3,0,3
2023-06-01,210766,1,0,1,1,0,1
2023-06-01,50517,6,0,6,2,0,2
2023-06-01,47581,1,0,1,1,0,1
2023-06-01,60121,1,0,1,3,0,3
2023-06-01,12599,14,0,14,2,0,2
2023-06-01,47194,1,0,1,3,0,3
2023-06-01,199480,1,0,1,1,0,1
2023-06-01,12548,1,0,1,1,0,1
2023-06-01,15787,1,0,1,1,0,1
2023-06-01,16174,3,1,4,3,1,3
2023-06-01,208284,2,0,2,1,0,1
2023-06-01,210591,1,0,1,1,0,1
2023-06-01,41726,1,0,1,2,0,2
2023-06-01,206362,1,1,2,3,1,3
2023-06-01,8396,1,0,1,1,0,1
2023-06-01,16141,7,0,7,1,0,1
2023-06-01,24731,1,0,1,1,0,1
2023-06-01,12657,3,4,7,3,2,3
2023-06-01,12756,1,0,1,1,0,1
2023-06-01,200995,1,1,2,2,3,3
2023-06-01,203153,1,0,1,1,0,1
2023-06-01,209333,1,0,1,3,0,3
2023-06-01,12569,1,0,1,1,0,1
2023-06-01,12827,12,0,12,6,0,6
2023-06-01,8855,14,0,14,6,0,6
2023-06-01,16057,4,0,4,1,0,1
2023-06-01,16339,26,0,26,1,0,1
2023-06-01,25136,1,0,1,2,0,2
2023-06-01,202538,2,0,2,1,0,1
2023-06-01,21198,1,0,1,1,0,1
2023-06-01,201871,1,0,1,1,0,1
2023-06-01,51280,3,0,3,3,0,3
2023-06-01,12750,1,1,2,1,2,2
2023-06-01,9075,1,0,1,2,0,2
2023-06-01,209971,1,0,1,1,0,1
2023-06-01,24727,1,0,1,1,0,1
2023-06-01,209965,1,0,1,1,0,1
2023-06-01,209948,4,0,4,1,0,1
2023-06-01,23880,1,1,2,1,1,1
2023-06-01,9089,2,0,2,3,0,3
2023-06-01,25210,1,0,1,4,0,4
2023-06-01,9039,1,0,1,3,0,3
2023-06-01,34853,2,0,2,3,0,3
2023-06-01,29340,1,0,1,1,0,1
2023-06-01,212843,1,0,1,1,0,1
2023-06-01,15518,5,1,6,2,1,2
2023-06-01,204370,1,0,1,2,0,2
2023-06-01,12512,2,1,3,3,3,4
2023-06-01,15373,5,1,6,2,2,2
2023-06-01,204275,1,0,1,2,0,2
2023-06-01,206241,1,0,1,3,0,3
2023-06-01,12404,1,0,1,1,0,1
2023-06-01,203756,1,1,2,1,1,1
2023-06-01,25154,2,0,2,8,0,8
2023-06-01,12515,1,0,1,1,0,1
2023-06-01,41610,1,0,1,2,0,2
2023-06-01,12790,1,0,1,1,0,1
2023-06-01,44412,1,0,1,1,0,1
2023-06-01,28859,2,1,3,2,1,3
2023-06-01,213126,1,1,2,1,1,1
2023-06-01,25301,9,0,9,1,0,1
2023-06-01,12409,1,1,2,2,2,2
2023-06-01,29674,11,0,11,1,0,1
2023-06-01,8950,7,0,7,1,0,1
2023-06-01,24766,6,0,6,4,0,4
2023-06-01,15819,1,0,1,2,0,2
2023-06-01,9011,9,0,9,2,0,2
2023-06-01,207635,1,0,1,1,0,1
2023-06-01,12437,1,1,2,2,2,3
2023-06-01,6691,8,0,8,3,0,3
2023-06-01,207750,1,0,1,1,0,1
2023-06-01,207749,1,0,1,2,0,2
2023-06-01,9081,3,0,3,2,0,2
2023-06-01,209891,1,1,2,1,1,1
2023-06-01,38964,4,0,4,1,0,1
2023-06-01,9076,4,0,4,1,0,1
2023-06-01,47507,1,0,1,2,0,2
2023-06-01,209953,1,0,1,1,0,1
2023-06-01,43794,9,0,9,4,0,4
2023-06-01,20855,5,0,5,1,0,1
2023-06-01,51456,1,0,1,3,0,3
2023-06-01,12822,2,1,3,3,4,5
2023-06-01,12840,10,0,10,1,0,1
2023-06-01,9103,1,1,2,1,1,1
2023-06-01,6850,6,0,6,1,0,1
2023-06-01,2600,1,0,1,2,0,2
2023-06-01,9172,9,0,9,2,0,2
2023-06-01,212730,1,0,1,3,0,3
2023-06-01,203930,1,0,1,2,0,2
2023-06-01,212431,1,0,1,2,0,2
2023-06-01,20693,1,0,1,1,0,1
2023-06-01,212343,1,0,1,2,0,2
2023-06-01,205656,1,0,1,1,0,1
2023-06-01,204879,1,0,1,1,0,1
2023-06-01,399618,1,0,1,1,0,1
2023-06-01,206248,4,0,4,1,0,1
2023-06-01,200935,1,0,1,1,0,1
2023-06-01,210223,1,1,2,1,1,2
2023-06-01,209950,1,0,1,2,0,2
2023-06-01,12309,1,0,1,1,0,1
2023-06-01,209951,1,0,1,1,0,1
2023-06-01,207352,1,0,1,3,0,3
2023-06-01,35573,1,0,1,1,0,1
2023-06-01,13250,2,1,3,7,4,7
2023-06-01,209915,1,2,3,3,4,4
2023-06-01,209947,1,1,2,1,1,1
2023-06-01,8982,21,1,22,2,1,2
2023-06-01,12536,1,0,1,2,0,2
2023-06-01,12539,8,0,8,1,0,1
2023-06-01,16344,12,0,12,5,0,5
2023-06-01,25554,2,0,2,1,0,1
2023-06-01,49950,1,0,1,3,0,3
2023-06-01,12915,1,1,2,3,3,3
2023-06-01,5419,15,0,15,3,0,3
2023-06-01,15432,1,0,1,2,0,2
2023-06-01,25244,3,0,3,2,0,2
2023-06-01,12729,2,0,2,2,0,2
2023-06-01,8869,2,0,2,1,0,1
2023-06-01,31674,1,0,1,1,0,1
2023-06-01,35700,1,0,1,1,0,1
2023-06-01,15656,6,0,6,1,0,1
2023-06-01,64622,1,0,1,2,0,2
2023-06-01,64625,0,0,0,3,0,3
2023-06-01,64605,1,0,1,1,0,1
2023-06-01,65509,0,0,0,2,0,2
2023-06-01,65511,1,0,1,1,0,1
2023-06-01,64669,1,0,1,1,0,1
2023-06-01,16254,1,0,1,2,0,2
2023-06-01,31635,1,0,1,1,0,1
2023-06-01,8234,2,0,2,3,0,3
2023-06-01,209931,2,0,2,2,0,2
2023-06-01,41994,1,0,1,3,0,3
2023-06-01,44989,1,0,1,3,0,3
2023-06-01,213304,2,0,2,5,0,5
2023-06-01,35671,1,0,1,1,0,1
2023-06-01,205302,1,0,1,3,0,3
2023-06-01,15910,1,0,1,2,0,2
2023-06-01,39879,1,1,2,3,3,3
2023-06-01,39885,1,0,1,2,0,2
2023-06-01,205902,1,0,1,1,0,1
2023-06-01,205003,1,0,1,3,0,3
2023-06-01,207637,1,0,1,2,0,2
2023-06-01,8411,1,0,1,4,0,4
2023-06-01,200214,1,0,1,2,0,2
2023-06-01,198542,1,0,1,1,0,1
2023-06-01,8684,3,1,4,4,3,4
2023-06-01,206710,1,0,1,2,0,2
2023-06-01,62404,1,0,1,3,0,3
2023-06-01,60628,1,0,1,2,0,2
2023-06-01,61259,1,0,1,4,0,4
2023-06-01,61265,1,0,1,2,0,2
2023-06-01,61261,1,0,1,2,0,2
2023-06-01,199798,1,0,1,4,0,4
2023-06-01,200627,1,0,1,3,0,3
2023-06-01,34528,1,0,1,1,0,1
2023-06-01,9077,1,0,1,1,0,1
2023-06-01,204878,2,0,2,1,0,1
2023-06-01,31344,1,0,1,1,0,1
2023-06-01,62389,1,0,1,1,0,1
2023-06-01,60600,1,0,1,1,0,1
2023-06-01,60519,1,0,1,1,0,1
2023-06-01,60329,1,0,1,3,0,3
2023-06-01,62264,1,0,1,1,0,1
2023-06-01,60361,1,0,1,1,0,1
2023-06-01,60308,3,0,3,3,0,3
2023-06-01,29531,3,0,3,2,0,2
2023-06-01,210973,2,0,2,3,0,3
2023-06-01,200815,2,0,2,1,0,1
2023-06-01,204783,1,0,1,2,0,2
2023-06-01,60190,1,0,1,1,0,1
2023-06-01,47538,1,0,1,2,0,2
2023-06-01,199225,1,0,1,3,0,3
2023-06-01,204483,1,0,1,2,0,2
2023-06-01,209880,1,0,1,1,0,1
2023-06-01,208980,1,0,1,2,0,2
2023-06-01,60420,1,0,1,2,0,2
2023-06-01,209848,3,0,3,3,0,3
2023-06-01,5458,1,0,1,1,0,1
2023-06-01,199333,1,0,1,2,0,2
2023-06-01,31085,1,0,1,1,0,1
2023-06-01,31307,1,0,1,2,0,2
2023-06-01,33960,1,0,1,1,0,1
2023-06-01,31541,4,0,4,1,0,1
2023-06-01,212230,1,0,1,2,0,2
2023-06-01,6794,1,0,1,1,0,1
2023-06-01,47407,1,0,1,2,0,2
2023-06-01,211404,1,0,1,1,0,1
2023-06-01,50141,1,0,1,1,0,1
2023-06-01,210697,1,0,1,2,0,2
2023-06-01,60928,1,0,1,3,0,3
2023-06-01,199503,1,0,1,3,0,3
2023-06-01,196858,2,1,3,4,2,4
2023-06-01,42141,1,0,1,1,0,1
2023-06-01,42193,2,0,2,1,0,1
2023-06-01,203611,1,0,1,2,0,2
2023-06-01,203445,1,0,1,1,0,1
2023-06-01,213116,1,0,1,1,0,1
2023-06-01,208082,1,0,1,2,0,2
2023-06-01,205903,1,0,1,3,0,3
2023-06-01,200724,1,0,1,1,0,1
2023-06-01,211984,1,0,1,1,0,1
2023-06-01,201759,1,0,1,3,0,3
2023-06-01,41921,1,0,1,1,0,1
2023-06-01,1890,1,0,1,1,0,1
2023-06-01,204169,1,1,2,2,1,2
2023-06-01,202934,1,0,1,1,0,1
2023-06-01,34076,2,0,2,1,0,1
2023-06-01,44551,1,0,1,1,0,1
2023-06-01,15633,3,0,3,2,0,2
2023-06-01,60659,1,0,1,2,0,2
2023-06-01,30854,6,0,6,1,0,1
2023-06-01,199858,1,0,1,2,0,2
2023-06-01,204723,1,1,2,1,1,1
2023-06-01,29209,1,0,1,2,0,2
2023-06-01,38996,2,0,2,1,0,1
2023-06-01,35473,1,0,1,1,0,1
2023-06-01,42115,5,0,5,1,0,1
2023-06-01,61066,1,0,1,2,0,2
2023-06-01,199512,1,0,1,4,0,4
2023-06-01,25407,1,0,1,2,0,2
2023-06-01,199301,1,0,1,1,0,1
2023-06-01,31527,1,0,1,3,0,3
2023-06-01,41256,11,0,11,1,0,1
2023-06-01,206252,2,0,2,1,0,1
2023-06-01,49300,1,0,1,4,0,4
2023-06-01,203688,1,1,2,3,2,3
2023-06-01,200316,2,0,2,2,0,2
2023-06-01,20581,4,0,4,1,0,1
2023-06-01,208943,1,0,1,1,0,1
2023-06-01,208629,1,0,1,3,0,3
2023-06-01,49757,6,0,6,2,0,2
2023-06-01,49736,1,0,1,1,0,1
2023-06-01,57161,1,0,1,1,0,1
2023-06-01,49834,3,0,3,1,0,1
2023-06-01,49649,1,0,1,1,0,1
2023-06-01,206396,1,0,1,1,0,1
2023-06-01,42444,1,0,1,2,0,2
2023-06-01,42834,1,0,1,2,0,2
2023-06-01,43795,1,0,1,1,0,1
2023-06-01,44903,1,0,1,2,0,2
2023-06-01,201184,1,0,1,2,0,2
2023-06-01,49782,1,0,1,1,0,1
2023-06-01,210224,1,0,1,3,0,3
2023-06-01,210685,1,1,2,1,1,1
2023-06-01,196829,11,0,11,1,0,1
2023-06-01,39575,1,0,1,2,0,2
2023-06-01,21478,1,0,1,11,0,11
2023-06-01,12925,3,0,3,1,0,1
2023-06-01,204961,1,0,1,1,0,1
2023-06-01,20618,1,1,2,3,2,3
2023-06-01,51423,3,0,3,1,0,1
2023-06-01,31219,1,0,1,1,0,1
2023-06-01,15665,5,0,5,1,0,1
2023-06-01,15396,1,0,1,2,0,2
2023-06-01,20555,2,1,3,4,2,4
2023-06-01,212260,1,0,1,2,0,2
2023-06-01,198976,1,0,1,3,0,3
2023-06-01,210600,1,0,1,1,0,1
2023-06-01,198602,1,0,1,1,0,1
2023-06-01,197994,1,0,1,1,0,1
2023-06-01,48863,2,0,2,2,0,2
2023-06-01,40997,1,0,1,3,0,3
2023-06-01,208405,2,0,2,1,0,1
2023-06-01,209599,3,0,3,4,0,4
2023-06-01,199382,3,0,3,2,0,2
2023-06-01,199305,1,0,1,1,0,1
2023-06-01,203780,1,0,1,1,0,1
2023-06-01,207062,1,0,1,1,0,1
2023-06-01,20578,4,0,4,1,0,1
2023-06-01,205094,1,1,2,3,3,4
2023-06-01,44993,2,1,3,2,2,2
2023-06-01,13233,1,0,1,1,0,1
2023-06-01,20864,1,0,1,1,0,1
2023-06-01,15937,3,0,3,2,0,2
2023-06-01,43116,1,0,1,1,0,1
2023-06-01,15934,3,0,3,2,0,2
2023-06-01,13115,3,1,4,2,1,2
2023-06-01,42625,1,0,1,3,0,3
2023-06-01,25575,1,1,2,4,3,5
2023-06-01,16267,1,1,2,2,2,2
2023-06-01,209765,2,0,2,1,0,1
2023-06-01,13224,1,0,1,1,0,1
2023-06-01,38937,1,1,2,3,1,3
2023-06-01,48988,2,0,2,1,0,1
2023-06-01,13138,15,0,15,4,0,4
2023-06-01,44787,2,0,2,1,0,1
2023-06-01,13095,1,0,1,1,0,1
2023-06-01,327862,3,0,3,1,0,1
2023-06-01,42587,2,0,2,1,0,1
2023-06-01,199027,1,0,1,1,0,1
2023-06-01,13182,6,1,7,6,1,6
2023-06-01,199515,1,0,1,1,0,1
2023-06-01,20663,26,0,26,1,0,1
2023-06-01,13053,6,0,6,6,0,6
2023-06-01,62066,1,0,1,3,0,3
2023-06-01,197388,4,0,4,2,0,2
2023-06-01,197373,1,0,1,3,0,3
2023-06-01,206949,1,0,1,1,0,1
2023-06-01,12979,3,0,3,3,0,3
2023-06-01,9092,2,1,3,4,3,5
2023-06-01,20510,1,0,1,2,0,2
2023-06-01,31496,2,0,2,1,0,1
2023-06-01,13078,1,0,1,1,0,1
2023-06-01,44845,4,0,4,3,0,3
2023-06-01,12574,6,1,7,1,1,1
2023-06-01,28781,1,0,1,3,0,3
2023-06-01,208676,1,0,1,3,0,3
2023-06-01,16091,1,1,2,1,1,1
2023-06-01,15667,31,0,31,4,0,4
2023-06-01,28909,32,0,32,3,0,3
2023-06-01,20805,2,0,2,3,0,3
2023-06-01,13079,1,0,1,1,0,1
2023-06-01,206511,1,0,1,1,0,1
2023-06-01,205526,1,0,1,1,0,1
2023-06-01,200422,1,0,1,1,0,1
2023-06-01,16203,2,0,2,1,0,1
2023-06-01,212788,1,0,1,1,0,1
2023-06-01,399786,1,0,1,2,0,2
2023-06-01,211058,1,0,1,1,0,1
2023-06-01,207312,1,0,1,1,0,1
2023-06-01,209942,4,0,4,1,0,1
2023-06-01,47594,15,0,15,1,0,1
2023-06-01,203966,1,0,1,1,0,1
2023-06-01,28675,1,0,1,1,0,1
2023-06-01,24913,2,0,2,2,0,2
2023-06-01,13292,1,0,1,1,0,1
2023-06-01,15613,2,1,3,1,1,1
2023-06-01,56797,1,0,1,3,0,3
2023-06-01,42014,1,0,1,2,0,2
2023-06-01,211527,1,0,1,1,0,1
2023-06-01,51610,1,0,1,1,0,1
2023-06-01,42663,1,0,1,2,0,2
2023-06-01,211838,1,0,1,1,0,1
2023-06-01,12443,1,0,1,1,0,1
2023-06-01,28780,2,0,2,2,0,2
2023-06-01,13226,5,1,6,3,3,3
2023-06-01,21175,2,0,2,2,0,2
2023-06-01,12898,1,1,2,1,1,1
2023-06-01,209056,1,1,2,2,1,2
2023-06-01,13251,7,0,7,2,0,2
2023-06-01,16214,1,0,1,1,0,1
2023-06-01,15829,1,0,1,1,0,1
2023-06-01,42371,1,1,2,1,1,1
2023-06-01,204026,2,0,2,1,0,1
2023-06-01,8524,18,0,18,4,0,4
2023-06-01,60623,2,0,2,3,0,3
2023-06-01,31314,1,0,1,1,0,1
2023-06-01,59407,1,0,1,1,0,1
2023-06-01,209865,1,0,1,1,0,1
2023-06-01,59795,2,1,3,1,1,1
2023-06-01,9032,3,1,4,4,2,4
2023-06-01,60744,3,0,3,3,0,3
2023-06-01,60769,2,0,2,1,0,1
2023-06-01,16162,1,0,1,1,0,1
2023-06-01,201592,1,0,1,1,0,1
2023-06-01,204021,1,0,1,3,0,3
2023-06-01,28881,1,0,1,1,0,1
2023-06-01,209923,5,0,5,2,0,2
2023-06-01,396091,1,0,1,1,0,1
2023-06-01,394508,1,0,1,1,0,1
2023-06-01,208225,1,0,1,1,0,1
2023-06-01,205686,1,0,1,1,0,1
2023-06-01,28900,1,0,1,1,0,1
2023-06-01,50828,1,0,1,2,0,2
2023-06-01,212887,1,0,1,1,0,1
2023-06-01,208027,1,0,1,2,0,2
2023-06-01,49538,1,0,1,2,0,2
2023-06-01,202097,1,0,1,3,0,3
2023-06-01,43159,1,0,1,1,0,1
2023-06-01,15915,2,0,2,2,0,2
2023-06-01,201044,1,0,1,2,0,2
2023-06-01,25045,1,0,1,3,0,3
2023-06-01,212293,1,0,1,1,0,1
2023-06-01,34463,1,0,1,3,0,3
2023-06-01,9163,11,0,11,1,0,1
2023-06-01,209575,1,0,1,1,0,1
2023-06-01,15759,5,0,5,1,0,1
2023-06-01,12610,1,0,1,2,0,2
2023-06-01,12463,1,0,1,1,0,1
2023-06-01,16142,1,0,1,3,0,3
2023-06-01,210967,1,1,2,2,2,2
2023-06-01,21451,26,0,26,3,0,3
2023-06-01,40968,1,0,1,1,0,1
2023-06-01,29438,2,0,2,5,0,5
2023-06-01,272692,1,1,2,3,3,3
2023-06-01,51313,1,0,1,2,0,2
2023-06-01,39360,1,1,2,1,2,2
2023-06-01,209761,3,0,3,2,0,2
2023-06-01,209776,2,0,2,2,0,2
2023-06-01,205824,1,0,1,1,0,1
2023-06-01,62146,1,0,1,3,0,3
2023-06-01,44790,1,0,1,2,0,2
2023-06-01,8382,1,0,1,1,0,1
2023-06-01,210262,1,0,1,3,0,3
2023-06-01,209744,2,0,2,3,0,3
2023-06-01,209770,1,0,1,1,0,1
2023-06-01,8247,8,0,8,3,0,3
2023-06-01,61193,1,1,2,3,2,3
2023-06-01,212409,1,0,1,3,0,3
2023-06-01,203250,1,0,1,1,0,1
2023-06-01,210983,1,1,2,1,1,1
2023-06-01,212190,1,0,1,2,0,2
2023-06-01,212436,1,0,1,3,0,3
2023-06-01,15464,6,1,7,3,2,3
2023-06-01,48779,1,0,1,1,0,1
2023-06-01,209956,4,0,4,1,0,1
2023-06-01,212069,1,0,1,1,0,1
2023-06-01,48542,1,0,1,1,0,1
2023-06-01,213261,1,0,1,1,0,1
2023-06-01,207766,1,0,1,1,0,1
2023-06-01,47793,1,0,1,3,0,3
2023-06-01,199120,1,0,1,4,0,4
2023-06-01,203407,1,0,1,2,0,2
2023-06-01,204933,1,0,1,2,0,2
2023-06-01,15982,2,0,2,1,0,1
2023-06-01,8683,6,2,8,8,4,9
2023-06-01,42585,2,1,3,1,1,1
2023-06-01,29420,6,0,6,1,0,1
2023-06-01,12907,1,1,2,3,1,3
2023-06-01,50256,2,0,2,3,0,3
2023-06-01,211614,1,0,1,1,0,1
2023-06-01,21209,1,0,1,2,0,2
2023-06-01,211060,1,1,2,2,2,2
2023-06-01,5842,8,0,8,1,0,1
2023-06-01,6002,3,0,3,1,0,1
2023-06-01,27079,4,0,4,1,0,1
2023-06-01,3474,1,0,1,1,0,1
2023-06-01,5376,1,1,2,1,1,1
2023-06-01,1908,1,0,1,1,0,1
2023-06-01,149,12,0,12,2,0,2
2023-06-01,5329,2,0,2,1,0,1
2023-06-01,1636,2,0,2,2,0,2
2023-06-01,27153,0,0,0,5,0,5
2023-06-01,27154,1,0,1,1,0,1
2023-06-01,571,65,0,65,1,0,1
2023-06-01,1208,3,0,3,1,0,1
2023-06-01,1913,2,0,2,1,0,1
2023-06-01,27149,2,0,2,1,0,1
2023-06-01,5052,2,0,2,1,0,1
2023-06-01,121,6,0,6,2,0,2
2023-06-01,634,6,0,6,1,0,1
2023-06-01,636,10,0,10,1,0,1
2023-06-01,170,1,0,1,2,0,2
2023-06-01,147,1,0,1,1,0,1
2023-06-01,18583,1,0,1,3,0,3
2023-06-01,394939,1,0,1,2,0,2
2023-06-01,30381,1,0,1,1,0,1
2023-06-01,394586,1,0,1,1,0,1
2023-06-01,11741,19,0,19,3,0,3
2023-06-01,32707,3,0,3,2,0,2
2023-06-01,26231,11,0,11,2,0,2
2023-06-01,18600,3,0,3,1,0,1
2023-06-01,399853,3,0,3,4,0,4
2023-06-01,13793,1,0,1,1,0,1
2023-06-01,18817,1,0,1,1,0,1
2023-06-01,22760,1,0,1,1,0,1
2023-06-01,46725,3,0,3,1,0,1
2023-06-01,5784,1,0,1,2,0,2
2023-06-01,26787,1,2,3,1,2,3
2023-06-01,5721,2,0,2,1,0,1
2023-06-01,16423,1,1,2,2,1,2
2023-06-01,30189,3,0,3,2,0,2
2023-06-01,397947,1,0,1,1,0,1
2023-06-01,397975,1,0,1,1,0,1
2023-06-01,26495,1,0,1,1,0,1
2023-06-01,26331,1,1,2,1,1,1
2023-06-01,18437,1,0,1,1,0,1
2023-06-01,397261,1,0,1,1,0,1
2023-06-01,398146,1,0,1,1,0,1
2023-06-01,397273,1,0,1,1,0,1
2023-06-01,33402,1,0,1,2,0,2
2023-06-01,397771,1,0,1,2,0,2
2023-06-01,30200,20,0,20,3,0,3
2023-06-01,46531,2,0,2,2,0,2
2023-06-01,40080,1,1,2,1,1,1
2023-06-01,32674,2,1,3,4,1,4
2023-06-01,20469,1,0,1,3,0,3
2023-06-01,14594,1,0,1,1,0,1
2023-06-01,394824,1,0,1,1,0,1
2023-06-01,394420,1,0,1,2,0,2
2023-06-01,394463,1,0,1,3,0,3
2023-06-01,10899,3,0,3,2,0,2
2023-06-01,30687,6,0,6,1,0,1
2023-06-01,27543,6,0,6,6,0,6
2023-06-01,15865,3,0,3,1,0,1
2023-06-01,990,1,0,1,2,0,2
2023-06-01,397751,4,0,4,4,0,4
2023-06-01,395775,1,0,1,2,0,2
2023-06-01,141001,2,0,2,1,0,1
2023-06-01,26867,7,0,7,3,0,3
2023-06-01,54552,1,0,1,1,0,1
2023-06-01,399858,4,0,4,1,0,1
2023-06-01,18523,6,0,6,4,0,4
2023-06-01,14643,2,0,2,3,0,3
2023-06-01,396946,1,0,1,1,0,1
2023-06-01,18999,1,0,1,1,0,1
2023-06-01,29936,1,0,1,3,0,3
2023-06-01,13597,3,0,3,2,0,2
2023-06-01,8180,4,0,4,1,0,1
2023-06-01,46214,1,0,1,3,0,3
2023-06-01,19945,1,1,2,3,1,4
2023-06-01,33136,1,0,1,1,0,1
2023-06-01,395810,1,0,1,1,0,1
2023-06-01,7265,21,0,21,1,0,1
2023-06-01,400213,2,0,2,2,0,2
2023-06-01,393273,1,0,1,3,0,3
2023-06-01,14505,1,0,1,3,0,3
2023-06-01,11889,8,1,9,2,2,2
2023-06-01,19980,2,0,2,2,0,2
2023-06-01,395285,1,0,1,1,0,1
2023-06-01,55018,1,0,1,2,0,2
2023-06-01,12254,1,0,1,1,0,1
2023-06-01,394439,1,0,1,2,0,2
2023-06-01,25604,2,0,2,2,0,2
2023-06-01,395934,1,0,1,1,0,1
2023-06-01,19396,1,0,1,1,0,1
2023-06-01,397055,1,0,1,3,0,3
2023-06-01,21746,1,0,1,1,0,1
2023-06-01,32383,1,0,1,1,0,1
2023-06-01,36456,1,0,1,2,0,2
2023-06-01,18521,1,0,1,2,0,2
2023-06-01,395004,1,0,1,1,0,1
2023-06-01,40849,1,0,1,1,0,1
2023-06-01,36396,1,0,1,2,0,2
2023-06-01,395203,1,0,1,1,0,1
2023-06-01,11350,1,0,1,2,0,2
2023-06-01,26082,4,0,4,1,0,1
2023-06-01,32466,1,0,1,1,0,1
2023-06-01,46326,1,0,1,3,0,3
2023-06-01,21706,1,0,1,1,0,1
2023-06-01,18975,1,0,1,1,0,1
2023-06-01,27572,18,0,18,2,0,2
2023-06-01,30533,10,0,10,1,0,1
2023-06-01,398922,1,1,2,2,1,2
2023-06-01,19263,1,0,1,1,0,1
2023-06-01,27203,2,0,2,2,0,2
2023-06-01,1067,1,0,1,2,0,2
2023-06-01,393231,1,0,1,1,0,1
2023-06-01,400436,2,0,2,1,0,1
2023-06-01,17242,12,0,12,1,0,1
2023-06-01,53554,2,0,2,1,0,1
2023-06-01,397652,1,0,1,3,0,3
2023-06-01,14044,0,0,0,3,0,3
2023-06-01,397277,2,2,4,1,1,1
2023-06-01,399680,2,0,2,3,0,3
2023-06-01,54125,2,0,2,3,0,3
2023-06-01,400071,1,1,2,1,1,1
2023-06-01,16813,1,1,2,3,2,4
2023-06-01,394787,1,0,1,2,0,2
2023-06-01,26363,2,0,2,3,0,3
2023-06-01,53317,1,0,1,3,0,3
2023-06-01,33104,1,0,1,1,0,1
2023-06-01,16867,3,0,3,1,0,1
2023-06-01,32482,2,1,3,1,1,1
2023-06-01,30346,4,0,4,4,0,4
2023-06-01,16463,3,0,3,2,0,2
2023-06-01,393538,1,0,1,2,0,2
2023-06-01,53895,1,0,1,1,0,1
2023-06-01,393478,1,0,1,1,0,1
2023-06-01,63163,1,0,1,1,0,1
2023-06-01,19924,1,0,1,1,0,1
2023-06-01,400398,1,0,1,2,0,2
2023-06-01,30597,1,0,1,2,0,2
2023-06-01,395824,2,0,2,3,0,3
2023-06-01,13877,5,0,5,3,0,3
2023-06-01,19650,1,0,1,1,0,1
2023-06-01,46215,3,0,3,1,0,1
2023-06-01,399004,1,0,1,1,0,1
2023-06-01,30428,1,0,1,1,0,1
2023-06-01,395504,1,0,1,3,0,3
2023-06-01,395790,1,0,1,1,0,1
2023-06-01,14039,1,0,1,1,0,1
2023-06-01,266226,5,1,6,1,1,1
2023-06-01,266193,5,0,5,3,0,3
2023-06-01,400234,2,0,2,3,0,3
2023-06-01,400100,2,0,2,1,0,1
2023-06-01,395482,1,0,1,1,0,1
2023-06-01,22297,1,1,2,3,1,3
2023-06-01,53557,1,0,1,1,0,1
2023-06-01,395012,3,0,3,3,0,3
2023-06-01,14421,1,0,1,3,0,3
2023-06-01,30443,1,0,1,3,0,3
2023-06-01,36074,2,0,2,1,0,1
2023-06-01,7146,1,0,1,1,0,1
2023-06-01,29039,9,0,9,1,0,1
2023-06-01,54471,1,0,1,2,0,2
2023-06-01,13557,1,0,1,2,0,2
2023-06-01,19155,2,0,2,2,0,2
2023-06-01,40908,2,0,2,1,0,1
2023-06-01,26526,1,0,1,2,0,2
2023-06-01,11688,1,0,1,3,0,3
2023-06-01,40533,5,0,5,1,0,1
2023-06-01,32395,1,0,1,1,0,1
2023-06-01,26851,5,0,5,1,0,1
2023-06-01,15136,1,0,1,1,0,1
2023-06-01,63417,1,0,1,1,0,1
2023-06-01,396975,1,0,1,1,0,1
2023-06-01,62722,2,0,2,2,0,2
2023-06-01,11102,14,0,14,1,0,1
2023-06-01,46130,1,0,1,2,0,2
2023-06-01,396113,2,1,3,3,1,4
2023-06-01,396211,1,0,1,2,0,2
2023-06-01,11936,1,0,1,2,0,2
2023-06-01,6943,1,0,1,1,0,1
2023-06-01,396285,2,0,2,3,0,3
2023-06-01,36782,12,0,12,1,0,1
2023-06-01,19135,1,0,1,2,0,2
2023-06-01,395666,1,0,1,3,0,3
2023-06-01,16775,1,0,1,1,0,1
2023-06-01,395566,4,0,4,3,0,3
2023-06-01,397611,1,0,1,2,0,2
2023-06-01,46248,2,0,2,3,0,3
2023-06-01,32165,5,0,5,3,0,3
2023-06-01,26838,10,0,10,8,0,8
2023-06-01,53986,1,0,1,1,0,1
2023-06-01,11491,5,0,5,1,0,1
2023-06-01,394666,10,3,13,5,3,5
2023-06-01,399555,1,0,1,1,0,1
2023-06-01,399066,2,0,2,1,0,1
2023-06-01,399184,2,0,2,2,0,2
2023-06-01,4310,5,0,5,3,0,3
2023-06-01,29869,1,1,2,1,1,1
2023-06-01,395433,2,0,2,1,0,1
2023-06-01,399212,1,0,1,1,0,1
2023-06-01,395667,1,0,1,1,0,1
2023-06-01,19505,1,0,1,3,0,3
2023-06-01,31825,1,0,1,2,0,2
2023-06-01,7221,1,0,1,1,0,1
2023-06-01,10973,3,8,11,4,4,5
2023-06-01,7254,4,0,4,2,0,2
2023-06-01,393710,2,1,3,2,1,3
2023-06-01,11264,4,0,4,5,0,5
2023-06-01,394424,1,0,1,3,0,3
2023-06-01,54323,9,0,9,2,0,2
2023-06-01,14165,1,0,1,1,0,1
2023-06-01,13769,1,0,1,1,0,1
2023-06-01,398120,1,0,1,3,0,3
2023-06-01,63277,1,0,1,1,0,1
2023-06-01,19859,1,0,1,1,0,1
2023-06-01,396274,1,0,1,2,0,2
2023-06-01,36264,1,0,1,1,0,1
2023-06-01,33203,1,0,1,1,0,1
2023-06-01,19326,4,0,4,1,0,1
2023-06-01,18551,2,0,2,1,0,1
2023-06-01,23030,1,0,1,3,0,3
2023-06-01,207731,1,0,1,1,0,1
2023-06-01,399673,18,1,19,3,1,3
2023-06-01,397834,5,0,5,3,0,3
2023-06-01,16846,1,0,1,1,0,1
2023-06-01,40113,7,0,7,1,0,1
2023-06-01,13959,16,0,16,2,0,2
2023-06-01,14881,2,0,2,1,0,1
2023-06-01,14425,2,0,2,1,0,1
2023-06-01,15272,1,0,1,2,0,2
2023-06-01,32318,1,0,1,2,0,2
2023-06-01,62773,1,0,1,2,0,2
2023-06-01,31869,7,0,7,4,0,4
2023-06-01,40006,1,0,1,1,0,1
2023-06-01,20344,1,1,2,3,3,3
2023-06-01,398956,1,0,1,1,0,1
2023-06-01,17073,11,0,11,9,0,9
2023-06-01,16706,16,0,16,3,0,3
2023-06-01,12073,8,0,8,2,0,2
2023-06-01,40351,1,0,1,2,0,2
2023-06-01,394573,1,0,1,3,0,3
2023-06-01,46624,1,0,1,2,0,2
2023-06-01,40693,1,0,1,3,0,3
2023-06-01,40349,1,0,1,1,0,1
2023-06-01,11072,1,0,1,2,0,2
2023-06-01,46621,1,0,1,2,0,2
2023-06-01,16478,17,4,21,3,2,3
2023-06-01,11559,10,0,10,1,0,1
2023-06-01,14068,1,0,1,2,0,2
2023-06-01,19079,11,0,11,2,0,2
2023-06-01,13482,1,0,1,3,0,3
2023-06-01,47067,1,0,1,2,0,2
2023-06-01,13912,1,0,1,2,0,2
2023-06-01,397066,2,0,2,1,0,1
2023-06-01,14305,1,0,1,1,0,1
2023-06-01,27190,1,0,1,2,0,2
2023-06-01,30268,1,0,1,3,0,3
2023-06-01,29937,1,0,1,1,0,1
2023-06-01,398307,1,0,1,2,0,2
2023-06-01,400023,1,0,1,1,0,1
2023-06-01,19848,2,0,2,1,0,1
2023-06-01,13556,1,0,1,2,0,2
2023-06-01,18858,1,0,1,1,0,1
2023-06-01,398393,1,0,1,1,0,1
2023-06-01,399292,1,0,1,1,0,1
2023-06-01,11946,1,0,1,1,0,1
2023-06-01,398017,2,1,3,4,3,4
2023-06-01,22641,3,0,3,2,0,2
2023-06-01,18886,15,0,15,1,0,1
2023-06-01,33412,1,2,3,5,2,5
2023-06-01,20155,1,0,1,1,0,1
2023-06-01,7030,13,1,14,3,1,3
2023-06-01,18638,10,1,11,3,1,3
2023-06-01,54066,1,0,1,1,0,1
2023-06-01,54278,1,0,1,1,0,1
2023-06-01,12263,1,0,1,1,0,1
2023-06-01,11632,1,0,1,2,0,2
2023-06-01,22948,4,0,4,1,0,1
2023-06-01,12285,9,0,9,2,0,2
2023-06-01,394348,1,0,1,2,0,2
2023-06-01,394658,1,0,1,1,0,1
2023-06-01,63009,11,0,11,3,0,3
2023-06-01,54599,1,0,1,1,0,1
2023-06-01,30243,1,0,1,1,0,1
2023-06-01,40055,1,0,1,1,0,1
2023-06-01,11548,2,0,2,1,0,1
2023-06-01,11579,1,0,1,2,0,2
2023-06-01,8175,1,0,1,2,0,2
2023-06-01,396883,2,0,2,3,0,3
2023-06-01,394751,1,0,1,1,0,1
2023-06-01,53638,1,0,1,1,0,1
2023-06-01,11604,1,0,1,1,0,1
2023-06-01,396361,1,0,1,3,0,3
2023-06-01,10935,1,0,1,2,0,2
2023-06-01,399496,1,0,1,3,0,3
2023-06-01,394579,1,0,1,1,0,1
2023-06-01,62784,1,0,1,3,0,3
2023-06-01,53335,1,0,1,3,0,3
2023-06-01,1058,1,0,1,1,0,1
2023-06-01,18650,1,0,1,4,0,4
2023-06-01,20176,2,0,2,1,0,1
2023-06-01,54114,1,0,1,1,0,1
2023-06-01,29759,1,0,1,3,0,3
2023-06-01,33149,3,0,3,5,0,5
2023-06-01,32504,2,1,3,2,2,2
2023-06-01,55132,2,0,2,3,0,3
2023-06-01,40365,1,0,1,2,0,2
2023-06-01,7001,1,1,2,1,1,1
2023-06-01,26666,1,0,1,1,0,1
2023-06-01,6081,1,0,1,2,0,2
2023-06-01,8059,1,1,2,2,1,2
2023-06-01,10700,3,2,5,2,2,2
2023-06-01,13412,6,0,6,3,0,3
2023-06-01,30669,1,0,1,2,0,2
2023-06-01,11359,5,0,5,1,0,1
2023-06-01,30039,3,0,3,1,0,1
2023-06-01,18436,1,0,1,1,0,1
2023-06-01,54554,2,0,2,2,0,2
2023-06-01,22077,11,0,11,3,0,3
2023-06-01,53541,2,0,2,1,0,1
2023-06-01,46301,1,0,1,3,0,3
2023-06-01,395067,2,0,2,1,0,1
2023-06-01,397497,3,0,3,6,0,6
2023-06-01,14908,1,0,1,1,0,1
2023-06-01,46879,2,0,2,1,0,1
2023-06-01,395818,1,0,1,3,0,3
2023-06-01,23022,6,0,6,1,0,1
2023-06-01,30343,16,1,17,1,1,1
2023-06-01,40709,1,0,1,1,0,1
2023-06-01,46741,1,0,1,2,0,2
2023-06-01,25721,1,0,1,2,0,2
2023-06-01,394870,1,0,1,2,0,2
2023-06-01,393614,1,0,1,1,0,1
2023-06-01,14264,2,1,3,1,1,1
2023-06-01,12266,7,3,10,3,2,3
2023-06-01,46541,1,0,1,2,0,2
2023-06-01,397129,1,0,1,1,0,1
2023-06-01,20254,1,0,1,1,0,1
2023-06-01,12242,2,0,2,3,0,3
2023-06-01,54815,1,0,1,1,0,1
2023-06-01,54361,1,0,1,2,0,2
2023-06-01,397676,3,0,3,1,0,1
2023-06-01,27461,6,0,6,3,0,3
2023-06-01,13630,4,0,4,4,0,4
2023-06-01,12051,2,0,2,1,0,1
2023-06-01,14545,2,0,2,1,0,1
2023-06-01,53624,1,0,1,1,0,1
2023-06-01,55224,1,0,1,2,0,2
2023-06-01,19082,1,0,1,1,0,1
2023-06-01,22420,1,0,1,2,0,2
2023-06-01,32260,1,0,1,2,0,2
2023-06-01,33625,1,0,1,1,0,1
2023-06-01,398050,18,0,18,2,0,2
2023-06-01,27565,2,0,2,3,0,3
2023-06-01,19802,1,0,1,1,0,1
2023-06-01,17037,5,0,5,1,0,1
2023-06-01,32336,5,1,6,1,1,1
2023-06-01,27391,11,0,11,4,0,4
2023-06-01,396289,3,0,3,3,0,3
2023-06-01,36432,4,0,4,3,0,3
2023-06-01,14514,1,0,1,1,0,1
2023-06-01,18763,2,0,2,3,0,3
2023-06-01,18766,2,0,2,1,0,1
2023-06-01,18769,1,0,1,1,0,1
2023-06-01,18767,2,0,2,3,0,3
2023-06-01,11521,6,0,6,3,0,3
2023-06-01,397633,1,0,1,1,0,1
2023-06-01,40270,9,0,9,1,0,1
2023-06-01,27612,1,0,1,1,0,1
2023-06-01,40373,1,0,1,2,0,2
2023-06-01,22694,1,0,1,1,0,1
2023-06-01,18660,1,0,1,2,0,2
2023-06-01,14760,3,0,3,3,0,3
2023-06-01,399763,1,0,1,1,0,1
2023-06-01,398406,2,0,2,5,0,5
2023-06-01,400493,2,0,2,1,0,1
2023-06-01,16588,1,0,1,3,0,3
2023-06-01,398570,2,1,3,3,2,3
2023-06-01,398279,1,0,1,2,0,2
2023-06-01,398300,4,0,4,3,0,3
2023-06-01,398696,1,0,1,2,0,2
2023-06-01,14416,1,0,1,2,0,2
2023-06-01,11657,4,0,4,2,0,2
2023-06-01,64229,1,0,1,1,0,1
2023-06-01,16360,3,0,3,2,0,2
2023-06-01,393590,1,0,1,2,0,2
2023-06-01,396130,1,0,1,3,0,3
2023-06-01,210142,1,0,1,3,0,3
2023-06-01,42105,1,0,1,3,0,3
2023-06-01,210158,3,0,3,1,0,1
2023-06-01,20745,1,0,1,3,0,3
2023-06-01,25432,2,1,3,2,2,2
2023-06-01,200669,1,0,1,1,0,1
2023-06-01,200862,1,0,1,4,0,4
2023-06-01,24997,10,0,10,1,0,1
2023-06-01,48383,1,0,1,1,0,1
2023-06-01,25389,9,0,9,1,0,1
2023-06-01,15632,10,1,11,3,2,3
2023-06-01,12559,17,0,17,2,0,2
2023-06-01,48932,11,0,11,6,0,6
2023-06-01,64520,3,0,3,1,0,1
2023-06-01,34836,1,0,1,2,0,2
2023-06-01,15629,1,0,1,1,0,1
2023-06-01,25487,1,0,1,1,0,1
2023-06-01,28712,2,0,2,2,0,2
2023-06-01,15815,1,1,2,1,1,1
2023-06-01,20976,1,0,1,1,0,1
2023-06-01,28731,1,0,1,2,0,2
2023-06-01,25582,11,1,12,2,1,2
2023-06-01,203492,1,0,1,2,0,2
2023-06-01,25545,1,0,1,1,0,1
2023-06-01,28705,1,0,1,1,0,1
2023-06-01,35515,1,0,1,2,0,2
2023-06-01,57355,1,0,1,1,0,1
2023-06-01,210901,1,0,1,1,0,1
2023-06-01,15807,2,0,2,1,0,1
2023-06-01,47832,2,1,3,1,1,1
2023-06-01,58209,1,0,1,1,0,1
2023-06-01,16210,2,0,2,1,0,1
2023-06-01,207310,4,0,4,5,0,5
2023-06-01,12804,5,0,5,4,0,4
2023-06-01,47414,1,0,1,1,0,1
2023-06-01,28703,1,0,1,1,0,1
2023-06-01,198387,5,0,5,2,0,2
2023-06-01,212619,2,0,2,2,0,2
2023-06-01,44031,2,0,2,1,0,1
2023-06-01,13171,1,0,1,1,0,1
2023-06-01,210871,1,0,1,1,0,1
2023-06-01,15721,4,0,4,5,0,5
2023-06-01,49214,1,0,1,1,0,1
2023-06-01,15711,3,0,3,2,0,2
2023-06-01,42870,5,0,5,2,0,2
2023-06-01,29036,3,0,3,2,0,2
2023-06-01,21465,1,0,1,1,0,1
2023-06-01,201992,1,0,1,1,0,1
2023-06-01,212172,1,0,1,2,0,2
2023-06-01,15770,1,0,1,1,0,1
2023-06-01,209729,1,0,1,2,0,2
2023-06-01,29079,17,0,17,3,0,3
2023-06-01,47801,1,0,1,2,0,2
2023-06-01,21234,1,0,1,1,0,1
2023-06-01,41783,5,1,6,1,1,1
2023-06-01,197312,9,0,9,3,0,3
2023-06-01,35260,1,1,2,1,1,1
2023-06-01,199275,1,0,1,9,0,9
2023-06-01,28990,4,0,4,1,0,1
2023-06-01,209353,1,0,1,1,0,1
2023-06-01,210014,2,0,2,1,0,1
2023-06-01,201149,2,0,2,4,0,4
2023-06-01,200703,1,0,1,2,0,2
2023-06-01,20893,1,0,1,2,0,2
2023-06-01,29270,1,0,1,1,0,1
2023-06-01,210045,1,1,2,1,1,1
2023-06-01,209976,1,0,1,1,0,1
2023-06-01,61141,1,0,1,1,0,1
2023-06-01,16004,2,1,3,7,4,7
2023-06-01,15788,1,0,1,1,0,1
2023-06-01,41878,15,0,15,2,0,2
2023-06-01,203931,1,0,1,1,0,1
2023-06-01,201004,7,1,8,2,2,2
2023-06-01,29145,1,0,1,2,0,2
2023-06-01,29403,4,1,5,3,1,3
2023-06-01,15892,23,0,23,3,0,3
2023-06-01,24985,1,0,1,1,0,1
2023-06-01,29341,1,0,1,1,0,1
2023-06-01,29312,17,0,17,2,0,2
2023-06-01,29086,5,1,6,5,3,5
2023-06-01,209475,2,0,2,4,0,4
2023-06-01,29189,3,0,3,2,0,2
2023-06-01,12607,7,0,7,1,0,1
2023-06-01,41265,3,0,3,1,0,1
2023-06-01,15984,5,0,5,1,0,1
2023-06-01,29263,8,1,9,7,6,9
2023-06-01,25328,3,0,3,2,0,2
2023-06-01,206808,2,0,2,1,0,1
2023-06-01,198500,1,1,2,1,1,1
2023-06-01,202555,1,0,1,1,0,1
2023-06-01,201611,1,0,1,2,0,2
2023-06-01,29591,6,0,6,1,0,1
2023-06-01,51969,1,2,3,1,1,1
2023-06-01,29481,2,0,2,3,0,3
2023-06-01,30754,1,0,1,1,0,1
2023-06-01,20692,2,1,3,2,2,3
2023-06-01,29388,2,0,2,3,0,3
2023-06-01,206627,6,0,6,2,0,2
2023-06-01,16072,3,0,3,1,0,1
2023-06-01,50090,5,0,5,1,0,1
2023-06-01,33819,17,0,17,1,0,1
2023-06-01,29488,1,1,2,3,3,3
2023-06-01,29633,1,0,1,2,0,2
2023-06-01,60990,1,0,1,1,0,1
2023-06-01,21333,1,0,1,7,0,7
2023-06-01,29598,2,0,2,1,0,1
2023-06-01,31082,1,0,1,2,0,2
2023-06-01,29609,1,0,1,1,0,1
2023-06-01,57839,11,2,13,1,1,1
2023-06-01,29617,1,0,1,2,0,2
2023-06-01,197349,9,0,9,1,0,1
2023-06-01,204049,1,0,1,1,0,1
2023-06-01,12828,1,0,1,1,0,1
2023-06-01,8817,1,0,1,1,0,1
2023-06-01,48125,1,0,1,3,0,3
2023-06-01,57206,1,0,1,1,0,1
2023-06-01,210147,1,0,1,1,0,1
2023-06-01,201235,1,0,1,1,0,1
2023-06-01,201363,1,0,1,2,0,2
2023-06-01,209262,3,0,3,3,0,3
2023-06-01,210677,1,0,1,1,0,1
2023-06-01,199698,1,0,1,2,0,2
2023-06-01,39909,1,0,1,1,0,1
2023-06-01,204887,4,0,4,2,0,2
2023-06-01,212835,1,0,1,1,0,1
2023-06-01,30847,1,1,2,1,1,1
2023-06-01,30811,2,7,9,4,2,4
2023-06-01,25267,1,0,1,3,0,3
2023-06-01,30856,1,0,1,1,0,1
2023-06-01,16314,1,0,1,3,0,3
2023-06-01,16331,1,0,1,1,0,1
2023-06-01,12942,17,3,20,3,3,3
2023-06-01,207384,1,0,1,2,0,2
2023-06-01,200945,1,0,1,1,0,1
2023-06-01,64822,1,0,1,1,0,1
2023-06-01,20504,5,0,5,10,0,10
2023-06-01,31144,1,0,1,2,0,2
2023-06-01,210545,1,1,2,3,1,3
2023-06-01,31259,3,1,4,2,2,2
2023-06-01,31161,8,0,8,3,0,3
2023-06-01,61332,5,0,5,3,0,3
2023-06-01,28939,15,0,15,5,0,5
2023-06-01,16253,1,1,2,5,1,5
2023-06-01,16356,5,0,5,1,0,1
2023-06-01,31180,16,0,16,3,0,3
2023-06-01,20665,3,0,3,4,0,4
2023-06-01,33896,1,0,1,1,0,1
2023-06-01,205931,1,0,1,1,0,1
2023-06-01,31336,3,0,3,1,0,1
2023-06-01,31346,7,0,7,4,0,4
2023-06-01,49349,0,0,0,4,2,4
2023-06-01,29503,1,0,1,4,0,4
2023-06-01,16363,10,1,11,6,4,6
2023-06-01,210116,5,0,5,3,0,3
2023-06-01,39882,4,0,4,1,0,1
2023-06-01,201071,6,0,6,4,0,4
2023-06-01,31403,1,0,1,1,0,1
2023-06-01,207305,1,0,1,1,0,1
2023-06-01,206638,1,0,1,1,0,1
2023-06-01,20529,2,0,2,3,0,3
2023-06-01,31474,11,0,11,3,0,3
2023-06-01,31495,3,0,3,2,0,2
2023-06-01,31653,16,0,16,1,0,1
2023-06-01,31570,1,0,1,2,0,2
2023-06-01,205151,1,1,2,2,2,2
2023-06-01,20768,1,0,1,1,0,1
2023-06-01,201581,1,0,1,2,0,2
2023-06-01,201253,1,0,1,1,0,1
2023-06-01,199410,1,1,2,4,1,4
2023-06-01,61224,1,0,1,1,0,1
2023-06-01,212593,2,0,2,1,0,1
2023-06-01,20606,1,0,1,1,0,1
2023-06-01,34648,1,0,1,1,0,1
2023-06-01,24914,1,0,1,1,0,1
2023-06-01,43347,1,0,1,2,0,2
2023-06-01,20553,1,0,1,3,0,3
2023-06-01,208801,1,0,1,3,0,3
2023-06-01,20571,3,1,4,1,1,1
2023-06-01,20695,20,0,20,3,0,3
2023-06-01,12794,9,0,9,2,0,2
2023-06-01,34210,1,0,1,2,0,2
2023-06-01,5418,1,0,1,2,0,2
2023-06-01,29001,1,1,2,5,3,5
2023-06-01,3235,1,0,1,2,0,2
2023-06-01,20658,7,0,7,1,0,1
2023-06-01,24661,7,0,7,3,0,3
2023-06-01,199509,2,0,2,3,0,3
2023-06-01,33902,1,0,1,1,0,1
2023-06-01,29077,2,0,2,1,0,1
2023-06-01,31699,10,0,10,2,0,2
2023-06-01,31303,1,0,1,1,0,1
2023-06-01,42347,1,0,1,1,0,1
2023-06-01,62361,1,0,1,1,0,1
2023-06-01,205128,1,0,1,1,0,1
2023-06-01,33936,11,0,11,4,0,4
2023-06-01,33964,6,1,7,2,1,2
2023-06-01,20595,1,0,1,1,0,1
2023-06-01,20702,2,0,2,3,0,3
2023-06-01,212379,1,0,1,1,0,1
2023-06-01,29330,1,1,2,2,3,3
2023-06-01,60520,1,0,1,1,0,1
2023-06-01,208836,1,0,1,1,0,1
2023-06-01,34761,1,0,1,1,0,1
2023-06-01,20623,1,0,1,1,0,1
2023-06-01,20653,1,0,1,3,0,3
2023-06-01,59722,1,0,1,3,0,3
2023-06-01,20690,3,0,3,4,0,4
2023-06-01,203131,1,0,1,2,0,2
2023-06-01,20720,1,0,1,1,0,1
2023-06-01,207769,1,0,1,2,0,2
2023-06-01,201757,2,0,2,3,0,3
2023-06-01,34234,6,0,6,2,0,2
2023-06-01,20793,5,0,5,1,0,1
2023-06-01,208025,1,0,1,2,0,2
2023-06-01,43150,1,1,2,1,1,1
2023-06-01,208107,1,0,1,2,0,2
2023-06-01,208752,1,0,1,1,0,1
2023-06-01,50739,1,0,1,2,0,2
2023-06-01,209406,1,0,1,1,0,1
2023-06-01,34322,4,0,4,1,0,1
2023-06-01,131848,1,0,1,2,0,2
2023-06-01,9574,1,0,1,1,0,1
2023-06-01,17699,1,0,1,1,0,1
2023-06-01,149979,5,9,14,1,1,1
2023-06-01,38135,3,0,3,2,0,2
2023-06-01,9772,1,0,1,2,0,2
2023-06-01,131095,3,0,3,1,0,1
2023-06-01,131873,1,0,1,2,0,2
2023-06-01,37979,1,0,1,1,0,1
2023-06-01,18116,8,0,8,4,7,10
2023-06-01,17953,21,3,24,2,2,2
2023-06-01,18175,2,0,2,2,0,2
2023-06-01,23743,1,0,1,1,0,1
2023-06-01,23824,3,0,3,3,0,3
2023-06-01,131898,1,0,1,2,0,2
2023-06-01,18072,5,0,5,1,0,1
2023-06-01,18090,2,0,2,3,0,3
2023-06-01,18141,1,0,1,2,0,2
2023-06-01,45675,3,0,3,1,0,1
2023-06-01,55897,1,0,1,2,0,2
2023-06-01,18263,1,0,1,3,0,3
2023-06-01,17633,13,3,16,1,1,1
2023-06-01,23558,1,0,1,2,0,2
2023-06-01,10191,2,0,2,3,0,3
2023-06-01,45397,1,0,1,2,0,2
2023-06-01,9969,2,0,2,3,0,3
2023-06-01,18335,2,0,2,1,0,1
2023-06-01,131096,1,0,1,2,0,2
2023-06-01,38668,2,0,2,2,0,2
2023-06-01,38185,3,1,4,3,2,3
2023-06-01,38188,2,0,2,2,0,2
2023-06-01,45351,7,0,7,2,0,2
2023-06-01,45360,1,0,1,2,0,2
2023-06-01,24372,1,1,2,1,1,2
2023-06-01,23574,1,0,1,1,0,1
2023-06-01,9685,2,0,2,1,0,1
2023-06-01,139626,1,0,1,1,0,1
2023-06-01,38171,6,0,6,3,0,3
2023-06-01,56206,1,0,1,1,0,1
2023-06-01,18332,1,0,1,2,0,2
2023-06-01,63555,12,0,12,1,0,1
2023-06-01,132153,3,4,7,1,1,1
2023-06-01,4821,4,0,4,3,0,3
2023-06-01,56146,7,0,7,4,0,4
2023-06-01,132504,1,0,1,1,0,1
2023-06-01,149772,1,0,1,1,0,1
2023-06-01,55750,3,0,3,1,0,1
2023-06-01,141419,1,0,1,1,0,1
2023-06-01,132389,1,0,1,1,0,1
2023-06-01,139619,1,0,1,3,0,3
2023-06-01,46010,55,0,55,2,0,2
2023-06-01,55628,32,0,32,2,0,2
2023-06-01,9635,1,0,1,1,0,1
2023-06-01,135621,1,0,1,1,0,1
2023-06-01,55382,1,0,1,5,0,5
2023-06-01,131894,1,0,1,2,0,2
2023-06-01,132281,1,0,1,1,0,1
2023-06-01,134426,1,2,3,1,1,1
2023-06-01,149178,1,6,7,1,1,1
2023-06-01,132833,1,2,3,1,1,1
2023-06-01,140694,2,0,2,2,0,2
2023-06-01,56000,4,0,4,2,0,2
2023-06-01,141694,0,8,8,0,35,35
2023-06-01,38173,0,2,2,0,61,61
2023-06-01,139317,0,37,37,0,115,115
2023-06-01,142067,0,1,1,0,1,1
2023-06-01,142069,0,1,1,0,1,1
2023-06-01,142072,0,1,1,0,1,1
2023-06-01,142074,0,1,1,0,1,1
2023-06-01,142075,0,1,1,0,1,1
2023-06-01,142076,0,1,1,0,1,1
2023-06-01,142080,0,1,1,0,1,1
2023-06-01,142081,0,1,1,0,1,1
2023-06-01,142082,0,1,1,0,1,1
2023-06-01,142083,0,1,1,0,1,1
2023-06-01,142086,0,1,1,0,1,1
2023-06-01,142089,0,1,1,0,1,1
2023-06-01,142090,0,1,1,0,1,1
2023-06-01,142091,0,1,1,0,1,1
2023-06-01,142092,0,1,1,0,1,1
2023-06-01,142093,0,1,1,0,1,1
2023-06-01,142094,0,1,1,0,1,1
2023-06-01,142099,0,1,1,0,1,1
2023-06-01,142100,0,1,1,0,1,1
2023-06-01,142102,0,1,1,0,1,1
2023-06-01,142103,0,1,1,0,1,1
2023-06-01,142104,0,1,1,0,1,1
2023-06-01,142106,0,1,1,0,1,1
2023-06-01,65409,0,1,1,0,1,1
2023-06-01,59799,0,1,1,0,1,1
2023-06-01,22296,0,1,1,0,1,1
2023-06-01,5887,0,1,1,0,1,1
2023-06-01,6043,0,1,1,0,1,1
2023-06-01,5980,0,1,1,0,1,1
2023-06-01,5132,0,6,6,0,1,1
2023-06-01,3381,0,1,1,0,1,1
2023-06-01,131171,0,5,5,0,33,33
2023-06-01,396550,0,4,4,0,2,2
2023-06-01,397209,0,9,9,0,2,2
2023-06-01,40647,0,1,1,0,2,2
2023-06-01,396567,0,4,4,0,2,2
2023-06-01,396726,0,1,1,0,2,2
2023-06-01,396639,0,2,2,0,2,2
2023-06-01,396746,0,1,1,0,2,2
2023-06-01,33656,0,9,9,0,1,1
2023-06-01,33665,0,2,2,0,1,1
2023-06-01,15218,0,1,1,0,1,1
2023-06-01,206725,0,1,1,0,1,1
2023-06-01,201567,0,1,1,0,2,2
2023-06-01,202886,0,1,1,0,3,3
2023-06-01,202739,0,1,1,0,4,4
2023-06-01,8882,0,1,1,0,4,4
2023-06-01,206128,0,1,1,0,1,1
2023-06-01,54444,0,49,49,0,1,1
2023-06-01,206777,0,1,1,0,1,1
2023-06-01,206740,0,3,3,0,1,1
2023-06-01,206480,0,1,1,0,1,1
2023-06-01,206514,0,1,1,0,1,1
2023-06-01,206506,0,1,1,0,1,1
2023-06-01,202584,0,1,1,0,1,1
2023-06-01,208733,0,1,1,0,1,1
2023-06-01,211509,0,5,5,0,12,12
2023-06-01,47451,0,1,1,0,1,1
2023-06-01,205956,0,1,1,0,1,1
2023-06-01,205866,0,1,1,0,1,1
2023-06-01,212704,0,4,4,0,2,2
2023-06-01,205339,0,1,1,0,1,1
2023-06-01,212789,0,7,7,0,4,4
2023-06-01,204926,0,1,1,0,4,4
2023-06-01,58132,0,1,1,0,1,1
2023-06-01,204675,0,1,1,0,2,2
2023-06-01,204423,0,1,1,0,1,1
2023-06-01,204345,0,1,1,0,3,3
2023-06-01,204307,0,3,3,0,3,3
2023-06-01,202481,0,1,1,0,4,4
2023-06-01,50073,0,1,1,0,7,7
2023-06-01,202388,0,1,1,0,1,1
2023-06-01,39334,0,1,1,0,1,1
2023-06-01,202266,0,1,1,0,1,1
2023-06-01,202171,0,1,1,0,1,1
2023-06-01,202144,0,1,1,0,1,1
2023-06-01,201836,0,1,1,0,1,1
2023-06-01,210814,0,2,2,0,1,1
2023-06-01,204743,0,2,2,0,5,5
2023-06-01,201380,0,3,3,0,2,2
2023-06-01,201292,0,1,1,0,1,1
2023-06-01,200306,0,6,6,0,2,2
2023-06-01,48880,0,0,0,0,2,2
2023-06-01,201572,0,2,2,0,1,1
2023-06-01,200273,0,1,1,0,1,1
2023-06-01,213103,0,2,2,0,2,2
2023-06-01,210316,0,1,1,0,1,1
2023-06-01,213297,0,1,1,0,2,2
2023-06-01,209933,0,1,1,0,4,4
2023-06-01,209619,0,2,2,0,3,3
2023-06-01,206253,0,1,1,0,1,1
2023-06-01,213210,0,1,1,0,1,1
2023-06-01,209395,0,1,1,0,1,1
2023-06-01,209075,0,1,1,0,4,4
2023-06-01,204882,0,2,2,0,4,4
2023-06-01,208713,0,1,1,0,1,1
2023-06-01,208723,0,1,1,0,1,1
2023-06-01,208658,0,1,1,0,1,1
2023-06-01,208584,0,2,2,0,2,2
2023-06-01,208505,0,4,4,0,3,3
2023-06-01,139321,0,2,2,0,3,3
2023-06-01,208562,0,1,1,0,2,2
2023-06-01,204867,0,1,1,0,2,2
2023-06-01,208051,0,1,1,0,1,1
2023-06-01,208003,0,1,1,0,3,3
2023-06-01,207880,0,1,1,0,2,2
2023-06-01,207824,0,1,1,0,2,2
2023-06-01,207687,0,4,4,0,1,1
2023-06-01,207671,0,2,2,0,1,1
2023-06-01,207632,0,2,2,0,2,2
2023-06-01,207491,0,1,1,0,2,2
2023-06-01,207487,0,1,1,0,1,1
2023-06-01,212746,0,4,4,0,4,4
2023-06-01,207411,0,1,1,0,2,2
2023-06-01,209718,0,4,4,0,2,2
2023-06-01,47937,0,1,1,0,3,3
2023-06-01,58275,0,1,1,0,1,1
2023-06-01,204931,0,3,3,0,3,3
2023-06-01,207278,0,4,4,0,2,2
2023-06-01,210660,0,1,1,0,1,1
2023-06-01,206384,0,1,1,0,1,1
2023-06-01,213376,0,1,1,0,2,2
2023-06-01,213343,0,1,1,0,3,3
2023-06-01,59570,0,3,3,0,3,3
2023-06-01,213204,0,4,4,0,3,3
2023-06-01,212535,0,1,1,0,2,2
2023-06-01,213092,0,5,5,0,8,8
2023-06-01,213032,0,3,3,0,3,3
2023-06-01,57632,0,1,1,0,1,1
2023-06-01,212834,0,1,1,0,2,2
2023-06-01,212783,0,1,1,0,4,4
2023-06-01,212651,0,1,1,0,1,1
2023-06-01,205593,0,17,17,0,9,9
2023-06-01,212622,0,1,1,0,1,1
2023-06-01,212596,0,1,1,0,3,3
2023-06-01,212518,0,1,1,0,4,4
2023-06-01,212495,0,1,1,0,2,2
2023-06-01,212378,0,2,2,0,3,3
2023-06-01,212135,0,1,1,0,1,1
2023-06-01,211646,0,1,1,0,1,1
2023-06-01,211586,0,1,1,0,1,1
2023-06-01,211514,0,3,3,0,1,1
2023-06-01,211362,0,1,1,0,1,1
2023-06-01,211640,0,3,3,0,3,3
2023-06-01,211169,0,1,1,0,2,2
2023-06-01,198902,0,1,1,0,1,1
2023-06-01,211088,0,3,3,0,3,3
2023-06-01,211069,0,1,1,0,1,1
2023-06-01,209878,0,1,1,0,2,2
2023-06-01,211042,0,3,3,0,2,2
2023-06-01,211023,0,1,1,0,2,2
2023-06-01,210961,0,1,1,0,2,2
2023-06-01,199918,0,3,3,0,2,2
2023-06-01,210454,0,1,1,0,1,1
2023-06-01,48908,0,1,1,0,1,1
2023-06-01,202244,0,1,1,0,1,1
2023-06-01,50395,0,3,3,0,2,2
2023-06-01,205088,0,3,3,0,4,4
2023-06-01,51861,0,7,7,0,3,3
2023-06-01,212488,0,1,1,0,3,3
2023-06-01,8949,0,2,2,0,2,2
2023-06-01,201824,0,1,1,0,1,1
2023-06-01,201742,0,1,1,0,1,1
2023-06-01,204254,0,5,5,0,5,5
2023-06-01,210941,0,1,1,0,3,3
2023-06-01,210833,0,1,1,0,2,2
2023-06-01,57964,0,1,1,0,1,1
2023-06-01,210775,0,5,5,0,1,1
2023-06-01,210562,0,9,9,0,6,6
2023-06-01,212925,0,2,2,0,2,2
2023-06-01,209693,0,1,1,0,1,1
2023-06-01,208985,0,4,4,0,2,2
2023-06-01,209460,0,1,1,0,2,2
2023-06-01,62256,0,1,1,0,1,1
2023-06-01,46553,0,17,17,0,1,1
2023-06-01,209719,0,1,1,0,3,3
2023-06-01,207947,0,1,1,0,1,1
2023-06-01,207716,0,4,4,0,3,3
2023-06-01,206292,0,1,1,0,1,1
2023-06-01,205878,0,1,1,0,3,3
2023-06-01,209105,0,3,3,0,2,2
2023-06-01,206020,0,2,2,0,1,1
2023-06-01,206072,0,1,1,0,1,1
2023-06-01,205791,0,1,1,0,1,1
2023-06-01,206290,0,3,3,0,2,2
2023-06-01,62430,0,3,3,0,2,2
2023-06-01,56997,0,1,1,0,2,2
2023-06-01,61978,0,1,1,0,1,1
2023-06-01,208753,0,13,13,0,15,15
2023-06-01,204617,0,1,1,0,1,1
2023-06-01,58145,0,0,0,0,2,2
2023-06-01,204181,0,1,1,0,1,1
2023-06-01,213366,0,2,2,0,1,1
2023-06-01,202729,0,1,1,0,3,3
2023-06-01,212900,0,2,2,0,2,2
2023-06-01,56841,0,4,4,0,1,1
2023-06-01,201377,0,1,1,0,2,2
2023-06-01,211992,0,1,1,0,2,2
2023-06-01,210072,0,1,1,0,1,1
2023-06-01,211207,0,1,1,0,1,1
2023-06-01,201257,0,2,2,0,1,1
2023-06-01,201034,0,1,1,0,1,1
2023-06-01,211194,0,2,2,0,2,2
2023-06-01,200360,0,5,5,0,6,6
2023-06-01,213045,0,7,7,0,9,9
2023-06-01,202952,0,3,3,0,8,8
2023-06-01,200372,0,1,1,0,2,2
2023-06-01,200368,0,1,1,0,1,1
2023-06-01,200305,0,1,1,0,1,1
2023-06-01,200258,0,1,1,0,3,3
2023-06-01,200270,0,2,2,0,3,3
2023-06-01,56762,0,2,2,0,2,2
2023-06-01,210761,0,1,1,0,1,1
2023-06-01,199789,0,2,2,0,1,1
2023-06-01,51019,0,3,3,0,3,3
2023-06-01,206271,0,2,2,0,3,3
2023-06-01,48925,0,1,1,0,2,2
2023-06-01,199591,0,1,1,0,1,1
2023-06-01,210199,0,3,3,0,2,2
2023-06-01,205740,0,7,7,0,1,1
2023-06-01,199392,0,1,1,0,2,2
2023-06-01,199384,0,1,1,0,1,1
2023-06-01,199257,0,3,3,0,4,4
2023-06-01,199195,0,1,1,0,1,1
2023-06-01,206081,0,1,1,0,1,1
2023-06-01,198846,0,1,1,0,1,1
2023-06-01,198707,0,1,1,0,1,1
2023-06-01,211479,0,3,3,0,1,1
2023-06-01,198501,0,2,2,0,1,1
2023-06-01,212977,0,1,1,0,1,1
2023-06-01,199249,0,1,1,0,2,2
2023-06-01,205969,0,1,1,0,2,2
2023-06-01,199268,0,1,1,0,1,1
2023-06-01,44286,0,2,2,0,1,1
2023-06-01,210577,0,1,1,0,3,3
2023-06-01,207076,0,1,1,0,2,2
2023-06-01,29478,0,2,2,0,2,2
2023-06-01,199302,0,1,1,0,1,1
2023-06-01,31451,0,1,1,0,2,2
2023-06-01,60910,0,1,1,0,1,1
2023-06-01,212037,0,1,1,0,3,3
2023-06-01,212024,0,2,2,0,2,2
2023-06-01,62311,0,1,1,0,1,1
2023-06-01,199957,0,1,1,0,1,1
2023-06-01,207760,0,1,1,0,1,1
2023-06-01,199852,0,1,1,0,1,1
2023-06-01,211879,0,1,1,0,1,1
2023-06-01,210729,0,1,1,0,2,2
2023-06-01,210564,0,1,1,0,1,1
2023-06-01,50967,0,1,1,0,1,1
2023-06-01,56662,0,2,2,0,14,14
2023-06-01,204828,0,1,1,0,1,1
2023-06-01,212966,0,1,1,0,1,1
2023-06-01,16375,0,1,1,0,1,1
2023-06-01,50683,0,1,1,0,1,1
2023-06-01,198660,0,1,1,0,1,1
2023-06-01,207394,0,1,1,0,2,2
2023-06-01,47596,0,10,10,0,6,6
2023-06-01,198478,0,1,1,0,1,1
2023-06-01,47462,0,1,1,0,1,1
2023-06-01,211696,0,3,3,0,4,4
2023-06-01,206493,0,1,1,0,2,2
2023-06-01,208818,0,1,1,0,1,1
2023-06-01,58148,0,1,1,0,1,1
2023-06-01,212125,0,1,1,0,2,2
2023-06-01,212034,0,10,10,0,4,4
2023-06-01,211935,0,3,3,0,3,3
2023-06-01,211781,0,1,1,0,2,2
2023-06-01,209844,0,1,1,0,2,2
2023-06-01,57330,0,1,1,0,1,1
2023-06-01,211723,0,1,1,0,1,1
2023-06-01,211671,0,1,1,0,4,4
2023-06-01,61298,0,2,2,0,1,1
2023-06-01,60275,0,1,1,0,2,2
2023-06-01,212129,0,3,3,0,2,2
2023-06-01,210466,0,2,2,0,1,1
2023-06-01,57295,0,1,1,0,1,1
2023-06-01,202881,0,2,2,0,1,1
2023-06-01,62396,0,1,1,0,1,1
2023-06-01,50838,0,7,7,0,2,2
2023-06-01,47867,0,1,1,0,2,2
2023-06-01,204088,0,1,1,0,1,1
2023-06-01,205414,0,1,1,0,1,1
2023-06-01,206321,0,1,1,0,1,1
2023-06-01,207575,0,1,1,0,1,1
2023-06-01,207583,0,1,1,0,1,1
2023-06-01,207576,0,1,1,0,1,1
2023-06-01,201173,0,1,1,0,2,2
2023-06-01,209022,0,14,14,0,8,8
2023-06-01,207372,0,1,1,0,1,1
2023-06-01,200259,0,1,1,0,1,1
2023-06-01,6890,0,1,1,0,2,2
2023-06-01,6766,0,1,1,0,1,1
2023-06-01,200149,0,1,1,0,3,3
2023-06-01,44496,0,1,1,0,1,1
2023-06-01,212467,0,1,1,0,1,1
2023-06-01,207424,0,1,1,0,4,4
2023-06-01,213156,0,1,1,0,1,1
2023-06-01,2832,0,1,1,0,1,1
2023-06-01,51988,0,1,1,0,2,2
2023-06-01,8695,0,1,1,0,1,1
2023-06-01,59714,0,1,1,0,1,1
2023-06-01,200522,0,1,1,0,1,1
2023-06-01,64588,0,1,1,0,1,1
2023-06-01,65564,0,1,1,0,1,1
2023-06-01,59265,0,5,5,0,1,1
2023-06-01,4717,0,1,1,0,1,1
2023-06-01,397224,0,1,1,0,1,1
2023-06-01,45689,0,1,1,0,1,1
2023-06-01,139062,0,1,1,0,1,1
2023-06-01,9400,0,0,0,0,2,2
2023-06-01,55700,0,0,0,0,2,2
2023-06-01,9886,0,11,11,0,9,9
2023-06-01,150314,0,1,1,0,1,1
2023-06-01,205977,0,1,1,0,3,3
2023-06-01,150413,0,1,1,0,1,1
2023-06-01,138603,0,1,1,0,3,3
2023-06-01,131203,0,1,1,0,1,1
2023-06-01,139727,0,1,1,0,1,1
2023-06-01,136421,0,1,1,0,1,1
2023-06-01,142290,0,1,1,0,1,1
2023-06-01,38323,0,1,1,0,1,1
2023-06-01,27661,0,1,1,0,1,1
2023-06-01,65001,0,1,1,0,1,1
2023-06-01,264684,0,26,26,0,1,1
2023-06-01,51103,0,1,1,0,1,1
2023-06-01,205950,0,1,1,0,1,1
2023-06-01,204628,0,1,1,0,1,1
2023-06-01,8938,0,1,1,0,1,1
2023-06-01,10241,0,0,0,0,13,13
2023-06-01,32279,0,1,1,0,1,1
2023-06-01,328206,0,1,1,0,2,2
2023-06-01,65302,0,15,15,0,1,1
2023-06-01,65211,0,10,10,0,1,1
2023-06-01,65213,0,13,13,0,1,1
2023-06-01,65230,0,6,6,0,1,1
2023-06-01,64516,0,17,17,0,1,1
2023-06-01,64517,0,12,12,0,1,1
2023-06-01,65400,0,8,8,0,1,1
2023-06-01,65402,0,2,2,0,1,1
2023-06-01,65312,0,15,15,0,1,1
2023-06-01,65307,0,15,15,0,1,1
2023-06-01,64519,0,17,17,0,1,1
2023-06-01,65306,0,15,15,0,1,1
2023-06-01,65315,0,15,15,0,1,1
2023-06-01,65332,0,15,15,0,1,1
2023-06-01,65333,0,15,15,0,1,1
2023-06-01,64706,0,4,4,0,1,1
2023-06-01,64705,0,18,18,0,1,1
2023-06-01,64704,0,15,15,0,1,1
2023-06-01,64703,0,17,17,0,1,1
2023-06-01,65250,0,2,2,0,1,1
2023-06-01,64700,0,1,1,0,1,1
2023-06-01,65266,0,1,1,0,1,1
2023-06-01,64701,0,1,1,0,1,1
2023-06-01,33437,0,1,1,0,1,1
2023-06-01,395326,0,1,1,0,1,1
2023-06-01,61126,0,4,4,0,1,1
2023-06-01,177,0,2,2,0,1,1
2023-06-01,75,0,1,1,0,1,1
2023-06-01,12635,0,2,2,0,1,1
2023-06-01,39700,0,1,1,0,1,1
2023-06-01,6067,0,1,1,0,1,1
2023-06-01,149476,0,3,3,0,1,1
2023-06-01,208690,0,7,7,0,3,3
2023-06-01,149500,0,6,6,0,3,3
2023-06-01,151192,0,3,3,0,3,3
2023-06-01,150404,0,1,1,0,1,1
2023-06-01,135395,0,1,1,0,2,2
2023-06-01,133512,0,6,6,0,6,6
2023-06-01,210445,0,10,10,0,6,6
2023-06-01,202820,0,2,2,0,2,2
2023-06-01,23736,0,41,41,0,1,1
2023-06-01,149104,0,1,1,0,2,2
2023-06-01,149599,0,1,1,0,1,1
2023-06-01,60445,0,4,4,0,3,3
2023-06-01,150006,0,1,1,0,1,1
2023-06-01,134169,0,2,2,0,6,6
2023-06-01,133517,0,1,1,0,1,1
2023-06-01,133515,0,5,5,0,1,1
2023-06-01,133518,0,1,1,0,2,2
2023-06-01,133513,0,2,2,0,4,4
2023-06-01,38587,0,4,4,0,2,2
2023-06-01,133375,0,1,1,0,1,1
2023-06-01,203472,0,16,16,0,11,11
2023-06-01,136600,0,1,1,0,1,1
2023-06-01,131298,0,1,1,0,1,1
2023-06-01,132915,0,2,2,0,1,1
2023-06-01,63778,0,31,31,0,1,1
2023-06-01,24150,0,2,2,0,2,2
2023-06-01,38355,0,2,2,0,1,1
2023-06-01,4671,0,3,3,0,1,1
2023-06-01,206729,0,3,3,0,3,3
2023-06-01,136961,0,1,1,0,1,1
2023-06-01,55641,0,3,3,0,1,1
2023-06-01,58810,0,504,504,0,1,1
2023-06-01,150071,0,1,1,0,3,3
2023-06-01,151074,0,1,1,0,1,1
2023-06-01,137910,0,1,1,0,1,1
2023-06-01,140913,0,1,1,0,3,3
2023-06-01,141706,0,1,1,0,1,1
2023-06-01,133492,0,3,3,0,1,1
2023-06-01,142107,0,1,1,0,1,1
2023-06-01,24423,0,8,8,0,1,1
2023-06-01,141025,0,0,0,0,2,2
2023-06-01,139100,0,1,1,0,1,1
2023-06-01,131137,0,2,2,0,1,1
2023-06-01,131119,0,1,1,0,1,1
2023-06-01,46025,0,1,1,0,1,1
2023-06-01,135103,0,1,1,0,1,1
2023-06-01,138631,0,1,1,0,1,1
2023-06-01,138351,0,1,1,0,1,1
2023-06-01,137548,0,1,1,0,1,1
2023-06-01,139073,0,16,16,0,1,1
2023-06-01,24360,0,1,1,0,1,1
2023-06-01,138986,0,1,1,0,1,1
2023-06-01,150414,0,2,2,0,1,1
2023-06-01,132088,0,3,3,0,1,1
2023-06-01,45576,0,4,4,0,3,3
2023-06-01,138391,0,1,1,0,1,1
2023-06-01,38324,0,1,1,0,1,1
2023-06-01,211622,0,3,3,0,3,3
2023-06-01,131157,0,1,1,0,1,1
2023-06-01,64087,0,1,1,0,1,1
2023-06-01,55826,0,1,1,0,1,1
2023-06-01,135309,0,4,4,0,2,2
2023-06-01,139264,0,1,1,0,1,1
2023-06-01,138399,0,1,1,0,1,1
2023-06-01,926,0,5,5,0,1,1
2023-06-01,147297,0,2,2,0,2,2
2023-06-01,212149,0,79,79,0,1,1
2023-06-01,199974,0,9,9,0,1,1
2023-06-01,17732,0,0,0,0,2,2
2023-06-01,37981,0,1,1,0,1,1
2023-06-01,138919,0,2,2,0,1,1
2023-06-01,138978,0,1,1,0,1,1
2023-06-01,149030,0,1,1,0,1,1
2023-06-01,32167,0,3,3,0,1,1
2023-06-01,210384,0,9,9,0,6,6
2023-06-01,209300,0,3,3,0,6,6
2023-06-01,24239,0,3,3,0,3,3
2023-06-01,139589,0,5,5,0,5,5
2023-06-01,139299,0,1,1,0,1,1
2023-06-01,142549,0,3,3,0,2,2
2023-06-01,134666,0,12,12,0,9,9
2023-06-01,140498,0,1,1,0,3,3
2023-06-01,138517,0,3,3,0,1,1
2023-06-01,149795,0,2,2,0,3,3
2023-06-01,134478,0,9,9,0,3,3
2023-06-01,199605,0,16,16,0,10,10
2023-06-01,142551,0,8,8,0,4,4
2023-06-01,142281,0,2,2,0,3,3
2023-06-01,142280,0,10,10,0,6,6
2023-06-01,142130,0,19,19,0,5,5
2023-06-01,142282,0,15,15,0,2,2
2023-06-01,142284,0,2,2,0,2,2
2023-06-01,139796,0,1,1,0,1,1
2023-06-01,139249,0,2,2,0,1,1
2023-06-01,139247,0,1,1,0,1,1
2023-06-01,149506,0,1,1,0,1,1
2023-06-01,140219,0,1,1,0,1,1
2023-06-01,63619,0,1,1,0,1,1
2023-06-01,59025,0,1,1,0,1,1
2023-06-01,139188,0,1,1,0,1,1
2023-06-01,59068,0,1,1,0,2,2
2023-06-01,149778,0,1,1,0,1,1
2023-06-01,132432,0,1,1,0,1,1
2023-06-01,137799,0,3,3,0,4,4
2023-06-01,209554,0,2,2,0,2,2
2023-06-01,210872,0,2,2,0,3,3
2023-06-01,139782,0,3,3,0,1,1
2023-06-01,139161,0,1,1,0,1,1
2023-06-01,17719,0,2,2,0,2,2
2023-06-01,38443,0,1,1,0,1,1
2023-06-01,133602,0,1,1,0,1,1
2023-06-01,133164,0,1,1,0,1,1
2023-06-01,56004,0,1,1,0,1,1
2023-06-01,135120,0,4,4,0,2,2
2023-06-01,199310,0,4,4,0,1,1
2023-06-01,151187,0,5,5,0,5,5
2023-06-01,150323,0,8,8,0,3,3
2023-06-01,200078,0,5,5,0,4,4
2023-06-01,203236,0,9,9,0,5,5
2023-06-01,213069,0,14,14,0,2,2
2023-06-01,142418,0,9,9,0,7,7
2023-06-01,141429,0,2,2,0,2,2
2023-06-01,134477,0,1,1,0,1,1
2023-06-01,142164,0,4,4,0,3,3
2023-06-01,142112,0,1,1,0,1,1
2023-06-01,150184,0,3,3,0,2,2
2023-06-01,150373,0,3,3,0,2,2
2023-06-01,149292,0,2,2,0,2,2
2023-06-01,211571,0,5,5,0,3,3
2023-06-01,151194,0,18,18,0,6,6
2023-06-01,211843,0,3,3,0,2,2
2023-06-01,136591,0,3,3,0,2,2
2023-06-01,134488,0,1,1,0,1,1
2023-06-01,209294,0,1,1,0,1,1
2023-06-01,142642,0,1,1,0,1,1
2023-06-01,142553,0,8,8,0,4,4
2023-06-01,213215,0,4,4,0,2,2
2023-06-01,142582,0,5,5,0,4,4
2023-06-01,151202,0,4,4,0,2,2
2023-06-01,39753,0,15,15,0,7,7
2023-06-01,133555,0,7,7,0,2,2
2023-06-01,137835,0,3,3,0,2,2
2023-06-01,142554,0,1,1,0,1,1
2023-06-01,140506,0,1,1,0,1,1
2023-06-01,208618,0,2,2,0,1,1
2023-06-01,150173,0,2,2,0,2,2
2023-06-01,140938,0,15,15,0,4,4
2023-06-01,132623,0,2,2,0,2,2
2023-06-01,134993,0,8,8,0,7,7
2023-06-01,136535,0,2,2,0,1,1
2023-06-01,138632,0,1,1,0,1,1
2023-06-01,151334,0,2,2,0,2,2
2023-06-01,149163,0,1,1,0,1,1
2023-06-01,151193,0,1,1,0,2,2
2023-06-01,134708,0,1,1,0,1,1
2023-06-01,150141,0,1,1,0,1,1
2023-06-01,142438,0,5,5,0,2,2
2023-06-01,139231,0,1,1,0,1,1
2023-06-01,141445,0,1,1,0,1,1
2023-06-01,142641,0,9,9,0,6,6
2023-06-01,396303,0,10,10,0,2,2
2023-06-01,146950,0,10,10,0,7,7
2023-06-01,207268,0,7,7,0,6,6
2023-06-01,213262,0,13,13,0,10,10
2023-06-01,136409,0,2,2,0,1,1
2023-06-01,141284,0,1,1,0,1,1
2023-06-01,135053,0,1,1,0,1,1
2023-06-01,58828,0,1,1,0,1,1
2023-06-01,140788,0,1,1,0,1,1
2023-06-01,134970,0,6,6,0,1,1
2023-06-01,142409,0,1,1,0,1,1
2023-06-01,141173,0,1,1,0,1,1
2023-06-01,149423,0,1,1,0,3,3
2023-06-01,201217,0,39,39,0,9,9
2023-06-01,146989,0,0,0,0,2,2
2023-06-01,199932,0,1,1,0,3,3
2023-06-01,147057,0,1,1,0,1,1
2023-06-01,142650,0,1,1,0,1,1
2023-06-01,142651,0,1,1,0,1,1
2023-06-01,142652,0,1,1,0,1,1
2023-06-01,142653,0,1,1,0,1,1
2023-06-01,142654,0,1,1,0,1,1
2023-06-01,142655,0,1,1,0,1,1
2023-06-01,142656,0,1,1,0,1,1
2023-06-01,142657,0,1,1,0,1,1
2023-06-01,142658,0,1,1,0,1,1
2023-06-01,142659,0,1,1,0,1,1
2023-06-01,142660,0,1,1,0,1,1
2023-06-01,142661,0,1,1,0,1,1
2023-06-01,142662,0,1,1,0,1,1
2023-06-01,142663,0,1,1,0,1,1
2023-06-01,142664,0,1,1,0,1,1
2023-06-01,142665,0,1,1,0,1,1
2023-06-01,142666,0,1,1,0,1,1
2023-06-01,142667,0,1,1,0,1,1
2023-06-01,142668,0,1,1,0,1,1
2023-06-01,142669,0,1,1,0,1,1
2023-06-01,142670,0,1,1,0,1,1
2023-06-01,142671,0,1,1,0,1,1
2023-06-01,142672,0,1,1,0,1,1
2023-06-01,142673,0,1,1,0,1,1
2023-06-01,142674,0,1,1,0,1,1
2023-06-01,142675,0,1,1,0,1,1
2023-06-01,142676,0,1,1,0,1,1
2023-06-01,142677,0,1,1,0,1,1
2023-06-01,142678,0,1,1,0,1,1
2023-06-01,142679,0,1,1,0,1,1
2023-06-01,142680,0,1,1,0,1,1
2023-06-01,142681,0,1,1,0,1,1
2023-06-01,142682,0,1,1,0,1,1
2023-06-01,142683,0,1,1,0,1,1
2023-06-01,142684,0,1,1,0,1,1
2023-06-01,142685,0,1,1,0,1,1
2023-06-01,142686,0,1,1,0,1,1
2023-06-01,142687,0,1,1,0,1,1
2023-06-01,142688,0,1,1,0,1,1
2023-06-01,142689,0,1,1,0,1,1
2023-06-01,142690,0,1,1,0,1,1
2023-06-01,142691,0,1,1,0,1,1
2023-06-01,142692,0,1,1,0,1,1
2023-06-01,142693,0,1,1,0,1,1
2023-06-01,142694,0,1,1,0,1,1
2023-06-01,142695,0,1,1,0,1,1
2023-06-01,142696,0,1,1,0,1,1
2023-06-01,142697,0,1,1,0,1,1
2023-06-01,142698,0,1,1,0,1,1
2023-06-01,142699,0,1,1,0,1,1
2023-06-01,142700,0,1,1,0,1,1
2023-06-01,142701,0,1,1,0,1,1
2023-06-01,142702,0,1,1,0,1,1
2023-06-01,142703,0,1,1,0,1,1
2023-06-01,142704,0,1,1,0,1,1
2023-06-01,142705,0,1,1,0,1,1
2023-06-01,142706,0,1,1,0,1,1
2023-06-01,142707,0,1,1,0,1,1
2023-06-01,142708,0,1,1,0,1,1
2023-06-01,142709,0,1,1,0,1,1
2023-06-01,142710,0,1,1,0,1,1
2023-06-01,142711,0,1,1,0,1,1
2023-06-01,142712,0,1,1,0,1,1
2023-06-01,142713,0,1,1,0,1,1
2023-06-01,142714,0,1,1,0,1,1
2023-06-01,142715,0,1,1,0,1,1
2023-06-01,142716,0,1,1,0,1,1
2023-06-01,142717,0,1,1,0,1,1
2023-06-01,142718,0,1,1,0,1,1
2023-06-01,142719,0,1,1,0,1,1
2023-06-01,142720,0,1,1,0,1,1
2023-06-01,142721,0,1,1,0,1,1
2023-06-01,142722,0,1,1,0,1,1
2023-06-01,142723,0,1,1,0,1,1
2023-06-01,142724,0,1,1,0,1,1
2023-06-01,142725,0,1,1,0,1,1
2023-06-01,142726,0,1,1,0,1,1
2023-06-01,142727,0,1,1,0,1,1
2023-06-01,142728,0,1,1,0,1,1
2023-06-01,142729,0,1,1,0,1,1
2023-06-01,142730,0,1,1,0,1,1
2023-06-01,142731,0,1,1,0,1,1
2023-06-01,142732,0,1,1,0,1,1
2023-06-01,142733,0,1,1,0,1,1
2023-06-01,142734,0,1,1,0,1,1
2023-06-01,142735,0,1,1,0,1,1
2023-06-01,142736,0,1,1,0,1,1
2023-06-01,142737,0,1,1,0,1,1
2023-06-01,142738,0,1,1,0,1,1
2023-06-01,142739,0,1,1,0,1,1
2023-06-01,142740,0,1,1,0,1,1
2023-06-01,142741,0,1,1,0,1,1
2023-06-01,142742,0,1,1,0,1,1
2023-06-01,142743,0,1,1,0,1,1
2023-06-01,142744,0,1,1,0,1,1
2023-06-01,142745,0,1,1,0,1,1
2023-06-01,142746,0,1,1,0,1,1
2023-06-01,142747,0,1,1,0,1,1
2023-06-01,142748,0,1,1,0,1,1
2023-06-01,142749,0,1,1,0,1,1
2023-06-01,142750,0,1,1,0,1,1
2023-06-01,142751,0,1,1,0,1,1
2023-06-01,142752,0,1,1,0,1,1
2023-06-01,142753,0,1,1,0,1,1
2023-06-01,142754,0,1,1,0,1,1
2023-06-01,142755,0,1,1,0,1,1
2023-06-01,142756,0,1,1,0,1,1
2023-06-01,142757,0,1,1,0,1,1
2023-06-01,142758,0,1,1,0,1,1
2023-06-01,142759,0,1,1,0,1,1
2023-06-01,142760,0,1,1,0,1,1
2023-06-01,142761,0,1,1,0,1,1
2023-06-01,142762,0,1,1,0,1,1
2023-06-01,142763,0,1,1,0,1,1
2023-06-01,142764,0,1,1,0,1,1
2023-06-01,142765,0,1,1,0,1,1
2023-06-01,142766,0,1,1,0,1,1
2023-06-01,142767,0,1,1,0,1,1
2023-06-01,142768,0,1,1,0,1,1
2023-06-01,142769,0,1,1,0,1,1
2023-06-01,142770,0,1,1,0,1,1
2023-06-01,142771,0,1,1,0,1,1
2023-06-01,142772,0,1,1,0,1,1
2023-06-01,142773,0,1,1,0,1,1
2023-06-01,142774,0,1,1,0,1,1
2023-06-01,142775,0,1,1,0,1,1
2023-06-01,142776,0,1,1,0,1,1
2023-06-01,142777,0,1,1,0,1,1
2023-06-01,142778,0,1,1,0,1,1
2023-06-01,142779,0,1,1,0,1,1
2023-06-01,142780,0,1,1,0,1,1
2023-06-01,142781,0,1,1,0,1,1
2023-06-01,142782,0,1,1,0,1,1
2023-06-01,142783,0,1,1,0,1,1
2023-06-01,142784,0,1,1,0,1,1
2023-06-01,142785,0,1,1,0,1,1
2023-06-01,142786,0,1,1,0,1,1
2023-06-01,142787,0,1,1,0,1,1
2023-06-01,142788,0,1,1,0,1,1
2023-06-01,142789,0,1,1,0,1,1
2023-06-01,142790,0,1,1,0,1,1
2023-06-01,142791,0,1,1,0,1,1
2023-06-01,142792,0,1,1,0,1,1
2023-06-01,142793,0,1,1,0,1,1
2023-06-01,142794,0,1,1,0,1,1
2023-06-01,142795,0,1,1,0,1,1
2023-06-01,142796,0,1,1,0,1,1
2023-06-01,142797,0,1,1,0,1,1
2023-06-01,142798,0,1,1,0,1,1
2023-06-01,142799,0,1,1,0,1,1
2023-06-01,142800,0,1,1,0,1,1
2023-06-01,142801,0,1,1,0,1,1
2023-06-01,142802,0,1,1,0,1,1
2023-06-01,142803,0,1,1,0,1,1
2023-06-01,142804,0,1,1,0,1,1
2023-06-01,142805,0,1,1,0,1,1
2023-06-01,142806,0,1,1,0,1,1
2023-06-01,142807,0,1,1,0,1,1
2023-06-01,142808,0,1,1,0,1,1
2023-06-01,142809,0,1,1,0,1,1
2023-06-01,142810,0,1,1,0,1,1
2023-06-01,142811,0,1,1,0,1,1
2023-06-01,142812,0,1,1,0,1,1
2023-06-01,142813,0,1,1,0,1,1
2023-06-01,142814,0,1,1,0,1,1
2023-06-01,142815,0,1,1,0,1,1
2023-06-01,142816,0,1,1,0,1,1
2023-06-01,142817,0,1,1,0,1,1
2023-06-01,142818,0,1,1,0,1,1
2023-06-01,142819,0,1,1,0,1,1
2023-06-01,142820,0,1,1,0,1,1
2023-06-01,142821,0,1,1,0,1,1
2023-06-01,142822,0,1,1,0,1,1
2023-06-01,142823,0,1,1,0,1,1
2023-06-01,142824,0,1,1,0,1,1
2023-06-01,142825,0,1,1,0,1,1
2023-06-01,142826,0,1,1,0,1,1
2023-06-01,142827,0,1,1,0,1,1
2023-06-01,142828,0,1,1,0,1,1
2023-06-01,142829,0,1,1,0,1,1
2023-06-01,142830,0,1,1,0,1,1
2023-06-01,142831,0,1,1,0,1,1
2023-06-01,142832,0,1,1,0,1,1
2023-06-01,142833,0,1,1,0,1,1
2023-06-01,142834,0,1,1,0,1,1
2023-06-01,142835,0,1,1,0,1,1
2023-06-01,142836,0,1,1,0,1,1
2023-06-01,142837,0,1,1,0,1,1
2023-06-01,142838,0,1,1,0,1,1
2023-06-01,142839,0,1,1,0,1,1
2023-06-01,142840,0,1,1,0,1,1
2023-06-01,142841,0,1,1,0,1,1
2023-06-01,142842,0,1,1,0,1,1
2023-06-01,142843,0,1,1,0,1,1
2023-06-01,142844,0,1,1,0,1,1
2023-06-01,142845,0,1,1,0,1,1
2023-06-01,142846,0,1,1,0,1,1
2023-06-01,142847,0,1,1,0,1,1
2023-06-01,142848,0,1,1,0,1,1
2023-06-01,142849,0,1,1,0,1,1
2023-06-01,142850,0,1,1,0,1,1
2023-06-01,142851,0,1,1,0,1,1
2023-06-01,142852,0,1,1,0,1,1
2023-06-01,142853,0,1,1,0,1,1
2023-06-01,142854,0,1,1,0,1,1
2023-06-01,142855,0,1,1,0,1,1
2023-06-01,142856,0,1,1,0,1,1
2023-06-01,142857,0,1,1,0,1,1
2023-06-01,142858,0,1,1,0,1,1
2023-06-01,142859,0,1,1,0,1,1
2023-06-01,142860,0,1,1,0,1,1
2023-06-01,142861,0,1,1,0,1,1
2023-06-01,142862,0,1,1,0,1,1
2023-06-01,142863,0,1,1,0,1,1
2023-06-01,142864,0,1,1,0,1,1
2023-06-01,142865,0,1,1,0,1,1
2023-06-01,142866,0,1,1,0,1,1
2023-06-01,142867,0,1,1,0,1,1
2023-06-01,142868,0,1,1,0,1,1
2023-06-01,142869,0,1,1,0,1,1
2023-06-01,142870,0,1,1,0,1,1
2023-06-01,142871,0,1,1,0,1,1
2023-06-01,142872,0,1,1,0,1,1
2023-06-01,142873,0,1,1,0,1,1
2023-06-01,142874,0,1,1,0,1,1
2023-06-01,142875,0,1,1,0,1,1
2023-06-01,142876,0,1,1,0,1,1
2023-06-01,142877,0,1,1,0,1,1
2023-06-01,142878,0,1,1,0,1,1
2023-06-01,142879,0,1,1,0,1,1
2023-06-01,142880,0,1,1,0,1,1
2023-06-01,142881,0,1,1,0,1,1
2023-06-01,142882,0,1,1,0,1,1
2023-06-01,142883,0,1,1,0,1,1
2023-06-01,142884,0,1,1,0,1,1
2023-06-01,142885,0,1,1,0,1,1
2023-06-01,142886,0,1,1,0,1,1
2023-06-01,142887,0,1,1,0,1,1
2023-06-01,142888,0,1,1,0,1,1
2023-06-01,142889,0,1,1,0,1,1
2023-06-01,142890,0,1,1,0,1,1
2023-06-01,142891,0,1,1,0,1,1
2023-06-01,142892,0,1,1,0,1,1
2023-06-01,142893,0,1,1,0,1,1
2023-06-01,142894,0,1,1,0,1,1
2023-06-01,142895,0,1,1,0,1,1
2023-06-01,142896,0,1,1,0,1,1
2023-06-01,142897,0,1,1,0,1,1
2023-06-01,142898,0,1,1,0,1,1
2023-06-01,142899,0,1,1,0,1,1
2023-06-01,142900,0,1,1,0,1,1
2023-06-01,142901,0,1,1,0,1,1
2023-06-01,142902,0,1,1,0,1,1
2023-06-01,142903,0,1,1,0,1,1
2023-06-01,142904,0,1,1,0,1,1
2023-06-01,142905,0,1,1,0,1,1
2023-06-01,142906,0,1,1,0,1,1
2023-06-01,142907,0,1,1,0,1,1
2023-06-01,142908,0,1,1,0,1,1
2023-06-01,142909,0,1,1,0,1,1
2023-06-01,142910,0,1,1,0,1,1
2023-06-01,142911,0,1,1,0,1,1
2023-06-01,142912,0,1,1,0,1,1
2023-06-01,142913,0,1,1,0,1,1
2023-06-01,142914,0,1,1,0,1,1
2023-06-01,142915,0,1,1,0,1,1
2023-06-01,142916,0,1,1,0,1,1
2023-06-01,142917,0,1,1,0,1,1
2023-06-01,142918,0,1,1,0,1,1
2023-06-01,142919,0,1,1,0,1,1
2023-06-01,142920,0,1,1,0,1,1
2023-06-01,142921,0,1,1,0,1,1
2023-06-01,142922,0,1,1,0,1,1
2023-06-01,142923,0,1,1,0,1,1
2023-06-01,142924,0,1,1,0,1,1
2023-06-01,142925,0,1,1,0,1,1
2023-06-01,142926,0,1,1,0,1,1
2023-06-01,142927,0,1,1,0,1,1
2023-06-01,142928,0,1,1,0,1,1
2023-06-01,142929,0,1,1,0,1,1
2023-06-01,142930,0,1,1,0,1,1
2023-06-01,142931,0,1,1,0,1,1
2023-06-01,142932,0,1,1,0,1,1
2023-06-01,142933,0,1,1,0,1,1
2023-06-01,142934,0,1,1,0,1,1
2023-06-01,142935,0,1,1,0,1,1
2023-06-01,142936,0,1,1,0,1,1
2023-06-01,142937,0,1,1,0,1,1
2023-06-01,142938,0,1,1,0,1,1
2023-06-01,142939,0,1,1,0,1,1
2023-06-01,142940,0,1,1,0,1,1
2023-06-01,142941,0,1,1,0,1,1
2023-06-01,142942,0,1,1,0,1,1
2023-06-01,142943,0,1,1,0,1,1
2023-06-01,142944,0,1,1,0,1,1
2023-06-01,142945,0,1,1,0,1,1
2023-06-01,142946,0,1,1,0,1,1
2023-06-01,142947,0,1,1,0,1,1
2023-06-01,142948,0,1,1,0,1,1
2023-06-01,142949,0,1,1,0,1,1
2023-06-01,142950,0,1,1,0,1,1
2023-06-01,142951,0,1,1,0,1,1
2023-06-01,142952,0,1,1,0,1,1
2023-06-01,142953,0,1,1,0,1,1
2023-06-01,142954,0,1,1,0,1,1
2023-06-01,142955,0,1,1,0,1,1
2023-06-01,142956,0,1,1,0,1,1
2023-06-01,142957,0,1,1,0,1,1
2023-06-01,142958,0,1,1,0,1,1
2023-06-01,142959,0,1,1,0,1,1
2023-06-01,142960,0,1,1,0,1,1
2023-06-01,142961,0,1,1,0,1,1
2023-06-01,142962,0,1,1,0,1,1
2023-06-01,142963,0,1,1,0,1,1
2023-06-01,142964,0,1,1,0,1,1
2023-06-01,142965,0,1,1,0,1,1
2023-06-01,142966,0,1,1,0,1,1
2023-06-01,142967,0,1,1,0,1,1
2023-06-01,142968,0,1,1,0,1,1
2023-06-01,142969,0,1,1,0,1,1
2023-06-01,142970,0,1,1,0,1,1
2023-06-01,142971,0,1,1,0,1,1
2023-06-01,142972,0,1,1,0,1,1
2023-06-01,142973,0,1,1,0,1,1
2023-06-01,142974,0,1,1,0,1,1
2023-06-01,142975,0,1,1,0,1,1
2023-06-01,142976,0,1,1,0,1,1
2023-06-01,142977,0,1,1,0,1,1
2023-06-01,142978,0,1,1,0,1,1
2023-06-01,142979,0,1,1,0,1,1
2023-06-01,142980,0,1,1,0,1,1
2023-06-01,142981,0,1,1,0,1,1
2023-06-01,142982,0,1,1,0,1,1
2023-06-01,142983,0,1,1,0,1,1
2023-06-01,142984,0,1,1,0,1,1
2023-06-01,142985,0,1,1,0,1,1
2023-06-01,142986,0,1,1,0,1,1
2023-06-01,142987,0,1,1,0,1,1
2023-06-01,142988,0,1,1,0,1,1
2023-06-01,142989,0,1,1,0,1,1
2023-06-01,142990,0,1,1,0,1,1
2023-06-01,142991,0,1,1,0,1,1
2023-06-01,142992,0,1,1,0,1,1
2023-06-01,142993,0,1,1,0,1,1
2023-06-01,142994,0,1,1,0,1,1
2023-06-01,142995,0,1,1,0,1,1
2023-06-01,142996,0,1,1,0,1,1
2023-06-01,142997,0,1,1,0,1,1
2023-06-01,142998,0,1,1,0,1,1
2023-06-01,142999,0,1,1,0,1,1
2023-06-01,143000,0,1,1,0,1,1
2023-06-01,143001,0,1,1,0,1,1
2023-06-01,143002,0,1,1,0,1,1
2023-06-01,143003,0,1,1,0,1,1
2023-06-01,143004,0,1,1,0,1,1
2023-06-01,143005,0,1,1,0,1,1
2023-06-01,143006,0,1,1,0,1,1
2023-06-01,143007,0,1,1,0,1,1
2023-06-01,143008,0,1,1,0,1,1
2023-06-01,143009,0,1,1,0,1,1
2023-06-01,143010,0,1,1,0,1,1
2023-06-01,143011,0,1,1,0,1,1
2023-06-01,143012,0,1,1,0,1,1
2023-06-01,143013,0,1,1,0,1,1
2023-06-01,143014,0,1,1,0,1,1
2023-06-01,143015,0,1,1,0,1,1
2023-06-01,143016,0,1,1,0,1,1
2023-06-01,143017,0,1,1,0,1,1
2023-06-01,143018,0,1,1,0,1,1
2023-06-01,143019,0,1,1,0,1,1
2023-06-01,143020,0,1,1,0,1,1
2023-06-01,143021,0,1,1,0,1,1
2023-06-01,143022,0,1,1,0,1,1
2023-06-01,143023,0,1,1,0,1,1
2023-06-01,143024,0,1,1,0,1,1
2023-06-01,143025,0,1,1,0,1,1
2023-06-01,143026,0,1,1,0,1,1
2023-06-01,143027,0,1,1,0,1,1
2023-06-01,143028,0,1,1,0,1,1
2023-06-01,143029,0,1,1,0,1,1
2023-06-01,143030,0,1,1,0,1,1
2023-06-01,143031,0,1,1,0,1,1
2023-06-01,143032,0,1,1,0,1,1
2023-06-01,143033,0,1,1,0,1,1
2023-06-01,143034,0,1,1,0,1,1
2023-06-01,143035,0,1,1,0,1,1
2023-06-01,143036,0,1,1,0,1,1
2023-06-01,143037,0,1,1,0,1,1
2023-06-01,143038,0,1,1,0,1,1
2023-06-01,143039,0,1,1,0,1,1
2023-06-01,143040,0,1,1,0,1,1
2023-06-01,143041,0,1,1,0,1,1
2023-06-01,143042,0,1,1,0,1,1
2023-06-01,143043,0,1,1,0,1,1
2023-06-01,143044,0,1,1,0,1,1
2023-06-01,143045,0,1,1,0,1,1
2023-06-01,143046,0,1,1,0,1,1
2023-06-01,143047,0,1,1,0,1,1
2023-06-01,143048,0,1,1,0,1,1
2023-06-01,143049,0,1,1,0,1,1
2023-06-01,143050,0,1,1,0,1,1
2023-06-01,143051,0,1,1,0,1,1
2023-06-01,143052,0,1,1,0,1,1
2023-06-01,143053,0,1,1,0,1,1
2023-06-01,143054,0,1,1,0,1,1
2023-06-01,143055,0,1,1,0,1,1
2023-06-01,143056,0,1,1,0,1,1
2023-06-01,143057,0,1,1,0,1,1
2023-06-01,143058,0,1,1,0,1,1
2023-06-01,143059,0,1,1,0,1,1
2023-06-01,143060,0,1,1,0,1,1
2023-06-01,143061,0,1,1,0,1,1
2023-06-01,143062,0,1,1,0,1,1
2023-06-01,143063,0,1,1,0,1,1
2023-06-01,143064,0,1,1,0,1,1
2023-06-01,143065,0,1,1,0,1,1
2023-06-01,143066,0,1,1,0,1,1
2023-06-01,143067,0,1,1,0,1,1
2023-06-01,143068,0,1,1,0,1,1
2023-06-01,143069,0,1,1,0,1,1
2023-06-01,143070,0,1,1,0,1,1
2023-06-01,143071,0,1,1,0,1,1
2023-06-01,143072,0,1,1,0,1,1
2023-06-01,143073,0,1,1,0,1,1
2023-06-01,143074,0,1,1,0,1,1
2023-06-01,143075,0,1,1,0,1,1
2023-06-01,143076,0,1,1,0,1,1
2023-06-01,143077,0,1,1,0,1,1
2023-06-01,143078,0,1,1,0,1,1
2023-06-01,143079,0,1,1,0,1,1
2023-06-01,143080,0,1,1,0,1,1
2023-06-01,143081,0,1,1,0,1,1
2023-06-01,143082,0,1,1,0,1,1
2023-06-01,143083,0,1,1,0,1,1
2023-06-01,143084,0,1,1,0,1,1
2023-06-01,143085,0,1,1,0,1,1
2023-06-01,143086,0,1,1,0,1,1
2023-06-01,143087,0,1,1,0,1,1
2023-06-01,143088,0,1,1,0,1,1
2023-06-01,143089,0,1,1,0,1,1
2023-06-01,143090,0,1,1,0,1,1
2023-06-01,143091,0,1,1,0,1,1
2023-06-01,143092,0,1,1,0,1,1
2023-06-01,143093,0,1,1,0,1,1
2023-06-01,143094,0,1,1,0,1,1
2023-06-01,143095,0,1,1,0,1,1
2023-06-01,143096,0,1,1,0,1,1
2023-06-01,143097,0,1,1,0,1,1
2023-06-01,143098,0,1,1,0,1,1
2023-06-01,143099,0,1,1,0,1,1
2023-06-01,143100,0,1,1,0,1,1
2023-06-01,143101,0,1,1,0,1,1
2023-06-01,143102,0,1,1,0,1,1
2023-06-01,143103,0,1,1,0,1,1
2023-06-01,143104,0,1,1,0,1,1
2023-06-01,143105,0,1,1,0,1,1
2023-06-01,143106,0,1,1,0,1,1
2023-06-01,143107,0,1,1,0,1,1
2023-06-01,143108,0,1,1,0,1,1
2023-06-01,143109,0,1,1,0,1,1
2023-06-01,143110,0,1,1,0,1,1
2023-06-01,143111,0,1,1,0,1,1
2023-06-01,143112,0,1,1,0,1,1
2023-06-01,143113,0,1,1,0,1,1
2023-06-01,143114,0,1,1,0,1,1
2023-06-01,143115,0,1,1,0,1,1
2023-06-01,143116,0,1,1,0,1,1
2023-06-01,143117,0,1,1,0,1,1
2023-06-01,143118,0,1,1,0,1,1
2023-06-01,143119,0,1,1,0,1,1
2023-06-01,143120,0,1,1,0,1,1
2023-06-01,143121,0,1,1,0,1,1
2023-06-01,143122,0,1,1,0,1,1
2023-06-01,143123,0,1,1,0,1,1
2023-06-01,143124,0,1,1,0,1,1
2023-06-01,143125,0,1,1,0,1,1
2023-06-01,143126,0,1,1,0,1,1
2023-06-01,143127,0,1,1,0,1,1
2023-06-01,143128,0,1,1,0,1,1
2023-06-01,143129,0,1,1,0,1,1
2023-06-01,143130,0,1,1,0,1,1
2023-06-01,143131,0,1,1,0,1,1
2023-06-01,143132,0,1,1,0,1,1
2023-06-01,143133,0,1,1,0,1,1
2023-06-01,143134,0,1,1,0,1,1
2023-06-01,143135,0,1,1,0,1,1
2023-06-01,143136,0,1,1,0,1,1
2023-06-01,143137,0,1,1,0,1,1
2023-06-01,143138,0,1,1,0,1,1
2023-06-01,143139,0,1,1,0,1,1
2023-06-01,143140,0,1,1,0,1,1
2023-06-01,143141,0,1,1,0,1,1
2023-06-01,143142,0,1,1,0,1,1
2023-06-01,143143,0,1,1,0,1,1
2023-06-01,143144,0,1,1,0,1,1
2023-06-01,143145,0,1,1,0,1,1
2023-06-01,143146,0,1,1,0,1,1
2023-06-01,143147,0,1,1,0,1,1
2023-06-01,143148,0,1,1,0,1,1
2023-06-01,143149,0,1,1,0,1,1
2023-06-01,143150,0,1,1,0,1,1
2023-06-01,143151,0,1,1,0,1,1
2023-06-01,143152,0,1,1,0,1,1
2023-06-01,143153,0,1,1,0,1,1
2023-06-01,143154,0,1,1,0,1,1
2023-06-01,143155,0,1,1,0,1,1
2023-06-01,143156,0,1,1,0,1,1
2023-06-01,143157,0,1,1,0,1,1
2023-06-01,143158,0,1,1,0,1,1
2023-06-01,143159,0,1,1,0,1,1
2023-06-01,143160,0,1,1,0,1,1
2023-06-01,143161,0,1,1,0,1,1
2023-06-01,143162,0,1,1,0,1,1
2023-06-01,143163,0,1,1,0,1,1
2023-06-01,143164,0,1,1,0,1,1
2023-06-01,143165,0,1,1,0,1,1
2023-06-01,143166,0,1,1,0,1,1
2023-06-01,143167,0,1,1,0,1,1
2023-06-01,143168,0,1,1,0,1,1
2023-06-01,143169,0,1,1,0,1,1
2023-06-01,143170,0,1,1,0,1,1
2023-06-01,143171,0,1,1,0,1,1
2023-06-01,143172,0,1,1,0,1,1
2023-06-01,143173,0,1,1,0,1,1
2023-06-01,143174,0,1,1,0,1,1
2023-06-01,143175,0,1,1,0,1,1
2023-06-01,143176,0,1,1,0,1,1
2023-06-01,143177,0,1,1,0,1,1
2023-06-01,143178,0,1,1,0,1,1
2023-06-01,143179,0,1,1,0,1,1
2023-06-01,143180,0,1,1,0,1,1
2023-06-01,143181,0,1,1,0,1,1
2023-06-01,143182,0,1,1,0,1,1
2023-06-01,143183,0,1,1,0,1,1
2023-06-01,143184,0,1,1,0,1,1
2023-06-01,143185,0,1,1,0,1,1
2023-06-01,143186,0,1,1,0,1,1
2023-06-01,143187,0,1,1,0,1,1
2023-06-01,143188,0,1,1,0,1,1
2023-06-01,143189,0,1,1,0,1,1
2023-06-01,143190,0,1,1,0,1,1
2023-06-01,143191,0,1,1,0,1,1
2023-06-01,143192,0,1,1,0,1,1
2023-06-01,143193,0,1,1,0,1,1
2023-06-01,143194,0,1,1,0,1,1
2023-06-01,143195,0,1,1,0,1,1
2023-06-01,143196,0,1,1,0,1,1
2023-06-01,143197,0,1,1,0,1,1
2023-06-01,143198,0,1,1,0,1,1
2023-06-01,143199,0,1,1,0,1,1
2023-06-01,143200,0,1,1,0,1,1
2023-06-01,143201,0,1,1,0,1,1
2023-06-01,143202,0,1,1,0,1,1
2023-06-01,143203,0,1,1,0,1,1
2023-06-01,143204,0,1,1,0,1,1
2023-06-01,143205,0,1,1,0,1,1
2023-06-01,143206,0,1,1,0,1,1
2023-06-01,143207,0,1,1,0,1,1
2023-06-01,143208,0,1,1,0,1,1
2023-06-01,143209,0,1,1,0,1,1
2023-06-01,143210,0,1,1,0,1,1
2023-06-01,143211,0,1,1,0,1,1
2023-06-01,143212,0,1,1,0,1,1
2023-06-01,143213,0,1,1,0,1,1
2023-06-01,143214,0,1,1,0,1,1
2023-06-01,143215,0,1,1,0,1,1
2023-06-01,143216,0,1,1,0,1,1
2023-06-01,143217,0,1,1,0,1,1
2023-06-01,143218,0,1,1,0,1,1
2023-06-01,143219,0,1,1,0,1,1
2023-06-01,143220,0,1,1,0,1,1
2023-06-01,143221,0,1,1,0,1,1
2023-06-01,143222,0,1,1,0,1,1
2023-06-01,143223,0,1,1,0,1,1
2023-06-01,143224,0,1,1,0,1,1
2023-06-01,143225,0,1,1,0,1,1
2023-06-01,143226,0,1,1,0,1,1
2023-06-01,143227,0,1,1,0,1,1
2023-06-01,143228,0,1,1,0,1,1
2023-06-01,143229,0,1,1,0,1,1
2023-06-01,143230,0,1,1,0,1,1
2023-06-01,143231,0,1,1,0,1,1
2023-06-01,143232,0,1,1,0,1,1
2023-06-01,143233,0,1,1,0,1,1
2023-06-01,143234,0,1,1,0,1,1
2023-06-01,143235,0,1,1,0,1,1
2023-06-01,143236,0,1,1,0,1,1
2023-06-01,143237,0,1,1,0,1,1
2023-06-01,143238,0,1,1,0,1,1
2023-06-01,143239,0,1,1,0,1,1
2023-06-01,143240,0,1,1,0,1,1
2023-06-01,143241,0,1,1,0,1,1
2023-06-01,143242,0,1,1,0,1,1
2023-06-01,143243,0,1,1,0,1,1
2023-06-01,143244,0,1,1,0,1,1
2023-06-01,143245,0,1,1,0,1,1
2023-06-01,143246,0,1,1,0,1,1
2023-06-01,143247,0,1,1,0,1,1
2023-06-01,143248,0,1,1,0,1,1
2023-06-01,143249,0,1,1,0,1,1
2023-06-01,143250,0,1,1,0,1,1
2023-06-01,143251,0,1,1,0,1,1
2023-06-01,143252,0,1,1,0,1,1
2023-06-01,143253,0,1,1,0,1,1
2023-06-01,143254,0,1,1,0,1,1
2023-06-01,143255,0,1,1,0,1,1
2023-06-01,143256,0,1,1,0,1,1
2023-06-01,143257,0,1,1,0,1,1
2023-06-01,143258,0,1,1,0,1,1
2023-06-01,143259,0,1,1,0,1,1
2023-06-01,143260,0,1,1,0,1,1
2023-06-01,143261,0,1,1,0,1,1
2023-06-01,143262,0,1,1,0,1,1
2023-06-01,143263,0,1,1,0,1,1
2023-06-01,143264,0,1,1,0,1,1
2023-06-01,143265,0,1,1,0,1,1
2023-06-01,143266,0,1,1,0,1,1
2023-06-01,143267,0,1,1,0,1,1
2023-06-01,143268,0,1,1,0,1,1
2023-06-01,143269,0,1,1,0,1,1
2023-06-01,143270,0,1,1,0,1,1
2023-06-01,143271,0,1,1,0,1,1
2023-06-01,143272,0,1,1,0,1,1
2023-06-01,143273,0,1,1,0,1,1
2023-06-01,143274,0,1,1,0,1,1
2023-06-01,143275,0,1,1,0,1,1
2023-06-01,143276,0,1,1,0,1,1
2023-06-01,143277,0,1,1,0,1,1
2023-06-01,143278,0,1,1,0,1,1
2023-06-01,143279,0,1,1,0,1,1
2023-06-01,143280,0,1,1,0,1,1
2023-06-01,143281,0,1,1,0,1,1
2023-06-01,143282,0,1,1,0,1,1
2023-06-01,143283,0,1,1,0,1,1
2023-06-01,143284,0,1,1,0,1,1
2023-06-01,143285,0,1,1,0,1,1
2023-06-01,143286,0,1,1,0,1,1
2023-06-01,143287,0,1,1,0,1,1
2023-06-01,143288,0,1,1,0,1,1
2023-06-01,143289,0,1,1,0,1,1
2023-06-01,143290,0,1,1,0,1,1
2023-06-01,143291,0,1,1,0,1,1
2023-06-01,143292,0,1,1,0,1,1
2023-06-01,143293,0,1,1,0,1,1
2023-06-01,143294,0,1,1,0,1,1
2023-06-01,143295,0,1,1,0,1,1
2023-06-01,143296,0,1,1,0,1,1
2023-06-01,143297,0,1,1,0,1,1
2023-06-01,143298,0,1,1,0,1,1
2023-06-01,143299,0,1,1,0,1,1
2023-06-01,143300,0,1,1,0,1,1
2023-06-01,143301,0,1,1,0,1,1
2023-06-01,143302,0,1,1,0,1,1
2023-06-01,143303,0,1,1,0,1,1
2023-06-01,143304,0,1,1,0,1,1
2023-06-01,143305,0,1,1,0,1,1
2023-06-01,143306,0,1,1,0,1,1
2023-06-01,143307,0,1,1,0,1,1
2023-06-01,143308,0,1,1,0,1,1
2023-06-01,143309,0,1,1,0,1,1
2023-06-01,143310,0,1,1,0,1,1
2023-06-01,143311,0,1,1,0,1,1
2023-06-01,143312,0,1,1,0,1,1
2023-06-01,143313,0,1,1,0,1,1
2023-06-01,143314,0,1,1,0,1,1
2023-06-01,143315,0,1,1,0,1,1
2023-06-01,143316,0,1,1,0,1,1
2023-06-01,143317,0,1,1,0,1,1
2023-06-01,143318,0,1,1,0,1,1
2023-06-01,143319,0,1,1,0,1,1
2023-06-01,143320,0,1,1,0,1,1
2023-06-01,143321,0,1,1,0,1,1
2023-06-01,143322,0,1,1,0,1,1
2023-06-01,143323,0,1,1,0,1,1
2023-06-01,143324,0,1,1,0,1,1
2023-06-01,143325,0,1,1,0,1,1
2023-06-01,143326,0,1,1,0,1,1
2023-06-01,143327,0,1,1,0,1,1
2023-06-01,143328,0,1,1,0,1,1
2023-06-01,143329,0,1,1,0,1,1
2023-06-01,143330,0,1,1,0,1,1
2023-06-01,143331,0,1,1,0,1,1
2023-06-01,143332,0,1,1,0,1,1
2023-06-01,143333,0,1,1,0,1,1
2023-06-01,143334,0,1,1,0,1,1
2023-06-01,143335,0,1,1,0,1,1
2023-06-01,143336,0,1,1,0,1,1
2023-06-01,143337,0,1,1,0,1,1
2023-06-01,143338,0,1,1,0,1,1
2023-06-01,143339,0,1,1,0,1,1
2023-06-01,143340,0,1,1,0,1,1
2023-06-01,143341,0,1,1,0,1,1
2023-06-01,143342,0,1,1,0,1,1
2023-06-01,143343,0,1,1,0,1,1
2023-06-01,143344,0,1,1,0,1,1
2023-06-01,143345,0,1,1,0,1,1
2023-06-01,143346,0,1,1,0,1,1
2023-06-01,143347,0,1,1,0,1,1
2023-06-01,143348,0,1,1,0,1,1
2023-06-01,143349,0,1,1,0,1,1
2023-06-01,143350,0,1,1,0,1,1
2023-06-01,143351,0,1,1,0,1,1
2023-06-01,143352,0,1,1,0,1,1
2023-06-01,143353,0,1,1,0,1,1
2023-06-01,143354,0,1,1,0,1,1
2023-06-01,143355,0,1,1,0,1,1
2023-06-01,143356,0,1,1,0,1,1
2023-06-01,143357,0,1,1,0,1,1
2023-06-01,143358,0,1,1,0,1,1
2023-06-01,143359,0,1,1,0,1,1
2023-06-01,143360,0,1,1,0,1,1
2023-06-01,143361,0,1,1,0,1,1
2023-06-01,143362,0,1,1,0,1,1
2023-06-01,143363,0,1,1,0,1,1
2023-06-01,143364,0,1,1,0,1,1
2023-06-01,143365,0,1,1,0,1,1
2023-06-01,143366,0,1,1,0,1,1
2023-06-01,143367,0,1,1,0,1,1
2023-06-01,143368,0,1,1,0,1,1
2023-06-01,143369,0,1,1,0,1,1
2023-06-01,143370,0,1,1,0,1,1
2023-06-01,143371,0,1,1,0,1,1
2023-06-01,143372,0,1,1,0,1,1
2023-06-01,143373,0,1,1,0,1,1
2023-06-01,143374,0,1,1,0,1,1
2023-06-01,143375,0,1,1,0,1,1
2023-06-01,143376,0,1,1,0,1,1
2023-06-01,143377,0,1,1,0,1,1
2023-06-01,143378,0,1,1,0,1,1
2023-06-01,143379,0,1,1,0,1,1
2023-06-01,143380,0,1,1,0,1,1
2023-06-01,143381,0,1,1,0,1,1
2023-06-01,143382,0,1,1,0,1,1
2023-06-01,143383,0,1,1,0,1,1
2023-06-01,143384,0,1,1,0,1,1
2023-06-01,143385,0,1,1,0,1,1
2023-06-01,143386,0,1,1,0,1,1
2023-06-01,143387,0,1,1,0,1,1
2023-06-01,143388,0,1,1,0,1,1
2023-06-01,143389,0,1,1,0,1,1
2023-06-01,143390,0,1,1,0,1,1
2023-06-01,143391,0,1,1,0,1,1
2023-06-01,143392,0,1,1,0,1,1
2023-06-01,143393,0,1,1,0,1,1
2023-06-01,143394,0,1,1,0,1,1
2023-06-01,143395,0,1,1,0,1,1
2023-06-01,143396,0,1,1,0,1,1
2023-06-01,143397,0,1,1,0,1,1
2023-06-01,143398,0,1,1,0,1,1
2023-06-01,143399,0,1,1,0,1,1
2023-06-01,143400,0,1,1,0,1,1
2023-06-01,143401,0,1,1,0,1,1
2023-06-01,143402,0,1,1,0,1,1
2023-06-01,143403,0,1,1,0,1,1
2023-06-01,143404,0,1,1,0,1,1
2023-06-01,143405,0,1,1,0,1,1
2023-06-01,143406,0,1,1,0,1,1
2023-06-01,143407,0,1,1,0,1,1
2023-06-01,143408,0,1,1,0,1,1
2023-06-01,143409,0,1,1,0,1,1
2023-06-01,143410,0,1,1,0,1,1
2023-06-01,143411,0,1,1,0,1,1
2023-06-01,143412,0,1,1,0,1,1
2023-06-01,143413,0,1,1,0,1,1
2023-06-01,143414,0,1,1,0,1,1
2023-06-01,143415,0,1,1,0,1,1
2023-06-01,143416,0,1,1,0,1,1
2023-06-01,143417,0,1,1,0,1,1
2023-06-01,143418,0,1,1,0,1,1
2023-06-01,143419,0,1,1,0,1,1
2023-06-01,143420,0,1,1,0,1,1
2023-06-01,143421,0,1,1,0,1,1
2023-06-01,143422,0,1,1,0,1,1
2023-06-01,143423,0,1,1,0,1,1
2023-06-01,143424,0,1,1,0,1,1
2023-06-01,143425,0,1,1,0,1,1
2023-06-01,143426,0,1,1,0,1,1
2023-06-01,143427,0,1,1,0,1,1
2023-06-01,143428,0,1,1,0,1,1
2023-06-01,143429,0,1,1,0,1,1
2023-06-01,143430,0,1,1,0,1,1
2023-06-01,143431,0,1,1,0,1,1
2023-06-01,143432,0,1,1,0,1,1
2023-06-01,143433,0,1,1,0,1,1
2023-06-01,143434,0,1,1,0,1,1
2023-06-01,143435,0,1,1,0,1,1
2023-06-01,143436,0,1,1,0,1,1
2023-06-01,143437,0,1,1,0,1,1
2023-06-01,143438,0,1,1,0,1,1
2023-06-01,143439,0,1,1,0,1,1
2023-06-01,143440,0,1,1,0,1,1
2023-06-01,143441,0,1,1,0,1,1
2023-06-01,143442,0,1,1,0,1,1
2023-06-01,143443,0,1,1,0,1,1
2023-06-01,143444,0,1,1,0,1,1
2023-06-01,143445,0,1,1,0,1,1
2023-06-01,143446,0,1,1,0,1,1
2023-06-01,143447,0,1,1,0,1,1
2023-06-01,143448,0,1,1,0,1,1
2023-06-01,143449,0,1,1,0,1,1
2023-06-01,143450,0,1,1,0,1,1
2023-06-01,143451,0,1,1,0,1,1
2023-06-01,143452,0,1,1,0,1,1
2023-06-01,143453,0,1,1,0,1,1
2023-06-01,143454,0,1,1,0,1,1
2023-06-01,143455,0,1,1,0,1,1
2023-06-01,143456,0,1,1,0,1,1
2023-06-01,143457,0,1,1,0,1,1
2023-06-01,143458,0,1,1,0,1,1
2023-06-01,143459,0,1,1,0,1,1
2023-06-01,143460,0,1,1,0,1,1
2023-06-01,143461,0,1,1,0,1,1
2023-06-01,143462,0,1,1,0,1,1
2023-06-01,143463,0,1,1,0,1,1
2023-06-01,143464,0,1,1,0,1,1
2023-06-01,143465,0,1,1,0,1,1
2023-06-01,143466,0,1,1,0,1,1
2023-06-01,143467,0,1,1,0,1,1
2023-06-01,143468,0,1,1,0,1,1
2023-06-01,143469,0,1,1,0,1,1
2023-06-01,143470,0,1,1,0,1,1
2023-06-01,143471,0,1,1,0,1,1
2023-06-01,143472,0,1,1,0,1,1
2023-06-01,143473,0,1,1,0,1,1
2023-06-01,143474,0,1,1,0,1,1
2023-06-01,143475,0,1,1,0,1,1
2023-06-01,143476,0,1,1,0,1,1
2023-06-01,143477,0,1,1,0,1,1
2023-06-01,143478,0,1,1,0,1,1
2023-06-01,143479,0,1,1,0,1,1
2023-06-01,143480,0,1,1,0,1,1
2023-06-01,143481,0,1,1,0,1,1
2023-06-01,143482,0,1,1,0,1,1
2023-06-01,143483,0,1,1,0,1,1
2023-06-01,143484,0,1,1,0,1,1
2023-06-01,143485,0,1,1,0,1,1
2023-06-01,143486,0,1,1,0,1,1
2023-06-01,143487,0,1,1,0,1,1
2023-06-01,143488,0,1,1,0,1,1
2023-06-01,143489,0,1,1,0,1,1
2023-06-01,143490,0,1,1,0,1,1
2023-06-01,143491,0,1,1,0,1,1
2023-06-01,143492,0,1,1,0,1,1
2023-06-01,143493,0,1,1,0,1,1
2023-06-01,143494,0,1,1,0,1,1
2023-06-01,143495,0,1,1,0,1,1
2023-06-01,143496,0,1,1,0,1,1
2023-06-01,143497,0,1,1,0,1,1
2023-06-01,143498,0,1,1,0,1,1
2023-06-01,143499,0,1,1,0,1,1
2023-06-01,143500,0,1,1,0,1,1
2023-06-01,143501,0,1,1,0,1,1
2023-06-01,143502,0,1,1,0,1,1
2023-06-01,143503,0,1,1,0,1,1
2023-06-01,143504,0,1,1,0,1,1
2023-06-01,143505,0,1,1,0,1,1
2023-06-01,143506,0,1,1,0,1,1
2023-06-01,143507,0,1,1,0,1,1
2023-06-01,143508,0,1,1,0,1,1
2023-06-01,143509,0,1,1,0,1,1
2023-06-01,143510,0,1,1,0,1,1
2023-06-01,143511,0,1,1,0,1,1
2023-06-01,143512,0,1,1,0,1,1
2023-06-01,143513,0,1,1,0,1,1
2023-06-01,143514,0,1,1,0,1,1
2023-06-01,143515,0,1,1,0,1,1
2023-06-01,143516,0,1,1,0,1,1
2023-06-01,143517,0,1,1,0,1,1
2023-06-01,143518,0,1,1,0,1,1
2023-06-01,143519,0,1,1,0,1,1
2023-06-01,143520,0,1,1,0,1,1
2023-06-01,143521,0,1,1,0,1,1
2023-06-01,143522,0,1,1,0,1,1
2023-06-01,143523,0,1,1,0,1,1
2023-06-01,143524,0,1,1,0,1,1
2023-06-01,143525,0,1,1,0,1,1
2023-06-01,143526,0,1,1,0,1,1
2023-06-01,143527,0,1,1,0,1,1
2023-06-01,143528,0,1,1,0,1,1
2023-06-01,143529,0,1,1,0,1,1
2023-06-01,143530,0,1,1,0,1,1
2023-06-01,143531,0,1,1,0,1,1
2023-06-01,143532,0,1,1,0,1,1
2023-06-01,143533,0,1,1,0,1,1
2023-06-01,143534,0,1,1,0,1,1
2023-06-01,143535,0,1,1,0,1,1
2023-06-01,143536,0,1,1,0,1,1
2023-06-01,143537,0,1,1,0,1,1
2023-06-01,143538,0,1,1,0,1,1
2023-06-01,143539,0,1,1,0,1,1
2023-06-01,143540,0,1,1,0,1,1
2023-06-01,143541,0,1,1,0,1,1
2023-06-01,143542,0,1,1,0,1,1
2023-06-01,143543,0,1,1,0,1,1
2023-06-01,143544,0,1,1,0,1,1
2023-06-01,143545,0,1,1,0,1,1
2023-06-01,143546,0,1,1,0,1,1
2023-06-01,143547,0,1,1,0,1,1
2023-06-01,143548,0,1,1,0,1,1
2023-06-01,143549,0,1,1,0,1,1
2023-06-01,143550,0,1,1,0,1,1
2023-06-01,143551,0,1,1,0,1,1
2023-06-01,143552,0,1,1,0,1,1
2023-06-01,143553,0,1,1,0,1,1
2023-06-01,143554,0,1,1,0,1,1
2023-06-01,143555,0,1,1,0,1,1
2023-06-01,143556,0,1,1,0,1,1
2023-06-01,143557,0,1,1,0,1,1
2023-06-01,143558,0,1,1,0,1,1
2023-06-01,143559,0,1,1,0,1,1
2023-06-01,143560,0,1,1,0,1,1
2023-06-01,143561,0,1,1,0,1,1
2023-06-01,143562,0,1,1,0,1,1
2023-06-01,143563,0,1,1,0,1,1
2023-06-01,143564,0,1,1,0,1,1
2023-06-01,143565,0,1,1,0,1,1
2023-06-01,143566,0,1,1,0,1,1
2023-06-01,143567,0,1,1,0,1,1
2023-06-01,143568,0,1,1,0,1,1
2023-06-01,143569,0,1,1,0,1,1
2023-06-01,143570,0,1,1,0,1,1
2023-06-01,143571,0,1,1,0,1,1
2023-06-01,143572,0,1,1,0,1,1
2023-06-01,143573,0,1,1,0,1,1
2023-06-01,143574,0,1,1,0,1,1
2023-06-01,143575,0,1,1,0,1,1
2023-06-01,143576,0,1,1,0,1,1
2023-06-01,143577,0,1,1,0,1,1
2023-06-01,143578,0,1,1,0,1,1
2023-06-01,143579,0,1,1,0,1,1
2023-06-01,143580,0,1,1,0,1,1
2023-06-01,143581,0,1,1,0,1,1
2023-06-01,143582,0,1,1,0,1,1
2023-06-01,143583,0,1,1,0,1,1
2023-06-01,143584,0,1,1,0,1,1
2023-06-01,143585,0,1,1,0,1,1
2023-06-01,143586,0,1,1,0,1,1
2023-06-01,143587,0,1,1,0,1,1
2023-06-01,143588,0,1,1,0,1,1
2023-06-01,143589,0,1,1,0,1,1
2023-06-01,143590,0,1,1,0,1,1
2023-06-01,143591,0,1,1,0,1,1
2023-06-01,143592,0,1,1,0,1,1
2023-06-01,143593,0,1,1,0,1,1
2023-06-01,143594,0,1,1,0,1,1
2023-06-01,143595,0,1,1,0,1,1
2023-06-01,143596,0,1,1,0,1,1
2023-06-01,143597,0,1,1,0,1,1
2023-06-01,143598,0,1,1,0,1,1
2023-06-01,143599,0,1,1,0,1,1
2023-06-01,143600,0,1,1,0,1,1
2023-06-01,143601,0,1,1,0,1,1
2023-06-01,143602,0,1,1,0,1,1
2023-06-01,143603,0,1,1,0,1,1
2023-06-01,143604,0,1,1,0,1,1
2023-06-01,143605,0,1,1,0,1,1
2023-06-01,143606,0,1,1,0,1,1
2023-06-01,143607,0,1,1,0,1,1
2023-06-01,143608,0,1,1,0,1,1
2023-06-01,143609,0,1,1,0,1,1
2023-06-01,143610,0,1,1,0,1,1
2023-06-01,143611,0,1,1,0,1,1
2023-06-01,143612,0,1,1,0,1,1
2023-06-01,143613,0,1,1,0,1,1
2023-06-01,143614,0,1,1,0,1,1
2023-06-01,143615,0,1,1,0,1,1
2023-06-01,143616,0,1,1,0,1,1
2023-06-01,143617,0,1,1,0,1,1
2023-06-01,143618,0,1,1,0,1,1
2023-06-01,143619,0,1,1,0,1,1
2023-06-01,143620,0,1,1,0,1,1
2023-06-01,143621,0,1,1,0,1,1
2023-06-01,143622,0,1,1,0,1,1
2023-06-01,143623,0,1,1,0,1,1
2023-06-01,143624,0,1,1,0,1,1
2023-06-01,143625,0,1,1,0,1,1
2023-06-01,143626,0,1,1,0,1,1
2023-06-01,143627,0,1,1,0,1,1
2023-06-01,143628,0,1,1,0,1,1
2023-06-01,143629,0,1,1,0,1,1
2023-06-01,143630,0,1,1,0,1,1
2023-06-01,143631,0,1,1,0,1,1
2023-06-01,143632,0,1,1,0,1,1
2023-06-01,143633,0,1,1,0,1,1
2023-06-01,143634,0,1,1,0,1,1
2023-06-01,143635,0,1,1,0,1,1
2023-06-01,143636,0,1,1,0,1,1
2023-06-01,143637,0,1,1,0,1,1
2023-06-01,143638,0,1,1,0,1,1
2023-06-01,143639,0,1,1,0,1,1
2023-06-01,143640,0,1,1,0,1,1
2023-06-01,143641,0,1,1,0,1,1
2023-06-01,143642,0,1,1,0,1,1
2023-06-01,143643,0,1,1,0,1,1
2023-06-01,143644,0,1,1,0,1,1
2023-06-01,143645,0,1,1,0,1,1
2023-06-01,143646,0,1,1,0,1,1
2023-06-01,143647,0,1,1,0,1,1
2023-06-01,143648,0,1,1,0,1,1
2023-06-01,143649,0,1,1,0,1,1
2023-06-01,143650,0,1,1,0,1,1
2023-06-01,143651,0,1,1,0,1,1
2023-06-01,143652,0,1,1,0,1,1
2023-06-01,143653,0,1,1,0,1,1
2023-06-01,143654,0,1,1,0,1,1
2023-06-01,143655,0,1,1,0,1,1
2023-06-01,143656,0,1,1,0,1,1
2023-06-01,143657,0,1,1,0,1,1
2023-06-01,143658,0,1,1,0,1,1
2023-06-01,143659,0,1,1,0,1,1
2023-06-01,143660,0,1,1,0,1,1
2023-06-01,143661,0,1,1,0,1,1
2023-06-01,143662,0,1,1,0,1,1
2023-06-01,143663,0,1,1,0,1,1
2023-06-01,143664,0,1,1,0,1,1
2023-06-01,143665,0,1,1,0,1,1
2023-06-01,143666,0,1,1,0,1,1
2023-06-01,143667,0,1,1,0,1,1
2023-06-01,143668,0,1,1,0,1,1
2023-06-01,143669,0,1,1,0,1,1
2023-06-01,143670,0,1,1,0,1,1
2023-06-01,143671,0,1,1,0,1,1
2023-06-01,143672,0,1,1,0,1,1
2023-06-01,143673,0,1,1,0,1,1
2023-06-01,143674,0,1,1,0,1,1
2023-06-01,143675,0,1,1,0,1,1
2023-06-01,143676,0,1,1,0,1,1
2023-06-01,143677,0,1,1,0,1,1
2023-06-01,143678,0,1,1,0,1,1
2023-06-01,143679,0,1,1,0,1,1
2023-06-01,143680,0,1,1,0,1,1
2023-06-01,143681,0,1,1,0,1,1
2023-06-01,143682,0,1,1,0,1,1
2023-06-01,143683,0,1,1,0,1,1
2023-06-01,143684,0,1,1,0,1,1
2023-06-01,143685,0,1,1,0,1,1
2023-06-01,143686,0,1,1,0,1,1
2023-06-01,143687,0,1,1,0,1,1
2023-06-01,143688,0,1,1,0,1,1
2023-06-01,143689,0,1,1,0,1,1
2023-06-01,143690,0,1,1,0,1,1
2023-06-01,143691,0,1,1,0,1,1
2023-06-01,143692,0,1,1,0,1,1
2023-06-01,143693,0,1,1,0,1,1
2023-06-01,143694,0,1,1,0,1,1
2023-06-01,143695,0,1,1,0,1,1
2023-06-01,143696,0,1,1,0,1,1
2023-06-01,143697,0,1,1,0,1,1
2023-06-01,143698,0,1,1,0,1,1
2023-06-01,143699,0,1,1,0,1,1
2023-06-01,143700,0,1,1,0,1,1
2023-06-01,143701,0,1,1,0,1,1
2023-06-01,143702,0,1,1,0,1,1
2023-06-01,143703,0,1,1,0,1,1
2023-06-01,143704,0,1,1,0,1,1
2023-06-01,143705,0,1,1,0,1,1
2023-06-01,143706,0,1,1,0,1,1
2023-06-01,143707,0,1,1,0,1,1
2023-06-01,143708,0,1,1,0,1,1
2023-06-01,143709,0,1,1,0,1,1
2023-06-01,143710,0,1,1,0,1,1
2023-06-01,143711,0,1,1,0,1,1
2023-06-01,143712,0,1,1,0,1,1
2023-06-01,143713,0,1,1,0,1,1
2023-06-01,143714,0,1,1,0,1,1
2023-06-01,143715,0,1,1,0,1,1
2023-06-01,143716,0,1,1,0,1,1
2023-06-01,143717,0,1,1,0,1,1
2023-06-01,143718,0,1,1,0,1,1
2023-06-01,143719,0,1,1,0,1,1
2023-06-01,143720,0,1,1,0,1,1
2023-06-01,143721,0,1,1,0,1,1
2023-06-01,143722,0,1,1,0,1,1
2023-06-01,143723,0,1,1,0,1,1
2023-06-01,143724,0,1,1,0,1,1
2023-06-01,143725,0,1,1,0,1,1
2023-06-01,143726,0,1,1,0,1,1
2023-06-01,143727,0,1,1,0,1,1
2023-06-01,143728,0,1,1,0,1,1
2023-06-01,143729,0,1,1,0,1,1
2023-06-01,143730,0,1,1,0,1,1
2023-06-01,143731,0,1,1,0,1,1
2023-06-01,143732,0,1,1,0,1,1
2023-06-01,143733,0,1,1,0,1,1
2023-06-01,143734,0,1,1,0,1,1
2023-06-01,143735,0,1,1,0,1,1
2023-06-01,143736,0,1,1,0,1,1
2023-06-01,143737,0,1,1,0,1,1
2023-06-01,143738,0,1,1,0,1,1
2023-06-01,143739,0,1,1,0,1,1
2023-06-01,143740,0,1,1,0,1,1
2023-06-01,143741,0,1,1,0,1,1
2023-06-01,143742,0,1,1,0,1,1
2023-06-01,143743,0,1,1,0,1,1
2023-06-01,143744,0,1,1,0,1,1
2023-06-01,143745,0,1,1,0,1,1
2023-06-01,143746,0,1,1,0,1,1
2023-06-01,143747,0,1,1,0,1,1
2023-06-01,143748,0,1,1,0,1,1
2023-06-01,143749,0,1,1,0,1,1
2023-06-01,143750,0,1,1,0,1,1
2023-06-01,143751,0,1,1,0,1,1
2023-06-01,143752,0,1,1,0,1,1
2023-06-01,143753,0,1,1,0,1,1
2023-06-01,143754,0,1,1,0,1,1
2023-06-01,143755,0,1,1,0,1,1
2023-06-01,143756,0,1,1,0,1,1
2023-06-01,143757,0,1,1,0,1,1
2023-06-01,143758,0,1,1,0,1,1
2023-06-01,143759,0,1,1,0,1,1
2023-06-01,143760,0,1,1,0,1,1
2023-06-01,143761,0,1,1,0,1,1
2023-06-01,143762,0,1,1,0,1,1
2023-06-01,143763,0,1,1,0,1,1
2023-06-01,143764,0,1,1,0,1,1
2023-06-01,143765,0,1,1,0,1,1
2023-06-01,143766,0,1,1,0,1,1
2023-06-01,143767,0,1,1,0,1,1
2023-06-01,143768,0,1,1,0,1,1
2023-06-01,143769,0,1,1,0,1,1
2023-06-01,143770,0,1,1,0,1,1
2023-06-01,143771,0,1,1,0,1,1
2023-06-01,143772,0,1,1,0,1,1
2023-06-01,143773,0,1,1,0,1,1
2023-06-01,143774,0,1,1,0,1,1
2023-06-01,143775,0,1,1,0,1,1
2023-06-01,143776,0,1,1,0,1,1
2023-06-01,143777,0,1,1,0,1,1
2023-06-01,143778,0,1,1,0,1,1
2023-06-01,143779,0,1,1,0,1,1
2023-06-01,143780,0,1,1,0,1,1
2023-06-01,143781,0,1,1,0,1,1
2023-06-01,143782,0,1,1,0,1,1
2023-06-01,143783,0,1,1,0,1,1
2023-06-01,143784,0,1,1,0,1,1
2023-06-01,143785,0,1,1,0,1,1
2023-06-01,143786,0,1,1,0,1,1
2023-06-01,143787,0,1,1,0,1,1
2023-06-01,143788,0,1,1,0,1,1
2023-06-01,143789,0,1,1,0,1,1
2023-06-01,143790,0,1,1,0,1,1
2023-06-01,143791,0,1,1,0,1,1
2023-06-01,143792,0,1,1,0,1,1
2023-06-01,143793,0,1,1,0,1,1
2023-06-01,143794,0,1,1,0,1,1
2023-06-01,143795,0,1,1,0,1,1
2023-06-01,143796,0,1,1,0,1,1
2023-06-01,143797,0,1,1,0,1,1
2023-06-01,143798,0,1,1,0,1,1
2023-06-01,143799,0,1,1,0,1,1
2023-06-01,143800,0,1,1,0,1,1
2023-06-01,143801,0,1,1,0,1,1
2023-06-01,143802,0,1,1,0,1,1
2023-06-01,143803,0,1,1,0,1,1
2023-06-01,143804,0,1,1,0,1,1
2023-06-01,143805,0,1,1,0,1,1
2023-06-01,143806,0,1,1,0,1,1
2023-06-01,143807,0,1,1,0,1,1
2023-06-01,143808,0,1,1,0,1,1
2023-06-01,143809,0,1,1,0,1,1
2023-06-01,143810,0,1,1,0,1,1
2023-06-01,143811,0,1,1,0,1,1
2023-06-01,143812,0,1,1,0,1,1
2023-06-01,143813,0,1,1,0,1,1
2023-06-01,143814,0,1,1,0,1,1
2023-06-01,143815,0,1,1,0,1,1
2023-06-01,143816,0,1,1,0,1,1
2023-06-01,143817,0,1,1,0,1,1
2023-06-01,143818,0,1,1,0,1,1
2023-06-01,143819,0,1,1,0,1,1
2023-06-01,143820,0,1,1,0,1,1
2023-06-01,143821,0,1,1,0,1,1
2023-06-01,143822,0,1,1,0,1,1
2023-06-01,143823,0,1,1,0,1,1
2023-06-01,143824,0,1,1,0,1,1
2023-06-01,143825,0,1,1,0,1,1
2023-06-01,143826,0,1,1,0,1,1
2023-06-01,143827,0,1,1,0,1,1
2023-06-01,143828,0,1,1,0,1,1
2023-06-01,143829,0,1,1,0,1,1
2023-06-01,143830,0,1,1,0,1,1
2023-06-01,143831,0,1,1,0,1,1
2023-06-01,143832,0,1,1,0,1,1
2023-06-01,143833,0,1,1,0,1,1
2023-06-01,143834,0,1,1,0,1,1
2023-06-01,143835,0,1,1,0,1,1
2023-06-01,143836,0,1,1,0,1,1
2023-06-01,143837,0,1,1,0,1,1
2023-06-01,143838,0,1,1,0,1,1
2023-06-01,143839,0,1,1,0,1,1
2023-06-01,143840,0,1,1,0,1,1
2023-06-01,143841,0,1,1,0,1,1
2023-06-01,143842,0,1,1,0,1,1
2023-06-01,143843,0,1,1,0,1,1
2023-06-01,143844,0,1,1,0,1,1
2023-06-01,143845,0,1,1,0,1,1
2023-06-01,143846,0,1,1,0,1,1
2023-06-01,143847,0,1,1,0,1,1
2023-06-01,143848,0,1,1,0,1,1
2023-06-01,143849,0,1,1,0,1,1
2023-06-01,143850,0,1,1,0,1,1
2023-06-01,143851,0,1,1,0,1,1
2023-06-01,143852,0,1,1,0,1,1
2023-06-01,143853,0,1,1,0,1,1
2023-06-01,143854,0,1,1,0,1,1
2023-06-01,143855,0,1,1,0,1,1
2023-06-01,143856,0,1,1,0,1,1
2023-06-01,143857,0,1,1,0,1,1
2023-06-01,143858,0,1,1,0,1,1
2023-06-01,143859,0,1,1,0,1,1
2023-06-01,143860,0,1,1,0,1,1
2023-06-01,143861,0,1,1,0,1,1
2023-06-01,143862,0,1,1,0,1,1
2023-06-01,143863,0,1,1,0,1,1
2023-06-01,143864,0,1,1,0,1,1
2023-06-01,143865,0,1,1,0,1,1
2023-06-01,143866,0,1,1,0,1,1
2023-06-01,143867,0,1,1,0,1,1
2023-06-01,143868,0,1,1,0,1,1
2023-06-01,143869,0,1,1,0,1,1
2023-06-01,143870,0,1,1,0,1,1
2023-06-01,143871,0,1,1,0,1,1
2023-06-01,143872,0,1,1,0,1,1
2023-06-01,143873,0,1,1,0,1,1
2023-06-01,143874,0,1,1,0,1,1
2023-06-01,143875,0,1,1,0,1,1
2023-06-01,143876,0,1,1,0,1,1
2023-06-01,143877,0,1,1,0,1,1
2023-06-01,143878,0,1,1,0,1,1
2023-06-01,143879,0,1,1,0,1,1
2023-06-01,143880,0,1,1,0,1,1
2023-06-01,143881,0,1,1,0,1,1
2023-06-01,143882,0,1,1,0,1,1
2023-06-01,143883,0,1,1,0,1,1
2023-06-01,143884,0,1,1,0,1,1
2023-06-01,143885,0,1,1,0,1,1
2023-06-01,143886,0,1,1,0,1,1
2023-06-01,143887,0,1,1,0,1,1
2023-06-01,143888,0,1,1,0,1,1
2023-06-01,143889,0,1,1,0,1,1
2023-06-01,143890,0,1,1,0,1,1
2023-06-01,143891,0,1,1,0,1,1
2023-06-01,143892,0,1,1,0,1,1
2023-06-01,143893,0,1,1,0,1,1
2023-06-01,143894,0,1,1,0,1,1
2023-06-01,143895,0,1,1,0,1,1
2023-06-01,143896,0,1,1,0,1,1
2023-06-01,143897,0,1,1,0,1,1
2023-06-01,143898,0,1,1,0,1,1
2023-06-01,143899,0,1,1,0,1,1
2023-06-01,143900,0,1,1,0,1,1
2023-06-01,143901,0,1,1,0,1,1
2023-06-01,143902,0,1,1,0,1,1
2023-06-01,143903,0,1,1,0,1,1
2023-06-01,143904,0,1,1,0,1,1
2023-06-01,143905,0,1,1,0,1,1
2023-06-01,143906,0,1,1,0,1,1
2023-06-01,143907,0,1,1,0,1,1
2023-06-01,143908,0,1,1,0,1,1
2023-06-01,143909,0,1,1,0,1,1
2023-06-01,143910,0,1,1,0,1,1
2023-06-01,143911,0,1,1,0,1,1
2023-06-01,143912,0,1,1,0,1,1
2023-06-01,143913,0,1,1,0,1,1
2023-06-01,143914,0,1,1,0,1,1
2023-06-01,143915,0,1,1,0,1,1
2023-06-01,143916,0,1,1,0,1,1
2023-06-01,143917,0,1,1,0,1,1
2023-06-01,143918,0,1,1,0,1,1
2023-06-01,143919,0,1,1,0,1,1
2023-06-01,143920,0,1,1,0,1,1
2023-06-01,143921,0,1,1,0,1,1
2023-06-01,143922,0,1,1,0,1,1
2023-06-01,143923,0,1,1,0,1,1
2023-06-01,143924,0,1,1,0,1,1
2023-06-01,143925,0,1,1,0,1,1
2023-06-01,143926,0,1,1,0,1,1
2023-06-01,143927,0,1,1,0,1,1
2023-06-01,143928,0,1,1,0,1,1
2023-06-01,143929,0,1,1,0,1,1
2023-06-01,143930,0,1,1,0,1,1
2023-06-01,143931,0,1,1,0,1,1
2023-06-01,143932,0,1,1,0,1,1
2023-06-01,143933,0,1,1,0,1,1
2023-06-01,143934,0,1,1,0,1,1
2023-06-01,143935,0,1,1,0,1,1
2023-06-01,143936,0,1,1,0,1,1
2023-06-01,143937,0,1,1,0,1,1
2023-06-01,143938,0,1,1,0,1,1
2023-06-01,143939,0,1,1,0,1,1
2023-06-01,143940,0,1,1,0,1,1
2023-06-01,143941,0,1,1,0,1,1
2023-06-01,143942,0,1,1,0,1,1
2023-06-01,143943,0,1,1,0,1,1
2023-06-01,143944,0,1,1,0,1,1
2023-06-01,143945,0,1,1,0,1,1
2023-06-01,143946,0,1,1,0,1,1
2023-06-01,143947,0,1,1,0,1,1
2023-06-01,143948,0,1,1,0,1,1
2023-06-01,143949,0,1,1,0,1,1
2023-06-01,143950,0,1,1,0,1,1
2023-06-01,143951,0,1,1,0,1,1
2023-06-01,143952,0,1,1,0,1,1
2023-06-01,143953,0,1,1,0,1,1
2023-06-01,143954,0,1,1,0,1,1
2023-06-01,143955,0,1,1,0,1,1
2023-06-01,143956,0,1,1,0,1,1
2023-06-01,143957,0,1,1,0,1,1
2023-06-01,143958,0,1,1,0,1,1
2023-06-01,143959,0,1,1,0,1,1
2023-06-01,143960,0,1,1,0,1,1
2023-06-01,143961,0,1,1,0,1,1
2023-06-01,143962,0,1,1,0,1,1
2023-06-01,143963,0,1,1,0,1,1
2023-06-01,143964,0,1,1,0,1,1
2023-06-01,143965,0,1,1,0,1,1
2023-06-01,143966,0,1,1,0,1,1
2023-06-01,143967,0,1,1,0,1,1
2023-06-01,143968,0,1,1,0,1,1
2023-06-01,143969,0,1,1,0,1,1
2023-06-01,143970,0,1,1,0,1,1
2023-06-01,143971,0,1,1,0,1,1
2023-06-01,143972,0,1,1,0,1,1
2023-06-01,143973,0,1,1,0,1,1
2023-06-01,143974,0,1,1,0,1,1
2023-06-01,143975,0,1,1,0,1,1
2023-06-01,143976,0,1,1,0,1,1
2023-06-01,143977,0,1,1,0,1,1
2023-06-01,143978,0,1,1,0,1,1
2023-06-01,143979,0,1,1,0,1,1
2023-06-01,143980,0,1,1,0,1,1
2023-06-01,143981,0,1,1,0,1,1
2023-06-01,143982,0,1,1,0,1,1
2023-06-01,143983,0,1,1,0,1,1
2023-06-01,143984,0,1,1,0,1,1
2023-06-01,143985,0,1,1,0,1,1
2023-06-01,143986,0,1,1,0,1,1
2023-06-01,143987,0,1,1,0,1,1
2023-06-01,143988,0,1,1,0,1,1
2023-06-01,143989,0,1,1,0,1,1
2023-06-01,143990,0,1,1,0,1,1
2023-06-01,143991,0,1,1,0,1,1
2023-06-01,143992,0,1,1,0,1,1
2023-06-01,143993,0,1,1,0,1,1
2023-06-01,143994,0,1,1,0,1,1
2023-06-01,143995,0,1,1,0,1,1
2023-06-01,143996,0,1,1,0,1,1
2023-06-01,143997,0,1,1,0,1,1
2023-06-01,143998,0,1,1,0,1,1
2023-06-01,143999,0,1,1,0,1,1
2023-06-01,144000,0,1,1,0,1,1
2023-06-01,144001,0,1,1,0,1,1
2023-06-01,144002,0,1,1,0,1,1
2023-06-01,144003,0,1,1,0,1,1
2023-06-01,144004,0,1,1,0,1,1
2023-06-01,144005,0,1,1,0,1,1
2023-06-01,144006,0,1,1,0,1,1
2023-06-01,144007,0,1,1,0,1,1
2023-06-01,144008,0,1,1,0,1,1
2023-06-01,144009,0,1,1,0,1,1
2023-06-01,144010,0,1,1,0,1,1
2023-06-01,144011,0,1,1,0,1,1
2023-06-01,144012,0,1,1,0,1,1
2023-06-01,144013,0,1,1,0,1,1
2023-06-01,144014,0,1,1,0,1,1
2023-06-01,144015,0,1,1,0,1,1
2023-06-01,144016,0,1,1,0,1,1
2023-06-01,144017,0,1,1,0,1,1
2023-06-01,144018,0,1,1,0,1,1
2023-06-01,144019,0,1,1,0,1,1
2023-06-01,144020,0,1,1,0,1,1
2023-06-01,144021,0,1,1,0,1,1
2023-06-01,144022,0,1,1,0,1,1
2023-06-01,144023,0,1,1,0,1,1
2023-06-01,144024,0,1,1,0,1,1
2023-06-01,144025,0,1,1,0,1,1
2023-06-01,144026,0,1,1,0,1,1
2023-06-01,144027,0,1,1,0,1,1
2023-06-01,144028,0,1,1,0,1,1
2023-06-01,144029,0,1,1,0,1,1
2023-06-01,144030,0,1,1,0,1,1
2023-06-01,144031,0,1,1,0,1,1
2023-06-01,144032,0,1,1,0,1,1
2023-06-01,144033,0,1,1,0,1,1
2023-06-01,144034,0,1,1,0,1,1
2023-06-01,144035,0,1,1,0,1,1
2023-06-01,144036,0,1,1,0,1,1
2023-06-01,144037,0,1,1,0,1,1
2023-06-01,144038,0,1,1,0,1,1
2023-06-01,144039,0,1,1,0,1,1
2023-06-01,144040,0,1,1,0,1,1
2023-06-01,144041,0,1,1,0,1,1
2023-06-01,144042,0,1,1,0,1,1
2023-06-01,144043,0,1,1,0,1,1
2023-06-01,144044,0,1,1,0,1,1
2023-06-01,144045,0,1,1,0,1,1
2023-06-01,144046,0,1,1,0,1,1
2023-06-01,144047,0,1,1,0,1,1
2023-06-01,144048,0,1,1,0,1,1
2023-06-01,144049,0,1,1,0,1,1
2023-06-01,144050,0,1,1,0,1,1
2023-06-01,144051,0,1,1,0,1,1
2023-06-01,144052,0,1,1,0,1,1
2023-06-01,144053,0,1,1,0,1,1
2023-06-01,144054,0,1,1,0,1,1
2023-06-01,144055,0,1,1,0,1,1
2023-06-01,144056,0,1,1,0,1,1
2023-06-01,144057,0,1,1,0,1,1
2023-06-01,144058,0,1,1,0,1,1
2023-06-01,144059,0,1,1,0,1,1
2023-06-01,144060,0,1,1,0,1,1
2023-06-01,144061,0,1,1,0,1,1
2023-06-01,144062,0,1,1,0,1,1
2023-06-01,144063,0,1,1,0,1,1
2023-06-01,144064,0,1,1,0,1,1
2023-06-01,144065,0,1,1,0,1,1
2023-06-01,144066,0,1,1,0,1,1
2023-06-01,144067,0,1,1,0,1,1
2023-06-01,144068,0,1,1,0,1,1
2023-06-01,144069,0,1,1,0,1,1
2023-06-01,144070,0,1,1,0,1,1
2023-06-01,144071,0,1,1,0,1,1
2023-06-01,144072,0,1,1,0,1,1
2023-06-01,144073,0,1,1,0,1,1
2023-06-01,144074,0,1,1,0,1,1
2023-06-01,144075,0,1,1,0,1,1
2023-06-01,144076,0,1,1,0,1,1
2023-06-01,144077,0,1,1,0,1,1
2023-06-01,144078,0,1,1,0,1,1
2023-06-01,144079,0,1,1,0,1,1
2023-06-01,144080,0,1,1,0,1,1
2023-06-01,144081,0,1,1,0,1,1
2023-06-01,144082,0,1,1,0,1,1
2023-06-01,144083,0,1,1,0,1,1
2023-06-01,144084,0,1,1,0,1,1
2023-06-01,144085,0,1,1,0,1,1
2023-06-01,144086,0,1,1,0,1,1
2023-06-01,144087,0,1,1,0,1,1
2023-06-01,144088,0,1,1,0,1,1
2023-06-01,144089,0,1,1,0,1,1
2023-06-01,144090,0,1,1,0,1,1
2023-06-01,144091,0,1,1,0,1,1
2023-06-01,144092,0,1,1,0,1,1
2023-06-01,144093,0,1,1,0,1,1
2023-06-01,144094,0,1,1,0,1,1
2023-06-01,144095,0,1,1,0,1,1
2023-06-01,144096,0,1,1,0,1,1
2023-06-01,144097,0,1,1,0,1,1
2023-06-01,144098,0,1,1,0,1,1
2023-06-01,144099,0,1,1,0,1,1
2023-06-01,144100,0,1,1,0,1,1
2023-06-01,144101,0,1,1,0,1,1
2023-06-01,144102,0,1,1,0,1,1
2023-06-01,144103,0,1,1,0,1,1
2023-06-01,144104,0,1,1,0,1,1
2023-06-01,144105,0,1,1,0,1,1
2023-06-01,144106,0,1,1,0,1,1
2023-06-01,144107,0,1,1,0,1,1
2023-06-01,144108,0,1,1,0,1,1
2023-06-01,144109,0,1,1,0,1,1
2023-06-01,144110,0,1,1,0,1,1
2023-06-01,144111,0,1,1,0,1,1
2023-06-01,144112,0,1,1,0,1,1
2023-06-01,144113,0,1,1,0,1,1
2023-06-01,144114,0,1,1,0,1,1
2023-06-01,144115,0,1,1,0,1,1
2023-06-01,144116,0,1,1,0,1,1
2023-06-01,144117,0,1,1,0,1,1
2023-06-01,144118,0,1,1,0,1,1
2023-06-01,144119,0,1,1,0,1,1
2023-06-01,144120,0,1,1,0,1,1
2023-06-01,144121,0,1,1,0,1,1
2023-06-01,144122,0,1,1,0,1,1
2023-06-01,144123,0,1,1,0,1,1
2023-06-01,144124,0,1,1,0,1,1
2023-06-01,144125,0,1,1,0,1,1
2023-06-01,144126,0,1,1,0,1,1
2023-06-01,144127,0,1,1,0,1,1
2023-06-01,144128,0,1,1,0,1,1
2023-06-01,144129,0,1,1,0,1,1
2023-06-01,144130,0,1,1,0,1,1
2023-06-01,144131,0,1,1,0,1,1
2023-06-01,144132,0,1,1,0,1,1
2023-06-01,144133,0,1,1,0,1,1
2023-06-01,144134,0,1,1,0,1,1
2023-06-01,144135,0,1,1,0,1,1
2023-06-01,144136,0,1,1,0,1,1
2023-06-01,144137,0,1,1,0,1,1
2023-06-01,144138,0,1,1,0,1,1
2023-06-01,144139,0,1,1,0,1,1
2023-06-01,144140,0,1,1,0,1,1
2023-06-01,144141,0,1,1,0,1,1
2023-06-01,144142,0,1,1,0,1,1
2023-06-01,144143,0,1,1,0,1,1
2023-06-01,144144,0,1,1,0,1,1
2023-06-01,144145,0,1,1,0,1,1
2023-06-01,144146,0,1,1,0,1,1
2023-06-01,144147,0,1,1,0,1,1
2023-06-01,144148,0,1,1,0,1,1
2023-06-01,144149,0,1,1,0,1,1
2023-06-01,144150,0,1,1,0,1,1
2023-06-01,144151,0,1,1,0,1,1
2023-06-01,144152,0,1,1,0,1,1
2023-06-01,144153,0,1,1,0,1,1
2023-06-01,144154,0,1,1,0,1,1
2023-06-01,144155,0,1,1,0,1,1
2023-06-01,144156,0,1,1,0,1,1
2023-06-01,144157,0,1,1,0,1,1
2023-06-01,144158,0,1,1,0,1,1
2023-06-01,144159,0,1,1,0,1,1
2023-06-01,144160,0,1,1,0,1,1
2023-06-01,144161,0,1,1,0,1,1
2023-06-01,144162,0,1,1,0,1,1
2023-06-01,144163,0,1,1,0,1,1
2023-06-01,144164,0,1,1,0,1,1
2023-06-01,144165,0,1,1,0,1,1
2023-06-01,144166,0,1,1,0,1,1
2023-06-01,144167,0,1,1,0,1,1
2023-06-01,144168,0,1,1,0,1,1
2023-06-01,144169,0,1,1,0,1,1
2023-06-01,144170,0,1,1,0,1,1
2023-06-01,144171,0,1,1,0,1,1
2023-06-01,144172,0,1,1,0,1,1
2023-06-01,144173,0,1,1,0,1,1
2023-06-01,144174,0,1,1,0,1,1
2023-06-01,144175,0,1,1,0,1,1
2023-06-01,144176,0,1,1,0,1,1
2023-06-01,144177,0,1,1,0,1,1
2023-06-01,144178,0,1,1,0,1,1
2023-06-01,144179,0,1,1,0,1,1
2023-06-01,144180,0,1,1,0,1,1
2023-06-01,144181,0,1,1,0,1,1
2023-06-01,144182,0,1,1,0,1,1
2023-06-01,144183,0,1,1,0,1,1
2023-06-01,144184,0,1,1,0,1,1
2023-06-01,144185,0,1,1,0,1,1
2023-06-01,144186,0,1,1,0,1,1
2023-06-01,144187,0,1,1,0,1,1
2023-06-01,144188,0,1,1,0,1,1
2023-06-01,144189,0,1,1,0,1,1
2023-06-01,144190,0,1,1,0,1,1
2023-06-01,144191,0,1,1,0,1,1
2023-06-01,144192,0,1,1,0,1,1
2023-06-01,144193,0,1,1,0,1,1
2023-06-01,144194,0,1,1,0,1,1
2023-06-01,144195,0,1,1,0,1,1
2023-06-01,144196,0,1,1,0,1,1
2023-06-01,144197,0,1,1,0,1,1
2023-06-01,144198,0,1,1,0,1,1
2023-06-01,144199,0,1,1,0,1,1
2023-06-01,144200,0,1,1,0,1,1
2023-06-01,144201,0,1,1,0,1,1
2023-06-01,144202,0,1,1,0,1,1
2023-06-01,144203,0,1,1,0,1,1
2023-06-01,144204,0,1,1,0,1,1
2023-06-01,144205,0,1,1,0,1,1
2023-06-01,144206,0,1,1,0,1,1
2023-06-01,144207,0,1,1,0,1,1
2023-06-01,144208,0,1,1,0,1,1
2023-06-01,144209,0,1,1,0,1,1
2023-06-01,144210,0,1,1,0,1,1
2023-06-01,144211,0,1,1,0,1,1
2023-06-01,144212,0,1,1,0,1,1
2023-06-01,144213,0,1,1,0,1,1
2023-06-01,144214,0,1,1,0,1,1
2023-06-01,144215,0,1,1,0,1,1
2023-06-01,144216,0,1,1,0,1,1
2023-06-01,144217,0,1,1,0,1,1
2023-06-01,144218,0,1,1,0,1,1
2023-06-01,144219,0,1,1,0,1,1
2023-06-01,144220,0,1,1,0,1,1
2023-06-01,144221,0,1,1,0,1,1
2023-06-01,144222,0,1,1,0,1,1
2023-06-01,144223,0,1,1,0,1,1
2023-06-01,144224,0,1,1,0,1,1
2023-06-01,144225,0,1,1,0,1,1
2023-06-01,144226,0,1,1,0,1,1
2023-06-01,144227,0,1,1,0,1,1
2023-06-01,144228,0,1,1,0,1,1
2023-06-01,144229,0,1,1,0,1,1
2023-06-01,144230,0,1,1,0,1,1
2023-06-01,144231,0,1,1,0,1,1
2023-06-01,144232,0,1,1,0,1,1
2023-06-01,144233,0,1,1,0,1,1
2023-06-01,144234,0,1,1,0,1,1
2023-06-01,144235,0,1,1,0,1,1
2023-06-01,144236,0,1,1,0,1,1
2023-06-01,144237,0,1,1,0,1,1
2023-06-01,144238,0,1,1,0,1,1
2023-06-01,144239,0,1,1,0,1,1
2023-06-01,144240,0,1,1,0,1,1
2023-06-01,144241,0,1,1,0,1,1
2023-06-01,144242,0,1,1,0,1,1
2023-06-01,144243,0,1,1,0,1,1
2023-06-01,144244,0,1,1,0,1,1
2023-06-01,144245,0,1,1,0,1,1
2023-06-01,144246,0,1,1,0,1,1
2023-06-01,144247,0,1,1,0,1,1
2023-06-01,144248,0,1,1,0,1,1
2023-06-01,144249,0,1,1,0,1,1
2023-06-01,144250,0,1,1,0,1,1
2023-06-01,144251,0,1,1,0,1,1
2023-06-01,144252,0,1,1,0,1,1
2023-06-01,144253,0,1,1,0,1,1
2023-06-01,144254,0,1,1,0,1,1
2023-06-01,144255,0,1,1,0,1,1
2023-06-01,144256,0,1,1,0,1,1
2023-06-01,144257,0,1,1,0,1,1
2023-06-01,144258,0,1,1,0,1,1
2023-06-01,144259,0,1,1,0,1,1
2023-06-01,144260,0,1,1,0,1,1
2023-06-01,144261,0,1,1,0,1,1
2023-06-01,144262,0,1,1,0,1,1
2023-06-01,144263,0,1,1,0,1,1
2023-06-01,144264,0,1,1,0,1,1
2023-06-01,144265,0,1,1,0,1,1
2023-06-01,144266,0,1,1,0,1,1
2023-06-01,144267,0,1,1,0,1,1
2023-06-01,144268,0,1,1,0,1,1
2023-06-01,144269,0,1,1,0,1,1
2023-06-01,144270,0,1,1,0,1,1
2023-06-01,144271,0,1,1,0,1,1
2023-06-01,144272,0,1,1,0,1,1
2023-06-01,144273,0,1,1,0,1,1
2023-06-01,144274,0,1,1,0,1,1
2023-06-01,144275,0,1,1,0,1,1
2023-06-01,144276,0,1,1,0,1,1
2023-06-01,144277,0,1,1,0,1,1
2023-06-01,144278,0,1,1,0,1,1
2023-06-01,144279,0,1,1,0,1,1
2023-06-01,144280,0,1,1,0,1,1
2023-06-01,144281,0,1,1,0,1,1
2023-06-01,144282,0,1,1,0,1,1
2023-06-01,144283,0,1,1,0,1,1
2023-06-01,144284,0,1,1,0,1,1
2023-06-01,144285,0,1,1,0,1,1
2023-06-01,144286,0,1,1,0,1,1
2023-06-01,144287,0,1,1,0,1,1
2023-06-01,144288,0,1,1,0,1,1
2023-06-01,144289,0,1,1,0,1,1
2023-06-01,144290,0,1,1,0,1,1
2023-06-01,144291,0,1,1,0,1,1
2023-06-01,144292,0,1,1,0,1,1
2023-06-01,144293,0,1,1,0,1,1
2023-06-01,144294,0,1,1,0,1,1
2023-06-01,144295,0,1,1,0,1,1
2023-06-01,144296,0,1,1,0,1,1
2023-06-01,144297,0,1,1,0,1,1
2023-06-01,144298,0,1,1,0,1,1
2023-06-01,144299,0,1,1,0,1,1
2023-06-01,144300,0,1,1,0,1,1
2023-06-01,144301,0,1,1,0,1,1
2023-06-01,144302,0,1,1,0,1,1
2023-06-01,144303,0,1,1,0,1,1
2023-06-01,144304,0,1,1,0,1,1
2023-06-01,144305,0,1,1,0,1,1
2023-06-01,144306,0,1,1,0,1,1
2023-06-01,144307,0,1,1,0,1,1
2023-06-01,144308,0,1,1,0,1,1
2023-06-01,144309,0,1,1,0,1,1
2023-06-01,144310,0,1,1,0,1,1
2023-06-01,144311,0,1,1,0,1,1
2023-06-01,144312,0,1,1,0,1,1
2023-06-01,144313,0,1,1,0,1,1
2023-06-01,144314,0,1,1,0,1,1
2023-06-01,144315,0,1,1,0,1,1
2023-06-01,144316,0,1,1,0,1,1
2023-06-01,144317,0,1,1,0,1,1
2023-06-01,144318,0,1,1,0,1,1
2023-06-01,144319,0,1,1,0,1,1
2023-06-01,144320,0,1,1,0,1,1
2023-06-01,144321,0,1,1,0,1,1
2023-06-01,144322,0,1,1,0,1,1
2023-06-01,144323,0,1,1,0,1,1
2023-06-01,144324,0,1,1,0,1,1
2023-06-01,144325,0,1,1,0,1,1
2023-06-01,144326,0,1,1,0,1,1
2023-06-01,144327,0,1,1,0,1,1
2023-06-01,144328,0,1,1,0,1,1
2023-06-01,144329,0,1,1,0,1,1
2023-06-01,144330,0,1,1,0,1,1
2023-06-01,144331,0,1,1,0,1,1
2023-06-01,144332,0,1,1,0,1,1
2023-06-01,144333,0,1,1,0,1,1
2023-06-01,144334,0,1,1,0,1,1
2023-06-01,144335,0,1,1,0,1,1
2023-06-01,144336,0,1,1,0,1,1
2023-06-01,144337,0,1,1,0,1,1
2023-06-01,144338,0,1,1,0,1,1
2023-06-01,144339,0,1,1,0,1,1
2023-06-01,144340,0,1,1,0,1,1
2023-06-01,144341,0,1,1,0,1,1
2023-06-01,144342,0,1,1,0,1,1
2023-06-01,144343,0,1,1,0,1,1
2023-06-01,144344,0,1,1,0,1,1
2023-06-01,144345,0,1,1,0,1,1
2023-06-01,144346,0,1,1,0,1,1
2023-06-01,144347,0,1,1,0,1,1
2023-06-01,144348,0,1,1,0,1,1
2023-06-01,144349,0,1,1,0,1,1
2023-06-01,144350,0,1,1,0,1,1
2023-06-01,144351,0,1,1,0,1,1
2023-06-01,144352,0,1,1,0,1,1
2023-06-01,144353,0,1,1,0,1,1
2023-06-01,144354,0,1,1,0,1,1
2023-06-01,144355,0,1,1,0,1,1
2023-06-01,144356,0,1,1,0,1,1
2023-06-01,144357,0,1,1,0,1,1
2023-06-01,144358,0,1,1,0,1,1
2023-06-01,144359,0,1,1,0,1,1
2023-06-01,144360,0,1,1,0,1,1
2023-06-01,144361,0,1,1,0,1,1
2023-06-01,144362,0,1,1,0,1,1
2023-06-01,144363,0,1,1,0,1,1
2023-06-01,144364,0,1,1,0,1,1
2023-06-01,144365,0,1,1,0,1,1
2023-06-01,144366,0,1,1,0,1,1
2023-06-01,144367,0,1,1,0,1,1
2023-06-01,144368,0,1,1,0,1,1
2023-06-01,144369,0,1,1,0,1,1
2023-06-01,144370,0,1,1,0,1,1
2023-06-01,144371,0,1,1,0,1,1
2023-06-01,144372,0,1,1,0,1,1
2023-06-01,144373,0,1,1,0,1,1
2023-06-01,144374,0,1,1,0,1,1
2023-06-01,144375,0,1,1,0,1,1
2023-06-01,144376,0,1,1,0,1,1
2023-06-01,144377,0,1,1,0,1,1
2023-06-01,144378,0,1,1,0,1,1
2023-06-01,144379,0,1,1,0,1,1
2023-06-01,144380,0,1,1,0,1,1
2023-06-01,144381,0,1,1,0,1,1
2023-06-01,144382,0,1,1,0,1,1
2023-06-01,144383,0,1,1,0,1,1
2023-06-01,144384,0,1,1,0,1,1
2023-06-01,144385,0,1,1,0,1,1
2023-06-01,144386,0,1,1,0,1,1
2023-06-01,144387,0,1,1,0,1,1
2023-06-01,144388,0,1,1,0,1,1
2023-06-01,144389,0,1,1,0,1,1
2023-06-01,144390,0,1,1,0,1,1
2023-06-01,144391,0,1,1,0,1,1
2023-06-01,144392,0,1,1,0,1,1
2023-06-01,144393,0,1,1,0,1,1
2023-06-01,144394,0,1,1,0,1,1
2023-06-01,144395,0,1,1,0,1,1
2023-06-01,144396,0,1,1,0,1,1
2023-06-01,144397,0,1,1,0,1,1
2023-06-01,144398,0,1,1,0,1,1
2023-06-01,144399,0,1,1,0,1,1
2023-06-01,144400,0,1,1,0,1,1
2023-06-01,144401,0,1,1,0,1,1
2023-06-01,144402,0,1,1,0,1,1
2023-06-01,144403,0,1,1,0,1,1
2023-06-01,144404,0,1,1,0,1,1
2023-06-01,144405,0,1,1,0,1,1
2023-06-01,144406,0,1,1,0,1,1
2023-06-01,144407,0,1,1,0,1,1
2023-06-01,144408,0,1,1,0,1,1
2023-06-01,144409,0,1,1,0,1,1
2023-06-01,144410,0,1,1,0,1,1
2023-06-01,144411,0,1,1,0,1,1
2023-06-01,144412,0,1,1,0,1,1
2023-06-01,144413,0,1,1,0,1,1
2023-06-01,144414,0,1,1,0,1,1
2023-06-01,144415,0,1,1,0,1,1
2023-06-01,144416,0,1,1,0,1,1
2023-06-01,144417,0,1,1,0,1,1
2023-06-01,144418,0,1,1,0,1,1
2023-06-01,144419,0,1,1,0,1,1
2023-06-01,144420,0,1,1,0,1,1
2023-06-01,144421,0,1,1,0,1,1
2023-06-01,144422,0,1,1,0,1,1
2023-06-01,144423,0,1,1,0,1,1
2023-06-01,144424,0,1,1,0,1,1
2023-06-01,144425,0,1,1,0,1,1
2023-06-01,144426,0,1,1,0,1,1
2023-06-01,144427,0,1,1,0,1,1
2023-06-01,144428,0,1,1,0,1,1
2023-06-01,144429,0,1,1,0,1,1
2023-06-01,144430,0,1,1,0,1,1
2023-06-01,144431,0,1,1,0,1,1
2023-06-01,144432,0,1,1,0,1,1
2023-06-01,144433,0,1,1,0,1,1
2023-06-01,144434,0,1,1,0,1,1
2023-06-01,144435,0,1,1,0,1,1
2023-06-01,144436,0,1,1,0,1,1
2023-06-01,144437,0,1,1,0,1,1
2023-06-01,144438,0,1,1,0,1,1
2023-06-01,144439,0,1,1,0,1,1
2023-06-01,144440,0,1,1,0,1,1
2023-06-01,144441,0,1,1,0,1,1
2023-06-01,144442,0,1,1,0,1,1
2023-06-01,144443,0,1,1,0,1,1
2023-06-01,144444,0,1,1,0,1,1
2023-06-01,144445,0,1,1,0,1,1
2023-06-01,144446,0,1,1,0,1,1
2023-06-01,144447,0,1,1,0,1,1
2023-06-01,144448,0,1,1,0,1,1
2023-06-01,144449,0,1,1,0,1,1
2023-06-01,144450,0,1,1,0,1,1
2023-06-01,144451,0,1,1,0,1,1
2023-06-01,144452,0,1,1,0,1,1
2023-06-01,144453,0,1,1,0,1,1
2023-06-01,144454,0,1,1,0,1,1
2023-06-01,144455,0,1,1,0,1,1
2023-06-01,144456,0,1,1,0,1,1
2023-06-01,144457,0,1,1,0,1,1
2023-06-01,144458,0,1,1,0,1,1
2023-06-01,144459,0,1,1,0,1,1
2023-06-01,144460,0,1,1,0,1,1
2023-06-01,144461,0,1,1,0,1,1
2023-06-01,144462,0,1,1,0,1,1
2023-06-01,144463,0,1,1,0,1,1
2023-06-01,144464,0,1,1,0,1,1
2023-06-01,144465,0,1,1,0,1,1
2023-06-01,144466,0,1,1,0,1,1
2023-06-01,144467,0,1,1,0,1,1
2023-06-01,144468,0,1,1,0,1,1
2023-06-01,144469,0,1,1,0,1,1
2023-06-01,144470,0,1,1,0,1,1
2023-06-01,144471,0,1,1,0,1,1
2023-06-01,144472,0,1,1,0,1,1
2023-06-01,144473,0,1,1,0,1,1
2023-06-01,144474,0,1,1,0,1,1
2023-06-01,144475,0,1,1,0,1,1
2023-06-01,144476,0,1,1,0,1,1
2023-06-01,144477,0,1,1,0,1,1
2023-06-01,144478,0,1,1,0,1,1
2023-06-01,144479,0,1,1,0,1,1
2023-06-01,144480,0,1,1,0,1,1
2023-06-01,144481,0,1,1,0,1,1
2023-06-01,144482,0,1,1,0,1,1
2023-06-01,144483,0,1,1,0,1,1
2023-06-01,144484,0,1,1,0,1,1
2023-06-01,144485,0,1,1,0,1,1
2023-06-01,144486,0,1,1,0,1,1
2023-06-01,144487,0,1,1,0,1,1
2023-06-01,144488,0,1,1,0,1,1
2023-06-01,144489,0,1,1,0,1,1
2023-06-01,144490,0,1,1,0,1,1
2023-06-01,144491,0,1,1,0,1,1
2023-06-01,144492,0,1,1,0,1,1
2023-06-01,144493,0,1,1,0,1,1
2023-06-01,144494,0,1,1,0,1,1
2023-06-01,144495,0,1,1,0,1,1
2023-06-01,144496,0,1,1,0,1,1
2023-06-01,144497,0,1,1,0,1,1
2023-06-01,144498,0,1,1,0,1,1
2023-06-01,144499,0,1,1,0,1,1
2023-06-01,144500,0,1,1,0,1,1
2023-06-01,144501,0,1,1,0,1,1
2023-06-01,144502,0,1,1,0,1,1
2023-06-01,144503,0,1,1,0,1,1
2023-06-01,144504,0,1,1,0,1,1
2023-06-01,144505,0,1,1,0,1,1
2023-06-01,144506,0,1,1,0,1,1
2023-06-01,144507,0,1,1,0,1,1
2023-06-01,144508,0,1,1,0,1,1
2023-06-01,144509,0,1,1,0,1,1
2023-06-01,144510,0,1,1,0,1,1
2023-06-01,144511,0,1,1,0,1,1
2023-06-01,144512,0,1,1,0,1,1
2023-06-01,144513,0,1,1,0,1,1
2023-06-01,144514,0,1,1,0,1,1
2023-06-01,144515,0,1,1,0,1,1
2023-06-01,144516,0,1,1,0,1,1
2023-06-01,144517,0,1,1,0,1,1
2023-06-01,144518,0,1,1,0,1,1
2023-06-01,144519,0,1,1,0,1,1
2023-06-01,144520,0,1,1,0,1,1
2023-06-01,144521,0,1,1,0,1,1
2023-06-01,144522,0,1,1,0,1,1
2023-06-01,144523,0,1,1,0,1,1
2023-06-01,144524,0,1,1,0,1,1
2023-06-01,144525,0,1,1,0,1,1
2023-06-01,144526,0,1,1,0,1,1
2023-06-01,144527,0,1,1,0,1,1
2023-06-01,144528,0,1,1,0,1,1
2023-06-01,144529,0,1,1,0,1,1
2023-06-01,144530,0,1,1,0,1,1
2023-06-01,144531,0,1,1,0,1,1
2023-06-01,144532,0,1,1,0,1,1
2023-06-01,144533,0,1,1,0,1,1
2023-06-01,144534,0,1,1,0,1,1
2023-06-01,144535,0,1,1,0,1,1
2023-06-01,144536,0,1,1,0,1,1
2023-06-01,144537,0,1,1,0,1,1
2023-06-01,144538,0,1,1,0,1,1
2023-06-01,144539,0,1,1,0,1,1
2023-06-01,144540,0,1,1,0,1,1
2023-06-01,144541,0,1,1,0,1,1
2023-06-01,144542,0,1,1,0,1,1
2023-06-01,144543,0,1,1,0,1,1
2023-06-01,144544,0,1,1,0,1,1
2023-06-01,144545,0,1,1,0,1,1
2023-06-01,144546,0,1,1,0,1,1
2023-06-01,144547,0,1,1,0,1,1
2023-06-01,144548,0,1,1,0,1,1
2023-06-01,144549,0,1,1,0,1,1
2023-06-01,144550,0,1,1,0,1,1
2023-06-01,144551,0,1,1,0,1,1
2023-06-01,144552,0,1,1,0,1,1
2023-06-01,144553,0,1,1,0,1,1
2023-06-01,144554,0,1,1,0,1,1
2023-06-01,144555,0,1,1,0,1,1
2023-06-01,144556,0,1,1,0,1,1
2023-06-01,144557,0,1,1,0,1,1
2023-06-01,144558,0,1,1,0,1,1
2023-06-01,144559,0,1,1,0,1,1
2023-06-01,144560,0,1,1,0,1,1
2023-06-01,144561,0,1,1,0,1,1
2023-06-01,144562,0,1,1,0,1,1
2023-06-01,144563,0,1,1,0,1,1
2023-06-01,144564,0,1,1,0,1,1
2023-06-01,144565,0,1,1,0,1,1
2023-06-01,144566,0,1,1,0,1,1
2023-06-01,144567,0,1,1,0,1,1
2023-06-01,144568,0,1,1,0,1,1
2023-06-01,144569,0,1,1,0,1,1
2023-06-01,144570,0,1,1,0,1,1
2023-06-01,144571,0,1,1,0,1,1
2023-06-01,144572,0,1,1,0,1,1
2023-06-01,144573,0,1,1,0,1,1
2023-06-01,144574,0,1,1,0,1,1
2023-06-01,144575,0,1,1,0,1,1
2023-06-01,144576,0,1,1,0,1,1
2023-06-01,144577,0,1,1,0,1,1
2023-06-01,144578,0,1,1,0,1,1
2023-06-01,144579,0,1,1,0,1,1
2023-06-01,144580,0,1,1,0,1,1
2023-06-01,144581,0,1,1,0,1,1
2023-06-01,144582,0,1,1,0,1,1
2023-06-01,144583,0,1,1,0,1,1
2023-06-01,144584,0,1,1,0,1,1
2023-06-01,144585,0,1,1,0,1,1
2023-06-01,144586,0,1,1,0,1,1
2023-06-01,144587,0,1,1,0,1,1
2023-06-01,144588,0,1,1,0,1,1
2023-06-01,144589,0,1,1,0,1,1
2023-06-01,144590,0,1,1,0,1,1
2023-06-01,144591,0,1,1,0,1,1
2023-06-01,144592,0,1,1,0,1,1
2023-06-01,144593,0,1,1,0,1,1
2023-06-01,144594,0,1,1,0,1,1
2023-06-01,144595,0,1,1,0,1,1
2023-06-01,144596,0,1,1,0,1,1
2023-06-01,144597,0,1,1,0,1,1
2023-06-01,144598,0,1,1,0,1,1
2023-06-01,144599,0,1,1,0,1,1
2023-06-01,144600,0,1,1,0,1,1
2023-06-01,144601,0,1,1,0,1,1
2023-06-01,144602,0,1,1,0,1,1
2023-06-01,144603,0,1,1,0,1,1
2023-06-01,144604,0,1,1,0,1,1
2023-06-01,144605,0,1,1,0,1,1
2023-06-01,144606,0,1,1,0,1,1
2023-06-01,144607,0,1,1,0,1,1
2023-06-01,144608,0,1,1,0,1,1
2023-06-01,144609,0,1,1,0,1,1
2023-06-01,144610,0,1,1,0,1,1
2023-06-01,144611,0,1,1,0,1,1
2023-06-01,144612,0,1,1,0,1,1
2023-06-01,144613,0,1,1,0,1,1
2023-06-01,144614,0,1,1,0,1,1
2023-06-01,144615,0,1,1,0,1,1
2023-06-01,144616,0,1,1,0,1,1
2023-06-01,144617,0,1,1,0,1,1
2023-06-01,144618,0,1,1,0,1,1
2023-06-01,144619,0,1,1,0,1,1
2023-06-01,144620,0,1,1,0,1,1
2023-06-01,144621,0,1,1,0,1,1
2023-06-01,144622,0,1,1,0,1,1
2023-06-01,144623,0,1,1,0,1,1
2023-06-01,144624,0,1,1,0,1,1
2023-06-01,144625,0,1,1,0,1,1
2023-06-01,144626,0,1,1,0,1,1
2023-06-01,144627,0,1,1,0,1,1
2023-06-01,144628,0,1,1,0,1,1
2023-06-01,144629,0,1,1,0,1,1
2023-06-01,144630,0,1,1,0,1,1
2023-06-01,144631,0,1,1,0,1,1
2023-06-01,144632,0,1,1,0,1,1
2023-06-01,144633,0,1,1,0,1,1
2023-06-01,144634,0,1,1,0,1,1
2023-06-01,144635,0,1,1,0,1,1
2023-06-01,144636,0,1,1,0,1,1
2023-06-01,144637,0,1,1,0,1,1
2023-06-01,144638,0,1,1,0,1,1
2023-06-01,144639,0,1,1,0,1,1
2023-06-01,144640,0,1,1,0,1,1
2023-06-01,144641,0,1,1,0,1,1
2023-06-01,144642,0,1,1,0,1,1
2023-06-01,144643,0,1,1,0,1,1
2023-06-01,144644,0,1,1,0,1,1
2023-06-01,144645,0,1,1,0,1,1
2023-06-01,144646,0,1,1,0,1,1
2023-06-01,144647,0,1,1,0,1,1
2023-06-01,144648,0,1,1,0,1,1
2023-06-01,144649,0,1,1,0,1,1
2023-06-01,144650,0,1,1,0,1,1
2023-06-01,144651,0,1,1,0,1,1
2023-06-01,144652,0,1,1,0,1,1
2023-06-01,144653,0,1,1,0,1,1
2023-06-01,144654,0,1,1,0,1,1
2023-06-01,144655,0,1,1,0,1,1
2023-06-01,144656,0,1,1,0,1,1
2023-06-01,144657,0,1,1,0,1,1
2023-06-01,144658,0,1,1,0,1,1
2023-06-01,144659,0,1,1,0,1,1
2023-06-01,144660,0,1,1,0,1,1
2023-06-01,144661,0,1,1,0,1,1
2023-06-01,144662,0,1,1,0,1,1
2023-06-01,144663,0,1,1,0,1,1
2023-06-01,144664,0,1,1,0,1,1
2023-06-01,144665,0,1,1,0,1,1
2023-06-01,144666,0,1,1,0,1,1
2023-06-01,144667,0,1,1,0,1,1
2023-06-01,144668,0,1,1,0,1,1
2023-06-01,144669,0,1,1,0,1,1
2023-06-01,144670,0,1,1,0,1,1
2023-06-01,144671,0,1,1,0,1,1
2023-06-01,144672,0,1,1,0,1,1
2023-06-01,144673,0,1,1,0,1,1
2023-06-01,144674,0,1,1,0,1,1
2023-06-01,144675,0,1,1,0,1,1
2023-06-01,144676,0,1,1,0,1,1
2023-06-01,144677,0,1,1,0,1,1
2023-06-01,144678,0,1,1,0,1,1
2023-06-01,144679,0,1,1,0,1,1
2023-06-01,144680,0,1,1,0,1,1
2023-06-01,144681,0,1,1,0,1,1
2023-06-01,144682,0,1,1,0,1,1
2023-06-01,144683,0,1,1,0,1,1
2023-06-01,144684,0,1,1,0,1,1
2023-06-01,144685,0,1,1,0,1,1
2023-06-01,144686,0,1,1,0,1,1
2023-06-01,144687,0,1,1,0,1,1
2023-06-01,144688,0,1,1,0,1,1
2023-06-01,144689,0,1,1,0,1,1
2023-06-01,144690,0,1,1,0,1,1
2023-06-01,144691,0,1,1,0,1,1
2023-06-01,144692,0,1,1,0,1,1
2023-06-01,144693,0,1,1,0,1,1
2023-06-01,144694,0,1,1,0,1,1
2023-06-01,144695,0,1,1,0,1,1
2023-06-01,144696,0,1,1,0,1,1
2023-06-01,144697,0,1,1,0,1,1
2023-06-01,144698,0,1,1,0,1,1
2023-06-01,144699,0,1,1,0,1,1
2023-06-01,144700,0,1,1,0,1,1
2023-06-01,144701,0,1,1,0,1,1
2023-06-01,144702,0,1,1,0,1,1
2023-06-01,144703,0,1,1,0,1,1
2023-06-01,144704,0,1,1,0,1,1
2023-06-01,144705,0,1,1,0,1,1
2023-06-01,144706,0,1,1,0,1,1
2023-06-01,144707,0,1,1,0,1,1
2023-06-01,144708,0,1,1,0,1,1
2023-06-01,144709,0,1,1,0,1,1
2023-06-01,144710,0,1,1,0,1,1
2023-06-01,144711,0,1,1,0,1,1
2023-06-01,144712,0,1,1,0,1,1
2023-06-01,144713,0,1,1,0,1,1
2023-06-01,144714,0,1,1,0,1,1
2023-06-01,144715,0,1,1,0,1,1
2023-06-01,144716,0,1,1,0,1,1
2023-06-01,144717,0,1,1,0,1,1
2023-06-01,144718,0,1,1,0,1,1
2023-06-01,144719,0,1,1,0,1,1
2023-06-01,144720,0,1,1,0,1,1
2023-06-01,144721,0,1,1,0,1,1
2023-06-01,144722,0,1,1,0,1,1
2023-06-01,144723,0,1,1,0,1,1
2023-06-01,144724,0,1,1,0,1,1
2023-06-01,144725,0,1,1,0,1,1
2023-06-01,144726,0,1,1,0,1,1
2023-06-01,144727,0,1,1,0,1,1
2023-06-01,144728,0,1,1,0,1,1
2023-06-01,144729,0,1,1,0,1,1
2023-06-01,144730,0,1,1,0,1,1
2023-06-01,144731,0,1,1,0,1,1
2023-06-01,144732,0,1,1,0,1,1
2023-06-01,144733,0,1,1,0,1,1
2023-06-01,144734,0,1,1,0,1,1
2023-06-01,144735,0,1,1,0,1,1
2023-06-01,144736,0,1,1,0,1,1
2023-06-01,144737,0,1,1,0,1,1
2023-06-01,144738,0,1,1,0,1,1
2023-06-01,144739,0,1,1,0,1,1
2023-06-01,144740,0,1,1,0,1,1
2023-06-01,144741,0,1,1,0,1,1
2023-06-01,144742,0,1,1,0,1,1
2023-06-01,144743,0,1,1,0,1,1
2023-06-01,144744,0,1,1,0,1,1
2023-06-01,144745,0,1,1,0,1,1
2023-06-01,144746,0,1,1,0,1,1
2023-06-01,144747,0,1,1,0,1,1
2023-06-01,144748,0,1,1,0,1,1
2023-06-01,144749,0,1,1,0,1,1
2023-06-01,144750,0,1,1,0,1,1
2023-06-01,144751,0,1,1,0,1,1
2023-06-01,144752,0,1,1,0,1,1
2023-06-01,144753,0,1,1,0,1,1
2023-06-01,144754,0,1,1,0,1,1
2023-06-01,144755,0,1,1,0,1,1
2023-06-01,144756,0,1,1,0,1,1
2023-06-01,144757,0,1,1,0,1,1
2023-06-01,144758,0,1,1,0,1,1
2023-06-01,144759,0,1,1,0,1,1
2023-06-01,144760,0,1,1,0,1,1
2023-06-01,144761,0,1,1,0,1,1
2023-06-01,144762,0,1,1,0,1,1
2023-06-01,144763,0,1,1,0,1,1
2023-06-01,144764,0,1,1,0,1,1
2023-06-01,144765,0,1,1,0,1,1
2023-06-01,144766,0,1,1,0,1,1
2023-06-01,144767,0,1,1,0,1,1
2023-06-01,144768,0,1,1,0,1,1
2023-06-01,144769,0,1,1,0,1,1
2023-06-01,144770,0,1,1,0,1,1
2023-06-01,144771,0,1,1,0,1,1
2023-06-01,144772,0,1,1,0,1,1
2023-06-01,144773,0,1,1,0,1,1
2023-06-01,144774,0,1,1,0,1,1
2023-06-01,144775,0,1,1,0,1,1
2023-06-01,144776,0,1,1,0,1,1
2023-06-01,144777,0,1,1,0,1,1
2023-06-01,144778,0,1,1,0,1,1
2023-06-01,144779,0,1,1,0,1,1
2023-06-01,144780,0,1,1,0,1,1
2023-06-01,144781,0,1,1,0,1,1
2023-06-01,144782,0,1,1,0,1,1
2023-06-01,144783,0,1,1,0,1,1
2023-06-01,144784,0,1,1,0,1,1
2023-06-01,144785,0,1,1,0,1,1
2023-06-01,144786,0,1,1,0,1,1
2023-06-01,144787,0,1,1,0,1,1
2023-06-01,144788,0,1,1,0,1,1
2023-06-01,144789,0,1,1,0,1,1
2023-06-01,144790,0,1,1,0,1,1
2023-06-01,144791,0,1,1,0,1,1
2023-06-01,144792,0,1,1,0,1,1
2023-06-01,144793,0,1,1,0,1,1
2023-06-01,144794,0,1,1,0,1,1
2023-06-01,144795,0,1,1,0,1,1
2023-06-01,144796,0,1,1,0,1,1
2023-06-01,144797,0,1,1,0,1,1
2023-06-01,144798,0,1,1,0,1,1
2023-06-01,144799,0,1,1,0,1,1
2023-06-01,144800,0,1,1,0,1,1
2023-06-01,144801,0,1,1,0,1,1
2023-06-01,144802,0,1,1,0,1,1
2023-06-01,144803,0,1,1,0,1,1
2023-06-01,144804,0,1,1,0,1,1
2023-06-01,144805,0,1,1,0,1,1
2023-06-01,144806,0,1,1,0,1,1
2023-06-01,144807,0,1,1,0,1,1
2023-06-01,144808,0,1,1,0,1,1
2023-06-01,144809,0,1,1,0,1,1
2023-06-01,144810,0,1,1,0,1,1
2023-06-01,144811,0,1,1,0,1,1
2023-06-01,144812,0,1,1,0,1,1
2023-06-01,144813,0,1,1,0,1,1
2023-06-01,144814,0,1,1,0,1,1
2023-06-01,144815,0,1,1,0,1,1
2023-06-01,144816,0,1,1,0,1,1
2023-06-01,144817,0,1,1,0,1,1
2023-06-01,144818,0,1,1,0,1,1
2023-06-01,144819,0,1,1,0,1,1
2023-06-01,144820,0,1,1,0,1,1
2023-06-01,144821,0,1,1,0,1,1
2023-06-01,144822,0,1,1,0,1,1
2023-06-01,144823,0,1,1,0,1,1
2023-06-01,144824,0,1,1,0,1,1
2023-06-01,144825,0,1,1,0,1,1
2023-06-01,144826,0,1,1,0,1,1
2023-06-01,144827,0,1,1,0,1,1
2023-06-01,144828,0,1,1,0,1,1
2023-06-01,144829,0,1,1,0,1,1
2023-06-01,144830,0,1,1,0,1,1
2023-06-01,144831,0,1,1,0,1,1
2023-06-01,144832,0,1,1,0,1,1
2023-06-01,144833,0,1,1,0,1,1
2023-06-01,144834,0,1,1,0,1,1
2023-06-01,144835,0,1,1,0,1,1
2023-06-01,144836,0,1,1,0,1,1
2023-06-01,144837,0,1,1,0,1,1
2023-06-01,144838,0,1,1,0,1,1
2023-06-01,144839,0,1,1,0,1,1
2023-06-01,144840,0,1,1,0,1,1
2023-06-01,144841,0,1,1,0,1,1
2023-06-01,144842,0,1,1,0,1,1
2023-06-01,144843,0,1,1,0,1,1
2023-06-01,144844,0,1,1,0,1,1
2023-06-01,144845,0,1,1,0,1,1
2023-06-01,144846,0,1,1,0,1,1
2023-06-01,144847,0,1,1,0,1,1
2023-06-01,144848,0,1,1,0,1,1
2023-06-01,144849,0,1,1,0,1,1
2023-06-01,144850,0,1,1,0,1,1
2023-06-01,144851,0,1,1,0,1,1
2023-06-01,144852,0,1,1,0,1,1
2023-06-01,144853,0,1,1,0,1,1
2023-06-01,144854,0,1,1,0,1,1
2023-06-01,144855,0,1,1,0,1,1
2023-06-01,144856,0,1,1,0,1,1
2023-06-01,144857,0,1,1,0,1,1
2023-06-01,144858,0,1,1,0,1,1
2023-06-01,144859,0,1,1,0,1,1
2023-06-01,144860,0,1,1,0,1,1
2023-06-01,144861,0,1,1,0,1,1
2023-06-01,144862,0,1,1,0,1,1
2023-06-01,144863,0,1,1,0,1,1
2023-06-01,144864,0,1,1,0,1,1
2023-06-01,144865,0,1,1,0,1,1
2023-06-01,144866,0,1,1,0,1,1
2023-06-01,144867,0,1,1,0,1,1
2023-06-01,144868,0,1,1,0,1,1
2023-06-01,144869,0,1,1,0,1,1
2023-06-01,144870,0,1,1,0,1,1
2023-06-01,144871,0,1,1,0,1,1
2023-06-01,144872,0,1,1,0,1,1
2023-06-01,144873,0,1,1,0,1,1
2023-06-01,144874,0,1,1,0,1,1
2023-06-01,144875,0,1,1,0,1,1
2023-06-01,144876,0,1,1,0,1,1
2023-06-01,144877,0,1,1,0,1,1
2023-06-01,144878,0,1,1,0,1,1
2023-06-01,144879,0,1,1,0,1,1
2023-06-01,144880,0,1,1,0,1,1
2023-06-01,144881,0,1,1,0,1,1
2023-06-01,144882,0,1,1,0,1,1
2023-06-01,144883,0,1,1,0,1,1
2023-06-01,144884,0,1,1,0,1,1
2023-06-01,144885,0,1,1,0,1,1
2023-06-01,144886,0,1,1,0,1,1
2023-06-01,144887,0,1,1,0,1,1
2023-06-01,144888,0,1,1,0,1,1
2023-06-01,144889,0,1,1,0,1,1
2023-06-01,144890,0,1,1,0,1,1
2023-06-01,144891,0,1,1,0,1,1
2023-06-01,144892,0,1,1,0,1,1
2023-06-01,144893,0,1,1,0,1,1
2023-06-01,144894,0,1,1,0,1,1
2023-06-01,144895,0,1,1,0,1,1
2023-06-01,144896,0,1,1,0,1,1
2023-06-01,144897,0,1,1,0,1,1
2023-06-01,144898,0,1,1,0,1,1
2023-06-01,144899,0,1,1,0,1,1
2023-06-01,144900,0,1,1,0,1,1
2023-06-01,144901,0,1,1,0,1,1
2023-06-01,144902,0,1,1,0,1,1
2023-06-01,144903,0,1,1,0,1,1
2023-06-01,144904,0,1,1,0,1,1
2023-06-01,144905,0,1,1,0,1,1
2023-06-01,144906,0,1,1,0,1,1
2023-06-01,144907,0,1,1,0,1,1
2023-06-01,144908,0,1,1,0,1,1
2023-06-01,144909,0,1,1,0,1,1
2023-06-01,144910,0,1,1,0,1,1
2023-06-01,144911,0,1,1,0,1,1
2023-06-01,144912,0,1,1,0,1,1
2023-06-01,144913,0,1,1,0,1,1
2023-06-01,144914,0,1,1,0,1,1
2023-06-01,144915,0,1,1,0,1,1
2023-06-01,144916,0,1,1,0,1,1
2023-06-01,144917,0,1,1,0,1,1
2023-06-01,144918,0,1,1,0,1,1
2023-06-01,144919,0,1,1,0,1,1
2023-06-01,144920,0,1,1,0,1,1
2023-06-01,144921,0,1,1,0,1,1
2023-06-01,144922,0,1,1,0,1,1
2023-06-01,144923,0,1,1,0,1,1
2023-06-01,144924,0,1,1,0,1,1
2023-06-01,144925,0,1,1,0,1,1
2023-06-01,144926,0,1,1,0,1,1
2023-06-01,144927,0,1,1,0,1,1
2023-06-01,144928,0,1,1,0,1,1
2023-06-01,144929,0,1,1,0,1,1
2023-06-01,144930,0,1,1,0,1,1
2023-06-01,144931,0,1,1,0,1,1
2023-06-01,144932,0,1,1,0,1,1
2023-06-01,144933,0,1,1,0,1,1
2023-06-01,144934,0,1,1,0,1,1
2023-06-01,144935,0,1,1,0,1,1
2023-06-01,144936,0,1,1,0,1,1
2023-06-01,144937,0,1,1,0,1,1
2023-06-01,144938,0,1,1,0,1,1
2023-06-01,144939,0,1,1,0,1,1
2023-06-01,144940,0,1,1,0,1,1
2023-06-01,144941,0,1,1,0,1,1
2023-06-01,144942,0,1,1,0,1,1
2023-06-01,144943,0,1,1,0,1,1
2023-06-01,144944,0,1,1,0,1,1
2023-06-01,144945,0,1,1,0,1,1
2023-06-01,144946,0,1,1,0,1,1
2023-06-01,144947,0,1,1,0,1,1
2023-06-01,144948,0,1,1,0,1,1
2023-06-01,144949,0,1,1,0,1,1
2023-06-01,144950,0,1,1,0,1,1
2023-06-01,144951,0,1,1,0,1,1
2023-06-01,144952,0,1,1,0,1,1
2023-06-01,144953,0,1,1,0,1,1
2023-06-01,144954,0,1,1,0,1,1
2023-06-01,144955,0,1,1,0,1,1
2023-06-01,144956,0,1,1,0,1,1
2023-06-01,144957,0,1,1,0,1,1
2023-06-01,144958,0,1,1,0,1,1
2023-06-01,144959,0,1,1,0,1,1
2023-06-01,144960,0,1,1,0,1,1
2023-06-01,144961,0,1,1,0,1,1
2023-06-01,144962,0,1,1,0,1,1
2023-06-01,144963,0,1,1,0,1,1
2023-06-01,144964,0,1,1,0,1,1
2023-06-01,144965,0,1,1,0,1,1
2023-06-01,144966,0,1,1,0,1,1
2023-06-01,144967,0,1,1,0,1,1
2023-06-01,144968,0,1,1,0,1,1
2023-06-01,144969,0,1,1,0,1,1
2023-06-01,144970,0,1,1,0,1,1
2023-06-01,144971,0,1,1,0,1,1
2023-06-01,144972,0,1,1,0,1,1
2023-06-01,144973,0,1,1,0,1,1
2023-06-01,144974,0,1,1,0,1,1
2023-06-01,144975,0,1,1,0,1,1
2023-06-01,144976,0,1,1,0,1,1
2023-06-01,144977,0,1,1,0,1,1
2023-06-01,144978,0,1,1,0,1,1
2023-06-01,144979,0,1,1,0,1,1
2023-06-01,144980,0,1,1,0,1,1
2023-06-01,144981,0,1,1,0,1,1
2023-06-01,144982,0,1,1,0,1,1
2023-06-01,144983,0,1,1,0,1,1
2023-06-01,144984,0,1,1,0,1,1
2023-06-01,144985,0,1,1,0,1,1
2023-06-01,144986,0,1,1,0,1,1
2023-06-01,144987,0,1,1,0,1,1
2023-06-01,144988,0,1,1,0,1,1
2023-06-01,144989,0,1,1,0,1,1
2023-06-01,144990,0,1,1,0,1,1
2023-06-01,144991,0,1,1,0,1,1
2023-06-01,144992,0,1,1,0,1,1
2023-06-01,144993,0,1,1,0,1,1
2023-06-01,144994,0,1,1,0,1,1
2023-06-01,144995,0,1,1,0,1,1
2023-06-01,144996,0,1,1,0,1,1
2023-06-01,144997,0,1,1,0,1,1
2023-06-01,144998,0,1,1,0,1,1
2023-06-01,144999,0,1,1,0,1,1
2023-06-01,145000,0,1,1,0,1,1
2023-06-01,145001,0,1,1,0,1,1
2023-06-01,145002,0,1,1,0,1,1
2023-06-01,145003,0,1,1,0,1,1
2023-06-01,145004,0,1,1,0,1,1
2023-06-01,145005,0,1,1,0,1,1
2023-06-01,145006,0,1,1,0,1,1
2023-06-01,145007,0,1,1,0,1,1
2023-06-01,145008,0,1,1,0,1,1
2023-06-01,145009,0,1,1,0,1,1
2023-06-01,145010,0,1,1,0,1,1
2023-06-01,145011,0,1,1,0,1,1
2023-06-01,145012,0,1,1,0,1,1
2023-06-01,145013,0,1,1,0,1,1
2023-06-01,145014,0,1,1,0,1,1
2023-06-01,145015,0,1,1,0,1,1
2023-06-01,145016,0,1,1,0,1,1
2023-06-01,145017,0,1,1,0,1,1
2023-06-01,145018,0,1,1,0,1,1
2023-06-01,145019,0,1,1,0,1,1
2023-06-01,145020,0,1,1,0,1,1
2023-06-01,145021,0,1,1,0,1,1
2023-06-01,145022,0,1,1,0,1,1
2023-06-01,145023,0,1,1,0,1,1
2023-06-01,145024,0,1,1,0,1,1
2023-06-01,145025,0,1,1,0,1,1
2023-06-01,145026,0,1,1,0,1,1
2023-06-01,145027,0,1,1,0,1,1
2023-06-01,145028,0,1,1,0,1,1
2023-06-01,145029,0,1,1,0,1,1
2023-06-01,145030,0,1,1,0,1,1
2023-06-01,145031,0,1,1,0,1,1
2023-06-01,145032,0,1,1,0,1,1
2023-06-01,145033,0,1,1,0,1,1
2023-06-01,145034,0,1,1,0,1,1
2023-06-01,145035,0,1,1,0,1,1
2023-06-01,145036,0,1,1,0,1,1
2023-06-01,145037,0,1,1,0,1,1
2023-06-01,145038,0,1,1,0,1,1
2023-06-01,145039,0,1,1,0,1,1
2023-06-01,145040,0,1,1,0,1,1
2023-06-01,145041,0,1,1,0,1,1
2023-06-01,145042,0,1,1,0,1,1
2023-06-01,145043,0,1,1,0,1,1
2023-06-01,145044,0,1,1,0,1,1
2023-06-01,145045,0,1,1,0,1,1
2023-06-01,145046,0,1,1,0,1,1
2023-06-01,145047,0,1,1,0,1,1
2023-06-01,145048,0,1,1,0,1,1
2023-06-01,145049,0,1,1,0,1,1
2023-06-01,145050,0,1,1,0,1,1
2023-06-01,145051,0,1,1,0,1,1
2023-06-01,145052,0,1,1,0,1,1
2023-06-01,145053,0,1,1,0,1,1
2023-06-01,145054,0,1,1,0,1,1
2023-06-01,145055,0,1,1,0,1,1
2023-06-01,145056,0,1,1,0,1,1
2023-06-01,145057,0,1,1,0,1,1
2023-06-01,145058,0,1,1,0,1,1
2023-06-01,145059,0,1,1,0,1,1
2023-06-01,145060,0,1,1,0,1,1
2023-06-01,145061,0,1,1,0,1,1
2023-06-01,145062,0,1,1,0,1,1
2023-06-01,145063,0,1,1,0,1,1
2023-06-01,145064,0,1,1,0,1,1
2023-06-01,145065,0,1,1,0,1,1
2023-06-01,145066,0,1,1,0,1,1
2023-06-01,145067,0,1,1,0,1,1
2023-06-01,145068,0,1,1,0,1,1
2023-06-01,145069,0,1,1,0,1,1
2023-06-01,145070,0,1,1,0,1,1
2023-06-01,145071,0,1,1,0,1,1
2023-06-01,145072,0,1,1,0,1,1
2023-06-01,145073,0,1,1,0,1,1
2023-06-01,145074,0,1,1,0,1,1
2023-06-01,145075,0,1,1,0,1,1
2023-06-01,145076,0,1,1,0,1,1
2023-06-01,145077,0,1,1,0,1,1
2023-06-01,145078,0,1,1,0,1,1
2023-06-01,145079,0,1,1,0,1,1
2023-06-01,145080,0,1,1,0,1,1
2023-06-01,145081,0,1,1,0,1,1
2023-06-01,145082,0,1,1,0,1,1
2023-06-01,145083,0,1,1,0,1,1
2023-06-01,145084,0,1,1,0,1,1
2023-06-01,145085,0,1,1,0,1,1
2023-06-01,145086,0,1,1,0,1,1
2023-06-01,145087,0,1,1,0,1,1
2023-06-01,145088,0,1,1,0,1,1
2023-06-01,145089,0,1,1,0,1,1
2023-06-01,145090,0,1,1,0,1,1
2023-06-01,145091,0,1,1,0,1,1
2023-06-01,145092,0,1,1,0,1,1
2023-06-01,145093,0,1,1,0,1,1
2023-06-01,145094,0,1,1,0,1,1
2023-06-01,145095,0,1,1,0,1,1
2023-06-01,145096,0,1,1,0,1,1
2023-06-01,145097,0,1,1,0,1,1
2023-06-01,145098,0,1,1,0,1,1
2023-06-01,145099,0,1,1,0,1,1
2023-06-01,145100,0,1,1,0,1,1
2023-06-01,145101,0,1,1,0,1,1
2023-06-01,145102,0,1,1,0,1,1
2023-06-01,145103,0,1,1,0,1,1
2023-06-01,145104,0,1,1,0,1,1
2023-06-01,145105,0,1,1,0,1,1
2023-06-01,145106,0,1,1,0,1,1
2023-06-01,145107,0,1,1,0,1,1
2023-06-01,145108,0,1,1,0,1,1
2023-06-01,145109,0,1,1,0,1,1
2023-06-01,145110,0,1,1,0,1,1
2023-06-01,145111,0,1,1,0,1,1
2023-06-01,145112,0,1,1,0,1,1
2023-06-01,145113,0,1,1,0,1,1
2023-06-01,145114,0,1,1,0,1,1
2023-06-01,145115,0,1,1,0,1,1
2023-06-01,145116,0,1,1,0,1,1
2023-06-01,145117,0,1,1,0,1,1
2023-06-01,145118,0,1,1,0,1,1
2023-06-01,145119,0,1,1,0,1,1
2023-06-01,145120,0,1,1,0,1,1
2023-06-01,145121,0,1,1,0,1,1
2023-06-01,145122,0,1,1,0,1,1
2023-06-01,145123,0,1,1,0,1,1
2023-06-01,145124,0,1,1,0,1,1
2023-06-01,145125,0,1,1,0,1,1
2023-06-01,145126,0,1,1,0,1,1
2023-06-01,145127,0,1,1,0,1,1
2023-06-01,145128,0,1,1,0,1,1
2023-06-01,145129,0,1,1,0,1,1
2023-06-01,145130,0,1,1,0,1,1
2023-06-01,145131,0,1,1,0,1,1
2023-06-01,145132,0,1,1,0,1,1
2023-06-01,145133,0,1,1,0,1,1
2023-06-01,145134,0,1,1,0,1,1
2023-06-01,145135,0,1,1,0,1,1
2023-06-01,145136,0,1,1,0,1,1
2023-06-01,145137,0,1,1,0,1,1
2023-06-01,145138,0,1,1,0,1,1
2023-06-01,145139,0,1,1,0,1,1
2023-06-01,145140,0,1,1,0,1,1
2023-06-01,145141,0,1,1,0,1,1
2023-06-01,145142,0,1,1,0,1,1
2023-06-01,145143,0,1,1,0,1,1
2023-06-01,145144,0,1,1,0,1,1
2023-06-01,145145,0,1,1,0,1,1
2023-06-01,145146,0,1,1,0,1,1
2023-06-01,145147,0,1,1,0,1,1
2023-06-01,145148,0,1,1,0,1,1
2023-06-01,145149,0,1,1,0,1,1
2023-06-01,145150,0,1,1,0,1,1
2023-06-01,145151,0,1,1,0,1,1
2023-06-01,145152,0,1,1,0,1,1
2023-06-01,145153,0,1,1,0,1,1
2023-06-01,145154,0,1,1,0,1,1
2023-06-01,145155,0,1,1,0,1,1
2023-06-01,145156,0,1,1,0,1,1
2023-06-01,145157,0,1,1,0,1,1
2023-06-01,145158,0,1,1,0,1,1
2023-06-01,145159,0,1,1,0,1,1
2023-06-01,145160,0,1,1,0,1,1
2023-06-01,145161,0,1,1,0,1,1
2023-06-01,145162,0,1,1,0,1,1
2023-06-01,145163,0,1,1,0,1,1
2023-06-01,145164,0,1,1,0,1,1
2023-06-01,145165,0,1,1,0,1,1
2023-06-01,145166,0,1,1,0,1,1
2023-06-01,145167,0,1,1,0,1,1
2023-06-01,145168,0,1,1,0,1,1
2023-06-01,145169,0,1,1,0,1,1
2023-06-01,145170,0,1,1,0,1,1
2023-06-01,145171,0,1,1,0,1,1
2023-06-01,145172,0,1,1,0,1,1
2023-06-01,145173,0,1,1,0,1,1
2023-06-01,145174,0,1,1,0,1,1
2023-06-01,145175,0,1,1,0,1,1
2023-06-01,145176,0,1,1,0,1,1
2023-06-01,145177,0,1,1,0,1,1
2023-06-01,145178,0,1,1,0,1,1
2023-06-01,145179,0,1,1,0,1,1
2023-06-01,145180,0,1,1,0,1,1
2023-06-01,145181,0,1,1,0,1,1
2023-06-01,145182,0,1,1,0,1,1
2023-06-01,145183,0,1,1,0,1,1
2023-06-01,145184,0,1,1,0,1,1
2023-06-01,145185,0,1,1,0,1,1
2023-06-01,145186,0,1,1,0,1,1
2023-06-01,145187,0,1,1,0,1,1
2023-06-01,145188,0,1,1,0,1,1
2023-06-01,145189,0,1,1,0,1,1
2023-06-01,145190,0,1,1,0,1,1
2023-06-01,145191,0,1,1,0,1,1
2023-06-01,145192,0,1,1,0,1,1
2023-06-01,145193,0,1,1,0,1,1
2023-06-01,145194,0,1,1,0,1,1
2023-06-01,145195,0,1,1,0,1,1
2023-06-01,145196,0,1,1,0,1,1
2023-06-01,145197,0,1,1,0,1,1
2023-06-01,145198,0,1,1,0,1,1
2023-06-01,145199,0,1,1,0,1,1
2023-06-01,145200,0,1,1,0,1,1
2023-06-01,145201,0,1,1,0,1,1
2023-06-01,145202,0,1,1,0,1,1
2023-06-01,145203,0,1,1,0,1,1
2023-06-01,145204,0,1,1,0,1,1
2023-06-01,145205,0,1,1,0,1,1
2023-06-01,145206,0,1,1,0,1,1
2023-06-01,145207,0,1,1,0,1,1
2023-06-01,145208,0,1,1,0,1,1
2023-06-01,145209,0,1,1,0,1,1
2023-06-01,145210,0,1,1,0,1,1
2023-06-01,145211,0,1,1,0,1,1
2023-06-01,145212,0,1,1,0,1,1
2023-06-01,145213,0,1,1,0,1,1
2023-06-01,145214,0,1,1,0,1,1
2023-06-01,145215,0,1,1,0,1,1
2023-06-01,145216,0,1,1,0,1,1
2023-06-01,145217,0,1,1,0,1,1
2023-06-01,145218,0,1,1,0,1,1
2023-06-01,145219,0,1,1,0,1,1
2023-06-01,145220,0,1,1,0,1,1
2023-06-01,145221,0,1,1,0,1,1
2023-06-01,145222,0,1,1,0,1,1
2023-06-01,145223,0,1,1,0,1,1
2023-06-01,145224,0,1,1,0,1,1
2023-06-01,145225,0,1,1,0,1,1
2023-06-01,145226,0,1,1,0,1,1
2023-06-01,145227,0,1,1,0,1,1
2023-06-01,145228,0,1,1,0,1,1
2023-06-01,145229,0,1,1,0,1,1
2023-06-01,145230,0,1,1,0,1,1
2023-06-01,145231,0,1,1,0,1,1
2023-06-01,145232,0,1,1,0,1,1
2023-06-01,145233,0,1,1,0,1,1
2023-06-01,145234,0,1,1,0,1,1
2023-06-01,145235,0,1,1,0,1,1
2023-06-01,145236,0,1,1,0,1,1
2023-06-01,145237,0,1,1,0,1,1
2023-06-01,145238,0,1,1,0,1,1
2023-06-01,145239,0,1,1,0,1,1
2023-06-01,145240,0,1,1,0,1,1
2023-06-01,145241,0,1,1,0,1,1
2023-06-01,145242,0,1,1,0,1,1
2023-06-01,145243,0,1,1,0,1,1
2023-06-01,145244,0,1,1,0,1,1
2023-06-01,145245,0,1,1,0,1,1
2023-06-01,145246,0,1,1,0,1,1
2023-06-01,145247,0,1,1,0,1,1
2023-06-01,145248,0,1,1,0,1,1
2023-06-01,145249,0,1,1,0,1,1
2023-06-01,145250,0,1,1,0,1,1
2023-06-01,145251,0,1,1,0,1,1
2023-06-01,145252,0,1,1,0,1,1
2023-06-01,145253,0,1,1,0,1,1
2023-06-01,145254,0,1,1,0,1,1
2023-06-01,145255,0,1,1,0,1,1
2023-06-01,145256,0,1,1,0,1,1
2023-06-01,145257,0,1,1,0,1,1
2023-06-01,145258,0,1,1,0,1,1
2023-06-01,145259,0,1,1,0,1,1
2023-06-01,145260,0,1,1,0,1,1
2023-06-01,145261,0,1,1,0,1,1
2023-06-01,145262,0,1,1,0,1,1
2023-06-01,145263,0,1,1,0,1,1
2023-06-01,145264,0,1,1,0,1,1
2023-06-01,145265,0,1,1,0,1,1
2023-06-01,145266,0,1,1,0,1,1
2023-06-01,145267,0,1,1,0,1,1
2023-06-01,145268,0,1,1,0,1,1
2023-06-01,145269,0,1,1,0,1,1
2023-06-01,145270,0,1,1,0,1,1
2023-06-01,145271,0,1,1,0,1,1
2023-06-01,145272,0,1,1,0,1,1
2023-06-01,145273,0,1,1,0,1,1
2023-06-01,145274,0,1,1,0,1,1
2023-06-01,145275,0,1,1,0,1,1
2023-06-01,145276,0,1,1,0,1,1
2023-06-01,145277,0,1,1,0,1,1
2023-06-01,145278,0,1,1,0,1,1
2023-06-01,145279,0,1,1,0,1,1
2023-06-01,145280,0,1,1,0,1,1
2023-06-01,145281,0,1,1,0,1,1
2023-06-01,145282,0,1,1,0,1,1
2023-06-01,145283,0,1,1,0,1,1
2023-06-01,145284,0,1,1,0,1,1
2023-06-01,145285,0,1,1,0,1,1
2023-06-01,145286,0,1,1,0,1,1
2023-06-01,145287,0,1,1,0,1,1
2023-06-01,145288,0,1,1,0,1,1
2023-06-01,145289,0,1,1,0,1,1
2023-06-01,145290,0,1,1,0,1,1
2023-06-01,145291,0,1,1,0,1,1
2023-06-01,145292,0,1,1,0,1,1
2023-06-01,145293,0,1,1,0,1,1
2023-06-01,145294,0,1,1,0,1,1
2023-06-01,145295,0,1,1,0,1,1
2023-06-01,145296,0,1,1,0,1,1
2023-06-01,145297,0,1,1,0,1,1
2023-06-01,145298,0,1,1,0,1,1
2023-06-01,145299,0,1,1,0,1,1
2023-06-01,145300,0,1,1,0,1,1
2023-06-01,145301,0,1,1,0,1,1
2023-06-01,145302,0,1,1,0,1,1
2023-06-01,145303,0,1,1,0,1,1
2023-06-01,145304,0,1,1,0,1,1
2023-06-01,145305,0,1,1,0,1,1
2023-06-01,145306,0,1,1,0,1,1
2023-06-01,145307,0,1,1,0,1,1
2023-06-01,145308,0,1,1,0,1,1
2023-06-01,145309,0,1,1,0,1,1
2023-06-01,145310,0,1,1,0,1,1
2023-06-01,145311,0,1,1,0,1,1
2023-06-01,145312,0,1,1,0,1,1
2023-06-01,145313,0,1,1,0,1,1
2023-06-01,145314,0,1,1,0,1,1
2023-06-01,145315,0,1,1,0,1,1
2023-06-01,145316,0,1,1,0,1,1
2023-06-01,145317,0,1,1,0,1,1
2023-06-01,145318,0,1,1,0,1,1
2023-06-01,145319,0,1,1,0,1,1
2023-06-01,145320,0,1,1,0,1,1
2023-06-01,145321,0,1,1,0,1,1
2023-06-01,145322,0,1,1,0,1,1
2023-06-01,145323,0,1,1,0,1,1
2023-06-01,145324,0,1,1,0,1,1
2023-06-01,145325,0,1,1,0,1,1
2023-06-01,145326,0,1,1,0,1,1
2023-06-01,145327,0,1,1,0,1,1
2023-06-01,145328,0,1,1,0,1,1
2023-06-01,145329,0,1,1,0,1,1
2023-06-01,145330,0,1,1,0,1,1
2023-06-01,145331,0,1,1,0,1,1
2023-06-01,145332,0,1,1,0,1,1
2023-06-01,145333,0,1,1,0,1,1
2023-06-01,145334,0,1,1,0,1,1
2023-06-01,145335,0,1,1,0,1,1
2023-06-01,145336,0,1,1,0,1,1
2023-06-01,145337,0,1,1,0,1,1
2023-06-01,145338,0,1,1,0,1,1
2023-06-01,145339,0,1,1,0,1,1
2023-06-01,145340,0,1,1,0,1,1
2023-06-01,145341,0,1,1,0,1,1
2023-06-01,145342,0,1,1,0,1,1
2023-06-01,145343,0,1,1,0,1,1
2023-06-01,145344,0,1,1,0,1,1
2023-06-01,145345,0,1,1,0,1,1
2023-06-01,145346,0,1,1,0,1,1
2023-06-01,145347,0,1,1,0,1,1
2023-06-01,145348,0,1,1,0,1,1
2023-06-01,145349,0,1,1,0,1,1
2023-06-01,145350,0,1,1,0,1,1
2023-06-01,145351,0,1,1,0,1,1
2023-06-01,145352,0,1,1,0,1,1
2023-06-01,145353,0,1,1,0,1,1
2023-06-01,145354,0,1,1,0,1,1
2023-06-01,145355,0,1,1,0,1,1
2023-06-01,145356,0,1,1,0,1,1
2023-06-01,145357,0,1,1,0,1,1
2023-06-01,145358,0,1,1,0,1,1
2023-06-01,145359,0,1,1,0,1,1
2023-06-01,145360,0,1,1,0,1,1
2023-06-01,145361,0,1,1,0,1,1
2023-06-01,145362,0,1,1,0,1,1
2023-06-01,145363,0,1,1,0,1,1
2023-06-01,145364,0,1,1,0,1,1
2023-06-01,145365,0,1,1,0,1,1
2023-06-01,145366,0,1,1,0,1,1
2023-06-01,145367,0,1,1,0,1,1
2023-06-01,145368,0,1,1,0,1,1
2023-06-01,145369,0,1,1,0,1,1
2023-06-01,145370,0,1,1,0,1,1
2023-06-01,145371,0,1,1,0,1,1
2023-06-01,145372,0,1,1,0,1,1
2023-06-01,145373,0,1,1,0,1,1
2023-06-01,145374,0,1,1,0,1,1
2023-06-01,145375,0,1,1,0,1,1
2023-06-01,145376,0,1,1,0,1,1
2023-06-01,145377,0,1,1,0,1,1
2023-06-01,145378,0,1,1,0,1,1
2023-06-01,145379,0,1,1,0,1,1
2023-06-01,145380,0,1,1,0,1,1
2023-06-01,145381,0,1,1,0,1,1
2023-06-01,145382,0,1,1,0,1,1
2023-06-01,145383,0,1,1,0,1,1
2023-06-01,145384,0,1,1,0,1,1
2023-06-01,145385,0,1,1,0,1,1
2023-06-01,145386,0,1,1,0,1,1
2023-06-01,145387,0,1,1,0,1,1
2023-06-01,145388,0,1,1,0,1,1
2023-06-01,145389,0,1,1,0,1,1
2023-06-01,145390,0,1,1,0,1,1
2023-06-01,145391,0,1,1,0,1,1
2023-06-01,145392,0,1,1,0,1,1
2023-06-01,145393,0,1,1,0,1,1
2023-06-01,145394,0,1,1,0,1,1
2023-06-01,145395,0,1,1,0,1,1
2023-06-01,145396,0,1,1,0,1,1
2023-06-01,145397,0,1,1,0,1,1
2023-06-01,145398,0,1,1,0,1,1
2023-06-01,145399,0,1,1,0,1,1
2023-06-01,145400,0,1,1,0,1,1
2023-06-01,145401,0,1,1,0,1,1
2023-06-01,145402,0,1,1,0,1,1
2023-06-01,145403,0,1,1,0,1,1
2023-06-01,145404,0,1,1,0,1,1
2023-06-01,145405,0,1,1,0,1,1
2023-06-01,145406,0,1,1,0,1,1
2023-06-01,145407,0,1,1,0,1,1
2023-06-01,145408,0,1,1,0,1,1
2023-06-01,145409,0,1,1,0,1,1
2023-06-01,145410,0,1,1,0,1,1
2023-06-01,145411,0,1,1,0,1,1
2023-06-01,145412,0,1,1,0,1,1
2023-06-01,145413,0,1,1,0,1,1
2023-06-01,145414,0,1,1,0,1,1
2023-06-01,145415,0,1,1,0,1,1
2023-06-01,145416,0,1,1,0,1,1
2023-06-01,145417,0,1,1,0,1,1
2023-06-01,145418,0,1,1,0,1,1
2023-06-01,145419,0,1,1,0,1,1
2023-06-01,145420,0,1,1,0,1,1
2023-06-01,145421,0,1,1,0,1,1
2023-06-01,145422,0,1,1,0,1,1
2023-06-01,145423,0,1,1,0,1,1
2023-06-01,145424,0,1,1,0,1,1
2023-06-01,145425,0,1,1,0,1,1
2023-06-01,145426,0,1,1,0,1,1
2023-06-01,145427,0,1,1,0,1,1
2023-06-01,145428,0,1,1,0,1,1
2023-06-01,145429,0,1,1,0,1,1
2023-06-01,145430,0,1,1,0,1,1
2023-06-01,145431,0,1,1,0,1,1
2023-06-01,145432,0,1,1,0,1,1
2023-06-01,145433,0,1,1,0,1,1
2023-06-01,145434,0,1,1,0,1,1
2023-06-01,145435,0,1,1,0,1,1
2023-06-01,145436,0,1,1,0,1,1
2023-06-01,145437,0,1,1,0,1,1
2023-06-01,145438,0,1,1,0,1,1
2023-06-01,145439,0,1,1,0,1,1
2023-06-01,145440,0,1,1,0,1,1
2023-06-01,145441,0,1,1,0,1,1
2023-06-01,145442,0,1,1,0,1,1
2023-06-01,145443,0,1,1,0,1,1
2023-06-01,145444,0,1,1,0,1,1
2023-06-01,145445,0,1,1,0,1,1
2023-06-01,145446,0,1,1,0,1,1
2023-06-01,145447,0,1,1,0,1,1
2023-06-01,145448,0,1,1,0,1,1
2023-06-01,145449,0,1,1,0,1,1
2023-06-01,145450,0,1,1,0,1,1
2023-06-01,145451,0,1,1,0,1,1
2023-06-01,145452,0,1,1,0,1,1
2023-06-01,145453,0,1,1,0,1,1
2023-06-01,145454,0,1,1,0,1,1
2023-06-01,145455,0,1,1,0,1,1
2023-06-01,145456,0,1,1,0,1,1
2023-06-01,145457,0,1,1,0,1,1
2023-06-01,145458,0,1,1,0,1,1
2023-06-01,145459,0,1,1,0,1,1
2023-06-01,145460,0,1,1,0,1,1
2023-06-01,145461,0,1,1,0,1,1
2023-06-01,145462,0,1,1,0,1,1
2023-06-01,145463,0,1,1,0,1,1
2023-06-01,145464,0,1,1,0,1,1
2023-06-01,145465,0,1,1,0,1,1
2023-06-01,145466,0,1,1,0,1,1
2023-06-01,145467,0,1,1,0,1,1
2023-06-01,145468,0,1,1,0,1,1
2023-06-01,145469,0,1,1,0,1,1
2023-06-01,145470,0,1,1,0,1,1
2023-06-01,145471,0,1,1,0,1,1
2023-06-01,145472,0,1,1,0,1,1
2023-06-01,145473,0,1,1,0,1,1
2023-06-01,145474,0,1,1,0,1,1
2023-06-01,145475,0,1,1,0,1,1
2023-06-01,145476,0,1,1,0,1,1
2023-06-01,145477,0,1,1,0,1,1
2023-06-01,145478,0,1,1,0,1,1
2023-06-01,145479,0,1,1,0,1,1
2023-06-01,145480,0,1,1,0,1,1
2023-06-01,145481,0,1,1,0,1,1
2023-06-01,145482,0,1,1,0,1,1
2023-06-01,145483,0,1,1,0,1,1
2023-06-01,145484,0,1,1,0,1,1
2023-06-01,145485,0,1,1,0,1,1
2023-06-01,145486,0,1,1,0,1,1
2023-06-01,145487,0,1,1,0,1,1
2023-06-01,145488,0,1,1,0,1,1
2023-06-01,145489,0,1,1,0,1,1
2023-06-01,145490,0,1,1,0,1,1
2023-06-01,145491,0,1,1,0,1,1
2023-06-01,145492,0,1,1,0,1,1
2023-06-01,145493,0,1,1,0,1,1
2023-06-01,145494,0,1,1,0,1,1
2023-06-01,145495,0,1,1,0,1,1
2023-06-01,145496,0,1,1,0,1,1
2023-06-01,145497,0,1,1,0,1,1
2023-06-01,145498,0,1,1,0,1,1
2023-06-01,145499,0,1,1,0,1,1
2023-06-01,145500,0,1,1,0,1,1
2023-06-01,145501,0,1,1,0,1,1
2023-06-01,145502,0,1,1,0,1,1
2023-06-01,145503,0,1,1,0,1,1
2023-06-01,145504,0,1,1,0,1,1
2023-06-01,145505,0,1,1,0,1,1
2023-06-01,145506,0,1,1,0,1,1
2023-06-01,145507,0,1,1,0,1,1
2023-06-01,145508,0,1,1,0,1,1
2023-06-01,145509,0,1,1,0,1,1
2023-06-01,145510,0,1,1,0,1,1
2023-06-01,145511,0,1,1,0,1,1
2023-06-01,145512,0,1,1,0,1,1
2023-06-01,145513,0,1,1,0,1,1
2023-06-01,145514,0,1,1,0,1,1
2023-06-01,145515,0,1,1,0,1,1
2023-06-01,145516,0,1,1,0,1,1
2023-06-01,145517,0,1,1,0,1,1
2023-06-01,145518,0,1,1,0,1,1
2023-06-01,145519,0,1,1,0,1,1
2023-06-01,145520,0,1,1,0,1,1
2023-06-01,145521,0,1,1,0,1,1
2023-06-01,145522,0,1,1,0,1,1
2023-06-01,145523,0,1,1,0,1,1
2023-06-01,145524,0,1,1,0,1,1
2023-06-01,145525,0,1,1,0,1,1
2023-06-01,145526,0,1,1,0,1,1
2023-06-01,145527,0,1,1,0,1,1
2023-06-01,145528,0,1,1,0,1,1
2023-06-01,145529,0,1,1,0,1,1
2023-06-01,145530,0,1,1,0,1,1
2023-06-01,145531,0,1,1,0,1,1
2023-06-01,145532,0,1,1,0,1,1
2023-06-01,145533,0,1,1,0,1,1
2023-06-01,145534,0,1,1,0,1,1
2023-06-01,145535,0,1,1,0,1,1
2023-06-01,145536,0,1,1,0,1,1
2023-06-01,145537,0,1,1,0,1,1
2023-06-01,145538,0,1,1,0,1,1
2023-06-01,145539,0,1,1,0,1,1
2023-06-01,145540,0,1,1,0,1,1
2023-06-01,145541,0,1,1,0,1,1
2023-06-01,145542,0,1,1,0,1,1
2023-06-01,145543,0,1,1,0,1,1
2023-06-01,145544,0,1,1,0,1,1
2023-06-01,145545,0,1,1,0,1,1
2023-06-01,145546,0,1,1,0,1,1
2023-06-01,145547,0,1,1,0,1,1
2023-06-01,145548,0,1,1,0,1,1
2023-06-01,145549,0,1,1,0,1,1
2023-06-01,145550,0,1,1,0,1,1
2023-06-01,145551,0,1,1,0,1,1
2023-06-01,145552,0,1,1,0,1,1
2023-06-01,145553,0,1,1,0,1,1
2023-06-01,145554,0,1,1,0,1,1
2023-06-01,145555,0,1,1,0,1,1
2023-06-01,145556,0,1,1,0,1,1
2023-06-01,145557,0,1,1,0,1,1
2023-06-01,145558,0,1,1,0,1,1
2023-06-01,145559,0,1,1,0,1,1
2023-06-01,145560,0,1,1,0,1,1
2023-06-01,145561,0,1,1,0,1,1
2023-06-01,145562,0,1,1,0,1,1
2023-06-01,145563,0,1,1,0,1,1
2023-06-01,145564,0,1,1,0,1,1
2023-06-01,145565,0,1,1,0,1,1
2023-06-01,145566,0,1,1,0,1,1
2023-06-01,145567,0,1,1,0,1,1
2023-06-01,145568,0,1,1,0,1,1
2023-06-01,145569,0,1,1,0,1,1
2023-06-01,145570,0,1,1,0,1,1
2023-06-01,145571,0,1,1,0,1,1
2023-06-01,145572,0,1,1,0,1,1
2023-06-01,145573,0,1,1,0,1,1
2023-06-01,145574,0,1,1,0,1,1
2023-06-01,145575,0,1,1,0,1,1
2023-06-01,145576,0,1,1,0,1,1
2023-06-01,145577,0,1,1,0,1,1
2023-06-01,145578,0,1,1,0,1,1
2023-06-01,145579,0,1,1,0,1,1
2023-06-01,145580,0,1,1,0,1,1
2023-06-01,145581,0,1,1,0,1,1
2023-06-01,145582,0,1,1,0,1,1
2023-06-01,145583,0,1,1,0,1,1
2023-06-01,145584,0,1,1,0,1,1
2023-06-01,145585,0,1,1,0,1,1
2023-06-01,145586,0,1,1,0,1,1
2023-06-01,145587,0,1,1,0,1,1
2023-06-01,145588,0,1,1,0,1,1
2023-06-01,145589,0,1,1,0,1,1
2023-06-01,145590,0,1,1,0,1,1
2023-06-01,145591,0,1,1,0,1,1
2023-06-01,145592,0,1,1,0,1,1
2023-06-01,145593,0,1,1,0,1,1
2023-06-01,145594,0,1,1,0,1,1
2023-06-01,145595,0,1,1,0,1,1
2023-06-01,145596,0,1,1,0,1,1
2023-06-01,145597,0,1,1,0,1,1
2023-06-01,145598,0,1,1,0,1,1
2023-06-01,145599,0,1,1,0,1,1
2023-06-01,145600,0,1,1,0,1,1
2023-06-01,145601,0,1,1,0,1,1
2023-06-01,145602,0,1,1,0,1,1
2023-06-01,145603,0,1,1,0,1,1
2023-06-01,145604,0,1,1,0,1,1
2023-06-01,145605,0,1,1,0,1,1
2023-06-01,145606,0,1,1,0,1,1
2023-06-01,145607,0,1,1,0,1,1
2023-06-01,145608,0,1,1,0,1,1
2023-06-01,145609,0,1,1,0,1,1
2023-06-01,145610,0,1,1,0,1,1
2023-06-01,145611,0,1,1,0,1,1
2023-06-01,145612,0,1,1,0,1,1
2023-06-01,145613,0,1,1,0,1,1
2023-06-01,145614,0,1,1,0,1,1
2023-06-01,145615,0,1,1,0,1,1
2023-06-01,145616,0,1,1,0,1,1
2023-06-01,145617,0,1,1,0,1,1
2023-06-01,145618,0,1,1,0,1,1
2023-06-01,145619,0,1,1,0,1,1
2023-06-01,145620,0,1,1,0,1,1
2023-06-01,145621,0,1,1,0,1,1
2023-06-01,145622,0,1,1,0,1,1
2023-06-01,145623,0,1,1,0,1,1
2023-06-01,145624,0,1,1,0,1,1
2023-06-01,145625,0,1,1,0,1,1
2023-06-01,145626,0,1,1,0,1,1
2023-06-01,145627,0,1,1,0,1,1
2023-06-01,145628,0,1,1,0,1,1
2023-06-01,145629,0,1,1,0,1,1
2023-06-01,145630,0,1,1,0,1,1
2023-06-01,145631,0,1,1,0,1,1
2023-06-01,145632,0,1,1,0,1,1
2023-06-01,145633,0,1,1,0,1,1
2023-06-01,145634,0,1,1,0,1,1
2023-06-01,145635,0,1,1,0,1,1
2023-06-01,145636,0,1,1,0,1,1
2023-06-01,145637,0,1,1,0,1,1
2023-06-01,145638,0,1,1,0,1,1
2023-06-01,145639,0,1,1,0,1,1
2023-06-01,145640,0,1,1,0,1,1
2023-06-01,145641,0,1,1,0,1,1
2023-06-01,145642,0,1,1,0,1,1
2023-06-01,145643,0,1,1,0,1,1
2023-06-01,145644,0,1,1,0,1,1
2023-06-01,145645,0,1,1,0,1,1
2023-06-01,145646,0,1,1,0,1,1
2023-06-01,145647,0,1,1,0,1,1
2023-06-01,145648,0,1,1,0,1,1
2023-06-01,145649,0,1,1,0,1,1
2023-06-01,145650,0,1,1,0,1,1
2023-06-01,145651,0,1,1,0,1,1
2023-06-01,145652,0,1,1,0,1,1
2023-06-01,145653,0,1,1,0,1,1
2023-06-01,145654,0,1,1,0,1,1
2023-06-01,145655,0,1,1,0,1,1
2023-06-01,145656,0,1,1,0,1,1
2023-06-01,145657,0,1,1,0,1,1
2023-06-01,145658,0,1,1,0,1,1
2023-06-01,145659,0,1,1,0,1,1
2023-06-01,145660,0,1,1,0,1,1
2023-06-01,145661,0,1,1,0,1,1
2023-06-01,145662,0,1,1,0,1,1
2023-06-01,145663,0,1,1,0,1,1
2023-06-01,145664,0,1,1,0,1,1
2023-06-01,145665,0,1,1,0,1,1
2023-06-01,145666,0,1,1,0,1,1
2023-06-01,145667,0,1,1,0,1,1
2023-06-01,145668,0,1,1,0,1,1
2023-06-01,145669,0,1,1,0,1,1
2023-06-01,145670,0,1,1,0,1,1
2023-06-01,145671,0,1,1,0,1,1
2023-06-01,145672,0,1,1,0,1,1
2023-06-01,145673,0,1,1,0,1,1
2023-06-01,145674,0,1,1,0,1,1
2023-06-01,145675,0,1,1,0,1,1
2023-06-01,145676,0,1,1,0,1,1
2023-06-01,145677,0,1,1,0,1,1
2023-06-01,145678,0,1,1,0,1,1
2023-06-01,145679,0,1,1,0,1,1
2023-06-01,145680,0,1,1,0,1,1
2023-06-01,145681,0,1,1,0,1,1
2023-06-01,145682,0,1,1,0,1,1
2023-06-01,145683,0,1,1,0,1,1
2023-06-01,145684,0,1,1,0,1,1
2023-06-01,145685,0,1,1,0,1,1
2023-06-01,145686,0,1,1,0,1,1
2023-06-01,145687,0,1,1,0,1,1
2023-06-01,145688,0,1,1,0,1,1
2023-06-01,145689,0,1,1,0,1,1
2023-06-01,145690,0,1,1,0,1,1
2023-06-01,145691,0,1,1,0,1,1
2023-06-01,145692,0,1,1,0,1,1
2023-06-01,145693,0,1,1,0,1,1
2023-06-01,145694,0,1,1,0,1,1
2023-06-01,145695,0,1,1,0,1,1
2023-06-01,145696,0,1,1,0,1,1
2023-06-01,145697,0,1,1,0,1,1
2023-06-01,145698,0,1,1,0,1,1
2023-06-01,145699,0,1,1,0,1,1
2023-06-01,145700,0,1,1,0,1,1
2023-06-01,145701,0,1,1,0,1,1
2023-06-01,145702,0,1,1,0,1,1
2023-06-01,145703,0,1,1,0,1,1
2023-06-01,145704,0,1,1,0,1,1
2023-06-01,145705,0,1,1,0,1,1
2023-06-01,145706,0,1,1,0,1,1
2023-06-01,145707,0,1,1,0,1,1
2023-06-01,145708,0,1,1,0,1,1
2023-06-01,145709,0,1,1,0,1,1
2023-06-01,145710,0,1,1,0,1,1
2023-06-01,145711,0,1,1,0,1,1
2023-06-01,145712,0,1,1,0,1,1
2023-06-01,145713,0,1,1,0,1,1
2023-06-01,145714,0,1,1,0,1,1
2023-06-01,145715,0,1,1,0,1,1
2023-06-01,145716,0,1,1,0,1,1
2023-06-01,145717,0,1,1,0,1,1
2023-06-01,145718,0,1,1,0,1,1
2023-06-01,145719,0,1,1,0,1,1
2023-06-01,145720,0,1,1,0,1,1
2023-06-01,145721,0,1,1,0,1,1
2023-06-01,145722,0,1,1,0,1,1
2023-06-01,145723,0,1,1,0,1,1
2023-06-01,145724,0,1,1,0,1,1
2023-06-01,145725,0,1,1,0,1,1
2023-06-01,145726,0,1,1,0,1,1
2023-06-01,145727,0,1,1,0,1,1
2023-06-01,145728,0,1,1,0,1,1
2023-06-01,145729,0,1,1,0,1,1
2023-06-01,145730,0,1,1,0,1,1
2023-06-01,145731,0,1,1,0,1,1
2023-06-01,145732,0,1,1,0,1,1
2023-06-01,145733,0,1,1,0,1,1
2023-06-01,145734,0,1,1,0,1,1
2023-06-01,145735,0,1,1,0,1,1
2023-06-01,145736,0,1,1,0,1,1
2023-06-01,145737,0,1,1,0,1,1
2023-06-01,145738,0,1,1,0,1,1
2023-06-01,145739,0,1,1,0,1,1
2023-06-01,145740,0,1,1,0,1,1
2023-06-01,145741,0,1,1,0,1,1
2023-06-01,145742,0,1,1,0,1,1
2023-06-01,145743,0,1,1,0,1,1
2023-06-01,145744,0,1,1,0,1,1
2023-06-01,145745,0,1,1,0,1,1
2023-06-01,145746,0,1,1,0,1,1
2023-06-01,145747,0,1,1,0,1,1
2023-06-01,145748,0,1,1,0,1,1
2023-06-01,145749,0,1,1,0,1,1
2023-06-01,145750,0,1,1,0,1,1
2023-06-01,145751,0,1,1,0,1,1
2023-06-01,145752,0,1,1,0,1,1
2023-06-01,145753,0,1,1,0,1,1
2023-06-01,145754,0,1,1,0,1,1
2023-06-01,145755,0,1,1,0,1,1
2023-06-01,145756,0,1,1,0,1,1
2023-06-01,145757,0,1,1,0,1,1
2023-06-01,145758,0,1,1,0,1,1
2023-06-01,145759,0,1,1,0,1,1
2023-06-01,145760,0,1,1,0,1,1
2023-06-01,145761,0,1,1,0,1,1
2023-06-01,145762,0,1,1,0,1,1
2023-06-01,145763,0,1,1,0,1,1
2023-06-01,145764,0,1,1,0,1,1
2023-06-01,145765,0,1,1,0,1,1
2023-06-01,145766,0,1,1,0,1,1
2023-06-01,145767,0,1,1,0,1,1
2023-06-01,145768,0,1,1,0,1,1
2023-06-01,145769,0,1,1,0,1,1
2023-06-01,145770,0,1,1,0,1,1
2023-06-01,145771,0,1,1,0,1,1
2023-06-01,145772,0,1,1,0,1,1
2023-06-01,145773,0,1,1,0,1,1
2023-06-01,145774,0,1,1,0,1,1
2023-06-01,145775,0,1,1,0,1,1
2023-06-01,145776,0,1,1,0,1,1
2023-06-01,145777,0,1,1,0,1,1
2023-06-01,145778,0,1,1,0,1,1
2023-06-01,145779,0,1,1,0,1,1
2023-06-01,145780,0,1,1,0,1,1
2023-06-01,145781,0,1,1,0,1,1
2023-06-01,145782,0,1,1,0,1,1
2023-06-01,145783,0,1,1,0,1,1
2023-06-01,145784,0,1,1,0,1,1
2023-06-01,145785,0,1,1,0,1,1
2023-06-01,145786,0,1,1,0,1,1
2023-06-01,145787,0,1,1,0,1,1
2023-06-01,145788,0,1,1,0,1,1
2023-06-01,145789,0,1,1,0,1,1
2023-06-01,145790,0,1,1,0,1,1
2023-06-01,145791,0,1,1,0,1,1
2023-06-01,145792,0,1,1,0,1,1
2023-06-01,145793,0,1,1,0,1,1
2023-06-01,145794,0,1,1,0,1,1
2023-06-01,145795,0,1,1,0,1,1
2023-06-01,145796,0,1,1,0,1,1
2023-06-01,145797,0,1,1,0,1,1
2023-06-01,145798,0,1,1,0,1,1
2023-06-01,145799,0,1,1,0,1,1
2023-06-01,145800,0,1,1,0,1,1
2023-06-01,145801,0,1,1,0,1,1
2023-06-01,145802,0,1,1,0,1,1
2023-06-01,145803,0,1,1,0,1,1
2023-06-01,145804,0,1,1,0,1,1
2023-06-01,145805,0,1,1,0,1,1
2023-06-01,145806,0,1,1,0,1,1
2023-06-01,145807,0,1,1,0,1,1
2023-06-01,145808,0,1,1,0,1,1
2023-06-01,145809,0,1,1,0,1,1
2023-06-01,145810,0,1,1,0,1,1
2023-06-01,145811,0,1,1,0,1,1
2023-06-01,145812,0,1,1,0,1,1
2023-06-01,145813,0,1,1,0,1,1
2023-06-01,145814,0,1,1,0,1,1
2023-06-01,145815,0,1,1,0,1,1
2023-06-01,145816,0,1,1,0,1,1
2023-06-01,145817,0,1,1,0,1,1
2023-06-01,145818,0,1,1,0,1,1
2023-06-01,145819,0,1,1,0,1,1
2023-06-01,145820,0,1,1,0,1,1
2023-06-01,145821,0,1,1,0,1,1
2023-06-01,145822,0,1,1,0,1,1
2023-06-01,145823,0,1,1,0,1,1
2023-06-01,145824,0,1,1,0,1,1
2023-06-01,145825,0,1,1,0,1,1
2023-06-01,145826,0,1,1,0,1,1
2023-06-01,145827,0,1,1,0,1,1
2023-06-01,145828,0,1,1,0,1,1
2023-06-01,145829,0,1,1,0,1,1
2023-06-01,145830,0,1,1,0,1,1
2023-06-01,145831,0,1,1,0,1,1
2023-06-01,145832,0,1,1,0,1,1
2023-06-01,145833,0,1,1,0,1,1
2023-06-01,145834,0,1,1,0,1,1
2023-06-01,145835,0,1,1,0,1,1
2023-06-01,145836,0,1,1,0,1,1
2023-06-01,145837,0,1,1,0,1,1
2023-06-01,145838,0,1,1,0,1,1
2023-06-01,145839,0,1,1,0,1,1
2023-06-01,145840,0,1,1,0,1,1
2023-06-01,145841,0,1,1,0,1,1
2023-06-01,145842,0,1,1,0,1,1
2023-06-01,145843,0,1,1,0,1,1
2023-06-01,145844,0,1,1,0,1,1
2023-06-01,145845,0,1,1,0,1,1
2023-06-01,145846,0,1,1,0,1,1
2023-06-01,145847,0,1,1,0,1,1
2023-06-01,145848,0,1,1,0,1,1
2023-06-01,145849,0,1,1,0,1,1
2023-06-01,145850,0,1,1,0,1,1
2023-06-01,145851,0,1,1,0,1,1
2023-06-01,145852,0,1,1,0,1,1
2023-06-01,145853,0,1,1,0,1,1
2023-06-01,145854,0,1,1,0,1,1
2023-06-01,145855,0,1,1,0,1,1
2023-06-01,145856,0,1,1,0,1,1
2023-06-01,145857,0,1,1,0,1,1
2023-06-01,145858,0,1,1,0,1,1
2023-06-01,145859,0,1,1,0,1,1
2023-06-01,145860,0,1,1,0,1,1
2023-06-01,145861,0,1,1,0,1,1
2023-06-01,145862,0,1,1,0,1,1
2023-06-01,145863,0,1,1,0,1,1
2023-06-01,145864,0,1,1,0,1,1
2023-06-01,145865,0,1,1,0,1,1
2023-06-01,145866,0,1,1,0,1,1
2023-06-01,145867,0,1,1,0,1,1
2023-06-01,145868,0,1,1,0,1,1
2023-06-01,145869,0,1,1,0,1,1
2023-06-01,145870,0,1,1,0,1,1
2023-06-01,145871,0,1,1,0,1,1
2023-06-01,145872,0,1,1,0,1,1
2023-06-01,145873,0,1,1,0,1,1
2023-06-01,145874,0,1,1,0,1,1
2023-06-01,145875,0,1,1,0,1,1
2023-06-01,145876,0,1,1,0,1,1
2023-06-01,145877,0,1,1,0,1,1
2023-06-01,145878,0,1,1,0,1,1
2023-06-01,145879,0,1,1,0,1,1
2023-06-01,145880,0,1,1,0,1,1
2023-06-01,145881,0,1,1,0,1,1
2023-06-01,145882,0,1,1,0,1,1
2023-06-01,145883,0,1,1,0,1,1
2023-06-01,145884,0,1,1,0,1,1
2023-06-01,145885,0,1,1,0,1,1
2023-06-01,145886,0,1,1,0,1,1
2023-06-01,145887,0,1,1,0,1,1
2023-06-01,145888,0,1,1,0,1,1
2023-06-01,145889,0,1,1,0,1,1
2023-06-01,145890,0,1,1,0,1,1
2023-06-01,145891,0,1,1,0,1,1
2023-06-01,145892,0,1,1,0,1,1
2023-06-01,145893,0,1,1,0,1,1
2023-06-01,145894,0,1,1,0,1,1
2023-06-01,145895,0,1,1,0,1,1
2023-06-01,145896,0,1,1,0,1,1
2023-06-01,145897,0,1,1,0,1,1
2023-06-01,145898,0,1,1,0,1,1
2023-06-01,145899,0,1,1,0,1,1
2023-06-01,145900,0,1,1,0,1,1
2023-06-01,145901,0,1,1,0,1,1
2023-06-01,145902,0,1,1,0,1,1
2023-06-01,145903,0,1,1,0,1,1
2023-06-01,145904,0,1,1,0,1,1
2023-06-01,145905,0,1,1,0,1,1
2023-06-01,145906,0,1,1,0,1,1
2023-06-01,145907,0,1,1,0,1,1
2023-06-01,145908,0,1,1,0,1,1
2023-06-01,145909,0,1,1,0,1,1
2023-06-01,145910,0,1,1,0,1,1
2023-06-01,145911,0,1,1,0,1,1
2023-06-01,145912,0,1,1,0,1,1
2023-06-01,145913,0,1,1,0,1,1
2023-06-01,145914,0,1,1,0,1,1
2023-06-01,145915,0,1,1,0,1,1
2023-06-01,145916,0,1,1,0,1,1
2023-06-01,145917,0,1,1,0,1,1
2023-06-01,145918,0,1,1,0,1,1
2023-06-01,145919,0,1,1,0,1,1
2023-06-01,145920,0,1,1,0,1,1
2023-06-01,145921,0,1,1,0,1,1
2023-06-01,145922,0,1,1,0,1,1
2023-06-01,145923,0,1,1,0,1,1
2023-06-01,145924,0,1,1,0,1,1
2023-06-01,145925,0,1,1,0,1,1
2023-06-01,145926,0,1,1,0,1,1
2023-06-01,145927,0,1,1,0,1,1
2023-06-01,145928,0,1,1,0,1,1
2023-06-01,145929,0,1,1,0,1,1
2023-06-01,145930,0,1,1,0,1,1
2023-06-01,145931,0,1,1,0,1,1
2023-06-01,145932,0,1,1,0,1,1
2023-06-01,145933,0,1,1,0,1,1
2023-06-01,145934,0,1,1,0,1,1
2023-06-01,145935,0,1,1,0,1,1
2023-06-01,145936,0,1,1,0,1,1
2023-06-01,145937,0,1,1,0,1,1
2023-06-01,145938,0,1,1,0,1,1
2023-06-01,145939,0,1,1,0,1,1
2023-06-01,145940,0,1,1,0,1,1
2023-06-01,145941,0,1,1,0,1,1
2023-06-01,145942,0,1,1,0,1,1
2023-06-01,145943,0,1,1,0,1,1
2023-06-01,145944,0,1,1,0,1,1
2023-06-01,145945,0,1,1,0,1,1
2023-06-01,145946,0,1,1,0,1,1
2023-06-01,145947,0,1,1,0,1,1
2023-06-01,145948,0,1,1,0,1,1
2023-06-01,145949,0,1,1,0,1,1
2023-06-01,145950,0,1,1,0,1,1
2023-06-01,145951,0,1,1,0,1,1
2023-06-01,145952,0,1,1,0,1,1
2023-06-01,145953,0,1,1,0,1,1
2023-06-01,145954,0,1,1,0,1,1
2023-06-01,145955,0,1,1,0,1,1
2023-06-01,145956,0,1,1,0,1,1
2023-06-01,145957,0,1,1,0,1,1
2023-06-01,145958,0,1,1,0,1,1
2023-06-01,145959,0,1,1,0,1,1
2023-06-01,145960,0,1,1,0,1,1
2023-06-01,145961,0,1,1,0,1,1
2023-06-01,145962,0,1,1,0,1,1
2023-06-01,145963,0,1,1,0,1,1
2023-06-01,145964,0,1,1,0,1,1
2023-06-01,145965,0,1,1,0,1,1
2023-06-01,145966,0,1,1,0,1,1
2023-06-01,145967,0,1,1,0,1,1
2023-06-01,145968,0,1,1,0,1,1
2023-06-01,145969,0,1,1,0,1,1
2023-06-01,145970,0,1,1,0,1,1
2023-06-01,145971,0,1,1,0,1,1
2023-06-01,145972,0,1,1,0,1,1
2023-06-01,145973,0,1,1,0,1,1
2023-06-01,145974,0,1,1,0,1,1
2023-06-01,145975,0,1,1,0,1,1
2023-06-01,145976,0,1,1,0,1,1
2023-06-01,145977,0,1,1,0,1,1
2023-06-01,145978,0,1,1,0,1,1
2023-06-01,145979,0,1,1,0,1,1
2023-06-01,145980,0,1,1,0,1,1
2023-06-01,145981,0,1,1,0,1,1
2023-06-01,145982,0,1,1,0,1,1
2023-06-01,145983,0,1,1,0,1,1
2023-06-01,145984,0,1,1,0,1,1
2023-06-01,145985,0,1,1,0,1,1
2023-06-01,145986,0,1,1,0,1,1
2023-06-01,145987,0,1,1,0,1,1
2023-06-01,145988,0,1,1,0,1,1
2023-06-01,145989,0,1,1,0,1,1
2023-06-01,145990,0,1,1,0,1,1
2023-06-01,145991,0,1,1,0,1,1
2023-06-01,145992,0,1,1,0,1,1
2023-06-01,145993,0,1,1,0,1,1
2023-06-01,145994,0,1,1,0,1,1
2023-06-01,145995,0,1,1,0,1,1
2023-06-01,145996,0,1,1,0,1,1
2023-06-01,145997,0,1,1,0,1,1
2023-06-01,145998,0,1,1,0,1,1
2023-06-01,145999,0,1,1,0,1,1
2023-06-01,146000,0,1,1,0,1,1
2023-06-01,146001,0,1,1,0,1,1
2023-06-01,146002,0,1,1,0,1,1
2023-06-01,146003,0,1,1,0,1,1
2023-06-01,146004,0,1,1,0,1,1
2023-06-01,146005,0,1,1,0,1,1
2023-06-01,146006,0,1,1,0,1,1
2023-06-01,146007,0,1,1,0,1,1
2023-06-01,146008,0,1,1,0,1,1
2023-06-01,146009,0,1,1,0,1,1
2023-06-01,146010,0,1,1,0,1,1
2023-06-01,146011,0,1,1,0,1,1
2023-06-01,146012,0,1,1,0,1,1
2023-06-01,146013,0,1,1,0,1,1
2023-06-01,146014,0,1,1,0,1,1
2023-06-01,146015,0,1,1,0,1,1
2023-06-01,146016,0,1,1,0,1,1
2023-06-01,146017,0,1,1,0,1,1
2023-06-01,146018,0,1,1,0,1,1
2023-06-01,146019,0,1,1,0,1,1
2023-06-01,146020,0,1,1,0,1,1
2023-06-01,146021,0,1,1,0,1,1
2023-06-01,146022,0,1,1,0,1,1
2023-06-01,146023,0,1,1,0,1,1
2023-06-01,146024,0,1,1,0,1,1
2023-06-01,146025,0,1,1,0,1,1
2023-06-01,146026,0,1,1,0,1,1
2023-06-01,146027,0,1,1,0,1,1
2023-06-01,146028,0,1,1,0,1,1
2023-06-01,146029,0,1,1,0,1,1
2023-06-01,146030,0,1,1,0,1,1
2023-06-01,146031,0,1,1,0,1,1
2023-06-01,146032,0,1,1,0,1,1
2023-06-01,146033,0,1,1,0,1,1
2023-06-01,146034,0,1,1,0,1,1
2023-06-01,146035,0,1,1,0,1,1
2023-06-01,146036,0,1,1,0,1,1
2023-06-01,146037,0,1,1,0,1,1
2023-06-01,146038,0,1,1,0,1,1
2023-06-01,146039,0,1,1,0,1,1
2023-06-01,146040,0,1,1,0,1,1
2023-06-01,146041,0,1,1,0,1,1
2023-06-01,146042,0,1,1,0,1,1
2023-06-01,146043,0,1,1,0,1,1
2023-06-01,146044,0,1,1,0,1,1
2023-06-01,146045,0,1,1,0,1,1
2023-06-01,146046,0,1,1,0,1,1
2023-06-01,146047,0,1,1,0,1,1
2023-06-01,146048,0,1,1,0,1,1
2023-06-01,146049,0,1,1,0,1,1
2023-06-01,146050,0,1,1,0,1,1
2023-06-01,146051,0,1,1,0,1,1
2023-06-01,146052,0,1,1,0,1,1
2023-06-01,146053,0,1,1,0,1,1
2023-06-01,146054,0,1,1,0,1,1
2023-06-01,146055,0,1,1,0,1,1
2023-06-01,146056,0,1,1,0,1,1
2023-06-01,146057,0,1,1,0,1,1
2023-06-01,146058,0,1,1,0,1,1
2023-06-01,146059,0,1,1,0,1,1
2023-06-01,146060,0,1,1,0,1,1
2023-06-01,146061,0,1,1,0,1,1
2023-06-01,146062,0,1,1,0,1,1
2023-06-01,146063,0,1,1,0,1,1
2023-06-01,146064,0,1,1,0,1,1
2023-06-01,146065,0,1,1,0,1,1
2023-06-01,146066,0,1,1,0,1,1
2023-06-01,146067,0,1,1,0,1,1
2023-06-01,146068,0,1,1,0,1,1
2023-06-01,146069,0,1,1,0,1,1
2023-06-01,146070,0,1,1,0,1,1
2023-06-01,146071,0,1,1,0,1,1
2023-06-01,146072,0,1,1,0,1,1
2023-06-01,146073,0,1,1,0,1,1
2023-06-01,146074,0,1,1,0,1,1
2023-06-01,146075,0,1,1,0,1,1
2023-06-01,146076,0,1,1,0,1,1
2023-06-01,146077,0,1,1,0,1,1
2023-06-01,146078,0,1,1,0,1,1
2023-06-01,146079,0,1,1,0,1,1
2023-06-01,146080,0,1,1,0,1,1
2023-06-01,146081,0,1,1,0,1,1
2023-06-01,146082,0,1,1,0,1,1
2023-06-01,146083,0,1,1,0,1,1
2023-06-01,146084,0,1,1,0,1,1
2023-06-01,146085,0,1,1,0,1,1
2023-06-01,146086,0,1,1,0,1,1
2023-06-01,146087,0,1,1,0,1,1
2023-06-01,146088,0,1,1,0,1,1
2023-06-01,146089,0,1,1,0,1,1
2023-06-01,146090,0,1,1,0,1,1
2023-06-01,146091,0,1,1,0,1,1
2023-06-01,146092,0,1,1,0,1,1
2023-06-01,146093,0,1,1,0,1,1
2023-06-01,146094,0,1,1,0,1,1
2023-06-01,146095,0,1,1,0,1,1
2023-06-01,146096,0,1,1,0,1,1
2023-06-01,146097,0,1,1,0,1,1
2023-06-01,146098,0,1,1,0,1,1
2023-06-01,146099,0,1,1,0,1,1
2023-06-01,146100,0,1,1,0,1,1
2023-06-01,146101,0,1,1,0,1,1
2023-06-01,146102,0,1,1,0,1,1
2023-06-01,146103,0,1,1,0,1,1
2023-06-01,146104,0,1,1,0,1,1
2023-06-01,146105,0,1,1,0,1,1
2023-06-01,146106,0,1,1,0,1,1
2023-06-01,146107,0,1,1,0,1,1
2023-06-01,146108,0,1,1,0,1,1
2023-06-01,146109,0,1,1,0,1,1
2023-06-01,146110,0,1,1,0,1,1
2023-06-01,146111,0,1,1,0,1,1
2023-06-01,146112,0,1,1,0,1,1
2023-06-01,146113,0,1,1,0,1,1
2023-06-01,146114,0,1,1,0,1,1
2023-06-01,146115,0,1,1,0,1,1
2023-06-01,146116,0,1,1,0,1,1
2023-06-01,146117,0,1,1,0,1,1
2023-06-01,146118,0,1,1,0,1,1
2023-06-01,146119,0,1,1,0,1,1
2023-06-01,146120,0,1,1,0,1,1
2023-06-01,146121,0,1,1,0,1,1
2023-06-01,146122,0,1,1,0,1,1
2023-06-01,146123,0,1,1,0,1,1
2023-06-01,146124,0,1,1,0,1,1
2023-06-01,146125,0,1,1,0,1,1
2023-06-01,146126,0,1,1,0,1,1
2023-06-01,146127,0,1,1,0,1,1
2023-06-01,146128,0,1,1,0,1,1
2023-06-01,146129,0,1,1,0,1,1
2023-06-01,146130,0,1,1,0,1,1
2023-06-01,146131,0,1,1,0,1,1
2023-06-01,146132,0,1,1,0,1,1
2023-06-01,146133,0,1,1,0,1,1
2023-06-01,146134,0,1,1,0,1,1
2023-06-01,146135,0,1,1,0,1,1
2023-06-01,146136,0,1,1,0,1,1
2023-06-01,146137,0,1,1,0,1,1
2023-06-01,146138,0,1,1,0,1,1
2023-06-01,146139,0,1,1,0,1,1
2023-06-01,146140,0,1,1,0,1,1
2023-06-01,146141,0,1,1,0,1,1
2023-06-01,146142,0,1,1,0,1,1
2023-06-01,146143,0,1,1,0,1,1
2023-06-01,146144,0,1,1,0,1,1
2023-06-01,146145,0,1,1,0,1,1
2023-06-01,146146,0,1,1,0,1,1
2023-06-01,146147,0,1,1,0,1,1
2023-06-01,146148,0,1,1,0,1,1
2023-06-01,146149,0,1,1,0,1,1
2023-06-01,146150,0,1,1,0,1,1
2023-06-01,146151,0,1,1,0,1,1
2023-06-01,146152,0,1,1,0,1,1
2023-06-01,146153,0,1,1,0,1,1
2023-06-01,146154,0,1,1,0,1,1
2023-06-01,146155,0,1,1,0,1,1
2023-06-01,146156,0,1,1,0,1,1
2023-06-01,146157,0,1,1,0,1,1
2023-06-01,146158,0,1,1,0,1,1
2023-06-01,146159,0,1,1,0,1,1
2023-06-01,146160,0,1,1,0,1,1
2023-06-01,146161,0,1,1,0,1,1
2023-06-01,146162,0,1,1,0,1,1
2023-06-01,146163,0,1,1,0,1,1
2023-06-01,146164,0,1,1,0,1,1
2023-06-01,146165,0,1,1,0,1,1
2023-06-01,146166,0,1,1,0,1,1
2023-06-01,146167,0,1,1,0,1,1
2023-06-01,146168,0,1,1,0,1,1
2023-06-01,146169,0,1,1,0,1,1
2023-06-01,146170,0,1,1,0,1,1
2023-06-01,146171,0,1,1,0,1,1
2023-06-01,146172,0,1,1,0,1,1
2023-06-01,146173,0,1,1,0,1,1
2023-06-01,146174,0,1,1,0,1,1
2023-06-01,146175,0,1,1,0,1,1
2023-06-01,146176,0,1,1,0,1,1
2023-06-01,146177,0,1,1,0,1,1
2023-06-01,146178,0,1,1,0,1,1
2023-06-01,146179,0,1,1,0,1,1
2023-06-01,146180,0,1,1,0,1,1
2023-06-01,146181,0,1,1,0,1,1
2023-06-01,146182,0,1,1,0,1,1
2023-06-01,146183,0,1,1,0,1,1
2023-06-01,146184,0,1,1,0,1,1
2023-06-01,146185,0,1,1,0,1,1
2023-06-01,146186,0,1,1,0,1,1
2023-06-01,146187,0,1,1,0,1,1
2023-06-01,146188,0,1,1,0,1,1
2023-06-01,146189,0,1,1,0,1,1
2023-06-01,146190,0,1,1,0,1,1
2023-06-01,146191,0,1,1,0,1,1
2023-06-01,146192,0,1,1,0,1,1
2023-06-01,146193,0,1,1,0,1,1
2023-06-01,146194,0,1,1,0,1,1
2023-06-01,146195,0,1,1,0,1,1
2023-06-01,146196,0,1,1,0,1,1
2023-06-01,146197,0,1,1,0,1,1
2023-06-01,146198,0,1,1,0,1,1
2023-06-01,146199,0,1,1,0,1,1
2023-06-01,146200,0,1,1,0,1,1
2023-06-01,146201,0,1,1,0,1,1
2023-06-01,146202,0,1,1,0,1,1
2023-06-01,146203,0,1,1,0,1,1
2023-06-01,146204,0,1,1,0,1,1
2023-06-01,146205,0,1,1,0,1,1
2023-06-01,146206,0,1,1,0,1,1
2023-06-01,146207,0,1,1,0,1,1
2023-06-01,146208,0,1,1,0,1,1
2023-06-01,146209,0,1,1,0,1,1
2023-06-01,146210,0,1,1,0,1,1
2023-06-01,146211,0,1,1,0,1,1
2023-06-01,146212,0,1,1,0,1,1
2023-06-01,146213,0,1,1,0,1,1
2023-06-01,146214,0,1,1,0,1,1
2023-06-01,146215,0,1,1,0,1,1
2023-06-01,146216,0,1,1,0,1,1
2023-06-01,146217,0,1,1,0,1,1
2023-06-01,146218,0,1,1,0,1,1
2023-06-01,146219,0,1,1,0,1,1
2023-06-01,146220,0,1,1,0,1,1
2023-06-01,146221,0,1,1,0,1,1
2023-06-01,146222,0,1,1,0,1,1
2023-06-01,146223,0,1,1,0,1,1
2023-06-01,146224,0,1,1,0,1,1
2023-06-01,146225,0,1,1,0,1,1
2023-06-01,146226,0,1,1,0,1,1
2023-06-01,146227,0,1,1,0,1,1
2023-06-01,146228,0,1,1,0,1,1
2023-06-01,146229,0,1,1,0,1,1
2023-06-01,146230,0,1,1,0,1,1
2023-06-01,146231,0,1,1,0,1,1
2023-06-01,146232,0,1,1,0,1,1
2023-06-01,146233,0,1,1,0,1,1
2023-06-01,146234,0,1,1,0,1,1
2023-06-01,146235,0,1,1,0,1,1
2023-06-01,146236,0,1,1,0,1,1
2023-06-01,146237,0,1,1,0,1,1
2023-06-01,146238,0,1,1,0,1,1
2023-06-01,146239,0,1,1,0,1,1
2023-06-01,146240,0,1,1,0,1,1
2023-06-01,146241,0,1,1,0,1,1
2023-06-01,146242,0,1,1,0,1,1
2023-06-01,146243,0,1,1,0,1,1
2023-06-01,146244,0,1,1,0,1,1
2023-06-01,146245,0,1,1,0,1,1
2023-06-01,146246,0,1,1,0,1,1
2023-06-01,146247,0,1,1,0,1,1
2023-06-01,146248,0,1,1,0,1,1
2023-06-01,146249,0,1,1,0,1,1
2023-06-01,146250,0,1,1,0,1,1
2023-06-01,146251,0,1,1,0,1,1
2023-06-01,146252,0,1,1,0,1,1
2023-06-01,146253,0,1,1,0,1,1
2023-06-01,146254,0,1,1,0,1,1
2023-06-01,146255,0,1,1,0,1,1
2023-06-01,146256,0,1,1,0,1,1
2023-06-01,146257,0,1,1,0,1,1
2023-06-01,146258,0,1,1,0,1,1
2023-06-01,146259,0,1,1,0,1,1
2023-06-01,146260,0,1,1,0,1,1
2023-06-01,146261,0,1,1,0,1,1
2023-06-01,146262,0,1,1,0,1,1
2023-06-01,146263,0,1,1,0,1,1
2023-06-01,146264,0,1,1,0,1,1
2023-06-01,146265,0,1,1,0,1,1
2023-06-01,146266,0,1,1,0,1,1
2023-06-01,146267,0,1,1,0,1,1
2023-06-01,146268,0,1,1,0,1,1
2023-06-01,146269,0,1,1,0,1,1
2023-06-01,146270,0,1,1,0,1,1
2023-06-01,146271,0,1,1,0,1,1
2023-06-01,146272,0,1,1,0,1,1
2023-06-01,146273,0,1,1,0,1,1
2023-06-01,146274,0,1,1,0,1,1
2023-06-01,146275,0,1,1,0,1,1
2023-06-01,146276,0,1,1,0,1,1
2023-06-01,146277,0,1,1,0,1,1
2023-06-01,146278,0,1,1,0,1,1
2023-06-01,146279,0,1,1,0,1,1
2023-06-01,146280,0,1,1,0,1,1
2023-06-01,146281,0,1,1,0,1,1
2023-06-01,146282,0,1,1,0,1,1
2023-06-01,146283,0,1,1,0,1,1
2023-06-01,146284,0,1,1,0,1,1
2023-06-01,146285,0,1,1,0,1,1
2023-06-01,146286,0,1,1,0,1,1
2023-06-01,146287,0,1,1,0,1,1
2023-06-01,146288,0,1,1,0,1,1
2023-06-01,146289,0,1,1,0,1,1
2023-06-01,146290,0,1,1,0,1,1
2023-06-01,146291,0,1,1,0,1,1
2023-06-01,146292,0,1,1,0,1,1
2023-06-01,146293,0,1,1,0,1,1
2023-06-01,146294,0,1,1,0,1,1
2023-06-01,146295,0,1,1,0,1,1
2023-06-01,146296,0,1,1,0,1,1
2023-06-01,146297,0,1,1,0,1,1
2023-06-01,146298,0,1,1,0,1,1
2023-06-01,146299,0,1,1,0,1,1
2023-06-01,146300,0,1,1,0,1,1
2023-06-01,146301,0,1,1,0,1,1
2023-06-01,146302,0,1,1,0,1,1
2023-06-01,146303,0,1,1,0,1,1
2023-06-01,146304,0,1,1,0,1,1
2023-06-01,146305,0,1,1,0,1,1
2023-06-01,146306,0,1,1,0,1,1
2023-06-01,146307,0,1,1,0,1,1
2023-06-01,146308,0,1,1,0,1,1
2023-06-01,146309,0,1,1,0,1,1
2023-06-01,146310,0,1,1,0,1,1
2023-06-01,146311,0,1,1,0,1,1
2023-06-01,146312,0,1,1,0,1,1
2023-06-01,146313,0,1,1,0,1,1
2023-06-01,146314,0,1,1,0,1,1
2023-06-01,146315,0,1,1,0,1,1
2023-06-01,146316,0,1,1,0,1,1
2023-06-01,146317,0,1,1,0,1,1
2023-06-01,146318,0,1,1,0,1,1
2023-06-01,146319,0,1,1,0,1,1
2023-06-01,146320,0,1,1,0,1,1
2023-06-01,146321,0,1,1,0,1,1
2023-06-01,146322,0,1,1,0,1,1
2023-06-01,146323,0,1,1,0,1,1
2023-06-01,146324,0,1,1,0,1,1
2023-06-01,146325,0,1,1,0,1,1
2023-06-01,146326,0,1,1,0,1,1
2023-06-01,146327,0,1,1,0,1,1
2023-06-01,146328,0,1,1,0,1,1
2023-06-01,146329,0,1,1,0,1,1
2023-06-01,146330,0,1,1,0,1,1
2023-06-01,146331,0,1,1,0,1,1
2023-06-01,146332,0,1,1,0,1,1
2023-06-01,146333,0,1,1,0,1,1
2023-06-01,146334,0,1,1,0,1,1
2023-06-01,146335,0,1,1,0,1,1
2023-06-01,146336,0,1,1,0,1,1
2023-06-01,146337,0,1,1,0,1,1
2023-06-01,146338,0,1,1,0,1,1
2023-06-01,146339,0,1,1,0,1,1
2023-06-01,146340,0,1,1,0,1,1
2023-06-01,146341,0,1,1,0,1,1
2023-06-01,146342,0,1,1,0,1,1
2023-06-01,146343,0,1,1,0,1,1
2023-06-01,146344,0,1,1,0,1,1
2023-06-01,146345,0,1,1,0,1,1
2023-06-01,146346,0,1,1,0,1,1
2023-06-01,146347,0,1,1,0,1,1
2023-06-01,146348,0,1,1,0,1,1
2023-06-01,146349,0,1,1,0,1,1
2023-06-01,146350,0,1,1,0,1,1
2023-06-01,146351,0,1,1,0,1,1
2023-06-01,146352,0,1,1,0,1,1
2023-06-01,146353,0,1,1,0,1,1
2023-06-01,146354,0,1,1,0,1,1
2023-06-01,146355,0,1,1,0,1,1
2023-06-01,146356,0,1,1,0,1,1
2023-06-01,146357,0,1,1,0,1,1
2023-06-01,146358,0,1,1,0,1,1
2023-06-01,146359,0,1,1,0,1,1
2023-06-01,146360,0,1,1,0,1,1
2023-06-01,146361,0,1,1,0,1,1
2023-06-01,146362,0,1,1,0,1,1
2023-06-01,146363,0,1,1,0,1,1
2023-06-01,146364,0,1,1,0,1,1
2023-06-01,146365,0,1,1,0,1,1
2023-06-01,146366,0,1,1,0,1,1
2023-06-01,146367,0,1,1,0,1,1
2023-06-01,146368,0,1,1,0,1,1
2023-06-01,146369,0,1,1,0,1,1
2023-06-01,146370,0,1,1,0,1,1
2023-06-01,146371,0,1,1,0,1,1
2023-06-01,146372,0,1,1,0,1,1
2023-06-01,146373,0,1,1,0,1,1
2023-06-01,146374,0,1,1,0,1,1
2023-06-01,146375,0,1,1,0,1,1
2023-06-01,146376,0,1,1,0,1,1
2023-06-01,146377,0,1,1,0,1,1
2023-06-01,146378,0,1,1,0,1,1
2023-06-01,146379,0,1,1,0,1,1
2023-06-01,146380,0,1,1,0,1,1
2023-06-01,146381,0,1,1,0,1,1
2023-06-01,146382,0,1,1,0,1,1
2023-06-01,146383,0,1,1,0,1,1
2023-06-01,146384,0,1,1,0,1,1
2023-06-01,146385,0,1,1,0,1,1
2023-06-01,146386,0,1,1,0,1,1
2023-06-01,146387,0,1,1,0,1,1
2023-06-01,146388,0,1,1,0,1,1
2023-06-01,146389,0,1,1,0,1,1
2023-06-01,146390,0,1,1,0,1,1
2023-06-01,146391,0,1,1,0,1,1
2023-06-01,146392,0,1,1,0,1,1
2023-06-01,146393,0,1,1,0,1,1
2023-06-01,146394,0,1,1,0,1,1
2023-06-01,146395,0,1,1,0,1,1
2023-06-01,146396,0,1,1,0,1,1
2023-06-01,146397,0,1,1,0,1,1
2023-06-01,146398,0,1,1,0,1,1
2023-06-01,146399,0,1,1,0,1,1
2023-06-01,146400,0,1,1,0,1,1
2023-06-01,146401,0,1,1,0,1,1
2023-06-01,146402,0,1,1,0,1,1
2023-06-01,146403,0,1,1,0,1,1
2023-06-01,146404,0,1,1,0,1,1
2023-06-01,146405,0,1,1,0,1,1
2023-06-01,146406,0,1,1,0,1,1
2023-06-01,146407,0,1,1,0,1,1
2023-06-01,146408,0,1,1,0,1,1
2023-06-01,146409,0,1,1,0,1,1
2023-06-01,146410,0,1,1,0,1,1
2023-06-01,146411,0,1,1,0,1,1
2023-06-01,146412,0,1,1,0,1,1
2023-06-01,146413,0,1,1,0,1,1
2023-06-01,146414,0,1,1,0,1,1
2023-06-01,146415,0,1,1,0,1,1
2023-06-01,146416,0,1,1,0,1,1
2023-06-01,146417,0,1,1,0,1,1
2023-06-01,146418,0,1,1,0,1,1
2023-06-01,146419,0,1,1,0,1,1
2023-06-01,146420,0,1,1,0,1,1
2023-06-01,146421,0,1,1,0,1,1
2023-06-01,146422,0,1,1,0,1,1
2023-06-01,146423,0,1,1,0,1,1
2023-06-01,146424,0,1,1,0,1,1
2023-06-01,146425,0,1,1,0,1,1
2023-06-01,146426,0,1,1,0,1,1
2023-06-01,146427,0,1,1,0,1,1
2023-06-01,146428,0,1,1,0,1,1
2023-06-01,146429,0,1,1,0,1,1
2023-06-01,146430,0,1,1,0,1,1
2023-06-01,146431,0,1,1,0,1,1
2023-06-01,146432,0,1,1,0,1,1
2023-06-01,146433,0,1,1,0,1,1
2023-06-01,146434,0,1,1,0,1,1
2023-06-01,146435,0,1,1,0,1,1
2023-06-01,146436,0,1,1,0,1,1
2023-06-01,146437,0,1,1,0,1,1
2023-06-01,146438,0,1,1,0,1,1
2023-06-01,146439,0,1,1,0,1,1
2023-06-01,146440,0,1,1,0,1,1
2023-06-01,146441,0,1,1,0,1,1
2023-06-01,146442,0,1,1,0,1,1
2023-06-01,146443,0,1,1,0,1,1
2023-06-01,146444,0,1,1,0,1,1
2023-06-01,146445,0,1,1,0,1,1
2023-06-01,146446,0,1,1,0,1,1
2023-06-01,146447,0,1,1,0,1,1
2023-06-01,146448,0,1,1,0,1,1
2023-06-01,146449,0,1,1,0,1,1
2023-06-01,146450,0,1,1,0,1,1
2023-06-01,146451,0,1,1,0,1,1
2023-06-01,146452,0,1,1,0,1,1
2023-06-01,146453,0,1,1,0,1,1
2023-06-01,146454,0,1,1,0,1,1
2023-06-01,146455,0,1,1,0,1,1
2023-06-01,146456,0,1,1,0,1,1
2023-06-01,146457,0,1,1,0,1,1
2023-06-01,146458,0,1,1,0,1,1
2023-06-01,146459,0,1,1,0,1,1
2023-06-01,146460,0,1,1,0,1,1
2023-06-01,146461,0,1,1,0,1,1
2023-06-01,146462,0,1,1,0,1,1
2023-06-01,146463,0,1,1,0,1,1
2023-06-01,146464,0,1,1,0,1,1
2023-06-01,146465,0,1,1,0,1,1
2023-06-01,146466,0,1,1,0,1,1
2023-06-01,146467,0,1,1,0,1,1
2023-06-01,146468,0,1,1,0,1,1
2023-06-01,146469,0,1,1,0,1,1
2023-06-01,146470,0,1,1,0,1,1
2023-06-01,146471,0,1,1,0,1,1
2023-06-01,146472,0,1,1,0,1,1
2023-06-01,146473,0,1,1,0,1,1
2023-06-01,146474,0,1,1,0,1,1
2023-06-01,146475,0,1,1,0,1,1
2023-06-01,146476,0,1,1,0,1,1
2023-06-01,146477,0,1,1,0,1,1
2023-06-01,146478,0,1,1,0,1,1
2023-06-01,146479,0,1,1,0,1,1
2023-06-01,146480,0,1,1,0,1,1
2023-06-01,146481,0,1,1,0,1,1
2023-06-01,146482,0,1,1,0,1,1
2023-06-01,146483,0,1,1,0,1,1
2023-06-01,146484,0,1,1,0,1,1
2023-06-01,146485,0,1,1,0,1,1
2023-06-01,146486,0,1,1,0,1,1
2023-06-01,146487,0,1,1,0,1,1
2023-06-01,146488,0,1,1,0,1,1
2023-06-01,146489,0,1,1,0,1,1
2023-06-01,146490,0,1,1,0,1,1
2023-06-01,146491,0,1,1,0,1,1
2023-06-01,146492,0,1,1,0,1,1
2023-06-01,146493,0,1,1,0,1,1
2023-06-01,146494,0,1,1,0,1,1
2023-06-01,146495,0,1,1,0,1,1
2023-06-01,146496,0,1,1,0,1,1
2023-06-01,146497,0,1,1,0,1,1
2023-06-01,146498,0,1,1,0,1,1
2023-06-01,146499,0,1,1,0,1,1
2023-06-01,146500,0,1,1,0,1,1
2023-06-01,146501,0,1,1,0,1,1
2023-06-01,146502,0,1,1,0,1,1
2023-06-01,146503,0,1,1,0,1,1
2023-06-01,146504,0,1,1,0,1,1
2023-06-01,146505,0,1,1,0,1,1
2023-06-01,146506,0,1,1,0,1,1
2023-06-01,146507,0,1,1,0,1,1
2023-06-01,146508,0,1,1,0,1,1
2023-06-01,146509,0,1,1,0,1,1
2023-06-01,146510,0,1,1,0,1,1
2023-06-01,146511,0,1,1,0,1,1
2023-06-01,146512,0,1,1,0,1,1
2023-06-01,146513,0,1,1,0,1,1
2023-06-01,146514,0,1,1,0,1,1
2023-06-01,146515,0,1,1,0,1,1
2023-06-01,146516,0,1,1,0,1,1
2023-06-01,146517,0,1,1,0,1,1
2023-06-01,146518,0,1,1,0,1,1
2023-06-01,146519,0,1,1,0,1,1
2023-06-01,146520,0,1,1,0,1,1
2023-06-01,146521,0,1,1,0,1,1
2023-06-01,146522,0,1,1,0,1,1
2023-06-01,146523,0,1,1,0,1,1
2023-06-01,146524,0,1,1,0,1,1
2023-06-01,146525,0,1,1,0,1,1
2023-06-01,146526,0,1,1,0,1,1
2023-06-01,146527,0,1,1,0,1,1
2023-06-01,146528,0,1,1,0,1,1
2023-06-01,146529,0,1,1,0,1,1
2023-06-01,146530,0,1,1,0,1,1
2023-06-01,146531,0,1,1,0,1,1
2023-06-01,146532,0,1,1,0,1,1
2023-06-01,146533,0,1,1,0,1,1
2023-06-01,146534,0,1,1,0,1,1
2023-06-01,146535,0,1,1,0,1,1
2023-06-01,146536,0,1,1,0,1,1
2023-06-01,146537,0,1,1,0,1,1
2023-06-01,146538,0,1,1,0,1,1
2023-06-01,146539,0,1,1,0,1,1
2023-06-01,146540,0,1,1,0,1,1
2023-06-01,146541,0,1,1,0,1,1
2023-06-01,146542,0,1,1,0,1,1
2023-06-01,146543,0,1,1,0,1,1
2023-06-01,146544,0,1,1,0,1,1
2023-06-01,146545,0,1,1,0,1,1
2023-06-01,146546,0,1,1,0,1,1
2023-06-01,146547,0,1,1,0,1,1
2023-06-01,146548,0,1,1,0,1,1
2023-06-01,146549,0,1,1,0,1,1
2023-06-01,146550,0,1,1,0,1,1
2023-06-01,146551,0,1,1,0,1,1
2023-06-01,146552,0,1,1,0,1,1
2023-06-01,146553,0,1,1,0,1,1
2023-06-01,146554,0,1,1,0,1,1
2023-06-01,146555,0,1,1,0,1,1
2023-06-01,146556,0,1,1,0,1,1
2023-06-01,146557,0,1,1,0,1,1
2023-06-01,146558,0,1,1,0,1,1
2023-06-01,146559,0,1,1,0,1,1
2023-06-01,146560,0,1,1,0,1,1
2023-06-01,146561,0,1,1,0,1,1
2023-06-01,146562,0,1,1,0,1,1
2023-06-01,146563,0,1,1,0,1,1
2023-06-01,146564,0,1,1,0,1,1
2023-06-01,146565,0,1,1,0,1,1
2023-06-01,146566,0,1,1,0,1,1
2023-06-01,146567,0,1,1,0,1,1
2023-06-01,146568,0,1,1,0,1,1
2023-06-01,146569,0,1,1,0,1,1
2023-06-01,146570,0,1,1,0,1,1
2023-06-01,146571,0,1,1,0,1,1
2023-06-01,146572,0,1,1,0,1,1
2023-06-01,146573,0,1,1,0,1,1
2023-06-01,146574,0,1,1,0,1,1
2023-06-01,146575,0,1,1,0,1,1
2023-06-01,146576,0,1,1,0,1,1
2023-06-01,146577,0,1,1,0,1,1
2023-06-01,146578,0,1,1,0,1,1
2023-06-01,146579,0,1,1,0,1,1
2023-06-01,146580,0,1,1,0,1,1
2023-06-01,146581,0,1,1,0,1,1
2023-06-01,146582,0,1,1,0,1,1
2023-06-01,146583,0,1,1,0,1,1
2023-06-01,146584,0,1,1,0,1,1
2023-06-01,146585,0,1,1,0,1,1
2023-06-01,146586,0,1,1,0,1,1
2023-06-01,146587,0,1,1,0,1,1
2023-06-01,146588,0,1,1,0,1,1
2023-06-01,146589,0,1,1,0,1,1
2023-06-01,146590,0,1,1,0,1,1
2023-06-01,146591,0,1,1,0,1,1
2023-06-01,146592,0,1,1,0,1,1
2023-06-01,146593,0,1,1,0,1,1
2023-06-01,146594,0,1,1,0,1,1
2023-06-01,146595,0,1,1,0,1,1
2023-06-01,146596,0,1,1,0,1,1
2023-06-01,146597,0,1,1,0,1,1
2023-06-01,146598,0,1,1,0,1,1
2023-06-01,146599,0,1,1,0,1,1
2023-06-01,146600,0,1,1,0,1,1
2023-06-01,146601,0,1,1,0,1,1
2023-06-01,146602,0,1,1,0,1,1
2023-06-01,146603,0,1,1,0,1,1
2023-06-01,146604,0,1,1,0,1,1
2023-06-01,146605,0,1,1,0,1,1
2023-06-01,146606,0,1,1,0,1,1
2023-06-01,146607,0,1,1,0,1,1
2023-06-01,146608,0,1,1,0,1,1
2023-06-01,146609,0,1,1,0,1,1
2023-06-01,146610,0,1,1,0,1,1
2023-06-01,146611,0,1,1,0,1,1
2023-06-01,146612,0,1,1,0,1,1
2023-06-01,146613,0,1,1,0,1,1
2023-06-01,146614,0,1,1,0,1,1
2023-06-01,146615,0,1,1,0,1,1
2023-06-01,146616,0,1,1,0,1,1
2023-06-01,146617,0,1,1,0,1,1
2023-06-01,146618,0,1,1,0,1,1
2023-06-01,146619,0,1,1,0,1,1
2023-06-01,146620,0,1,1,0,1,1
2023-06-01,146621,0,1,1,0,1,1
2023-06-01,146622,0,1,1,0,1,1
2023-06-01,146623,0,1,1,0,1,1
2023-06-01,146624,0,1,1,0,1,1
2023-06-01,146625,0,1,1,0,1,1
2023-06-01,146626,0,1,1,0,1,1
2023-06-01,146627,0,1,1,0,1,1
2023-06-01,146628,0,1,1,0,1,1
2023-06-01,146629,0,1,1,0,1,1
2023-06-01,146630,0,1,1,0,1,1
2023-06-01,146631,0,1,1,0,1,1
2023-06-01,146632,0,1,1,0,1,1
2023-06-01,146633,0,1,1,0,1,1
2023-06-01,146634,0,1,1,0,1,1
2023-06-01,146635,0,1,1,0,1,1
2023-06-01,146636,0,1,1,0,1,1
2023-06-01,146637,0,1,1,0,1,1
2023-06-01,146638,0,1,1,0,1,1
2023-06-01,146639,0,1,1,0,1,1
2023-06-01,146640,0,1,1,0,1,1
2023-06-01,146641,0,1,1,0,1,1
2023-06-01,146642,0,1,1,0,1,1
2023-06-01,146643,0,1,1,0,1,1
2023-06-01,146644,0,1,1,0,1,1
2023-06-01,146645,0,1,1,0,1,1
2023-06-01,146646,0,1,1,0,1,1
2023-06-01,146647,0,1,1,0,1,1
2023-06-01,146648,0,1,1,0,1,1
2023-06-01,146649,0,1,1,0,1,1
2023-06-01,146650,0,1,1,0,1,1
2023-06-01,146651,0,1,1,0,1,1
2023-06-01,146652,0,1,1,0,1,1
2023-06-01,146653,0,1,1,0,1,1
2023-06-01,146654,0,1,1,0,1,1
2023-06-01,146655,0,1,1,0,1,1
2023-06-01,146656,0,1,1,0,1,1
2023-06-01,146657,0,1,1,0,1,1
2023-06-01,146658,0,1,1,0,1,1
2023-06-01,146659,0,1,1,0,1,1
2023-06-01,146660,0,1,1,0,1,1
2023-06-01,146661,0,1,1,0,1,1
2023-06-01,146662,0,1,1,0,1,1
2023-06-01,146663,0,1,1,0,1,1
2023-06-01,146664,0,1,1,0,1,1
2023-06-01,146665,0,1,1,0,1,1
2023-06-01,146666,0,1,1,0,1,1
2023-06-01,146667,0,1,1,0,1,1
2023-06-01,146668,0,1,1,0,1,1
2023-06-01,146669,0,1,1,0,1,1
2023-06-01,146670,0,1,1,0,1,1
2023-06-01,146671,0,1,1,0,1,1
2023-06-01,146672,0,1,1,0,1,1
2023-06-01,146673,0,1,1,0,1,1
2023-06-01,146674,0,1,1,0,1,1
2023-06-01,146675,0,1,1,0,1,1
2023-06-01,146676,0,1,1,0,1,1
2023-06-01,146677,0,1,1,0,1,1
2023-06-01,146678,0,1,1,0,1,1
2023-06-01,146679,0,1,1,0,1,1
2023-06-01,146680,0,1,1,0,1,1
2023-06-01,146681,0,1,1,0,1,1
2023-06-01,146682,0,1,1,0,1,1
2023-06-01,146683,0,1,1,0,1,1
2023-06-01,146684,0,1,1,0,1,1
2023-06-01,146685,0,1,1,0,1,1
2023-06-01,146686,0,1,1,0,1,1
2023-06-01,146687,0,1,1,0,1,1
2023-06-01,146688,0,1,1,0,1,1
2023-06-01,146689,0,1,1,0,1,1
2023-06-01,146690,0,1,1,0,1,1
2023-06-01,146691,0,1,1,0,1,1
2023-06-01,146692,0,1,1,0,1,1
2023-06-01,146693,0,1,1,0,1,1
2023-06-01,146694,0,1,1,0,1,1
2023-06-01,146695,0,1,1,0,1,1
2023-06-01,146696,0,1,1,0,1,1
2023-06-01,146697,0,1,1,0,1,1
2023-06-01,146698,0,1,1,0,1,1
2023-06-01,146699,0,1,1,0,1,1
2023-06-01,146700,0,1,1,0,1,1
2023-06-01,146701,0,1,1,0,1,1
2023-06-01,146702,0,1,1,0,1,1
2023-06-01,146703,0,1,1,0,1,1
2023-06-01,146704,0,1,1,0,1,1
2023-06-01,146705,0,1,1,0,1,1
2023-06-01,146706,0,1,1,0,1,1
2023-06-01,146707,0,1,1,0,1,1
2023-06-01,146708,0,1,1,0,1,1
2023-06-01,146709,0,1,1,0,1,1
2023-06-01,146710,0,1,1,0,1,1
2023-06-01,146711,0,1,1,0,1,1
2023-06-01,146712,0,1,1,0,1,1
2023-06-01,146713,0,1,1,0,1,1
2023-06-01,146714,0,1,1,0,1,1
2023-06-01,146715,0,1,1,0,1,1
2023-06-01,146716,0,1,1,0,1,1
2023-06-01,146717,0,1,1,0,1,1
2023-06-01,146718,0,1,1,0,1,1
2023-06-01,146719,0,1,1,0,1,1
2023-06-01,146720,0,1,1,0,1,1
2023-06-01,146721,0,1,1,0,1,1
2023-06-01,146722,0,1,1,0,1,1
2023-06-01,146723,0,1,1,0,1,1
2023-06-01,146724,0,1,1,0,1,1
2023-06-01,146725,0,1,1,0,1,1
2023-06-01,146726,0,1,1,0,1,1
2023-06-01,146727,0,1,1,0,1,1
2023-06-01,146728,0,1,1,0,1,1
2023-06-01,146729,0,1,1,0,1,1
2023-06-01,146730,0,1,1,0,1,1
2023-06-01,146731,0,1,1,0,1,1
2023-06-01,146732,0,1,1,0,1,1
2023-06-01,146733,0,1,1,0,1,1
2023-06-01,146734,0,1,1,0,1,1
2023-06-01,146735,0,1,1,0,1,1
2023-06-01,146736,0,1,1,0,1,1
2023-06-01,146737,0,1,1,0,1,1
2023-06-01,146738,0,1,1,0,1,1
2023-06-01,146739,0,1,1,0,1,1
2023-06-01,146740,0,1,1,0,1,1
2023-06-01,146741,0,1,1,0,1,1
2023-06-01,146742,0,1,1,0,1,1
2023-06-01,146743,0,1,1,0,1,1
2023-06-01,146744,0,1,1,0,1,1
2023-06-01,146745,0,1,1,0,1,1
2023-06-01,137726,0,1,1,0,1,1
2023-06-01,45275,0,5,5,0,6,6
2023-06-01,140852,0,1,1,0,1,1
2023-06-01,140853,0,1,1,0,1,1
2023-06-01,140854,0,1,1,0,1,1
2023-06-01,140855,0,1,1,0,1,1
2023-06-01,140856,0,1,1,0,1,1
2023-06-01,140857,0,1,1,0,1,1
2023-06-01,140858,0,1,1,0,1,1
2023-06-01,140859,0,1,1,0,1,1
2023-06-01,140860,0,1,1,0,1,1
2023-06-01,140861,0,1,1,0,1,1
2023-06-01,140862,0,1,1,0,1,1
2023-06-01,140863,0,1,1,0,1,1
2023-06-01,140329,0,81,81,0,1,1
2023-06-01,135089,0,7,7,0,1,1
2023-06-01,140056,0,1,1,0,7,7
2023-06-01,140290,0,3,3,0,1,1
2023-06-01,140291,0,3,3,0,1,1
2023-06-01,140293,0,3,3,0,1,1
2023-06-01,140294,0,3,3,0,1,1
2023-06-01,140295,0,3,3,0,1,1
2023-06-01,140296,0,3,3,0,1,1
2023-06-01,140297,0,3,3,0,1,1
2023-06-01,140298,0,3,3,0,1,1
2023-06-01,140299,0,3,3,0,1,1
2023-06-01,140300,0,3,3,0,1,1
2023-06-01,140301,0,3,3,0,1,1
2023-06-01,140302,0,3,3,0,1,1
2023-06-01,140303,0,3,3,0,1,1
2023-06-01,140309,0,4,4,0,1,1
2023-06-01,140311,0,4,4,0,1,1
2023-06-01,140318,0,4,4,0,1,1
2023-06-01,140319,0,4,4,0,1,1
2023-06-01,140320,0,4,4,0,1,1
2023-06-01,140053,0,4,4,0,1,1
2023-06-01,140245,0,3,3,0,1,1
2023-06-01,140246,0,3,3,0,1,1
2023-06-01,140247,0,3,3,0,1,1
2023-06-01,140248,0,3,3,0,1,1
2023-06-01,140249,0,3,3,0,1,1
2023-06-01,140250,0,3,3,0,1,1
2023-06-01,140251,0,3,3,0,1,1
2023-06-01,140252,0,3,3,0,1,1
2023-06-01,140253,0,3,3,0,1,1
2023-06-01,140254,0,3,3,0,1,1
2023-06-01,140255,0,3,3,0,1,1
2023-06-01,140256,0,3,3,0,1,1
2023-06-01,140257,0,3,3,0,1,1
2023-06-01,140258,0,3,3,0,1,1
2023-06-01,140259,0,3,3,0,1,1
2023-06-01,140260,0,3,3,0,1,1
2023-06-01,140261,0,3,3,0,1,1
2023-06-01,140508,0,3,3,0,1,1
2023-06-01,140509,0,3,3,0,1,1
2023-06-01,140510,0,3,3,0,1,1
2023-06-01,140511,0,3,3,0,1,1
2023-06-01,140512,0,3,3,0,1,1
2023-06-01,140513,0,3,3,0,1,1
2023-06-01,140514,0,3,3,0,1,1
2023-06-01,140515,0,3,3,0,1,1
2023-06-01,140516,0,3,3,0,1,1
2023-06-01,140517,0,3,3,0,1,1
2023-06-01,140518,0,3,3,0,1,1
2023-06-01,140519,0,3,3,0,1,1
2023-06-01,140520,0,3,3,0,1,1
2023-06-01,140521,0,3,3,0,1,1
2023-06-01,140522,0,3,3,0,1,1
2023-06-01,138387,0,4,4,0,1,1
2023-06-01,140238,0,4,4,0,1,1
2023-06-01,138679,0,4,4,0,1,1
2023-06-01,138641,0,4,4,0,1,1
2023-06-01,138635,0,4,4,0,1,1
2023-06-01,138597,0,4,4,0,1,1
2023-06-01,138514,0,4,4,0,1,1
2023-06-01,138513,0,4,4,0,1,1
2023-06-01,138409,0,4,4,0,1,1
2023-06-01,138436,0,4,4,0,1,1
2023-06-01,140648,0,4,4,0,1,1
2023-06-01,140649,0,4,4,0,1,1
2023-06-01,140650,0,4,4,0,1,1
2023-06-01,140651,0,4,4,0,1,1
2023-06-01,140652,0,4,4,0,1,1
2023-06-01,140653,0,4,4,0,1,1
2023-06-01,140654,0,4,4,0,1,1
2023-06-01,140655,0,4,4,0,1,1
2023-06-01,140656,0,4,4,0,1,1
2023-06-01,140657,0,4,4,0,1,1
2023-06-01,140328,0,4,4,0,1,1
2023-06-01,140331,0,4,4,0,1,1
2023-06-01,140332,0,4,4,0,1,1
2023-06-01,140333,0,4,4,0,1,1
2023-06-01,140334,0,4,4,0,1,1
2023-06-01,140335,0,4,4,0,1,1
2023-06-01,140336,0,4,4,0,1,1
2023-06-01,140337,0,4,4,0,1,1
2023-06-01,140494,0,14,14,0,2,2
2023-06-01,140483,0,3,3,0,1,1
2023-06-01,140484,0,3,3,0,1,1
2023-06-01,140487,0,3,3,0,1,1
2023-06-01,140488,0,3,3,0,1,1
2023-06-01,140489,0,3,3,0,1,1
2023-06-01,140490,0,3,3,0,1,1
2023-06-01,140491,0,3,3,0,1,1
2023-06-01,140492,0,3,3,0,1,1
2023-06-01,140493,0,3,3,0,1,1
2023-06-01,140495,0,3,3,0,1,1
2023-06-01,140496,0,3,3,0,1,1
2023-06-01,140497,0,3,3,0,1,1
2023-06-01,140346,0,4,4,0,1,1
2023-06-01,140358,0,4,4,0,1,1
2023-06-01,140360,0,4,4,0,1,1
2023-06-01,140361,0,4,4,0,1,1
2023-06-01,140349,0,4,4,0,1,1
2023-06-01,140353,0,4,4,0,1,1
2023-06-01,140359,0,4,4,0,1,1
2023-06-01,140357,0,4,4,0,1,1
2023-06-01,140347,0,3,3,0,1,1
2023-06-01,140350,0,4,4,0,1,1
2023-06-01,140348,0,4,4,0,1,1
2023-06-01,140351,0,4,4,0,1,1
2023-06-01,140354,0,4,4,0,1,1
2023-06-01,140356,0,4,4,0,1,1
2023-06-01,140352,0,3,3,0,1,1
2023-06-01,140355,0,4,4,0,1,1
2023-06-01,137401,0,3,3,0,1,1
2023-06-01,137402,0,3,3,0,1,1
2023-06-01,140528,0,3,3,0,1,1
2023-06-01,140529,0,3,3,0,1,1
2023-06-01,140530,0,3,3,0,1,1
2023-06-01,140531,0,3,3,0,1,1
2023-06-01,140532,0,3,3,0,1,1
2023-06-01,140533,0,3,3,0,1,1
2023-06-01,140534,0,3,3,0,1,1
2023-06-01,140535,0,3,3,0,1,1
2023-06-01,140537,0,3,3,0,1,1
2023-06-01,140536,0,3,3,0,1,1
2023-06-01,140538,0,3,3,0,1,1
2023-06-01,140486,0,5,5,0,1,1
2023-06-01,140365,0,3,3,0,15,15
2023-06-01,140364,0,3,3,0,1,1
2023-06-01,140366,0,3,3,0,1,1
2023-06-01,140367,0,3,3,0,1,1
2023-06-01,140368,0,3,3,0,1,1
2023-06-01,140369,0,3,3,0,1,1
2023-06-01,140370,0,3,3,0,1,1
2023-06-01,140371,0,3,3,0,1,1
2023-06-01,140372,0,3,3,0,1,1
2023-06-01,140373,0,3,3,0,1,1
2023-06-01,140374,0,3,3,0,1,1
2023-06-01,140375,0,3,3,0,1,1
2023-06-01,140376,0,3,3,0,1,1
2023-06-01,140377,0,3,3,0,1,1
2023-06-01,140378,0,3,3,0,1,1
2023-06-01,27030,0,1,1,0,1,1
2023-06-01,11145,0,0,0,0,2,2
2023-06-01,972,0,3,3,0,2,2
2023-06-01,62623,0,0,0,0,2,2
2023-06-01,32001,0,1,1,0,1,1
2023-06-01,200536,0,36,36,0,16,16
2023-06-01,138990,0,1,1,0,1,1
2023-06-01,199626,0,2,2,0,2,2
2023-06-01,199656,0,14,14,0,5,5
2023-06-01,203283,0,8,8,0,6,6
2023-06-01,33760,0,4,4,0,1,1
2023-06-01,399477,0,1,1,0,1,1
2023-06-01,397955,0,4,4,0,1,1
2023-06-01,27587,0,1,1,0,2,2
2023-06-01,394392,0,8,8,0,1,1
2023-06-01,399652,0,1,1,0,1,1
2023-06-01,982,0,1,1,0,1,1
2023-06-01,400235,0,1,1,0,1,1
2023-06-01,400567,0,3,3,0,2,2
2023-06-01,992,0,2,2,0,2,2
2023-06-01,20420,0,2,2,0,1,1
2023-06-01,40544,0,1,1,0,2,2
2023-06-01,212854,0,2,2,0,1,1
2023-06-01,49867,0,2,2,0,2,2
2023-06-01,48581,0,19,19,0,22,22
2023-06-01,211380,0,18,18,0,7,7
2023-06-01,201445,0,3,3,0,1,1
2023-06-01,199632,0,7,7,0,7,7
2023-06-01,200572,0,0,0,0,3,3
2023-06-01,199177,0,10,10,0,10,10
2023-06-01,208548,0,29,29,0,3,3
2023-06-01,15040,0,1,1,0,1,1
2023-06-01,395648,0,1,1,0,2,2
2023-06-01,211548,0,2,2,0,1,1
2023-06-01,204340,0,4,4,0,2,2
2023-06-01,204789,0,17,17,0,4,4
2023-06-01,199972,0,6,6,0,6,6
2023-06-01,21761,0,6,6,0,2,2
2023-06-01,202911,0,2,2,0,1,1
2023-06-01,398485,0,1,1,0,1,1
2023-06-01,1012,0,1,1,0,1,1
2023-06-01,50842,0,1,1,0,1,1
2023-06-01,393610,0,1,1,0,1,1
2023-06-01,44570,0,1,1,0,1,1
2023-06-01,49707,0,2,2,0,1,1
2023-06-01,400546,0,2,2,0,2,2
2023-06-01,51999,0,2,2,0,5,5
2023-06-01,400174,0,1,1,0,1,1
2023-06-01,950,0,1,1,0,1,1
2023-06-01,206018,0,1,1,0,1,1
2023-06-01,57429,0,2,2,0,2,2
2023-06-01,212360,0,5,5,0,7,7
2023-06-01,44406,0,8,8,0,1,1
2023-06-01,207852,0,4,4,0,3,3
2023-06-01,54625,0,1,1,0,1,1
2023-06-01,205432,0,32,32,0,12,12
2023-06-01,57481,0,1,1,0,1,1
2023-06-01,928,0,3,3,0,1,1
2023-06-01,211562,0,7,7,0,4,4
2023-06-01,213339,0,2,2,0,3,3
2023-06-01,987,0,1,1,0,1,1
2023-06-01,212243,0,2,2,0,1,1
2023-06-01,397901,0,1,1,0,1,1
2023-06-01,200570,0,2,2,0,1,1
2023-06-01,199184,0,1,1,0,1,1
2023-06-01,395886,0,1,1,0,2,2
2023-06-01,57957,0,1,1,0,1,1
2023-06-01,49780,0,1,1,0,1,1
2023-06-01,48413,0,1,1,0,1,1
2023-06-01,38041,0,2,2,0,1,1
2023-06-01,399980,0,1,1,0,1,1
2023-06-01,25848,0,1,1,0,1,1
2023-06-01,207071,0,2,2,0,3,3
2023-06-01,200329,0,2,2,0,1,1
2023-06-01,200676,0,10,10,0,7,7
2023-06-01,200579,0,5,5,0,4,4
2023-06-01,200351,0,12,12,0,7,7
2023-06-01,201097,0,7,7,0,1,1
2023-06-01,49134,0,5,5,0,5,5
2023-06-01,137908,0,1,1,0,1,1
2023-06-01,210842,0,197,197,0,2,2
2023-06-01,211481,0,3,3,0,1,1
2023-06-01,398051,0,1,1,0,1,1
2023-06-01,397081,0,1,1,0,1,1
2023-06-01,200809,0,12,12,0,7,7
2023-06-01,13752,0,1,1,0,1,1
2023-06-01,49459,0,17,17,0,1,1
2023-06-01,207393,0,2,2,0,1,1
2023-06-01,205096,0,1,1,0,1,1
2023-06-01,202479,0,5,5,0,3,3
2023-06-01,207414,0,2,2,0,1,1
2023-06-01,398325,0,2,2,0,1,1
2023-06-01,207618,0,9,9,0,1,1
2023-06-01,400307,0,1,1,0,1,1
2023-06-01,28045,0,2,2,0,1,1
2023-06-01,139693,0,1,1,0,1,1
2023-06-01,38179,0,1,1,0,1,1
2023-06-01,203027,0,5,5,0,1,1
2023-06-01,205532,0,5,5,0,2,2
2023-06-01,205058,0,2,2,0,3,3
2023-06-01,38023,0,1,1,0,1,1
2023-06-01,142025,0,1,1,0,1,1
2023-06-01,137256,0,4,4,0,2,2
2023-06-01,140926,0,1,1,0,1,1
2023-06-01,204185,0,17,17,0,2,2
2023-06-01,138210,0,3,3,0,2,2
2023-06-01,134575,0,1,1,0,2,2
2023-06-01,205947,0,2,2,0,1,1
2023-06-01,213361,0,15,15,0,2,2
2023-06-01,140362,0,3,3,0,1,1
2023-06-01,138038,0,1,1,0,1,1
2023-06-01,205923,0,1,1,0,1,1
2023-06-01,212995,0,47,47,0,9,9
2023-06-01,209297,0,3,3,0,1,1
2023-06-01,140946,0,1,1,0,1,1
2023-06-01,212359,0,3,3,0,1,1
2023-06-01,212580,0,4,4,0,3,3
2023-06-01,212425,0,5,5,0,3,3
2023-06-01,212279,0,2,2,0,3,3
2023-06-01,399015,0,1,1,0,1,1
2023-06-01,141221,0,1,1,0,1,1
2023-06-01,141712,0,2,2,0,3,3
2023-06-01,138435,0,2,2,0,4,4
2023-06-01,142048,0,1,1,0,1,1
2023-06-01,142566,0,1,1,0,1,1
2023-06-01,209645,0,1,1,0,1,1
2023-06-01,142055,0,5,5,0,2,2
2023-06-01,142427,0,1,1,0,2,2
2023-06-01,147071,0,1,1,0,1,1
2023-06-01,147028,0,5,5,0,4,4
2023-06-01,147173,0,3,3,0,2,2
2023-06-01,64577,0,0,0,0,2,2
2023-06-01,53849,0,1,1,0,1,1
2023-06-01,393562,0,7,7,0,4,4
2023-06-01,395841,0,2,2,0,1,1
2023-06-01,399196,0,7,7,0,4,4
2023-06-01,11006,0,3,3,0,2,2
2023-06-01,16483,0,1,1,0,1,1
2023-06-01,19748,0,1,1,0,1,1
2023-06-01,23748,0,1,1,0,8,8
2023-06-01,62599,0,1,1,0,1,1
2023-06-01,11930,0,1,1,0,1,1
2023-06-01,30317,0,1,1,0,1,1
2023-06-01,393763,0,1,1,0,1,1
2023-06-01,397042,0,2,2,0,1,1
2023-06-01,14077,0,1,1,0,1,1
2023-06-01,398338,0,1,1,0,1,1
2023-06-01,57439,0,2,2,0,1,1
2023-06-01,398733,0,2,2,0,2,2
2023-06-01,399448,0,8,8,0,1,1
2023-06-01,399516,0,6,6,0,1,1
2023-06-01,399342,0,1,1,0,1,1
2023-06-01,394536,0,1,1,0,1,1
2023-06-01,399570,0,1,1,0,1,1
2023-06-01,399969,0,1,1,0,1,1
2023-06-01,33262,0,1,1,0,1,1
2023-06-01,959,0,2,2,0,2,2
2023-06-01,399914,0,2,2,0,2,2
2023-06-01,399500,0,1,1,0,1,1
2023-06-01,400362,0,1,1,0,1,1
2023-06-01,398024,0,1,1,0,1,1
2023-06-01,400674,0,1,1,0,1,1
2023-06-01,394882,0,1,1,0,1,1
2023-06-01,399662,0,1,1,0,1,1
2023-06-01,30583,0,1,1,0,1,1
2023-06-01,394337,0,1,1,0,1,1
2023-06-01,53358,0,3,3,0,2,2
2023-06-01,21662,0,1,1,0,1,1
2023-06-01,14338,0,4,4,0,1,1
2023-06-01,64262,0,0,0,0,2,2
2023-06-01,6477,0,1,1,0,1,1
2023-06-01,21687,0,2,2,0,1,1
2023-06-01,6025,0,3,3,0,4,4
2023-06-01,22550,0,1,1,0,1,1
2023-06-01,395460,0,7,7,0,5,5
2023-06-01,395661,0,1,1,0,1,1
2023-06-01,396079,0,1,1,0,1,1
2023-06-01,395956,0,1,1,0,1,1
2023-06-01,22695,0,1,1,0,2,2
2023-06-01,393523,0,1,1,0,1,1
2023-06-01,396088,0,1,1,0,1,1
2023-06-01,396701,0,1,1,0,2,2
2023-06-01,36630,0,1,1,0,2,2
2023-06-01,396545,0,1,1,0,2,2
2023-06-01,397800,0,1,1,0,1,1
2023-06-01,394719,0,1,1,0,1,1
2023-06-01,400743,0,1,1,0,1,1
2023-06-01,398931,0,1,1,0,1,1
2023-06-01,19418,0,1,1,0,1,1
2023-06-01,394068,0,1,1,0,1,1
2023-06-01,32439,0,1,1,0,1,1
2023-06-01,55166,0,1,1,0,1,1
2023-06-01,560,0,2,2,0,1,1
2023-06-01,14815,0,1,1,0,1,1
2023-06-01,975,0,1,1,0,1,1
2023-06-01,399333,0,1,1,0,1,1
2023-06-01,393462,0,1,1,0,1,1
2023-06-01,396075,0,3,3,0,3,3
2023-06-01,27518,0,2,2,0,1,1
2023-06-01,65011,0,1,1,0,1,1
2023-06-01,10851,0,3,3,0,2,2
2023-06-01,394707,0,1,1,0,1,1
2023-06-01,396874,0,1,1,0,1,1
2023-06-01,809,0,1,1,0,1,1
2023-06-01,27538,0,1,1,0,1,1
2023-06-01,398767,0,1,1,0,1,1
2023-06-01,53692,0,2,2,0,1,1
2023-06-01,397962,0,1,1,0,1,1
2023-06-01,263719,0,2,2,0,1,1
2023-06-01,269850,0,1,1,0,1,1
2023-06-01,272835,0,1,1,0,1,1
2023-06-01,271925,0,1,1,0,1,1
2023-06-01,271877,0,1,1,0,1,1
2023-06-01,272087,0,1,1,0,1,1
2023-06-01,271995,0,1,1,0,1,1
2023-06-01,266906,0,2,2,0,2,2
2023-06-01,271963,0,1,1,0,1,1
2023-06-01,271828,0,1,1,0,1,1
2023-06-01,269977,0,1,1,0,1,1
2023-06-01,271940,0,1,1,0,1,1
2023-06-01,269883,0,1,1,0,2,2
2023-06-01,267928,0,1,1,0,1,1
2023-06-01,272088,0,2,2,0,2,2
2023-06-01,271918,0,1,1,0,1,1
2023-06-01,272079,0,1,1,0,1,1
2023-06-01,269848,0,1,1,0,1,1
2023-06-01,272519,0,1,1,0,1,1
2023-06-01,272493,0,1,1,0,1,1
2023-06-01,272215,0,1,1,0,2,2
2023-06-01,272576,0,1,1,0,1,1
2023-06-01,272616,0,1,1,0,1,1
2023-06-01,273679,0,2,2,0,1,1
2023-06-01,262922,0,2,2,0,1,1
2023-06-01,270178,0,1,1,0,1,1
2023-06-01,28500,0,1,1,0,1,1
2023-06-01,272842,0,1,1,0,1,1
2023-06-01,271844,0,1,1,0,1,1
2023-06-01,271827,0,2,2,0,2,2
2023-06-01,272919,0,1,1,0,1,1
2023-06-01,269888,0,1,1,0,1,1
2023-06-01,272904,0,1,1,0,1,1
2023-06-01,271858,0,1,1,0,1,1
2023-06-01,272084,0,1,1,0,1,1
2023-06-01,271958,0,5,5,0,1,1
2023-06-01,271891,0,32,32,0,2,2
2023-06-01,269937,0,2,2,0,1,1
2023-06-01,272115,0,1,1,0,1,1
2023-06-01,271780,0,0,0,0,2,2
2023-06-01,271954,0,1,1,0,1,1
2023-06-01,272153,0,4,4,0,2,2
2023-06-01,271845,0,1,1,0,1,1
2023-06-01,269845,0,3,3,0,1,1
2023-06-01,272909,0,2,2,0,1,1
2023-06-01,272952,0,6,6,0,1,1
2023-06-01,272920,0,2,2,0,1,1
2023-06-01,271901,0,1,1,0,1,1
2023-06-01,271820,0,2,2,0,2,2
2023-06-01,272881,0,2,2,0,1,1
2023-06-01,271987,0,1,1,0,1,1
2023-06-01,272950,0,1,1,0,1,1
2023-06-01,265850,0,1,1,0,1,1
2023-06-01,272937,0,8,8,0,2,2
2023-06-01,272069,0,1,1,0,1,1
2023-06-01,269880,0,1,1,0,1,1
2023-06-01,272841,0,1,1,0,1,1
2023-06-01,272853,0,3,3,0,3,3
2023-06-01,272814,0,1,1,0,1,1
2023-06-01,272875,0,3,3,0,1,1
2023-06-01,272145,0,1,1,0,1,1
2023-06-01,271910,0,1,1,0,1,1
2023-06-01,272864,0,1,1,0,1,1
2023-06-01,272010,0,1,1,0,1,1
2023-06-01,272955,0,1,1,0,1,1
2023-06-01,272799,0,1,1,0,1,1
2023-06-01,269866,0,1,1,0,1,1
2023-06-01,272800,0,1,1,0,1,1
2023-06-01,272847,0,1,1,0,1,1
2023-06-01,272123,0,1,1,0,1,1
2023-06-01,264639,0,1,1,0,1,1
2023-06-01,273009,0,1,1,0,1,1
2023-06-01,272889,0,4,4,0,1,1
2023-06-01,266865,0,1,1,0,1,1
2023-06-01,272056,0,1,1,0,1,1
2023-06-01,270046,0,6,6,0,4,4
2023-06-01,271967,0,4,4,0,1,1
2023-06-01,272146,0,3,3,0,1,1
2023-06-01,272977,0,1,1,0,1,1
2023-06-01,271990,0,1,1,0,1,1
2023-06-01,266774,0,1,1,0,1,1
2023-06-01,15201,0,6,6,0,1,1
2023-06-01,262345,0,1,1,0,1,1
2023-06-01,52666,0,1,1,0,3,3
2023-06-01,273646,0,1,1,0,1,1
2023-06-01,273758,0,1,1,0,1,1
2023-06-01,61607,0,1,1,0,1,1
2023-06-01,272220,0,7,7,0,2,2
2023-06-01,61574,0,8,8,0,1,1
2023-06-01,271645,0,4,4,0,2,2
2023-06-01,260342,0,0,0,0,2,2
2023-06-01,267371,0,2,2,0,1,1
2023-06-01,268521,0,1,1,0,1,1
2023-06-01,61598,0,1,1,0,1,1
2023-06-01,269594,0,1,1,0,1,1
2023-06-01,272436,0,3,3,0,2,2
2023-06-01,271715,0,3,3,0,2,2
2023-06-01,271530,0,19,19,0,2,2
2023-06-01,271593,0,1,1,0,1,1
2023-06-01,271621,0,1,1,0,1,1
2023-06-01,271629,0,1,1,0,1,1
2023-06-01,271636,0,1,1,0,1,1
2023-06-01,271641,0,1,1,0,1,1
2023-06-01,271643,0,1,1,0,1,1
2023-06-01,271648,0,1,1,0,1,1
2023-06-01,271657,0,5,5,0,1,1
2023-06-01,271658,0,1,1,0,1,1
2023-06-01,271661,0,1,1,0,1,1
2023-06-01,271663,0,1,1,0,1,1
2023-06-01,271664,0,1,1,0,1,1
2023-06-01,271665,0,2,2,0,1,1
2023-06-01,271669,0,1,1,0,1,1
2023-06-01,271671,0,1,1,0,1,1
2023-06-01,271672,0,3,3,0,1,1
2023-06-01,271674,0,6,6,0,1,1
2023-06-01,271676,0,1,1,0,1,1
2023-06-01,271677,0,1,1,0,2,2
2023-06-01,271678,0,0,0,0,2,2
2023-06-01,271681,0,3,3,0,1,1
2023-06-01,271686,0,1,1,0,1,1
2023-06-01,271687,0,100,100,0,3,3
2023-06-01,271688,0,1,1,0,1,1
2023-06-01,271692,0,5,5,0,3,3
2023-06-01,271695,0,7,7,0,2,2
2023-06-01,271698,0,1,1,0,1,1
2023-06-01,271699,0,2,2,0,3,3
2023-06-01,271702,0,1,1,0,1,1
2023-06-01,271704,0,7,7,0,3,3
2023-06-01,271705,0,1,1,0,1,1
2023-06-01,271707,0,4,4,0,1,1
2023-06-01,271708,0,6,6,0,1,1
2023-06-01,271711,0,3,3,0,1,1
2023-06-01,271712,0,3,3,0,2,2
2023-06-01,271713,0,1,1,0,1,1
2023-06-01,271717,0,1,1,0,1,1
2023-06-01,271720,0,48,48,0,1,1
2023-06-01,271725,0,1,1,0,2,2
2023-06-01,271730,0,1,1,0,1,1
2023-06-01,271731,0,3,3,0,1,1
2023-06-01,271732,0,1,1,0,1,1
2023-06-01,271734,0,7,7,0,1,1
2023-06-01,271736,0,1,1,0,1,1
2023-06-01,271737,0,1,1,0,2,2
2023-06-01,271738,0,1,1,0,1,1
2023-06-01,271744,0,2,2,0,2,2
2023-06-01,271750,0,2,2,0,1,1
2023-06-01,271752,0,1,1,0,1,1
2023-06-01,271754,0,5,5,0,2,2
2023-06-01,271756,0,1,1,0,1,1
2023-06-01,271757,0,5,5,0,1,1
2023-06-01,271758,0,7,7,0,4,4
2023-06-01,271760,0,1,1,0,1,1
2023-06-01,271762,0,1,1,0,1,1
2023-06-01,271765,0,2,2,0,1,1
2023-06-01,271766,0,1,1,0,1,1
2023-06-01,271770,0,1,1,0,1,1
2023-06-01,271771,0,1,1,0,3,3
2023-06-01,262626,0,2,2,0,2,2
2023-06-01,272413,0,8,8,0,1,1
2023-06-01,272414,0,1,1,0,1,1
2023-06-01,272415,0,2,2,0,1,1
2023-06-01,272416,0,1,1,0,1,1
2023-06-01,272417,0,1,1,0,1,1
2023-06-01,272418,0,1,1,0,2,2
2023-06-01,272419,0,5,5,0,2,2
2023-06-01,272422,0,1,1,0,1,1
2023-06-01,272423,0,5,5,0,1,1
2023-06-01,272426,0,1,1,0,2,2
2023-06-01,272428,0,1,1,0,1,1
2023-06-01,272429,0,1,1,0,1,1
2023-06-01,272431,0,1,1,0,1,1
2023-06-01,272433,0,1,1,0,1,1
2023-06-01,272434,0,1,1,0,1,1
2023-06-01,272437,0,1,1,0,2,2
2023-06-01,272438,0,3,3,0,1,1
2023-06-01,272439,0,1,1,0,2,2
2023-06-01,272440,0,3,3,0,1,1
2023-06-01,272442,0,4,4,0,1,1
2023-06-01,272446,0,14,14,0,3,3
2023-06-01,272453,0,3,3,0,1,1
2023-06-01,272454,0,1,1,0,2,2
2023-06-01,272455,0,1,1,0,1,1
2023-06-01,272456,0,1,1,0,1,1
2023-06-01,272459,0,1,1,0,1,1
2023-06-01,272463,0,1,1,0,1,1
2023-06-01,272464,0,1,1,0,1,1
2023-06-01,272468,0,1,1,0,1,1
2023-06-01,272471,0,1,1,0,1,1
2023-06-01,272473,0,3,3,0,1,1
2023-06-01,272478,0,5,5,0,3,3
2023-06-01,272480,0,3,3,0,2,2
2023-06-01,272486,0,1,1,0,1,1
2023-06-01,272487,0,1,1,0,1,1
2023-06-01,272490,0,1,1,0,1,1
2023-06-01,272494,0,6,6,0,1,1
2023-06-01,272495,0,1,1,0,2,2
2023-06-01,272496,0,1,1,0,1,1
2023-06-01,272497,0,1,1,0,1,1
2023-06-01,272498,0,1,1,0,1,1
2023-06-01,272499,0,1,1,0,1,1
2023-06-01,272500,0,1,1,0,1,1
2023-06-01,272502,0,1,1,0,1,1
2023-06-01,272503,0,1,1,0,2,2
2023-06-01,272504,0,3,3,0,1,1
2023-06-01,272506,0,1,1,0,1,1
2023-06-01,272507,0,1,1,0,1,1
2023-06-01,272508,0,4,4,0,2,2
2023-06-01,272509,0,2,2,0,1,1
2023-06-01,272510,0,3,3,0,2,2
2023-06-01,272511,0,2,2,0,1,1
2023-06-01,272513,0,1,1,0,1,1
2023-06-01,272514,0,1,1,0,2,2
2023-06-01,272518,0,2,2,0,2,2
2023-06-01,272520,0,1,1,0,1,1
2023-06-01,272522,0,1,1,0,1,1
2023-06-01,272527,0,1,1,0,2,2
2023-06-01,272530,0,1,1,0,1,1
2023-06-01,272532,0,1,1,0,1,1
2023-06-01,272533,0,1,1,0,3,3
2023-06-01,272536,0,1,1,0,2,2
2023-06-01,272537,0,1,1,0,1,1
2023-06-01,272538,0,5,5,0,1,1
2023-06-01,272540,0,1,1,0,1,1
2023-06-01,272159,0,1,1,0,1,1
2023-06-01,272164,0,7,7,0,1,1
2023-06-01,272165,0,2,2,0,1,1
2023-06-01,272167,0,7,7,0,2,2
2023-06-01,272169,0,1,1,0,2,2
2023-06-01,272171,0,3,3,0,1,1
2023-06-01,272172,0,1,1,0,1,1
2023-06-01,272176,0,3,3,0,2,2
2023-06-01,272179,0,3,3,0,1,1
2023-06-01,272180,0,1,1,0,2,2
2023-06-01,272183,0,1,1,0,1,1
2023-06-01,272185,0,2,2,0,1,1
2023-06-01,272191,0,1,1,0,1,1
2023-06-01,272192,0,1,1,0,2,2
2023-06-01,272197,0,1,1,0,1,1
2023-06-01,272198,0,1,1,0,1,1
2023-06-01,272200,0,1,1,0,2,2
2023-06-01,272201,0,1,1,0,1,1
2023-06-01,272202,0,3,3,0,1,1
2023-06-01,272203,0,1,1,0,1,1
2023-06-01,272205,0,1,1,0,2,2
2023-06-01,272206,0,1,1,0,1,1
2023-06-01,272209,0,1,1,0,1,1
2023-06-01,272211,0,1,1,0,1,1
2023-06-01,272216,0,1,1,0,1,1
2023-06-01,272217,0,1,1,0,2,2
2023-06-01,272223,0,1,1,0,1,1
2023-06-01,272224,0,1,1,0,3,3
2023-06-01,272225,0,1,1,0,1,1
2023-06-01,272229,0,1,1,0,1,1
2023-06-01,272234,0,3,3,0,1,1
2023-06-01,272236,0,1,1,0,1,1
2023-06-01,272238,0,3,3,0,1,1
2023-06-01,272242,0,2,2,0,1,1
2023-06-01,272243,0,1,1,0,1,1
2023-06-01,272245,0,5,5,0,1,1
2023-06-01,272246,0,5,5,0,1,1
2023-06-01,272250,0,2,2,0,2,2
2023-06-01,272251,0,3,3,0,1,1
2023-06-01,272254,0,1,1,0,1,1
2023-06-01,272255,0,1,1,0,1,1
2023-06-01,272257,0,1,1,0,1,1
2023-06-01,272259,0,1,1,0,1,1
2023-06-01,272260,0,1,1,0,1,1
2023-06-01,272262,0,1,1,0,3,3
2023-06-01,272265,0,1,1,0,1,1
2023-06-01,272269,0,7,7,0,3,3
2023-06-01,272270,0,1,1,0,1,1
2023-06-01,272271,0,2,2,0,2,2
2023-06-01,272275,0,1,1,0,1,1
2023-06-01,272277,0,2,2,0,1,1
2023-06-01,272279,0,1,1,0,1,1
2023-06-01,272280,0,1,1,0,1,1
2023-06-01,272281,0,1,1,0,1,1
2023-06-01,272282,0,2,2,0,1,1
2023-06-01,272283,0,1,1,0,2,2
2023-06-01,272543,0,1,1,0,1,1
2023-06-01,272546,0,1,1,0,2,2
2023-06-01,272550,0,3,3,0,1,1
2023-06-01,272551,0,1,1,0,1,1
2023-06-01,272564,0,1,1,0,1,1
2023-06-01,272566,0,7,7,0,1,1
2023-06-01,272567,0,3,3,0,1,1
2023-06-01,272568,0,1,1,0,2,2
2023-06-01,272569,0,1,1,0,1,1
2023-06-01,272577,0,1,1,0,1,1
2023-06-01,272579,0,1,1,0,1,1
2023-06-01,272580,0,1,1,0,2,2
2023-06-01,272581,0,3,3,0,1,1
2023-06-01,272586,0,3,3,0,2,2
2023-06-01,272589,0,5,5,0,1,1
2023-06-01,272590,0,1,1,0,1,1
2023-06-01,272592,0,1,1,0,1,1
2023-06-01,272593,0,1,1,0,1,1
2023-06-01,272594,0,1,1,0,1,1
2023-06-01,272595,0,3,3,0,1,1
2023-06-01,272596,0,1,1,0,2,2
2023-06-01,272599,0,0,0,0,2,2
2023-06-01,272600,0,1,1,0,1,1
2023-06-01,272603,0,3,3,0,1,1
2023-06-01,272606,0,1,1,0,1,1
2023-06-01,272607,0,1,1,0,1,1
2023-06-01,272608,0,4,4,0,1,1
2023-06-01,272609,0,1,1,0,2,2
2023-06-01,272610,0,1,1,0,2,2
2023-06-01,272613,0,1,1,0,1,1
2023-06-01,272614,0,4,4,0,2,2
2023-06-01,272620,0,3,3,0,1,1
2023-06-01,272623,0,7,7,0,1,1
2023-06-01,272627,0,1,1,0,1,1
2023-06-01,272628,0,1,1,0,1,1
2023-06-01,272629,0,1,1,0,1,1
2023-06-01,272631,0,1,1,0,1,1
2023-06-01,272632,0,1,1,0,1,1
2023-06-01,272633,0,1,1,0,1,1
2023-06-01,272635,0,3,3,0,2,2
2023-06-01,272637,0,2,2,0,3,3
2023-06-01,272639,0,1,1,0,1,1
2023-06-01,272641,0,1,1,0,1,1
2023-06-01,272643,0,1,1,0,1,1
2023-06-01,272648,0,1,1,0,1,1
2023-06-01,272650,0,3,3,0,1,1
2023-06-01,272651,0,3,3,0,2,2
2023-06-01,272652,0,23,23,0,1,1
2023-06-01,272653,0,5,5,0,2,2
2023-06-01,272655,0,10,10,0,2,2
2023-06-01,272656,0,3,3,0,1,1
2023-06-01,272658,0,1,1,0,1,1
2023-06-01,272660,0,5,5,0,1,1
2023-06-01,272661,0,1,1,0,2,2
2023-06-01,272662,0,1,1,0,1,1
2023-06-01,272663,0,1,1,0,1,1
2023-06-01,272664,0,1,1,0,1,1
2023-06-01,272666,0,1,1,0,2,2
2023-06-01,272668,0,1,1,0,1,1
2023-06-01,272669,0,5,5,0,1,1
2023-06-01,272670,0,1,1,0,1,1
2023-06-01,272672,0,1,1,0,1,1
2023-06-01,272673,0,1,1,0,1,1
2023-06-01,272675,0,1,1,0,1,1
2023-06-01,272680,0,3,3,0,1,1
2023-06-01,272682,0,1,1,0,1,1
2023-06-01,272684,0,2,2,0,1,1
2023-06-01,272685,0,1,1,0,1,1
2023-06-01,272687,0,3,3,0,1,1
2023-06-01,272690,0,1,1,0,1,1
2023-06-01,272699,0,1,1,0,1,1
2023-06-01,272700,0,1,1,0,1,1
2023-06-01,272704,0,23,23,0,1,1
2023-06-01,272705,0,1,1,0,1,1
2023-06-01,272708,0,1,1,0,2,2
2023-06-01,272709,0,1,1,0,1,1
2023-06-01,272712,0,1,1,0,1,1
2023-06-01,272714,0,1,1,0,1,1
2023-06-01,272715,0,1,1,0,1,1
2023-06-01,272716,0,3,3,0,1,1
2023-06-01,272720,0,2,2,0,1,1
2023-06-01,272721,0,3,3,0,2,2
2023-06-01,272723,0,2,2,0,1,1
2023-06-01,272725,0,1,1,0,1,1
2023-06-01,272726,0,1,1,0,1,1
2023-06-01,272728,0,1,1,0,1,1
2023-06-01,272729,0,1,1,0,1,1
2023-06-01,272732,0,1,1,0,1,1
2023-06-01,272733,0,1,1,0,1,1
2023-06-01,272735,0,1,1,0,2,2
2023-06-01,272736,0,3,3,0,1,1
2023-06-01,272738,0,3,3,0,1,1
2023-06-01,272740,0,1,1,0,1,1
2023-06-01,272742,0,1,1,0,1,1
2023-06-01,272743,0,1,1,0,1,1
2023-06-01,272744,0,2,2,0,1,1
2023-06-01,272745,0,3,3,0,1,1
2023-06-01,272746,0,1,1,0,2,2
2023-06-01,272751,0,1,1,0,1,1
2023-06-01,272753,0,1,1,0,1,1
2023-06-01,272755,0,1,1,0,1,1
2023-06-01,272758,0,3,3,0,2,2
2023-06-01,272760,0,7,7,0,1,1
2023-06-01,272761,0,1,1,0,1,1
2023-06-01,272763,0,2,2,0,1,1
2023-06-01,272765,0,1,1,0,1,1
2023-06-01,272766,0,1,1,0,1,1
2023-06-01,272770,0,1,1,0,2,2
2023-06-01,272771,0,7,7,0,1,1
2023-06-01,272773,0,1,1,0,1,1
2023-06-01,272774,0,1,1,0,1,1
2023-06-01,272777,0,1,1,0,1,1
2023-06-01,272780,0,5,5,0,1,1
2023-06-01,272782,0,1,1,0,1,1
2023-06-01,272783,0,1,1,0,1,1
2023-06-01,272785,0,1,1,0,1,1
2023-06-01,272787,0,1,1,0,1,1
2023-06-01,272788,0,1,1,0,3,3
2023-06-01,272789,0,1,1,0,1,1
2023-06-01,272793,0,3,3,0,1,1
2023-06-01,272795,0,1,1,0,1,1
2023-06-01,272796,0,7,7,0,1,1
2023-06-01,273566,0,1,1,0,1,1
2023-06-01,273567,0,1,1,0,1,1
2023-06-01,273570,0,1,1,0,2,2
2023-06-01,273571,0,1,1,0,1,1
2023-06-01,273574,0,1,1,0,1,1
2023-06-01,273575,0,2,2,0,1,1
2023-06-01,273577,0,1,1,0,3,3
2023-06-01,273579,0,3,3,0,1,1
2023-06-01,273581,0,2,2,0,2,2
2023-06-01,273583,0,2,2,0,1,1
2023-06-01,273585,0,1,1,0,1,1
2023-06-01,273586,0,1,1,0,1,1
2023-06-01,273587,0,1,1,0,1,1
2023-06-01,273588,0,1,1,0,2,2
2023-06-01,273590,0,1,1,0,1,1
2023-06-01,273591,0,1,1,0,1,1
2023-06-01,273592,0,1,1,0,1,1
2023-06-01,273594,0,1,1,0,1,1
2023-06-01,273596,0,1,1,0,1,1
2023-06-01,273597,0,1,1,0,1,1
2023-06-01,273599,0,1,1,0,1,1
2023-06-01,273601,0,5,5,0,2,2
2023-06-01,273604,0,1,1,0,1,1
2023-06-01,273605,0,1,1,0,1,1
2023-06-01,273606,0,10,10,0,1,1
2023-06-01,273608,0,1,1,0,1,1
2023-06-01,273609,0,1,1,0,1,1
2023-06-01,273610,0,5,5,0,2,2
2023-06-01,273611,0,1,1,0,2,2
2023-06-01,273613,0,1,1,0,1,1
2023-06-01,273614,0,1,1,0,1,1
2023-06-01,273615,0,1,1,0,1,1
2023-06-01,273617,0,1,1,0,1,1
2023-06-01,273620,0,7,7,0,3,3
2023-06-01,273621,0,1,1,0,1,1
2023-06-01,273622,0,1,1,0,1,1
2023-06-01,273623,0,1,1,0,1,1
2023-06-01,273626,0,1,1,0,1,1
2023-06-01,273628,0,1,1,0,1,1
2023-06-01,273629,0,7,7,0,1,1
2023-06-01,273630,0,7,7,0,1,1
2023-06-01,273631,0,1,1,0,1,1
2023-06-01,273632,0,1,1,0,1,1
2023-06-01,273634,0,1,1,0,2,2
2023-06-01,273636,0,1,1,0,1,1
2023-06-01,273638,0,2,2,0,2,2
2023-06-01,273640,0,1,1,0,1,1
2023-06-01,273644,0,1,1,0,1,1
2023-06-01,273643,0,1,1,0,1,1
2023-06-01,273645,0,3,3,0,1,1
2023-06-01,273647,0,1,1,0,1,1
2023-06-01,273651,0,1,1,0,1,1
2023-06-01,273652,0,2,2,0,1,1
2023-06-01,273654,0,2,2,0,3,3
2023-06-01,273656,0,2,2,0,1,1
2023-06-01,273662,0,1,1,0,1,1
2023-06-01,273663,0,5,5,0,3,3
2023-06-01,273664,0,1,1,0,1,1
2023-06-01,273665,0,1,1,0,1,1
2023-06-01,273668,0,3,3,0,1,1
2023-06-01,273670,0,3,3,0,1,1
2023-06-01,273674,0,1,1,0,3,3
2023-06-01,273677,0,1,1,0,1,1
2023-06-01,273684,0,1,1,0,1,1
2023-06-01,273685,0,1,1,0,1,1
2023-06-01,273687,0,1,1,0,1,1
2023-06-01,273690,0,1,1,0,1,1
2023-06-01,273691,0,1,1,0,1,1
2023-06-01,273692,0,1,1,0,1,1
2023-06-01,273694,0,1,1,0,1,1
2023-06-01,273695,0,1,1,0,1,1
2023-06-01,273697,0,1,1,0,1,1
2023-06-01,273700,0,2,2,0,1,1
2023-06-01,273701,0,1,1,0,1,1
2023-06-01,273702,0,2,2,0,1,1
2023-06-01,273704,0,1,1,0,1,1
2023-06-01,273705,0,3,3,0,2,2
2023-06-01,273706,0,11,11,0,1,1
2023-06-01,273709,0,1,1,0,1,1
2023-06-01,273710,0,1,1,0,1,1
2023-06-01,273711,0,1,1,0,2,2
2023-06-01,273712,0,1,1,0,1,1
2023-06-01,273713,0,3,3,0,2,2
2023-06-01,273714,0,1,1,0,2,2
2023-06-01,273715,0,1,1,0,1,1
2023-06-01,273716,0,1,1,0,2,2
2023-06-01,273719,0,1,1,0,1,1
2023-06-01,273721,0,4,4,0,4,4
2023-06-01,273724,0,3,3,0,1,1
2023-06-01,273726,0,1,1,0,1,1
2023-06-01,273729,0,1,1,0,1,1
2023-06-01,273731,0,1,1,0,1,1
2023-06-01,273735,0,1,1,0,1,1
2023-06-01,273736,0,5,5,0,1,1
2023-06-01,273737,0,1,1,0,1,1
2023-06-01,273738,0,1,1,0,1,1
2023-06-01,273740,0,1,1,0,1,1
2023-06-01,273741,0,1,1,0,1,1
2023-06-01,273745,0,1,1,0,1,1
2023-06-01,273746,0,3,3,0,1,1
2023-06-01,273747,0,1,1,0,1,1
2023-06-01,273748,0,3,3,0,1,1
2023-06-01,273751,0,1,1,0,1,1
2023-06-01,273753,0,1,1,0,1,1
2023-06-01,273755,0,1,1,0,1,1
2023-06-01,273757,0,1,1,0,1,1
2023-06-01,273763,0,1,1,0,1,1
2023-06-01,270164,0,2,2,0,1,1
2023-06-01,270148,0,1,1,0,1,1
2023-06-01,65504,0,0,0,0,2,2
2023-06-01,270141,0,4,4,0,1,1
2023-06-01,28443,0,1,1,0,1,1
2023-06-01,270159,0,1,1,0,1,1
2023-06-01,29290,0,8,8,0,4,4
2023-06-01,43447,0,8,8,0,1,1
2023-06-01,197264,0,0,0,0,2,2
2023-06-01,40986,0,1,1,0,1,1
2023-06-01,52011,0,1,1,0,1,1
2023-06-01,64646,0,1,1,0,1,1
2023-06-01,39229,0,1,1,0,1,1
2023-06-01,44611,0,1,1,0,1,1
2023-06-01,203875,0,1,1,0,1,1
2023-06-01,203871,0,1,1,0,1,1
2023-06-01,200774,0,1,1,0,1,1
2023-06-01,200549,0,1,1,0,2,2
2023-06-01,208157,0,1,1,0,1,1
2023-06-01,207806,0,1,1,0,1,1
2023-06-01,207808,0,1,1,0,1,1
2023-06-01,207807,0,1,1,0,1,1
2023-06-01,212775,0,1,1,0,1,1
2023-06-01,210675,0,1,1,0,1,1
2023-06-01,49191,0,15,15,0,1,1
2023-06-01,6584,0,1,1,0,1,1
2023-06-01,199092,0,1,1,0,1,1
2023-06-01,65556,0,1,1,0,1,1
2023-06-01,199935,0,1,1,0,1,1
2023-06-01,212144,0,42,42,0,3,3
2023-06-01,204790,0,100,100,0,2,2
2023-06-01,39639,0,1,1,0,1,1
2023-06-01,206202,0,1,1,0,3,3
2023-06-01,31458,0,1,1,0,1,1
2023-06-01,49413,0,1,1,0,1,1
2023-06-01,64105,0,10,10,0,1,1
2023-06-01,210641,0,1,1,0,2,2
2023-06-01,204405,0,1,1,0,1,1
2023-06-01,211085,0,1,1,0,1,1
2023-06-01,3305,0,1,1,0,1,1
2023-06-01,203025,0,2,2,0,1,1
2023-06-01,47254,0,1,1,0,1,1
2023-06-01,47246,0,1,1,0,1,1
2023-06-01,204693,0,5,5,0,2,2
2023-06-01,5543,0,1,1,0,1,1
2023-06-01,207388,0,1,1,0,1,1
2023-06-01,56925,0,1,1,0,1,1
2023-06-01,41002,0,1,1,0,1,1
2023-06-01,47279,0,1,1,0,1,1
2023-06-01,57400,0,1,1,0,1,1
2023-06-01,199586,0,1,1,0,1,1
2023-06-01,209652,0,5,5,0,4,4
2023-06-01,209484,0,1,1,0,1,1
2023-06-01,199580,0,1,1,0,1,1
2023-06-01,199158,0,1,1,0,1,1
2023-06-01,205232,0,5,5,0,4,4
2023-06-01,203083,0,1,1,0,1,1
2023-06-01,202473,0,1,1,0,1,1
2023-06-01,208657,0,1,1,0,1,1
2023-06-01,59819,0,3,3,0,4,4
2023-06-01,38945,0,1,1,0,1,1
2023-06-01,44394,0,1,1,0,1,1
2023-06-01,199813,0,1,1,0,1,1
2023-06-01,41732,0,13,13,0,5,5
2023-06-01,47710,0,1,1,0,1,1
2023-06-01,39827,0,1,1,0,1,1
2023-06-01,43419,0,1,1,0,1,1
2023-06-01,28695,0,2,2,0,2,2
2023-06-01,48619,0,1,1,0,1,1
2023-06-01,60786,0,4,4,0,2,2
2023-06-01,209489,0,1,1,0,1,1
2023-06-01,206731,0,1,1,0,1,1
2023-06-01,206634,0,1,1,0,2,2
2023-06-01,200299,0,2,2,0,4,4
2023-06-01,212008,0,6,6,0,5,5
2023-06-01,136918,0,9,9,0,4,4
2023-06-01,211013,0,2,2,0,3,3
2023-06-01,203458,0,2,2,0,2,2
2023-06-01,211889,0,1,1,0,1,1
2023-06-01,211188,0,1,1,0,1,1
2023-06-01,199018,0,2,2,0,1,1
2023-06-01,204508,0,15,15,0,11,11
2023-06-01,210633,0,8,8,0,9,9
2023-06-01,203323,0,3,3,0,4,4
2023-06-01,39831,0,1,1,0,1,1
2023-06-01,203438,0,4,4,0,1,1
2023-06-01,57640,0,1,1,0,1,1
2023-06-01,211358,0,8,8,0,5,5
2023-06-01,208078,0,2,2,0,1,1
2023-06-01,60310,0,5,5,0,5,5
2023-06-01,199925,0,5,5,0,1,1
2023-06-01,199459,0,6,6,0,3,3
2023-06-01,48606,0,4,4,0,3,3
2023-06-01,199097,0,4,4,0,1,1
2023-06-01,206919,0,12,12,0,2,2
2023-06-01,198969,0,2,2,0,2,2
2023-06-01,199079,0,2,2,0,2,2
2023-06-01,198942,0,1,1,0,2,2
2023-06-01,198714,0,2,2,0,1,1
2023-06-01,198889,0,6,6,0,1,1
2023-06-01,207941,0,14,14,0,15,15
2023-06-01,198383,0,1,1,0,1,1
2023-06-01,200242,0,15,15,0,8,8
2023-06-01,205789,0,1,1,0,1,1
2023-06-01,203069,0,2,2,0,1,1
2023-06-01,200897,0,66,66,0,2,2
2023-06-01,203909,0,2,2,0,1,1
2023-06-01,203062,0,8,8,0,7,7
2023-06-01,202828,0,7,7,0,3,3
2023-06-01,212252,0,2,2,0,1,1
2023-06-01,200952,0,6,6,0,2,2
2023-06-01,64457,0,1,1,0,1,1
2023-06-01,212173,0,5,5,0,2,2
2023-06-01,203888,0,4,4,0,3,3
2023-06-01,200160,0,22,22,0,12,12
2023-06-01,213086,0,5,5,0,6,6
2023-06-01,208076,0,2,2,0,2,2
2023-06-01,203199,0,8,8,0,2,2
2023-06-01,212294,0,6,6,0,3,3
2023-06-01,199680,0,3,3,0,2,2
2023-06-01,210631,0,1,1,0,6,6
2023-06-01,212504,0,2,2,0,1,1
2023-06-01,199762,0,6,6,0,7,7
2023-06-01,199376,0,4,4,0,2,2
2023-06-01,211151,0,4,4,0,4,4
2023-06-01,207466,0,8,8,0,10,10
2023-06-01,398559,0,40,40,0,2,2
2023-06-01,203943,0,7,7,0,2,2
2023-06-01,206981,0,6,6,0,2,2
2023-06-01,210260,0,4,4,0,2,2
2023-06-01,204374,0,19,19,0,4,4
2023-06-01,203913,0,4,4,0,5,5
2023-06-01,203852,0,3,3,0,2,2
2023-06-01,210932,0,3,3,0,5,5
2023-06-01,208223,0,23,23,0,11,11
2023-06-01,202736,0,1,1,0,1,1
2023-06-01,202990,0,1,1,0,1,1
2023-06-01,202939,0,8,8,0,5,5
2023-06-01,207480,0,2,2,0,4,4
2023-06-01,25595,0,1,1,0,5,5
2023-06-01,50007,0,9,9,0,1,1
2023-06-01,51711,0,5,5,0,1,1
2023-06-01,60188,0,2,2,0,1,1
2023-06-01,60262,0,54,54,0,2,2
2023-06-01,203271,0,2,2,0,1,1
2023-06-01,211480,0,2,2,0,1,1
2023-06-01,199052,0,5,5,0,1,1
2023-06-01,205980,0,4,4,0,2,2
2023-06-01,60900,0,9,9,0,7,7
2023-06-01,204857,0,2,2,0,5,5
2023-06-01,212085,0,15,15,0,12,12
2023-06-01,213234,0,2,2,0,2,2
2023-06-01,210387,0,4,4,0,1,1
2023-06-01,58270,0,2,2,0,1,1
2023-06-01,49975,0,2,2,0,1,1
2023-06-01,210023,0,3,3,0,2,2
2023-06-01,150325,0,3,3,0,3,3
2023-06-01,207740,0,4,4,0,6,6
2023-06-01,210925,0,3,3,0,5,5
2023-06-01,202197,0,4,4,0,5,5
2023-06-01,210461,0,1,1,0,2,2
2023-06-01,209512,0,2,2,0,1,1
2023-06-01,207705,0,6,6,0,3,3
2023-06-01,204375,0,3,3,0,1,1
2023-06-01,213386,0,2,2,0,1,1
2023-06-01,205398,0,17,17,0,10,10
2023-06-01,211604,0,11,11,0,6,6
2023-06-01,211869,0,7,7,0,9,9
2023-06-01,200101,0,1,1,0,1,1
2023-06-01,203169,0,2,2,0,4,4
2023-06-01,210013,0,14,14,0,2,2
2023-06-01,204842,0,1,1,0,3,3
2023-06-01,58015,0,2,2,0,2,2
2023-06-01,139328,0,19,19,0,7,7
2023-06-01,200227,0,2,2,0,1,1
2023-06-01,210576,0,25,25,0,3,3
2023-06-01,35619,0,2,2,0,3,3
2023-06-01,142289,0,8,8,0,7,7
2023-06-01,205214,0,5,5,0,4,4
2023-06-01,208679,0,4,4,0,1,1
2023-06-01,204740,0,1,1,0,2,2
2023-06-01,200879,0,18,18,0,7,7
2023-06-01,201242,0,3,3,0,1,1
2023-06-01,147016,0,3,3,0,5,5
2023-06-01,202222,0,3,3,0,3,3
2023-06-01,201979,0,2,2,0,3,3
2023-06-01,203333,0,3,3,0,4,4
2023-06-01,201444,0,1,1,0,1,1
2023-06-01,203874,0,2,2,0,2,2
2023-06-01,200237,0,2,2,0,1,1
2023-06-01,204518,0,3,3,0,2,2
2023-06-01,211946,0,9,9,0,4,4
2023-06-01,207445,0,3,3,0,2,2
2023-06-01,212049,0,2,2,0,2,2
2023-06-01,149835,0,7,7,0,6,6
2023-06-01,202467,0,2,2,0,1,1
2023-06-01,200754,0,8,8,0,8,8
2023-06-01,200730,0,4,4,0,2,2
2023-06-01,203899,0,4,4,0,4,4
2023-06-01,56808,0,1,1,0,1,1
2023-06-01,60379,0,1,1,0,1,1
2023-06-01,203873,0,8,8,0,2,2
2023-06-01,51856,0,1,1,0,1,1
2023-06-01,204446,0,5,5,0,8,8
2023-06-01,203655,0,8,8,0,3,3
2023-06-01,202518,0,1,1,0,1,1
2023-06-01,203597,0,21,21,0,1,1
2023-06-01,212178,0,2,2,0,1,1
2023-06-01,204406,0,3,3,0,3,3
2023-06-01,204901,0,1,1,0,1,1
2023-06-01,211431,0,6,6,0,1,1
2023-06-01,204291,0,3,3,0,2,2
2023-06-01,210965,0,6,6,0,5,5
2023-06-01,199668,0,5,5,0,3,3
2023-06-01,199676,0,4,4,0,6,6
2023-06-01,212888,0,1,1,0,3,3
2023-06-01,211233,0,3,3,0,2,2
2023-06-01,24676,0,1,1,0,1,1
2023-06-01,200890,0,7,7,0,4,4
2023-06-01,200221,0,6,6,0,2,2
2023-06-01,202199,0,1,1,0,1,1
2023-06-01,204474,0,1,1,0,1,1
2023-06-01,203861,0,1,1,0,1,1
2023-06-01,209710,0,8,8,0,4,4
2023-06-01,203577,0,12,12,0,5,5
2023-06-01,206569,0,3,3,0,2,2
2023-06-01,200959,0,12,12,0,3,3
2023-06-01,201938,0,2,2,0,2,2
2023-06-01,51312,0,1,1,0,1,1
2023-06-01,199767,0,3,3,0,2,2
2023-06-01,200965,0,3,3,0,2,2
2023-06-01,200912,0,2,2,0,2,2
2023-06-01,148971,0,9,9,0,5,5
2023-06-01,200866,0,25,25,0,10,10
2023-06-01,202427,0,19,19,0,10,10
2023-06-01,211665,0,1,1,0,3,3
2023-06-01,200455,0,8,8,0,9,9
2023-06-01,202776,0,3,3,0,3,3
2023-06-01,200158,0,3,3,0,2,2
2023-06-01,212196,0,6,6,0,2,2
2023-06-01,200169,0,1,1,0,1,1
2023-06-01,208768,0,5,5,0,3,3
2023-06-01,199467,0,2,2,0,2,2
2023-06-01,213267,0,3,3,0,3,3
2023-06-01,209431,0,1,1,0,1,1
2023-06-01,34775,0,7,7,0,1,1
2023-06-01,212044,0,1,1,0,1,1
2023-06-01,202693,0,3,3,0,1,1
2023-06-01,201849,0,1,1,0,1,1
2023-06-01,202256,0,63,63,0,2,2
2023-06-01,206633,0,1,1,0,2,2
2023-06-01,205634,0,1,1,0,1,1
2023-06-01,205117,0,2,2,0,1,1
2023-06-01,204604,0,2,2,0,3,3
2023-06-01,210090,0,1,1,0,1,1
2023-06-01,209808,0,6,6,0,2,2
2023-06-01,204003,0,3,3,0,3,3
2023-06-01,209569,0,1,1,0,1,1
2023-06-01,208958,0,1,1,0,1,1
2023-06-01,208872,0,3,3,0,1,1
2023-06-01,208434,0,2,2,0,3,3
2023-06-01,210286,0,1,1,0,1,1
2023-06-01,210883,0,2,2,0,1,1
2023-06-01,212845,0,1,1,0,1,1
2023-06-01,212856,0,2,2,0,4,4
2023-06-01,212405,0,1,1,0,1,1
2023-06-01,207649,0,2,2,0,3,3
2023-06-01,62177,0,5,5,0,1,1
2023-06-01,203232,0,1,1,0,1,1
2023-06-01,203967,0,1,1,0,1,1
2023-06-01,202262,0,4,4,0,4,4
2023-06-01,57851,0,1,1,0,1,1
2023-06-01,203635,0,2,2,0,2,2
2023-06-01,203867,0,3,3,0,2,2
2023-06-01,48599,0,1,1,0,1,1
2023-06-01,57416,0,1,1,0,2,2
2023-06-01,205413,0,16,16,0,2,2
2023-06-01,203638,0,0,0,0,1,1
2023-06-01,60960,0,1,1,0,1,1
2023-06-01,400177,0,10,10,0,1,1
2023-06-01,208828,0,1,1,0,1,1
2023-06-01,57831,0,1,1,0,1,1
2023-06-01,204543,0,2,2,0,1,1
2023-06-01,40970,0,18,18,0,2,2
2023-06-01,202398,0,1,1,0,1,1
2023-06-01,47343,0,1,1,0,1,1
2023-06-01,59872,0,1,1,0,1,1
2023-06-01,198571,0,8,8,0,2,2
2023-06-01,6679,0,1,1,0,1,1
2023-06-01,9098,0,1,1,0,1,1
2023-06-01,34567,0,1,1,0,1,1
2023-06-01,60135,0,6,6,0,2,2
2023-06-01,203914,0,6,6,0,2,2
2023-06-01,39220,0,1,1,0,1,1
2023-06-01,43992,0,1,1,0,1,1
2023-06-01,57969,0,1,1,0,1,1
2023-06-01,35536,0,1,1,0,1,1
2023-06-01,35537,0,1,1,0,1,1
2023-06-01,41767,0,1,1,0,1,1
2023-06-01,205758,0,1,1,0,1,1
2023-06-01,3258,0,2,2,0,2,2
2023-06-01,208982,0,1,1,0,1,1
2023-06-01,213372,0,3,3,0,3,3
2023-06-01,44364,0,9,9,0,1,1
2023-06-01,207613,0,3,3,0,4,4
2023-06-01,211352,0,6,6,0,2,2
2023-06-01,209562,0,7,7,0,1,1
2023-06-01,203959,0,3,3,0,2,2
2023-06-01,57027,0,1,1,0,1,1
2023-06-01,400522,0,29,29,0,2,2
2023-06-01,49492,0,2,2,0,1,1
2023-06-01,209451,0,1,1,0,1,1
2023-06-01,60389,0,3,3,0,1,1
2023-06-01,209289,0,1,1,0,1,1
2023-06-01,207343,0,6,6,0,2,2
2023-06-01,34641,0,4,4,0,3,3
2023-06-01,207781,0,6,6,0,3,3
2023-06-01,210712,0,0,0,0,2,2
2023-06-01,213327,0,5,5,0,4,4
2023-06-01,203868,0,3,3,0,4,4
2023-06-01,206304,0,1,1,0,2,2
2023-06-01,202572,0,1,1,0,3,3
2023-06-01,210695,0,9,9,0,1,1
2023-06-01,49748,0,1,1,0,1,1
2023-06-01,205415,0,1,1,0,3,3
2023-06-01,205723,0,1,1,0,3,3
2023-06-01,203279,0,1,1,0,1,1
2023-06-01,213396,0,1,1,0,2,2
2023-06-01,213341,0,1,1,0,2,2
2023-06-01,48662,0,1,1,0,1,1
2023-06-01,57755,0,1,1,0,1,1
2023-06-01,42780,0,1,1,0,1,1
2023-06-01,209437,0,1,1,0,1,1
2023-06-01,47926,0,4,4,0,2,2
2023-06-01,200850,0,1,1,0,1,1
2023-06-01,200267,0,1,1,0,1,1
2023-06-01,200853,0,4,4,0,2,2
2023-06-01,212532,0,1,1,0,1,1
2023-06-01,200556,0,4,4,0,1,1
2023-06-01,199651,0,1,1,0,1,1
2023-06-01,200210,0,4,4,0,1,1
2023-06-01,200708,0,2,2,0,2,2
2023-06-01,200219,0,3,3,0,3,3
2023-06-01,207079,0,3,3,0,3,3
2023-06-01,200256,0,1,1,0,1,1
2023-06-01,200335,0,1,1,0,1,1
2023-06-01,199751,0,1,1,0,1,1
2023-06-01,199347,0,6,6,0,2,2
2023-06-01,211576,0,1,1,0,1,1
2023-06-01,200201,0,1,1,0,1,1
2023-06-01,208185,0,1,1,0,2,2
2023-06-01,200179,0,3,3,0,4,4
2023-06-01,200103,0,1,1,0,1,1
2023-06-01,57934,0,1,1,0,1,1
2023-06-01,199763,0,4,4,0,3,3
2023-06-01,50224,0,2,2,0,2,2
2023-06-01,204676,0,1,1,0,1,1
2023-06-01,49105,0,3,3,0,4,4
2023-06-01,48818,0,51,51,0,2,2
2023-06-01,199613,0,13,13,0,10,10
2023-06-01,199594,0,1,1,0,3,3
2023-06-01,199488,0,3,3,0,2,2
2023-06-01,199344,0,2,2,0,1,1
2023-06-01,213293,0,2,2,0,1,1
2023-06-01,203843,0,1,1,0,1,1
2023-06-01,200800,0,1,1,0,1,1
2023-06-01,200690,0,7,7,0,4,4
2023-06-01,200558,0,1,1,0,1,1
2023-06-01,200307,0,1,1,0,1,1
2023-06-01,50755,0,4,4,0,2,2
2023-06-01,200731,0,17,17,0,4,4
2023-06-01,200255,0,3,3,0,3,3
2023-06-01,205183,0,3,3,0,3,3
2023-06-01,200840,0,1,1,0,1,1
2023-06-01,212164,0,14,14,0,7,7
2023-06-01,200728,0,1,1,0,1,1
2023-06-01,200936,0,1,1,0,1,1
2023-06-01,200895,0,1,1,0,2,2
2023-06-01,201504,0,1,1,0,1,1
2023-06-01,199514,0,3,3,0,3,3
2023-06-01,205987,0,1,1,0,1,1
2023-06-01,49548,0,5,5,0,3,3
2023-06-01,200907,0,1,1,0,1,1
2023-06-01,200882,0,2,2,0,2,2
2023-06-01,200545,0,1,1,0,2,2
2023-06-01,205794,0,3,3,0,4,4
2023-06-01,200716,0,1,1,0,1,1
2023-06-01,50219,0,1,1,0,1,1
2023-06-01,206986,0,1,1,0,1,1
2023-06-01,35594,0,2,2,0,1,1
2023-06-01,59922,0,4,4,0,2,2
2023-06-01,31168,0,1,1,0,1,1
2023-06-01,211375,0,1,1,0,1,1
2023-06-01,207152,0,1,1,0,1,1
2023-06-01,6369,0,1,1,0,1,1
2023-06-01,204363,0,4,4,0,2,2
2023-06-01,203564,0,1,1,0,1,1
2023-06-01,210596,0,1,1,0,1,1
2023-06-01,51837,0,6,6,0,1,1
2023-06-01,205749,0,5,5,0,1,1
2023-06-01,209556,0,1,1,0,2,2
2023-06-01,210902,0,1,1,0,1,1
2023-06-01,212450,0,1,1,0,1,1
2023-06-01,44754,0,1,1,0,1,1
2023-06-01,202307,0,1,1,0,1,1
2023-06-01,201331,0,1,1,0,1,1
2023-06-01,43685,0,3,3,0,1,1
2023-06-01,206315,0,1,1,0,2,2
2023-06-01,212521,0,6,6,0,1,1
2023-06-01,44582,0,2,2,0,1,1
2023-06-01,205603,0,2,2,0,1,1
2023-06-01,41979,0,1,1,0,1,1
2023-06-01,205618,0,1,1,0,1,1
2023-06-01,205610,0,8,8,0,2,2
2023-06-01,49904,0,1,1,0,1,1
2023-06-01,205152,0,2,2,0,2,2
2023-06-01,205699,0,1,1,0,1,1
2023-06-01,208249,0,1,1,0,1,1
2023-06-01,60271,0,2,2,0,1,1
2023-06-01,207080,0,2,2,0,4,4
2023-06-01,206699,0,5,5,0,2,2
2023-06-01,212232,0,1,1,0,1,1
2023-06-01,211387,0,2,2,0,1,1
2023-06-01,34856,0,3,3,0,1,1
2023-06-01,205494,0,1,1,0,1,1
2023-06-01,210589,0,1,1,0,1,1
2023-06-01,56708,0,6,6,0,2,2
2023-06-01,39117,0,3,3,0,1,1
2023-06-01,204378,0,1,1,0,1,1
2023-06-01,56434,0,1,1,0,1,1
2023-06-01,47945,0,2,2,0,1,1
2023-06-01,47893,0,1,1,0,1,1
2023-06-01,201996,0,0,0,0,2,2
2023-06-01,213288,0,1,1,0,1,1
2023-06-01,207965,0,3,3,0,1,1
2023-06-01,206824,0,3,3,0,1,1
2023-06-01,200857,0,1,1,0,2,2
2023-06-01,204438,0,6,6,0,3,3
2023-06-01,213385,0,1,1,0,2,2
2023-06-01,199689,0,4,4,0,3,3
2023-06-01,199109,0,1,1,0,1,1
2023-06-01,199266,0,4,4,0,2,2
2023-06-01,199307,0,1,1,0,1,1
2023-06-01,212996,0,16,16,0,3,3
2023-06-01,209533,0,2,2,0,2,2
2023-06-01,41498,0,5,5,0,1,1
2023-06-01,209716,0,1,1,0,1,1
2023-06-01,205523,0,1,1,0,1,1
2023-06-01,212299,0,1,1,0,2,2
2023-06-01,212007,0,2,2,0,1,1
2023-06-01,211364,0,2,2,0,4,4
2023-06-01,57470,0,2,2,0,1,1
2023-06-01,39792,0,1,1,0,1,1
2023-06-01,209661,0,4,4,0,5,5
2023-06-01,207149,0,1,1,0,7,7
2023-06-01,212625,0,2,2,0,2,2
2023-06-01,212510,0,1,1,0,2,2
2023-06-01,209606,0,13,13,0,4,4
2023-06-01,206592,0,3,3,0,3,3
2023-06-01,209389,0,2,2,0,1,1
2023-06-01,211944,0,2,2,0,1,1
2023-06-01,211891,0,2,2,0,1,1
2023-06-01,210344,0,2,2,0,1,1
2023-06-01,208333,0,2,2,0,1,1
2023-06-01,208421,0,2,2,0,1,1
2023-06-01,208471,0,2,2,0,1,1
2023-06-01,208749,0,2,2,0,1,1
2023-06-01,208771,0,2,2,0,1,1
2023-06-01,208850,0,2,2,0,1,1
2023-06-01,210335,0,2,2,0,1,1
2023-06-01,210348,0,2,2,0,1,1
2023-06-01,206058,0,2,2,0,1,1
2023-06-01,207359,0,2,2,0,1,1
2023-06-01,209586,0,1,1,0,1,1
2023-06-01,210481,0,2,2,0,4,4
2023-06-01,210469,0,1,1,0,1,1
2023-06-01,213015,0,1,1,0,3,3
2023-06-01,210189,0,1,1,0,1,1
2023-06-01,213201,0,2,2,0,4,4
2023-06-01,206368,0,1,1,0,1,1
2023-06-01,207363,0,1,1,0,2,2
2023-06-01,207338,0,4,4,0,5,5
2023-06-01,207299,0,1,1,0,3,3
2023-06-01,207301,0,4,4,0,2,2
2023-06-01,205778,0,1,1,0,1,1
2023-06-01,206425,0,1,1,0,1,1
2023-06-01,210233,0,1,1,0,5,5
2023-06-01,211754,0,1,1,0,1,1
2023-06-01,200153,0,1,1,0,1,1
2023-06-01,200118,0,1,1,0,3,3
2023-06-01,213219,0,1,1,0,1,1
2023-06-01,199258,0,1,1,0,1,1
2023-06-01,198764,0,4,4,0,6,6
2023-06-01,209527,0,1,1,0,2,2
2023-06-01,399975,0,13,13,0,1,1
2023-06-01,210951,0,8,8,0,7,7
2023-06-01,207968,0,1,1,0,4,4
2023-06-01,204646,0,1,1,0,1,1
2023-06-01,50801,0,2,2,0,1,1
2023-06-01,49133,0,1,1,0,1,1
2023-06-01,209261,0,3,3,0,2,2
2023-06-01,213115,0,1,1,0,1,1
2023-06-01,209419,0,7,7,0,1,1
2023-06-01,41838,0,1,1,0,1,1
2023-06-01,34202,0,1,1,0,1,1
2023-06-01,34672,0,1,1,0,1,1
2023-06-01,44167,0,1,1,0,1,1
2023-06-01,205145,0,1,1,0,2,2
2023-06-01,397881,0,2,2,0,2,2
2023-06-01,48079,0,2,2,0,1,1
2023-06-01,210662,0,3,3,0,1,1
2023-06-01,204888,0,1,1,0,1,1
2023-06-01,210400,0,1,1,0,1,1
2023-06-01,212500,0,1,1,0,2,2
2023-06-01,209334,0,1,1,0,2,2
2023-06-01,209083,0,2,2,0,1,1
2023-06-01,208266,0,3,3,0,1,1
2023-06-01,209112,0,1,1,0,1,1
2023-06-01,59566,0,1,1,0,1,1
2023-06-01,43282,0,2,2,0,1,1
2023-06-01,57757,0,1,1,0,2,2
2023-06-01,51745,0,1,1,0,3,3
2023-06-01,211579,0,3,3,0,4,4
2023-06-01,50580,0,247,247,0,1,1
2023-06-01,147047,0,1,1,0,1,1
2023-06-01,212767,0,2,2,0,3,3
2023-06-01,213326,0,11,11,0,3,3
2023-06-01,142597,0,7,7,0,1,1
2023-06-01,207955,0,1,1,0,2,2
2023-06-01,209771,0,1,1,0,3,3
2023-06-01,52042,0,5,5,0,2,2
2023-06-01,209121,0,1,1,0,1,1
2023-06-01,57616,0,1,1,0,1,1
2023-06-01,209833,0,3,3,0,1,1
2023-06-01,60742,0,1,1,0,1,1
2023-06-01,48627,0,2,2,0,1,1
2023-06-01,49933,0,5,5,0,6,6
2023-06-01,211635,0,6,6,0,4,4
2023-06-01,211414,0,2,2,0,2,2
2023-06-01,211168,0,1,1,0,2,2
2023-06-01,211153,0,4,4,0,1,1
2023-06-01,203528,0,1,1,0,2,2
2023-06-01,49192,0,1,1,0,1,1
2023-06-01,211860,0,2,2,0,1,1
2023-06-01,198480,0,1,1,0,2,2
2023-06-01,213127,0,1,1,0,2,2
2023-06-01,213033,0,1,1,0,2,2
2023-06-01,213031,0,1,1,0,1,1
2023-06-01,211980,0,1,1,0,1,1
2023-06-01,212844,0,1,1,0,1,1
2023-06-01,212331,0,1,1,0,1,1
2023-06-01,212112,0,1,1,0,2,2
2023-06-01,211747,0,1,1,0,1,1
2023-06-01,211498,0,1,1,0,3,3
2023-06-01,211522,0,2,2,0,1,1
2023-06-01,212519,0,1,1,0,5,5
2023-06-01,212577,0,2,2,0,1,1
2023-06-01,211242,0,3,3,0,1,1
2023-06-01,210707,0,1,1,0,1,1
2023-06-01,203738,0,1,1,0,1,1
2023-06-01,212387,0,1,1,0,1,1
2023-06-01,200240,0,2,2,0,2,2
2023-06-01,200224,0,1,1,0,1,1
2023-06-01,198797,0,1,1,0,1,1
2023-06-01,208809,0,1,1,0,1,1
2023-06-01,17818,0,1,1,0,1,1
2023-06-01,211868,0,16,16,0,1,1
2023-06-01,211840,0,4,4,0,4,4
2023-06-01,211337,0,1,1,0,1,1
2023-06-01,211688,0,2,2,0,4,4
2023-06-01,211685,0,3,3,0,4,4
2023-06-01,198747,0,1,1,0,1,1
2023-06-01,204750,0,6,6,0,3,3
2023-06-01,212539,0,6,6,0,1,1
2023-06-01,59936,0,1,1,0,1,1
2023-06-01,211275,0,4,4,0,3,3
2023-06-01,211267,0,2,2,0,2,2
2023-06-01,211044,0,1,1,0,1,1
2023-06-01,203074,0,4,4,0,2,2
2023-06-01,211024,0,3,3,0,3,3
2023-06-01,202976,0,1,1,0,1,1
2023-06-01,202929,0,3,3,0,4,4
2023-06-01,58336,0,20,20,0,3,3
2023-06-01,210617,0,1,1,0,1,1
2023-06-01,51939,0,6,6,0,1,1
2023-06-01,210426,0,1,1,0,2,2
2023-06-01,200872,0,2,2,0,1,1
2023-06-01,200625,0,1,1,0,2,2
2023-06-01,208328,0,4,4,0,4,4
2023-06-01,56758,0,6,6,0,4,4
2023-06-01,49953,0,1,1,0,1,1
2023-06-01,210076,0,1,1,0,3,3
2023-06-01,213367,0,1,1,0,1,1
2023-06-01,208779,0,1,1,0,1,1
2023-06-01,208699,0,3,3,0,1,1
2023-06-01,208260,0,4,4,0,2,2
2023-06-01,210836,0,1,1,0,2,2
2023-06-01,207662,0,2,2,0,5,5
2023-06-01,212935,0,1,1,0,1,1
2023-06-01,210397,0,7,7,0,2,2
2023-06-01,198661,0,1,1,0,1,1
2023-06-01,207043,0,1,1,0,1,1
2023-06-01,212427,0,18,18,0,5,5
2023-06-01,199956,0,4,4,0,1,1
2023-06-01,206895,0,2,2,0,1,1
2023-06-01,198599,0,2,2,0,1,1
2023-06-01,205121,0,1,1,0,2,2
2023-06-01,205043,0,3,3,0,2,2
2023-06-01,204610,0,1,1,0,1,1
2023-06-01,204160,0,1,1,0,1,1
2023-06-01,49922,0,17,17,0,3,3
2023-06-01,204051,0,17,17,0,1,1
2023-06-01,208840,0,1,1,0,1,1
2023-06-01,202184,0,1,1,0,1,1
2023-06-01,211979,0,1,1,0,1,1
2023-06-01,201412,0,2,2,0,2,2
2023-06-01,201197,0,1,1,0,1,1
2023-06-01,60939,0,4,4,0,1,1
2023-06-01,210499,0,3,3,0,1,1
2023-06-01,213169,0,2,2,0,2,2
2023-06-01,206843,0,2,2,0,2,2
2023-06-01,208370,0,1,1,0,3,3
2023-06-01,212916,0,1,1,0,1,1
2023-06-01,210934,0,1,1,0,1,1
2023-06-01,210903,0,33,33,0,3,3
2023-06-01,210815,0,3,3,0,2,2
2023-06-01,205825,0,1,1,0,1,1
2023-06-01,209837,0,1,1,0,1,1
2023-06-01,203664,0,1,1,0,3,3
2023-06-01,200021,0,7,7,0,2,2
2023-06-01,199684,0,8,8,0,5,5
2023-06-01,198768,0,1,1,0,1,1
2023-06-01,198734,0,16,16,0,8,8
2023-06-01,198527,0,1,1,0,1,1
2023-06-01,149007,0,3,3,0,1,1
2023-06-01,139216,0,4,4,0,4,4
2023-06-01,208680,0,32,32,0,1,1
2023-06-01,212227,0,2,2,0,2,2
2023-06-01,204982,0,1,1,0,3,3
2023-06-01,207683,0,2,2,0,2,2
2023-06-01,207401,0,3,3,0,2,2
2023-06-01,209101,0,3,3,0,2,2
2023-06-01,213188,0,2,2,0,2,2
2023-06-01,213171,0,1,1,0,2,2
2023-06-01,210980,0,1,1,0,1,1
2023-06-01,50798,0,2,2,0,1,1
2023-06-01,199183,0,2,2,0,4,4
2023-06-01,140936,0,1,1,0,1,1
2023-06-01,213244,0,1,1,0,3,3
2023-06-01,39282,0,2,2,0,1,1
2023-06-01,212120,0,2,2,0,5,5
2023-06-01,212268,0,1,1,0,2,2
2023-06-01,212270,0,2,2,0,3,3
2023-06-01,200516,0,1,1,0,1,1
2023-06-01,212121,0,7,7,0,6,6
2023-06-01,211231,0,1,1,0,1,1
2023-06-01,210926,0,2,2,0,1,1
2023-06-01,199186,0,1,1,0,1,1
2023-06-01,200367,0,1,1,0,1,1
2023-06-01,204611,0,3,3,0,1,1
2023-06-01,211411,0,32,32,0,5,5
2023-06-01,198535,0,2,2,0,1,1
2023-06-01,209391,0,16,16,0,1,1
2023-06-01,151349,0,5,5,0,3,3
2023-06-01,199068,0,7,7,0,2,2
2023-06-01,210960,0,4,4,0,3,3
2023-06-01,211066,0,1,1,0,1,1
2023-06-01,202436,0,1,1,0,1,1
2023-06-01,212971,0,1,1,0,3,3
2023-06-01,212970,0,1,1,0,1,1
2023-06-01,57048,0,1,1,0,2,2
2023-06-01,209883,0,1,1,0,1,1
2023-06-01,201963,0,1,1,0,1,1
2023-06-01,213249,0,1,1,0,2,2
2023-06-01,139921,0,1,1,0,2,2
2023-06-01,208624,0,1,1,0,1,1
2023-06-01,213253,0,1,1,0,2,2
2023-06-01,210383,0,1,1,0,1,1
2023-06-01,210305,0,1,1,0,1,1
2023-06-01,206715,0,1,1,0,1,1
2023-06-01,210888,0,1,1,0,1,1
2023-06-01,203656,0,1,1,0,1,1
2023-06-01,201760,0,1,1,0,1,1
2023-06-01,44258,0,1,1,0,1,1
2023-06-01,199779,0,1,1,0,1,1
2023-06-01,208150,0,1,1,0,1,1
2023-06-01,211132,0,2,2,0,1,1
2023-06-01,60236,0,1,1,0,1,1
2023-06-01,211626,0,1,1,0,1,1
2023-06-01,34658,0,1,1,0,1,1
2023-06-01,43959,0,1,1,0,1,1
2023-06-01,212592,0,2,2,0,2,2
2023-06-01,48126,0,1,1,0,2,2
2023-06-01,205210,0,2,2,0,1,1
2023-06-01,212591,0,2,2,0,1,1
2023-06-01,207469,0,1,1,0,2,2
2023-06-01,50310,0,1,1,0,1,1
2023-06-01,60472,0,1,1,0,1,1
2023-06-01,203307,0,2,2,0,1,1
2023-06-01,205719,0,1,1,0,1,1
2023-06-01,49470,0,1,1,0,1,1
2023-06-01,211027,0,17,17,0,1,1
2023-06-01,39900,0,3,3,0,1,1
2023-06-01,212623,0,4,4,0,3,3
2023-06-01,209735,0,1,1,0,1,1
2023-06-01,207831,0,2,2,0,2,2
2023-06-01,206792,0,1,1,0,1,1
2023-06-01,211966,0,1,1,0,1,1
2023-06-01,61290,0,1,1,0,1,1
2023-06-01,61421,0,1,1,0,2,2
2023-06-01,207267,0,1,1,0,3,3
2023-06-01,203040,0,1,1,0,1,1
2023-06-01,198959,0,1,1,0,1,1
2023-06-01,200241,0,4,4,0,2,2
2023-06-01,207890,0,3,3,0,1,1
2023-06-01,58093,0,2,2,0,1,1
2023-06-01,213312,0,1,1,0,2,2
2023-06-01,207756,0,1,1,0,1,1
2023-06-01,41255,0,1,1,0,1,1
2023-06-01,208083,0,1,1,0,1,1
2023-06-01,211672,0,1,1,0,2,2
2023-06-01,207801,0,1,1,0,1,1
2023-06-01,204755,0,9,9,0,1,1
2023-06-01,50028,0,1,1,0,1,1
2023-06-01,208317,0,1,1,0,1,1
2023-06-01,197424,0,1,1,0,1,1
2023-06-01,207650,0,2,2,0,3,3
2023-06-01,58133,0,1,1,0,2,2
2023-06-01,205635,0,5,5,0,1,1
2023-06-01,213383,0,1,1,0,1,1
2023-06-01,210074,0,1,1,0,1,1
2023-06-01,208893,0,1,1,0,1,1
2023-06-01,209225,0,4,4,0,1,1
2023-06-01,202747,0,1,1,0,1,1
2023-06-01,213164,0,1,1,0,3,3
2023-06-01,50922,0,1,1,0,1,1
2023-06-01,42101,0,1,1,0,1,1
2023-06-01,212124,0,1,1,0,1,1
2023-06-01,212106,0,2,2,0,1,1
2023-06-01,47157,0,2,2,0,1,1
2023-06-01,211617,0,1,1,0,1,1
2023-06-01,210816,0,1,1,0,1,1
2023-06-01,210810,0,1,1,0,1,1
2023-06-01,207708,0,1,1,0,1,1
2023-06-01,57080,0,2,2,0,2,2
2023-06-01,205021,0,1,1,0,1,1
2023-06-01,201480,0,1,1,0,1,1
2023-06-01,60668,0,1,1,0,1,1
2023-06-01,198596,0,1,1,0,1,1
2023-06-01,204125,0,1,1,0,1,1
2023-06-01,208914,0,6,6,0,1,1
2023-06-01,49689,0,1,1,0,1,1
2023-06-01,6729,0,1,1,0,1,1
2023-06-01,202340,0,5,5,0,1,1
2023-06-01,49768,0,1,1,0,2,2
2023-06-01,200099,0,1,1,0,1,1
2023-06-01,210563,0,2,2,0,2,2
2023-06-01,208454,0,3,3,0,1,1
2023-06-01,200950,0,4,4,0,5,5
2023-06-01,398464,0,3,3,0,2,2
2023-06-01,48878,0,1,1,0,1,1
2023-06-01,210916,0,8,8,0,2,2
2023-06-01,56897,0,3,3,0,1,1
2023-06-01,60935,0,3,3,0,1,1
2023-06-01,61192,0,3,3,0,1,1
2023-06-01,39182,0,4,4,0,1,1
2023-06-01,210985,0,1,1,0,1,1
2023-06-01,60894,0,1,1,0,1,1
2023-06-01,61100,0,5,5,0,1,1
2023-06-01,200198,0,1,1,0,1,1
2023-06-01,204224,0,5,5,0,1,1
2023-06-01,47362,0,3,3,0,1,1
2023-06-01,49655,0,5,5,0,1,1
2023-06-01,203942,0,5,5,0,1,1
2023-06-01,210807,0,1,1,0,1,1
2023-06-01,210852,0,3,3,0,1,1
2023-06-01,210652,0,2,2,0,2,2
2023-06-01,209164,0,1,1,0,3,3
2023-06-01,207318,0,1,1,0,2,2
2023-06-01,212568,0,4,4,0,4,4
2023-06-01,212245,0,2,2,0,1,1
2023-06-01,205589,0,1,1,0,1,1
2023-06-01,203024,0,1,1,0,2,2
2023-06-01,209245,0,1,1,0,3,3
2023-06-01,204017,0,1,1,0,3,3
2023-06-01,40963,0,1,1,0,1,1
2023-06-01,44379,0,1,1,0,1,1
2023-06-01,51250,0,1,1,0,1,1
2023-06-01,204701,0,5,5,0,1,1
2023-06-01,44659,0,4,4,0,1,1
2023-06-01,41918,0,3,3,0,1,1
2023-06-01,209988,0,1,1,0,1,1
2023-06-01,202408,0,1,1,0,1,1
2023-06-01,200949,0,1,1,0,1,1
2023-06-01,138211,0,1,1,0,1,1
2023-06-01,204183,0,5,5,0,1,1
2023-06-01,39106,0,3,3,0,1,1
2023-06-01,212389,0,1,1,0,1,1
2023-06-01,207574,0,1,1,0,2,2
2023-06-01,211184,0,1,1,0,2,2
2023-06-01,209958,0,1,1,0,2,2
2023-06-01,210434,0,4,4,0,1,1
2023-06-01,212104,0,1,1,0,1,1
2023-06-01,204187,0,5,5,0,1,1
2023-06-01,56414,0,1,1,0,1,1
2023-06-01,57797,0,2,2,0,6,6
2023-06-01,49316,0,1,1,0,1,1
2023-06-01,207084,0,1,1,0,1,1
2023-06-01,57097,0,1,1,0,1,1
2023-06-01,48734,0,1,1,0,1,1
2023-06-01,48743,0,1,1,0,1,1
2023-06-01,138330,0,1,1,0,1,1
2023-06-01,212353,0,1,1,0,1,1
2023-06-01,209263,0,1,1,0,1,1
2023-06-01,206125,0,3,3,0,3,3
2023-06-01,199695,0,1,1,0,1,1
2023-06-01,58052,0,4,4,0,2,2
2023-06-01,199671,0,2,2,0,1,1
2023-06-01,199423,0,4,4,0,1,1
2023-06-01,199111,0,1,1,0,1,1
2023-06-01,199030,0,1,1,0,1,1
2023-06-01,199654,0,3,3,0,2,2
2023-06-01,199519,0,6,6,0,1,1
2023-06-01,199175,0,2,2,0,1,1
2023-06-01,208453,0,1,1,0,1,1
2023-06-01,52181,0,1,1,0,1,1
2023-06-01,198699,0,1,1,0,1,1
2023-06-01,198590,0,2,2,0,1,1
2023-06-01,42505,0,1,1,0,1,1
2023-06-01,34425,0,1,1,0,1,1
2023-06-01,44445,0,2,2,0,1,1
2023-06-01,47316,0,5,5,0,3,3
2023-06-01,205696,0,1,1,0,1,1
2023-06-01,199203,0,7,7,0,2,2
2023-06-01,199331,0,1,1,0,1,1
2023-06-01,212168,0,5,5,0,4,4
2023-06-01,200226,0,1,1,0,1,1
2023-06-01,203529,0,2,2,0,2,2
2023-06-01,198954,0,1,1,0,1,1
2023-06-01,202996,0,2,2,0,1,1
2023-06-01,203145,0,8,8,0,2,2
2023-06-01,202412,0,1,1,0,1,1
2023-06-01,203737,0,4,4,0,3,3
2023-06-01,199682,0,1,1,0,1,1
2023-06-01,201386,0,2,2,0,2,2
2023-06-01,50555,0,1,1,0,1,1
2023-06-01,201398,0,1,1,0,1,1
2023-06-01,56731,0,1,1,0,1,1
2023-06-01,50836,0,2,2,0,1,1
2023-06-01,212503,0,3,3,0,3,3
2023-06-01,199693,0,2,2,0,2,2
2023-06-01,26533,0,2,2,0,4,4
2023-06-01,202573,0,3,3,0,4,4
2023-06-01,207962,0,1,1,0,1,1
2023-06-01,208022,0,8,8,0,1,1
2023-06-01,205154,0,1,1,0,1,1
2023-06-01,199841,0,1,1,0,1,1
2023-06-01,211833,0,1,1,0,1,1
2023-06-01,49844,0,1,1,0,1,1
2023-06-01,204214,0,1,1,0,1,1
2023-06-01,204089,0,1,1,0,1,1
2023-06-01,202361,0,1,1,0,1,1
2023-06-01,202066,0,1,1,0,1,1
2023-06-01,57521,0,2,2,0,2,2
2023-06-01,201712,0,1,1,0,1,1
2023-06-01,201988,0,1,1,0,1,1
2023-06-01,51236,0,1,1,0,1,1
2023-06-01,51345,0,3,3,0,2,2
2023-06-01,56648,0,1,1,0,1,1
2023-06-01,201348,0,1,1,0,2,2
2023-06-01,204037,0,1,1,0,1,1
2023-06-01,204091,0,4,4,0,1,1
2023-06-01,51126,0,2,2,0,1,1
2023-06-01,204318,0,10,10,0,1,1
2023-06-01,202278,0,1,1,0,2,2
2023-06-01,57644,0,1,1,0,1,1
2023-06-01,200617,0,1,1,0,1,1
2023-06-01,200327,0,1,1,0,1,1
2023-06-01,44283,0,1,1,0,2,2
2023-06-01,207175,0,3,3,0,2,2
2023-06-01,208029,0,3,3,0,3,3
2023-06-01,213320,0,1,1,0,1,1
2023-06-01,207142,0,2,2,0,1,1
2023-06-01,199683,0,7,7,0,5,5
2023-06-01,199460,0,1,1,0,1,1
2023-06-01,199436,0,4,4,0,2,2
2023-06-01,199465,0,1,1,0,1,1
2023-06-01,59486,0,1,1,0,1,1
2023-06-01,7719,0,1,1,0,1,1
2023-06-01,13586,0,1,1,0,1,1
2023-06-01,202151,0,2,2,0,4,4
2023-06-01,209658,0,1,1,0,1,1
2023-06-01,199176,0,1,1,0,2,2
2023-06-01,199108,0,1,1,0,2,2
2023-06-01,199327,0,1,1,0,2,2
2023-06-01,199227,0,1,1,0,1,1
2023-06-01,200203,0,2,2,0,1,1
2023-06-01,62414,0,1,1,0,1,1
2023-06-01,60743,0,1,1,0,1,1
2023-06-01,199471,0,1,1,0,2,2
2023-06-01,328889,0,1,1,0,1,1
2023-06-01,328962,0,6,6,0,4,4
2023-06-01,4200000001,0,0,0,0,2,2
2023-06-01,4200000002,0,1,1,0,1,1
2023-06-01,64613,0,2,2,0,1,1
2023-06-01,37277,0,1,1,0,1,1
